,timestamp,call,put,diff,sellOrBuy
18-09-20 9:15,9:15,6647000,5133575,-1513425,SELL
18-09-20 9:16,9:16,6615975,5139250,-1476725,SELL
18-09-20 9:17,9:17,6979300,5609275,-1370025,SELL
18-09-20 9:18,9:18,6907975,5406575,-1501400,SELL
18-09-20 9:19,9:19,6940575,5620950,-1319625,SELL
18-09-20 9:20,9:20,7285825,5870800,-1415025,SELL
18-09-20 9:21,9:21,7198675,5814250,-1384425,SELL
18-09-20 9:22,9:22,7260400,5757575,-1502825,SELL
18-09-20 9:23,9:23,7474100,5704625,-1769475,SELL
18-09-20 9:24,9:24,7385075,5848350,-1536725,SELL
18-09-20 9:25,9:25,7491600,5752675,-1738925,SELL
18-09-20 9:26,9:26,7532150,6052475,-1479675,SELL
18-09-20 9:27,9:27,7576625,6057400,-1519225,SELL
18-09-20 9:28,9:28,7482775,6044550,-1438225,SELL
18-09-20 9:29,9:29,7604475,6164700,-1439775,SELL
18-09-20 9:30,9:30,7605225,6040725,-1564500,SELL
18-09-20 9:31,9:31,7718425,6223600,-1494825,SELL
18-09-20 9:32,9:32,7813500,6178775,-1634725,SELL
18-09-20 9:33,9:33,7710850,6167725,-1543125,SELL
18-09-20 9:34,9:34,7817875,6001100,-1816775,SELL
18-09-20 9:35,9:35,7845750,6315375,-1530375,SELL
18-09-20 9:36,9:36,7843700,5914550,-1929150,SELL
18-09-20 9:37,9:37,7917075,6007100,-1909975,SELL
18-09-20 9:38,9:38,7882025,6316750,-1565275,SELL
18-09-20 9:39,9:39,7955200,6322575,-1632625,SELL
18-09-20 9:40,9:40,7865650,6055375,-1810275,SELL
18-09-20 9:41,9:41,7911800,6356450,-1555350,SELL
18-09-20 9:42,9:42,8015675,6436975,-1578700,SELL
18-09-20 9:43,9:43,7927725,6439100,-1488625,SELL
18-09-20 9:44,9:44,8104450,6318475,-1785975,SELL
18-09-20 9:45,9:45,8121125,6472025,-1649100,SELL
18-09-20 9:46,9:46,8103900,6131550,-1972350,SELL
18-09-20 9:47,9:47,8104125,6536125,-1568000,SELL
18-09-20 9:48,9:48,8145550,6400525,-1745025,SELL
18-09-20 9:49,9:49,8117350,6406750,-1710600,SELL
18-09-20 9:50,9:50,8199875,6395850,-1804025,SELL
18-09-20 9:51,9:51,8170000,6545775,-1624225,SELL
18-09-20 9:52,9:52,8125800,6371400,-1754400,SELL
18-09-20 9:53,9:53,8065825,6147125,-1918700,SELL
18-09-20 9:54,9:54,8142775,6501000,-1641775,SELL
18-09-20 9:55,9:55,8214600,6437600,-1777000,SELL
18-09-20 9:56,9:56,8129975,6494875,-1635100,SELL
18-09-20 9:57,9:57,8077625,6460475,-1617150,SELL
18-09-20 9:58,9:58,8243675,6548600,-1695075,SELL
18-09-20 9:59,9:59,8169600,6608175,-1561425,SELL
18-09-20 10:00,10:00,8244050,6474175,-1769875,SELL
18-09-20 10:01,10:01,8135525,6476100,-1659425,SELL
18-09-20 10:02,10:02,8276675,6522250,-1754425,SELL
18-09-20 10:03,10:03,8358225,6741225,-1617000,SELL
18-09-20 10:04,10:04,8244550,6412225,-1832325,SELL
18-09-20 10:05,10:05,8323025,6531350,-1791675,SELL
18-09-20 10:06,10:06,8381550,6615325,-1766225,SELL
18-09-20 10:07,10:07,8287725,6440025,-1847700,SELL
18-09-20 10:08,10:08,8417850,6808650,-1609200,SELL
18-09-20 10:09,10:09,8483125,6756200,-1726925,SELL
18-09-20 10:10,10:10,8470675,6759975,-1710700,SELL
18-09-20 10:11,10:11,8479225,6803825,-1675400,SELL
18-09-20 10:12,10:12,8546675,6841250,-1705425,SELL
18-09-20 10:13,10:13,8465000,6794225,-1670775,SELL
18-09-20 10:14,10:14,8641875,6856350,-1785525,SELL
18-09-20 10:15,10:15,8656550,6854375,-1802175,SELL
18-09-20 10:16,10:16,8628650,6816675,-1811975,SELL
18-09-20 10:17,10:17,8609975,6522850,-2087125,SELL
18-09-20 10:18,10:18,8641675,6881275,-1760400,SELL
18-09-20 10:19,10:19,8608950,6876450,-1732500,SELL
18-09-20 10:20,10:20,8761875,6792525,-1969350,SELL
18-09-20 10:21,10:21,8556600,6952975,-1603625,SELL
18-09-20 10:22,10:22,8751150,6912000,-1839150,SELL
18-09-20 10:23,10:23,8724375,6932975,-1791400,SELL
18-09-20 10:24,10:24,8740175,6683225,-2056950,SELL
18-09-20 10:25,10:25,8679675,6503475,-2176200,SELL
18-09-20 10:26,10:26,8848950,6883950,-1965000,SELL
18-09-20 10:27,10:27,8772300,6853150,-1919150,SELL
18-09-20 10:28,10:28,8740025,6494200,-2245825,SELL
18-09-20 10:29,10:29,8717975,6597575,-2120400,SELL
18-09-20 10:30,10:30,8792450,6762975,-2029475,SELL
18-09-20 10:31,10:31,8691575,6851800,-1839775,SELL
18-09-20 10:32,10:32,8661150,6705975,-1955175,SELL
18-09-20 10:33,10:33,8687900,6721350,-1966550,SELL
18-09-20 10:34,10:34,8841000,6651975,-2189025,SELL
18-09-20 10:35,10:35,8974925,6597125,-2377800,SELL
18-09-20 10:36,10:36,8763525,6348025,-2415500,SELL
18-09-20 10:37,10:37,8938525,6851050,-2087475,SELL
18-09-20 10:38,10:38,8920500,6548525,-2371975,SELL
18-09-20 10:39,10:39,8991100,6467725,-2523375,SELL
18-09-20 10:40,10:40,8996100,6966025,-2030075,SELL
18-09-20 10:41,10:41,9077250,6959150,-2118100,SELL
18-09-20 10:42,10:42,9003225,6511125,-2492100,SELL
18-09-20 10:43,10:43,9080875,6675725,-2405150,SELL
18-09-20 10:44,10:44,9006250,6775675,-2230575,SELL
18-09-20 10:45,10:45,9052050,6776775,-2275275,SELL
18-09-20 10:46,10:46,9049475,6797625,-2251850,SELL
18-09-20 10:47,10:47,8920625,6647600,-2273025,SELL
18-09-20 10:48,10:48,9149725,6778825,-2370900,SELL
18-09-20 10:49,10:49,9173975,6978300,-2195675,SELL
18-09-20 10:50,10:50,9173125,6782550,-2390575,SELL
18-09-20 10:51,10:51,9142100,7068700,-2073400,SELL
18-09-20 10:52,10:52,9072925,6537025,-2535900,SELL
18-09-20 10:53,10:53,8864850,6543750,-2321100,SELL
18-09-20 10:54,10:54,8838575,6719575,-2119000,SELL
18-09-20 10:55,10:55,9066975,6924625,-2142350,SELL
18-09-20 10:56,10:56,9048200,6960575,-2087625,SELL
18-09-20 10:57,10:57,9080375,6815425,-2264950,SELL
18-09-20 10:58,10:58,8947025,6643850,-2303175,SELL
18-09-20 10:59,10:59,9077225,6654350,-2422875,SELL
18-09-20 11:00,11:00,9175350,7090125,-2085225,SELL
18-09-20 11:01,11:01,8970050,6640325,-2329725,SELL
18-09-20 11:02,11:02,8536525,6832725,-1703800,SELL
18-09-20 11:03,11:03,9113450,6843375,-2270075,SELL
18-09-20 11:04,11:04,9076950,6667450,-2409500,SELL
18-09-20 11:05,11:05,9077900,6902775,-2175125,SELL
18-09-20 11:06,11:06,9159125,6871875,-2287250,SELL
18-09-20 11:07,11:07,9047575,6837475,-2210100,SELL
18-09-20 11:08,11:08,9266225,6889850,-2376375,SELL
18-09-20 11:09,11:09,9292100,6974775,-2317325,SELL
18-09-20 11:10,11:10,9191175,6717700,-2473475,SELL
18-09-20 11:11,11:11,9272925,6817650,-2455275,SELL
18-09-20 11:12,11:12,9367575,7207525,-2160050,SELL
18-09-20 11:13,11:13,9276225,7072750,-2203475,SELL
18-09-20 11:14,11:14,9346425,6990500,-2355925,SELL
18-09-20 11:15,11:15,9357350,7085200,-2272150,SELL
18-09-20 11:16,11:16,9351475,6854125,-2497350,SELL
18-09-20 11:17,11:17,9448575,6763450,-2685125,SELL
18-09-20 11:18,11:18,9476800,6747650,-2729150,SELL
18-09-20 11:19,11:19,9487975,6915225,-2572750,SELL
18-09-20 11:20,11:20,9319750,6885550,-2434200,SELL
18-09-20 11:21,11:21,9405700,7007850,-2397850,SELL
18-09-20 11:22,11:22,9316175,6882525,-2433650,SELL
18-09-20 11:23,11:23,9164375,7045550,-2118825,SELL
18-09-20 11:24,11:24,9449400,6959975,-2489425,SELL
18-09-20 11:25,11:25,9494775,7193425,-2301350,SELL
18-09-20 11:26,11:26,9464975,6828350,-2636625,SELL
18-09-20 11:27,11:27,9554750,6886625,-2668125,SELL
18-09-20 11:28,11:28,9588650,6971450,-2617200,SELL
18-09-20 11:29,11:29,9525800,6645025,-2880775,SELL
18-09-20 11:30,11:30,9693025,7391850,-2301175,SELL
18-09-20 11:31,11:31,9676950,7025125,-2651825,SELL
18-09-20 11:32,11:32,9598925,7242775,-2356150,SELL
18-09-20 11:33,11:33,9597175,7237075,-2360100,SELL
18-09-20 11:34,11:34,9483275,7145700,-2337575,SELL
18-09-20 11:35,11:35,9587200,7222550,-2364650,SELL
18-09-20 11:36,11:36,9542525,6924300,-2618225,SELL
18-09-20 11:37,11:37,9555875,7315700,-2240175,SELL
18-09-20 11:38,11:38,9477575,6952000,-2525575,SELL
18-09-20 11:39,11:39,9544675,7081350,-2463325,SELL
18-09-20 11:40,11:40,9680250,6968425,-2711825,SELL
18-09-20 11:41,11:41,9585100,6998225,-2586875,SELL
18-09-20 11:42,11:42,9591325,7171900,-2419425,SELL
18-09-20 11:43,11:43,9655625,7351700,-2303925,SELL
18-09-20 11:44,11:44,9562600,7157900,-2404700,SELL
18-09-20 11:45,11:45,9533925,7168925,-2365000,SELL
18-09-20 11:46,11:46,9655375,7196525,-2458850,SELL
18-09-20 11:47,11:47,9709325,7223400,-2485925,SELL
18-09-20 11:48,11:48,9657800,6849650,-2808150,SELL
18-09-20 11:49,11:49,9709000,6608725,-3100275,SELL
18-09-20 11:50,11:50,9758150,7058250,-2699900,SELL
18-09-20 11:51,11:51,9664950,7040625,-2624325,SELL
18-09-20 11:52,11:52,9638425,6718675,-2919750,SELL
18-09-20 11:53,11:53,9732150,6579175,-3152975,SELL
18-09-20 11:54,11:54,9794650,7106500,-2688150,SELL
18-09-20 11:55,11:55,9757850,6661900,-3095950,SELL
18-09-20 11:56,11:56,9766350,6795600,-2970750,SELL
18-09-20 11:57,11:57,9711450,7230950,-2480500,SELL
18-09-20 11:58,11:58,9705100,6647325,-3057775,SELL
18-09-20 11:59,11:59,9798300,7242225,-2556075,SELL
18-09-20 12:00,12:00,9773650,6551875,-3221775,SELL
18-09-20 12:01,12:01,9841375,6825775,-3015600,SELL
18-09-20 12:02,12:02,9849550,7135725,-2713825,SELL
18-09-20 12:03,12:03,9845550,6706000,-3139550,SELL
18-09-20 12:04,12:04,9828425,7287725,-2540700,SELL
18-09-20 12:05,12:05,9748475,6882050,-2866425,SELL
18-09-20 12:06,12:06,9845325,7121925,-2723400,SELL
18-09-20 12:07,12:07,9818800,6870625,-2948175,SELL
18-09-20 12:08,12:08,9923075,6459075,-3464000,SELL
18-09-20 12:09,12:09,9623825,6579800,-3044025,SELL
18-09-20 12:10,12:10,9902175,7277475,-2624700,SELL
18-09-20 12:11,12:11,9886025,6606200,-3279825,SELL
18-09-20 12:12,12:12,9933650,6864050,-3069600,SELL
18-09-20 12:13,12:13,9770625,6154475,-3616150,SELL
18-09-20 12:14,12:14,10001025,7028875,-2972150,SELL
18-09-20 12:15,12:15,9874200,7155475,-2718725,SELL
18-09-20 12:16,12:16,9944900,7097425,-2847475,SELL
18-09-20 12:17,12:17,10048425,7205600,-2842825,SELL
18-09-20 12:18,12:18,10100800,7603400,-2497400,SELL
18-09-20 12:19,12:19,10009625,7261975,-2747650,SELL
18-09-20 12:20,12:20,10048425,7336250,-2712175,SELL
18-09-20 12:21,12:21,9888500,7368350,-2520150,SELL
18-09-20 12:22,12:22,8924400,6973250,-1951150,SELL
18-09-20 12:23,12:23,9787400,6965300,-2822100,SELL
18-09-20 12:24,12:24,9631975,7203500,-2428475,SELL
18-09-20 12:25,12:25,10167900,6975725,-3192175,SELL
18-09-20 12:26,12:26,10234650,7470175,-2764475,SELL
18-09-20 12:27,12:27,9662575,7382375,-2280200,SELL
18-09-20 12:28,12:28,9877275,7211150,-2666125,SELL
18-09-20 12:29,12:29,10033950,7296950,-2737000,SELL
18-09-20 12:30,12:30,9803075,7262150,-2540925,SELL
18-09-20 12:31,12:31,9795250,7009775,-2785475,SELL
18-09-20 12:32,12:32,9737400,7252400,-2485000,SELL
18-09-20 12:33,12:33,9684425,7244275,-2440150,SELL
18-09-20 12:34,12:34,10129275,7256200,-2873075,SELL
18-09-20 12:35,12:35,10159800,7457525,-2702275,SELL
18-09-20 12:36,12:36,9748625,6997625,-2751000,SELL
18-09-20 12:37,12:37,9821325,7285275,-2536050,SELL
18-09-20 12:38,12:38,9978500,7271050,-2707450,SELL
18-09-20 12:39,12:39,10293650,7504700,-2788950,SELL
18-09-20 12:40,12:40,10290875,7717200,-2573675,SELL
18-09-20 12:41,12:41,10376925,7110625,-3266300,SELL
18-09-20 12:42,12:42,10212725,7522625,-2690100,SELL
18-09-20 12:43,12:43,10343700,7368725,-2974975,SELL
18-09-20 12:44,12:44,10251250,7535675,-2715575,SELL
18-09-20 12:45,12:45,10497625,7775575,-2722050,SELL
18-09-20 12:46,12:46,10459125,7355375,-3103750,SELL
18-09-20 12:47,12:47,10393825,7600225,-2793600,SELL
18-09-20 12:48,12:48,10365200,7209350,-3155850,SELL
18-09-20 12:49,12:49,10579450,7621850,-2957600,SELL
18-09-20 12:50,12:50,10445400,6935300,-3510100,SELL
18-09-20 12:51,12:51,10532200,7732450,-2799750,SELL
18-09-20 12:52,12:52,10366300,7648000,-2718300,SELL
18-09-20 12:53,12:53,10459100,7683000,-2776100,SELL
18-09-20 12:54,12:54,10465175,7224075,-3241100,SELL
18-09-20 12:55,12:55,10492250,7510700,-2981550,SELL
18-09-20 12:56,12:56,10330575,7656500,-2674075,SELL
18-09-20 12:57,12:57,10372200,7541725,-2830475,SELL
18-09-20 12:58,12:58,10536575,7939525,-2597050,SELL
18-09-20 12:59,12:59,10424550,7553400,-2871150,SELL
18-09-20 13:00,13:00,10536150,7615425,-2920725,SELL
18-09-20 13:01,13:01,10536250,7513750,-3022500,SELL
18-09-20 13:02,13:02,10456875,7590800,-2866075,SELL
18-09-20 13:03,13:03,10571325,7337750,-3233575,SELL
18-09-20 13:04,13:04,10599825,7895975,-2703850,SELL
18-09-20 13:05,13:05,10429275,7785575,-2643700,SELL
18-09-20 13:06,13:06,10471625,7569500,-2902125,SELL
18-09-20 13:07,13:07,10582325,7615325,-2967000,SELL
18-09-20 13:08,13:08,10599950,7781575,-2818375,SELL
18-09-20 13:09,13:09,10421875,7738550,-2683325,SELL
18-09-20 13:10,13:10,10495000,7500275,-2994725,SELL
18-09-20 13:11,13:11,10721500,7968875,-2752625,SELL
18-09-20 13:12,13:12,10619950,7786975,-2832975,SELL
18-09-20 13:13,13:13,10617675,7779425,-2838250,SELL
18-09-20 13:14,13:14,10592775,7781875,-2810900,SELL
18-09-20 13:15,13:15,10502575,8007350,-2495225,SELL
18-09-20 13:16,13:16,10698250,7627425,-3070825,SELL
18-09-20 13:17,13:17,10614075,7620550,-2993525,SELL
18-09-20 13:18,13:18,10495975,7687375,-2808600,SELL
18-09-20 13:19,13:19,10358900,7780600,-2578300,SELL
18-09-20 13:20,13:20,10559100,7174350,-3384750,SELL
18-09-20 13:21,13:21,10391875,7441950,-2949925,SELL
18-09-20 13:22,13:22,10393975,7991975,-2402000,SELL
18-09-20 13:23,13:23,10163375,7507425,-2655950,SELL
18-09-20 13:24,13:24,10570125,7746975,-2823150,SELL
18-09-20 13:25,13:25,10821525,8041250,-2780275,SELL
18-09-20 13:26,13:26,10572600,7869925,-2702675,SELL
18-09-20 13:27,13:27,10475875,7708725,-2767150,SELL
18-09-20 13:28,13:28,10511975,7879425,-2632550,SELL
18-09-20 13:29,13:29,10446025,7434425,-3011600,SELL
18-09-20 13:30,13:30,10534525,7745225,-2789300,SELL
18-09-20 13:31,13:31,10594600,7707600,-2887000,SELL
18-09-20 13:32,13:32,10098600,7839475,-2259125,SELL
18-09-20 13:33,13:33,10486425,7734875,-2751550,SELL
18-09-20 13:34,13:34,10310000,8022400,-2287600,SELL
18-09-20 13:35,13:35,10533900,7787125,-2746775,SELL
18-09-20 13:36,13:36,10338700,7747675,-2591025,SELL
18-09-20 13:37,13:37,10761450,7746275,-3015175,SELL
18-09-20 13:38,13:38,10671800,7498975,-3172825,SELL
18-09-20 13:39,13:39,9940475,7782300,-2158175,SELL
18-09-20 13:40,13:40,10485000,7736975,-2748025,SELL
18-09-20 13:41,13:41,10699925,7654950,-3044975,SELL
18-09-20 13:42,13:42,10832150,7882925,-2949225,SELL
18-09-20 13:43,13:43,10571200,7817600,-2753600,SELL
18-09-20 13:44,13:44,10381125,7782600,-2598525,SELL
18-09-20 13:45,13:45,10814075,8339075,-2475000,SELL
18-09-20 13:46,13:46,10760175,8060200,-2699975,SELL
18-09-20 13:47,13:47,10482075,8026600,-2455475,SELL
18-09-20 13:48,13:48,10651575,7794850,-2856725,SELL
18-09-20 13:49,13:49,10214350,8006450,-2207900,SELL
18-09-20 13:50,13:50,10733925,7974975,-2758950,SELL
18-09-20 13:51,13:51,10604800,7878900,-2725900,SELL
18-09-20 13:52,13:52,10692800,7838800,-2854000,SELL
18-09-20 13:53,13:53,10597100,8025725,-2571375,SELL
18-09-20 13:54,13:54,10654850,7961575,-2693275,SELL
18-09-20 13:55,13:55,10339025,7751200,-2587825,SELL
18-09-20 13:56,13:56,10712250,8043175,-2669075,SELL
18-09-20 13:57,13:57,10809300,8213000,-2596300,SELL
18-09-20 13:58,13:58,10755525,7768700,-2986825,SELL
18-09-20 13:59,13:59,10675825,7757850,-2917975,SELL
18-09-20 14:00,14:00,10848950,7948100,-2900850,SELL
18-09-20 14:01,14:01,10765225,7782900,-2982325,SELL
18-09-20 14:02,14:02,10432175,7970850,-2461325,SELL
18-09-20 14:03,14:03,10673400,7744300,-2929100,SELL
18-09-20 14:04,14:04,10858350,7918075,-2940275,SELL
18-09-20 14:05,14:05,10335675,7753350,-2582325,SELL
18-09-20 14:06,14:06,10695200,8073500,-2621700,SELL
18-09-20 14:07,14:07,10560800,7918825,-2641975,SELL
18-09-20 14:08,14:08,10883625,7795300,-3088325,SELL
18-09-20 14:09,14:09,10650525,7943375,-2707150,SELL
18-09-20 14:10,14:10,10870725,7789100,-3081625,SELL
18-09-20 14:11,14:11,10070525,7764050,-2306475,SELL
18-09-20 14:12,14:12,10954850,7916850,-3038000,SELL
18-09-20 14:13,14:13,10803000,7144175,-3658825,SELL
18-09-20 14:14,14:14,10906200,7101925,-3804275,SELL
18-09-20 14:15,14:15,11040150,8064425,-2975725,SELL
18-09-20 14:16,14:16,10911275,7655275,-3256000,SELL
18-09-20 14:17,14:17,10947775,8033525,-2914250,SELL
18-09-20 14:18,14:18,11068050,8062150,-3005900,SELL
18-09-20 14:19,14:19,11031475,7934575,-3096900,SELL
18-09-20 14:20,14:20,11118950,8246600,-2872350,SELL
18-09-20 14:21,14:21,11184100,7989525,-3194575,SELL
18-09-20 14:22,14:22,11189725,7949350,-3240375,SELL
18-09-20 14:23,14:23,11142250,7924025,-3218225,SELL
18-09-20 14:24,14:24,11002700,7640350,-3362350,SELL
18-09-20 14:25,14:25,11001300,7660275,-3341025,SELL
18-09-20 14:26,14:26,11033425,7378450,-3654975,SELL
18-09-20 14:27,14:27,11030950,7615825,-3415125,SELL
18-09-20 14:28,14:28,10964300,7526700,-3437600,SELL
18-09-20 14:29,14:29,10972750,7491225,-3481525,SELL
18-09-20 14:30,14:30,11045100,7450225,-3594875,SELL
18-09-20 14:31,14:31,11016800,7479675,-3537125,SELL
18-09-20 14:32,14:32,11018300,7520650,-3497650,SELL
18-09-20 14:33,14:33,11087000,7526900,-3560100,SELL
18-09-20 14:34,14:34,11093875,7559400,-3534475,SELL
18-09-20 14:35,14:35,11069850,7535925,-3533925,SELL
18-09-20 14:36,14:36,11189450,7583025,-3606425,SELL
18-09-20 14:37,14:37,11198850,7619950,-3578900,SELL
18-09-20 14:38,14:38,11222825,7560000,-3662825,SELL
18-09-20 14:39,14:39,11294225,7309950,-3984275,SELL
18-09-20 14:40,14:40,11289125,7550450,-3738675,SELL
18-09-20 14:41,14:41,11290200,7309175,-3981025,SELL
18-09-20 14:42,14:42,11379700,7416850,-3962850,SELL
18-09-20 14:43,14:43,11358550,7233675,-4124875,SELL
18-09-20 14:44,14:44,11389100,7524675,-3864425,SELL
18-09-20 14:45,14:45,11547225,7502850,-4044375,SELL
18-09-20 14:46,14:46,11541425,7605975,-3935450,SELL
18-09-20 14:47,14:47,11494175,7495875,-3998300,SELL
18-09-20 14:48,14:48,11479650,7519900,-3959750,SELL
18-09-20 14:49,14:49,11517300,7531500,-3985800,SELL
18-09-20 14:50,14:50,11510775,7470850,-4039925,SELL
18-09-20 14:51,14:51,11297200,7604475,-3692725,SELL
18-09-20 14:52,14:52,11249275,7361625,-3887650,SELL
18-09-20 14:53,14:53,11100775,7365500,-3735275,SELL
18-09-20 14:54,14:54,11219675,7394250,-3825425,SELL
18-09-20 14:55,14:55,11215675,7440475,-3775200,SELL
18-09-20 14:56,14:56,11198150,7322850,-3875300,SELL
18-09-20 14:57,14:57,11137650,7470450,-3667200,SELL
18-09-20 14:58,14:58,11095350,7437375,-3657975,SELL
18-09-20 14:59,14:59,11122450,7463650,-3658800,SELL
18-09-20 15:00,15:00,11041500,7534050,-3507450,SELL
18-09-20 15:01,15:01,11074850,7406575,-3668275,SELL
18-09-20 15:02,15:02,11083325,7301100,-3782225,SELL
18-09-20 15:03,15:03,11004825,7506250,-3498575,SELL
18-09-20 15:04,15:04,11063500,7154500,-3909000,SELL
18-09-20 15:05,15:05,11057600,7533850,-3523750,SELL
18-09-20 15:06,15:06,11043100,7422225,-3620875,SELL
18-09-20 15:07,15:07,11048875,7580550,-3468325,SELL
18-09-20 15:08,15:08,11038850,7519250,-3519600,SELL
18-09-20 15:09,15:09,11008400,7229050,-3779350,SELL
18-09-20 15:10,15:10,11054550,7357600,-3696950,SELL
18-09-20 15:11,15:11,11086800,7177100,-3909700,SELL
18-09-20 15:12,15:12,10918600,7349150,-3569450,SELL
18-09-20 15:13,15:13,10931675,6950050,-3981625,SELL
18-09-20 15:14,15:14,10916725,7361200,-3555525,SELL
18-09-20 15:15,15:15,10851475,7048050,-3803425,SELL
18-09-20 15:16,15:16,10869275,7199075,-3670200,SELL
18-09-20 15:17,15:17,10855575,7071700,-3783875,SELL
18-09-20 15:18,15:18,10801075,7218550,-3582525,SELL
18-09-20 15:19,15:19,10770425,7194475,-3575950,SELL
18-09-20 15:20,15:20,10844225,7184225,-3660000,SELL
18-09-20 15:21,15:21,10645700,7148275,-3497425,SELL
18-09-20 15:22,15:22,10642250,7037050,-3605200,SELL
18-09-20 15:23,15:23,10600975,6880900,-3720075,SELL
18-09-20 15:24,15:24,10617025,6977700,-3639325,SELL
18-09-20 15:25,15:25,10594125,6985550,-3608575,SELL
18-09-20 15:26,15:26,10544825,6788775,-3756050,SELL
18-09-20 15:27,15:27,10426750,6891650,-3535100,SELL
18-09-20 15:28,15:28,10416325,6944650,-3471675,SELL
18-09-20 15:29,15:29,10463800,6896200,-3567600,SELL
21-09-20 9:15,9:15,9981250,6577200,-3404050,SELL
21-09-20 9:16,9:16,9924700,6414825,-3509875,SELL
21-09-20 9:17,9:17,10252975,6875800,-3377175,SELL
21-09-20 9:18,9:18,10143375,6673200,-3470175,SELL
21-09-20 9:19,9:19,10265925,6718100,-3547825,SELL
21-09-20 9:20,9:20,10587775,7189675,-3398100,SELL
21-09-20 9:21,9:21,10609000,7150800,-3458200,SELL
21-09-20 9:22,9:22,10594425,7056675,-3537750,SELL
21-09-20 9:23,9:23,10712100,7295875,-3416225,SELL
21-09-20 9:24,9:24,10675750,7211675,-3464075,SELL
21-09-20 9:25,9:25,10704125,7350675,-3353450,SELL
21-09-20 9:26,9:26,10638325,7314300,-3324025,SELL
21-09-20 9:27,9:27,10767025,7303900,-3463125,SELL
21-09-20 9:28,9:28,10860675,7260975,-3599700,SELL
21-09-20 9:29,9:29,10867425,7201300,-3666125,SELL
21-09-20 9:30,9:30,10748000,7442950,-3305050,SELL
21-09-20 9:31,9:31,10815000,7193025,-3621975,SELL
21-09-20 9:32,9:32,10972500,7353400,-3619100,SELL
21-09-20 9:33,9:33,10903425,7264800,-3638625,SELL
21-09-20 9:34,9:34,10875225,7401950,-3473275,SELL
21-09-20 9:35,9:35,10948275,7402750,-3545525,SELL
21-09-20 9:36,9:36,10865075,7131025,-3734050,SELL
21-09-20 9:37,9:37,10753025,7210250,-3542775,SELL
21-09-20 9:38,9:38,10702225,7351250,-3350975,SELL
21-09-20 9:39,9:39,10459200,7340125,-3119075,SELL
21-09-20 9:40,9:40,10827975,7492200,-3335775,SELL
21-09-20 9:41,9:41,10644075,7465850,-3178225,SELL
21-09-20 9:42,9:42,10843525,7432025,-3411500,SELL
21-09-20 9:43,9:43,10747750,7548350,-3199400,SELL
21-09-20 9:44,9:44,10803325,7519550,-3283775,SELL
21-09-20 9:45,9:45,10741175,7505475,-3235700,SELL
21-09-20 9:46,9:46,10936425,7427975,-3508450,SELL
21-09-20 9:47,9:47,11026575,7632525,-3394050,SELL
21-09-20 9:48,9:48,10966175,7743400,-3222775,SELL
21-09-20 9:49,9:49,10903250,7320350,-3582900,SELL
21-09-20 9:50,9:50,10752000,7731525,-3020475,SELL
21-09-20 9:51,9:51,10850200,7632000,-3218200,SELL
21-09-20 9:52,9:52,10881850,7675200,-3206650,SELL
21-09-20 9:53,9:53,10717250,7562650,-3154600,SELL
21-09-20 9:54,9:54,10726725,7794725,-2932000,SELL
21-09-20 9:55,9:55,10705225,7527675,-3177550,SELL
21-09-20 9:56,9:56,10970175,7459025,-3511150,SELL
21-09-20 9:57,9:57,10896375,7767550,-3128825,SELL
21-09-20 9:58,9:58,10905325,7598950,-3306375,SELL
21-09-20 9:59,9:59,11080500,7664250,-3416250,SELL
21-09-20 10:00,10:00,11149225,7727425,-3421800,SELL
21-09-20 10:01,10:01,10909850,7688850,-3221000,SELL
21-09-20 10:02,10:02,11085525,7858075,-3227450,SELL
21-09-20 10:03,10:03,11036625,7707025,-3329600,SELL
21-09-20 10:04,10:04,10932725,7733300,-3199425,SELL
21-09-20 10:05,10:05,11016850,8048300,-2968550,SELL
21-09-20 10:06,10:06,11006750,7818150,-3188600,SELL
21-09-20 10:07,10:07,11222875,7762025,-3460850,SELL
21-09-20 10:08,10:08,11233250,7760250,-3473000,SELL
21-09-20 10:09,10:09,11257850,7845950,-3411900,SELL
21-09-20 10:10,10:10,11291800,7961750,-3330050,SELL
21-09-20 10:11,10:11,11179675,8006575,-3173100,SELL
21-09-20 10:12,10:12,11398750,7913150,-3485600,SELL
21-09-20 10:13,10:13,11287275,7998475,-3288800,SELL
21-09-20 10:14,10:14,11372425,7923375,-3449050,SELL
21-09-20 10:15,10:15,11292100,8090475,-3201625,SELL
21-09-20 10:16,10:16,11370400,7961000,-3409400,SELL
21-09-20 10:17,10:17,11373750,8045925,-3327825,SELL
21-09-20 10:18,10:18,11256850,7720425,-3536425,SELL
21-09-20 10:19,10:19,11075000,7663125,-3411875,SELL
21-09-20 10:20,10:20,11415900,8142150,-3273750,SELL
21-09-20 10:21,10:21,11481925,8311300,-3170625,SELL
21-09-20 10:22,10:22,11435425,8175600,-3259825,SELL
21-09-20 10:23,10:23,11296225,8355075,-2941150,SELL
21-09-20 10:24,10:24,11296300,7893850,-3402450,SELL
21-09-20 10:25,10:25,11385375,8371075,-3014300,SELL
21-09-20 10:26,10:26,10995025,8042650,-2952375,SELL
21-09-20 10:27,10:27,10989850,8014525,-2975325,SELL
21-09-20 10:28,10:28,10963375,8021050,-2942325,SELL
21-09-20 10:29,10:29,10999875,8037550,-2962325,SELL
21-09-20 10:30,10:30,11232350,7923650,-3308700,SELL
21-09-20 10:31,10:31,11234875,8098675,-3136200,SELL
21-09-20 10:32,10:32,11223300,7969675,-3253625,SELL
21-09-20 10:33,10:33,11165875,7951375,-3214500,SELL
21-09-20 10:34,10:34,11202675,8123900,-3078775,SELL
21-09-20 10:35,10:35,11011125,7993100,-3018025,SELL
21-09-20 10:36,10:36,11121625,8348925,-2772700,SELL
21-09-20 10:37,10:37,11198350,8053525,-3144825,SELL
21-09-20 10:38,10:38,11202725,8166725,-3036000,SELL
21-09-20 10:39,10:39,11181250,8029625,-3151625,SELL
21-09-20 10:40,10:40,11198925,8237500,-2961425,SELL
21-09-20 10:41,10:41,11046575,8200975,-2845600,SELL
21-09-20 10:42,10:42,10998675,8146300,-2852375,SELL
21-09-20 10:43,10:43,11188000,8146175,-3041825,SELL
21-09-20 10:44,10:44,10845150,8165800,-2679350,SELL
21-09-20 10:45,10:45,11023625,8064025,-2959600,SELL
21-09-20 10:46,10:46,10976825,7932125,-3044700,SELL
21-09-20 10:47,10:47,11270550,8214900,-3055650,SELL
21-09-20 10:48,10:48,11117575,8300450,-2817125,SELL
21-09-20 10:49,10:49,11076675,8151175,-2925500,SELL
21-09-20 10:50,10:50,11123325,8066150,-3057175,SELL
21-09-20 10:51,10:51,11166375,8249300,-2917075,SELL
21-09-20 10:52,10:52,11001075,8253450,-2747625,SELL
21-09-20 10:53,10:53,11317175,8285900,-3031275,SELL
21-09-20 10:54,10:54,11139100,7812725,-3326375,SELL
21-09-20 10:55,10:55,11011100,8186675,-2824425,SELL
21-09-20 10:56,10:56,11275800,8094100,-3181700,SELL
21-09-20 10:57,10:57,11309775,8311050,-2998725,SELL
21-09-20 10:58,10:58,10801150,8042225,-2758925,SELL
21-09-20 10:59,10:59,11310250,8296475,-3013775,SELL
21-09-20 11:00,11:00,11308725,8176550,-3132175,SELL
21-09-20 11:01,11:01,11256000,8151275,-3104725,SELL
21-09-20 11:02,11:02,11105100,8305775,-2799325,SELL
21-09-20 11:03,11:03,11304150,8446575,-2857575,SELL
21-09-20 11:04,11:04,11345550,8506825,-2838725,SELL
21-09-20 11:05,11:05,11247025,8305850,-2941175,SELL
21-09-20 11:06,11:06,11305650,8379750,-2925900,SELL
21-09-20 11:07,11:07,11244750,8467250,-2777500,SELL
21-09-20 11:08,11:08,11028700,7951525,-3077175,SELL
21-09-20 11:09,11:09,11337625,8557075,-2780550,SELL
21-09-20 11:10,11:10,10776725,8452750,-2323975,SELL
21-09-20 11:11,11:11,10859825,8194500,-2665325,SELL
21-09-20 11:12,11:12,10557525,7899000,-2658525,SELL
21-09-20 11:13,11:13,10966050,8101300,-2864750,SELL
21-09-20 11:14,11:14,11239100,8310525,-2928575,SELL
21-09-20 11:15,11:15,11152075,8302225,-2849850,SELL
21-09-20 11:16,11:16,11303800,8295300,-3008500,SELL
21-09-20 11:17,11:17,10997475,8132150,-2865325,SELL
21-09-20 11:18,11:18,11297975,8352100,-2945875,SELL
21-09-20 11:19,11:19,10819300,8093300,-2726000,SELL
21-09-20 11:20,11:20,11237100,8375350,-2861750,SELL
21-09-20 11:21,11:21,11366900,8198025,-3168875,SELL
21-09-20 11:22,11:22,11345350,8424450,-2920900,SELL
21-09-20 11:23,11:23,11381750,8218800,-3162950,SELL
21-09-20 11:24,11:24,11307050,8191325,-3115725,SELL
21-09-20 11:25,11:25,11323250,8280275,-3042975,SELL
21-09-20 11:26,11:26,11371125,7962075,-3409050,SELL
21-09-20 11:27,11:27,11407125,8398300,-3008825,SELL
21-09-20 11:28,11:28,11044975,8267450,-2777525,SELL
21-09-20 11:29,11:29,10840950,7930300,-2910650,SELL
21-09-20 11:30,11:30,11117400,8142800,-2974600,SELL
21-09-20 11:31,11:31,11300175,8103350,-3196825,SELL
21-09-20 11:32,11:32,11431350,8103575,-3327775,SELL
21-09-20 11:33,11:33,11381125,8323775,-3057350,SELL
21-09-20 11:34,11:34,11147650,8338025,-2809625,SELL
21-09-20 11:35,11:35,11065975,8259525,-2806450,SELL
21-09-20 11:36,11:36,11465525,8454550,-3010975,SELL
21-09-20 11:37,11:37,10949075,8217925,-2731150,SELL
21-09-20 11:38,11:38,11025800,8171100,-2854700,SELL
21-09-20 11:39,11:39,11431725,8452525,-2979200,SELL
21-09-20 11:40,11:40,11251625,8451075,-2800550,SELL
21-09-20 11:41,11:41,11461250,8723425,-2737825,SELL
21-09-20 11:42,11:42,10260800,8422025,-1838775,SELL
21-09-20 11:43,11:43,10880650,8392150,-2488500,SELL
21-09-20 11:44,11:44,11211300,8100800,-3110500,SELL
21-09-20 11:45,11:45,10980300,8286850,-2693450,SELL
21-09-20 11:46,11:46,10589000,8196900,-2392100,SELL
21-09-20 11:47,11:47,10658150,7798850,-2859300,SELL
21-09-20 11:48,11:48,10990875,7996600,-2994275,SELL
21-09-20 11:49,11:49,11464200,8589500,-2874700,SELL
21-09-20 11:50,11:50,11265675,8396550,-2869125,SELL
21-09-20 11:51,11:51,10453925,8607200,-1846725,SELL
21-09-20 11:52,11:52,11306050,8508225,-2797825,SELL
21-09-20 11:53,11:53,11183350,7527125,-3656225,SELL
21-09-20 11:54,11:54,11120850,8354900,-2765950,SELL
21-09-20 11:55,11:55,11277225,8517500,-2759725,SELL
21-09-20 11:56,11:56,11172275,8345025,-2827250,SELL
21-09-20 11:57,11:57,10902175,8347975,-2554200,SELL
21-09-20 11:58,11:58,11304250,8380000,-2924250,SELL
21-09-20 11:59,11:59,10769700,8336250,-2433450,SELL
21-09-20 12:00,12:00,11536525,8673775,-2862750,SELL
21-09-20 12:01,12:01,10946275,8401700,-2544575,SELL
21-09-20 12:02,12:02,11320600,8448650,-2871950,SELL
21-09-20 12:03,12:03,10602725,8476300,-2126425,SELL
21-09-20 12:04,12:04,10780200,8336100,-2444100,SELL
21-09-20 12:05,12:05,11520475,8187550,-3332925,SELL
21-09-20 12:06,12:06,10902950,8037950,-2865000,SELL
21-09-20 12:07,12:07,11284050,8578250,-2705800,SELL
21-09-20 12:08,12:08,10866200,8559550,-2306650,SELL
21-09-20 12:09,12:09,11356025,8056200,-3299825,SELL
21-09-20 12:10,12:10,10951675,8519500,-2432175,SELL
21-09-20 12:11,12:11,11312925,8511725,-2801200,SELL
21-09-20 12:12,12:12,11262150,8248925,-3013225,SELL
21-09-20 12:13,12:13,11177325,8377925,-2799400,SELL
21-09-20 12:14,12:14,11447025,8566250,-2880775,SELL
21-09-20 12:15,12:15,11305200,8360600,-2944600,SELL
21-09-20 12:16,12:16,11475175,8169725,-3305450,SELL
21-09-20 12:17,12:17,10802525,8218600,-2583925,SELL
21-09-20 12:18,12:18,11320475,8303150,-3017325,SELL
21-09-20 12:19,12:19,11210225,8133025,-3077200,SELL
21-09-20 12:20,12:20,11067550,8354850,-2712700,SELL
21-09-20 12:21,12:21,11379125,8554150,-2824975,SELL
21-09-20 12:22,12:22,10691700,8248200,-2443500,SELL
21-09-20 12:23,12:23,11071350,8433600,-2637750,SELL
21-09-20 12:24,12:24,11674625,8878000,-2796625,SELL
21-09-20 12:25,12:25,11466350,8609775,-2856575,SELL
21-09-20 12:26,12:26,10916625,8663100,-2253525,SELL
21-09-20 12:27,12:27,11431550,8261300,-3170250,SELL
21-09-20 12:28,12:28,11349275,8572375,-2776900,SELL
21-09-20 12:29,12:29,9746525,8603375,-1143150,SELL
21-09-20 12:30,12:30,11340325,8528600,-2811725,SELL
21-09-20 12:31,12:31,11585275,8661825,-2923450,SELL
21-09-20 12:32,12:32,11115375,8777875,-2337500,SELL
21-09-20 12:33,12:33,11242175,8589525,-2652650,SELL
21-09-20 12:34,12:34,11478975,8583900,-2895075,SELL
21-09-20 12:35,12:35,10997275,8633925,-2363350,SELL
21-09-20 12:36,12:36,11185100,8601750,-2583350,SELL
21-09-20 12:37,12:37,11318950,8574925,-2744025,SELL
21-09-20 12:38,12:38,11678275,8893600,-2784675,SELL
21-09-20 12:39,12:39,11530300,8486275,-3044025,SELL
21-09-20 12:40,12:40,11671950,8899850,-2772100,SELL
21-09-20 12:41,12:41,11586200,8637875,-2948325,SELL
21-09-20 12:42,12:42,11338425,8655475,-2682950,SELL
21-09-20 12:43,12:43,11123900,8643775,-2480125,SELL
21-09-20 12:44,12:44,11013950,8592800,-2421150,SELL
21-09-20 12:45,12:45,11518375,8587825,-2930550,SELL
21-09-20 12:46,12:46,11812950,8710750,-3102200,SELL
21-09-20 12:47,12:47,11368725,8426950,-2941775,SELL
21-09-20 12:48,12:48,11421900,8574825,-2847075,SELL
21-09-20 12:49,12:49,11694425,8674350,-3020075,SELL
21-09-20 12:50,12:50,11553675,8554375,-2999300,SELL
21-09-20 12:51,12:51,11774150,8417375,-3356775,SELL
21-09-20 12:52,12:52,11075425,8346775,-2728650,SELL
21-09-20 12:53,12:53,11541475,8572975,-2968500,SELL
21-09-20 12:54,12:54,11500950,8697650,-2803300,SELL
21-09-20 12:55,12:55,11810575,8595875,-3214700,SELL
21-09-20 12:56,12:56,11598775,8719275,-2879500,SELL
21-09-20 12:57,12:57,11265900,8564450,-2701450,SELL
21-09-20 12:58,12:58,11583800,8461800,-3122000,SELL
21-09-20 12:59,12:59,11675375,8429575,-3245800,SELL
21-09-20 13:00,13:00,11597800,8556600,-3041200,SELL
21-09-20 13:01,13:01,11743700,8611200,-3132500,SELL
21-09-20 13:02,13:02,11547400,8595200,-2952200,SELL
21-09-20 13:03,13:03,11854100,8748725,-3105375,SELL
21-09-20 13:04,13:04,11536600,8738550,-2798050,SELL
21-09-20 13:05,13:05,11776575,8600550,-3176025,SELL
21-09-20 13:06,13:06,11437925,8571300,-2866625,SELL
21-09-20 13:07,13:07,11238325,8602900,-2635425,SELL
21-09-20 13:08,13:08,11546075,8305925,-3240150,SELL
21-09-20 13:09,13:09,12005100,8456875,-3548225,SELL
21-09-20 13:10,13:10,11877150,8587675,-3289475,SELL
21-09-20 13:11,13:11,11853075,8529825,-3323250,SELL
21-09-20 13:12,13:12,11902150,8301500,-3600650,SELL
21-09-20 13:13,13:13,11835900,8455925,-3379975,SELL
21-09-20 13:14,13:14,11840350,8393750,-3446600,SELL
21-09-20 13:15,13:15,11988775,8629050,-3359725,SELL
21-09-20 13:16,13:16,12092300,8175500,-3916800,SELL
21-09-20 13:17,13:17,12022000,8542075,-3479925,SELL
21-09-20 13:18,13:18,11631300,8311275,-3320025,SELL
21-09-20 13:19,13:19,11608525,8516775,-3091750,SELL
21-09-20 13:20,13:20,12019625,8256850,-3762775,SELL
21-09-20 13:21,13:21,12144350,8408200,-3736150,SELL
21-09-20 13:22,13:22,12061225,8217500,-3843725,SELL
21-09-20 13:23,13:23,12072550,8418500,-3654050,SELL
21-09-20 13:24,13:24,11902400,8227550,-3674850,SELL
21-09-20 13:25,13:25,12239575,8406775,-3832800,SELL
21-09-20 13:26,13:26,11495600,8420525,-3075075,SELL
21-09-20 13:27,13:27,12048825,8423450,-3625375,SELL
21-09-20 13:28,13:28,12031500,8261825,-3769675,SELL
21-09-20 13:29,13:29,11935600,8038175,-3897425,SELL
21-09-20 13:30,13:30,12149300,8416625,-3732675,SELL
21-09-20 13:31,13:31,12244125,8349325,-3894800,SELL
21-09-20 13:32,13:32,11389225,8501875,-2887350,SELL
21-09-20 13:33,13:33,11590075,8212750,-3377325,SELL
21-09-20 13:34,13:34,11567800,8193225,-3374575,SELL
21-09-20 13:35,13:35,12015300,8369350,-3645950,SELL
21-09-20 13:36,13:36,11879625,8197075,-3682550,SELL
21-09-20 13:37,13:37,12058300,8393325,-3664975,SELL
21-09-20 13:38,13:38,11743025,8396100,-3346925,SELL
21-09-20 13:39,13:39,12447625,8600750,-3846875,SELL
21-09-20 13:40,13:40,12314850,8452700,-3862150,SELL
21-09-20 13:41,13:41,12471500,8319050,-4152450,SELL
21-09-20 13:42,13:42,12260725,8023850,-4236875,SELL
21-09-20 13:43,13:43,12121450,8166675,-3954775,SELL
21-09-20 13:44,13:44,12043950,7934425,-4109525,SELL
21-09-20 13:45,13:45,12229900,8023300,-4206600,SELL
21-09-20 13:46,13:46,12299300,8158025,-4141275,SELL
21-09-20 13:47,13:47,12163375,8036550,-4126825,SELL
21-09-20 13:48,13:48,11920225,8131950,-3788275,SELL
21-09-20 13:49,13:49,12312200,8195250,-4116950,SELL
21-09-20 13:50,13:50,12351700,7846625,-4505075,SELL
21-09-20 13:51,13:51,12148975,7757125,-4391850,SELL
21-09-20 13:52,13:52,12409925,8173125,-4236800,SELL
21-09-20 13:53,13:53,12504975,8122950,-4382025,SELL
21-09-20 13:54,13:54,12510725,7948825,-4561900,SELL
21-09-20 13:55,13:55,12389650,7918350,-4471300,SELL
21-09-20 13:56,13:56,12617475,7957650,-4659825,SELL
21-09-20 13:57,13:57,12604825,7900725,-4704100,SELL
21-09-20 13:58,13:58,12658725,7751700,-4907025,SELL
21-09-20 13:59,13:59,12364950,7728325,-4636625,SELL
21-09-20 14:00,14:00,12494225,7926225,-4568000,SELL
21-09-20 14:01,14:01,12691700,7910250,-4781450,SELL
21-09-20 14:02,14:02,12561975,7760200,-4801775,SELL
21-09-20 14:03,14:03,12615150,8041525,-4573625,SELL
21-09-20 14:04,14:04,12557125,7623650,-4933475,SELL
21-09-20 14:05,14:05,12579350,7826025,-4753325,SELL
21-09-20 14:06,14:06,12460950,7809725,-4651225,SELL
21-09-20 14:07,14:07,12264625,7575975,-4688650,SELL
21-09-20 14:08,14:08,12391225,7868875,-4522350,SELL
21-09-20 14:09,14:09,12713800,7602950,-5110850,SELL
21-09-20 14:10,14:10,12634075,7688075,-4946000,SELL
21-09-20 14:11,14:11,12598925,7400700,-5198225,SELL
21-09-20 14:12,14:12,12589225,7626250,-4962975,SELL
21-09-20 14:13,14:13,12783450,7519200,-5264250,SELL
21-09-20 14:14,14:14,12367900,7673225,-4694675,SELL
21-09-20 14:15,14:15,12644425,7631950,-5012475,SELL
21-09-20 14:16,14:16,12765250,7583025,-5182225,SELL
21-09-20 14:17,14:17,12606250,7559300,-5046950,SELL
21-09-20 14:18,14:18,12596025,7251425,-5344600,SELL
21-09-20 14:19,14:19,12906375,7424450,-5481925,SELL
21-09-20 14:20,14:20,12772350,7227550,-5544800,SELL
21-09-20 14:21,14:21,12675350,7221900,-5453450,SELL
21-09-20 14:22,14:22,12843175,7381275,-5461900,SELL
21-09-20 14:23,14:23,12422850,7257475,-5165375,SELL
21-09-20 14:24,14:24,12813700,7250250,-5563450,SELL
21-09-20 14:25,14:25,12826500,7285450,-5541050,SELL
21-09-20 14:26,14:26,12610875,7252150,-5358725,SELL
21-09-20 14:27,14:27,12716900,7220100,-5496800,SELL
21-09-20 14:28,14:28,12630450,7177275,-5453175,SELL
21-09-20 14:29,14:29,12681450,7284325,-5397125,SELL
21-09-20 14:30,14:30,12617975,7214300,-5403675,SELL
21-09-20 14:31,14:31,12727625,7246825,-5480800,SELL
21-09-20 14:32,14:32,12658925,7033725,-5625200,SELL
21-09-20 14:33,14:33,12587850,7385675,-5202175,SELL
21-09-20 14:34,14:34,12770675,7041475,-5729200,SELL
21-09-20 14:35,14:35,12823250,7339350,-5483900,SELL
21-09-20 14:36,14:36,12838625,7036825,-5801800,SELL
21-09-20 14:37,14:37,12824900,7183275,-5641625,SELL
21-09-20 14:38,14:38,12815375,7089600,-5725775,SELL
21-09-20 14:39,14:39,12842850,7274150,-5568700,SELL
21-09-20 14:40,14:40,12853675,7260200,-5593475,SELL
21-09-20 14:41,14:41,12836350,7342625,-5493725,SELL
21-09-20 14:42,14:42,12882950,7264875,-5618075,SELL
21-09-20 14:43,14:43,12891625,7096900,-5794725,SELL
21-09-20 14:44,14:44,12845100,7426850,-5418250,SELL
21-09-20 14:45,14:45,12837300,7241225,-5596075,SELL
21-09-20 14:46,14:46,12865425,7302325,-5563100,SELL
21-09-20 14:47,14:47,12834275,7319275,-5515000,SELL
21-09-20 14:48,14:48,12829575,7302825,-5526750,SELL
21-09-20 14:49,14:49,12843850,7248875,-5594975,SELL
21-09-20 14:50,14:50,12799175,6888200,-5910975,SELL
21-09-20 14:51,14:51,12894375,7058075,-5836300,SELL
21-09-20 14:52,14:52,12870625,6961375,-5909250,SELL
21-09-20 14:53,14:53,12820600,7234750,-5585850,SELL
21-09-20 14:54,14:54,12884000,7287075,-5596925,SELL
21-09-20 14:55,14:55,12857750,6926775,-5930975,SELL
21-09-20 14:56,14:56,12883425,6984525,-5898900,SELL
21-09-20 14:57,14:57,12731650,7210725,-5520925,SELL
21-09-20 14:58,14:58,12690875,7012025,-5678850,SELL
21-09-20 14:59,14:59,12635625,6957525,-5678100,SELL
21-09-20 15:00,15:00,12769225,6886500,-5882725,SELL
21-09-20 15:01,15:01,12763475,7264100,-5499375,SELL
21-09-20 15:02,15:02,12707975,7066125,-5641850,SELL
21-09-20 15:03,15:03,12613975,7110725,-5503250,SELL
21-09-20 15:04,15:04,12720275,7193225,-5527050,SELL
21-09-20 15:05,15:05,12730500,7375825,-5354675,SELL
21-09-20 15:06,15:06,12579750,7282325,-5297425,SELL
21-09-20 15:07,15:07,12478775,7198100,-5280675,SELL
21-09-20 15:08,15:08,12618600,7238950,-5379650,SELL
21-09-20 15:09,15:09,12578850,6985525,-5593325,SELL
21-09-20 15:10,15:10,12547850,7032225,-5515625,SELL
21-09-20 15:11,15:11,12501975,7125800,-5376175,SELL
21-09-20 15:12,15:12,12547800,7135525,-5412275,SELL
21-09-20 15:13,15:13,12509875,7038150,-5471725,SELL
21-09-20 15:14,15:14,12517100,6883875,-5633225,SELL
21-09-20 15:15,15:15,12514025,7104825,-5409200,SELL
21-09-20 15:16,15:16,12517000,6999425,-5517575,SELL
21-09-20 15:17,15:17,12537625,7161325,-5376300,SELL
21-09-20 15:18,15:18,12335625,6839350,-5496275,SELL
21-09-20 15:19,15:19,12385250,6772600,-5612650,SELL
21-09-20 15:20,15:20,12324800,6963325,-5361475,SELL
21-09-20 15:21,15:21,12196250,6836000,-5360250,SELL
21-09-20 15:22,15:22,12169875,6630400,-5539475,SELL
21-09-20 15:23,15:23,12207875,6908125,-5299750,SELL
21-09-20 15:24,15:24,12120650,6720725,-5399925,SELL
21-09-20 15:25,15:25,12047075,6901750,-5145325,SELL
21-09-20 15:26,15:26,12009325,6768250,-5241075,SELL
21-09-20 15:27,15:27,11986025,6499050,-5486975,SELL
21-09-20 15:28,15:28,11980650,6701775,-5278875,SELL
21-09-20 15:29,15:29,11998100,6717600,-5280500,SELL
22-09-20 9:15,9:15,11468175,6225800,-5242375,SELL
22-09-20 9:16,9:16,11550025,6358225,-5191800,SELL
22-09-20 9:17,9:17,11621875,6320675,-5301200,SELL
22-09-20 9:18,9:18,11667625,6547000,-5120625,SELL
22-09-20 9:19,9:19,11650625,6547825,-5102800,SELL
22-09-20 9:20,9:20,11805625,6931275,-4874350,SELL
22-09-20 9:21,9:21,11792200,6644525,-5147675,SELL
22-09-20 9:22,9:22,11811625,6745300,-5066325,SELL
22-09-20 9:23,9:23,11852825,6830750,-5022075,SELL
22-09-20 9:24,9:24,11970050,6993300,-4976750,SELL
22-09-20 9:25,9:25,11871400,7037725,-4833675,SELL
22-09-20 9:26,9:26,12131900,7392850,-4739050,SELL
22-09-20 9:27,9:27,12064650,7392650,-4672000,SELL
22-09-20 9:28,9:28,12118725,7391325,-4727400,SELL
22-09-20 9:29,9:29,12255450,7258400,-4997050,SELL
22-09-20 9:30,9:30,12212925,7050900,-5162025,SELL
22-09-20 9:31,9:31,12353950,7523400,-4830550,SELL
22-09-20 9:32,9:32,12422125,7737050,-4685075,SELL
22-09-20 9:33,9:33,12300600,7439000,-4861600,SELL
22-09-20 9:34,9:34,12292375,7725150,-4567225,SELL
22-09-20 9:35,9:35,12439550,7716875,-4722675,SELL
22-09-20 9:36,9:36,12405175,7681350,-4723825,SELL
22-09-20 9:37,9:37,12368125,7855150,-4512975,SELL
22-09-20 9:38,9:38,12222725,7848125,-4374600,SELL
22-09-20 9:39,9:39,12162450,7562650,-4599800,SELL
22-09-20 9:40,9:40,12409325,8074375,-4334950,SELL
22-09-20 9:41,9:41,12493400,8003750,-4489650,SELL
22-09-20 9:42,9:42,12529150,8191200,-4337950,SELL
22-09-20 9:43,9:43,12404825,8080525,-4324300,SELL
22-09-20 9:44,9:44,12600600,8139975,-4460625,SELL
22-09-20 9:45,9:45,12414575,8207175,-4207400,SELL
22-09-20 9:46,9:46,12556100,8202550,-4353550,SELL
22-09-20 9:47,9:47,12591825,8264425,-4327400,SELL
22-09-20 9:48,9:48,12568125,7990050,-4578075,SELL
22-09-20 9:49,9:49,12488700,8188075,-4300625,SELL
22-09-20 9:50,9:50,12708800,8566725,-4142075,SELL
22-09-20 9:51,9:51,12394875,8434375,-3960500,SELL
22-09-20 9:52,9:52,12774200,8367475,-4406725,SELL
22-09-20 9:53,9:53,12640625,8586300,-4054325,SELL
22-09-20 9:54,9:54,12682900,8280900,-4402000,SELL
22-09-20 9:55,9:55,12300150,8341275,-3958875,SELL
22-09-20 9:56,9:56,12600225,8146900,-4453325,SELL
22-09-20 9:57,9:57,12572225,8517400,-4054825,SELL
22-09-20 9:58,9:58,12552750,8446025,-4106725,SELL
22-09-20 9:59,9:59,12606725,8956900,-3649825,SELL
22-09-20 10:00,10:00,12690900,8861175,-3829725,SELL
22-09-20 10:01,10:01,12612300,8750650,-3861650,SELL
22-09-20 10:02,10:02,12557225,8658000,-3899225,SELL
22-09-20 10:03,10:03,12248675,8542575,-3706100,SELL
22-09-20 10:04,10:04,12560850,8829225,-3731625,SELL
22-09-20 10:05,10:05,12354225,8831625,-3522600,SELL
22-09-20 10:06,10:06,12784175,9117700,-3666475,SELL
22-09-20 10:07,10:07,12800725,8788075,-4012650,SELL
22-09-20 10:08,10:08,12370400,8591975,-3778425,SELL
22-09-20 10:09,10:09,12297050,8877750,-3419300,SELL
22-09-20 10:10,10:10,12381225,8623875,-3757350,SELL
22-09-20 10:11,10:11,12408500,8560475,-3848025,SELL
22-09-20 10:12,10:12,12424625,8590975,-3833650,SELL
22-09-20 10:13,10:13,12399350,8918550,-3480800,SELL
22-09-20 10:14,10:14,11869250,8848725,-3020525,SELL
22-09-20 10:15,10:15,12252850,9055000,-3197850,SELL
22-09-20 10:16,10:16,12289650,8898000,-3391650,SELL
22-09-20 10:17,10:17,12301425,9096700,-3204725,SELL
22-09-20 10:18,10:18,12289400,8512950,-3776450,SELL
22-09-20 10:19,10:19,12377675,9034625,-3343050,SELL
22-09-20 10:20,10:20,12504900,8902900,-3602000,SELL
22-09-20 10:21,10:21,12558675,8978625,-3580050,SELL
22-09-20 10:22,10:22,12477750,9022300,-3455450,SELL
22-09-20 10:23,10:23,12601725,9122850,-3478875,SELL
22-09-20 10:24,10:24,12068100,9071325,-2996775,SELL
22-09-20 10:25,10:25,12463550,9040000,-3423550,SELL
22-09-20 10:26,10:26,12502800,9354075,-3148725,SELL
22-09-20 10:27,10:27,12543550,9171950,-3371600,SELL
22-09-20 10:28,10:28,12441050,9431400,-3009650,SELL
22-09-20 10:29,10:29,12447650,9189725,-3257925,SELL
22-09-20 10:30,10:30,12396400,9244500,-3151900,SELL
22-09-20 10:31,10:31,12584300,9454975,-3129325,SELL
22-09-20 10:32,10:32,12443850,8812350,-3631500,SELL
22-09-20 10:33,10:33,12597050,9538225,-3058825,SELL
22-09-20 10:34,10:34,12548450,8988625,-3559825,SELL
22-09-20 10:35,10:35,12547625,9158375,-3389250,SELL
22-09-20 10:36,10:36,12643675,9029975,-3613700,SELL
22-09-20 10:37,10:37,12610625,9014625,-3596000,SELL
22-09-20 10:38,10:38,12582875,9096725,-3486150,SELL
22-09-20 10:39,10:39,12334050,9218800,-3115250,SELL
22-09-20 10:40,10:40,12522825,9097475,-3425350,SELL
22-09-20 10:41,10:41,12574200,9317750,-3256450,SELL
22-09-20 10:42,10:42,12645875,9154200,-3491675,SELL
22-09-20 10:43,10:43,12645325,8897325,-3748000,SELL
22-09-20 10:44,10:44,12548650,8918225,-3630425,SELL
22-09-20 10:45,10:45,12664950,9022825,-3642125,SELL
22-09-20 10:46,10:46,12534700,8950600,-3584100,SELL
22-09-20 10:47,10:47,12643375,9140300,-3503075,SELL
22-09-20 10:48,10:48,12649025,9674575,-2974450,SELL
22-09-20 10:49,10:49,12393625,9398625,-2995000,SELL
22-09-20 10:50,10:50,12729450,9205400,-3524050,SELL
22-09-20 10:51,10:51,12420125,9471700,-2948425,SELL
22-09-20 10:52,10:52,12187200,9506275,-2680925,SELL
22-09-20 10:53,10:53,12085150,9258800,-2826350,SELL
22-09-20 10:54,10:54,12771050,9151350,-3619700,SELL
22-09-20 10:55,10:55,12652575,9379050,-3273525,SELL
22-09-20 10:56,10:56,12575225,9245950,-3329275,SELL
22-09-20 10:57,10:57,12110450,9000725,-3109725,SELL
22-09-20 10:58,10:58,12699000,9386600,-3312400,SELL
22-09-20 10:59,10:59,12184750,9310475,-2874275,SELL
22-09-20 11:00,11:00,12864925,9583875,-3281050,SELL
22-09-20 11:01,11:01,12760650,9443500,-3317150,SELL
22-09-20 11:02,11:02,12250825,9378575,-2872250,SELL
22-09-20 11:03,11:03,12490750,9005350,-3485400,SELL
22-09-20 11:04,11:04,12377900,9284675,-3093225,SELL
22-09-20 11:05,11:05,12742825,9554025,-3188800,SELL
22-09-20 11:06,11:06,12732275,9265600,-3466675,SELL
22-09-20 11:07,11:07,12858600,9424525,-3434075,SELL
22-09-20 11:08,11:08,11480900,9337900,-2143000,SELL
22-09-20 11:09,11:09,11905300,9112625,-2792675,SELL
22-09-20 11:10,11:10,12378300,9380925,-2997375,SELL
22-09-20 11:11,11:11,12804200,9440050,-3364150,SELL
22-09-20 11:12,11:12,12860325,9414175,-3446150,SELL
22-09-20 11:13,11:13,12597975,9786850,-2811125,SELL
22-09-20 11:14,11:14,12771275,9473425,-3297850,SELL
22-09-20 11:15,11:15,12926225,9759925,-3166300,SELL
22-09-20 11:16,11:16,12671050,9419700,-3251350,SELL
22-09-20 11:17,11:17,12994325,9487800,-3506525,SELL
22-09-20 11:18,11:18,12660300,9040850,-3619450,SELL
22-09-20 11:19,11:19,12601850,9108250,-3493600,SELL
22-09-20 11:20,11:20,12804825,9430725,-3374100,SELL
22-09-20 11:21,11:21,12523125,9491825,-3031300,SELL
22-09-20 11:22,11:22,12642125,9096400,-3545725,SELL
22-09-20 11:23,11:23,12931425,9349100,-3582325,SELL
22-09-20 11:24,11:24,12485375,9341050,-3144325,SELL
22-09-20 11:25,11:25,12774150,9299100,-3475050,SELL
22-09-20 11:26,11:26,12153975,9654050,-2499925,SELL
22-09-20 11:27,11:27,11795075,9212025,-2583050,SELL
22-09-20 11:28,11:28,12912100,9040875,-3871225,SELL
22-09-20 11:29,11:29,12898225,9684975,-3213250,SELL
22-09-20 11:30,11:30,13005150,9803425,-3201725,SELL
22-09-20 11:31,11:31,12966200,9501325,-3464875,SELL
22-09-20 11:32,11:32,12950800,9396025,-3554775,SELL
22-09-20 11:33,11:33,12591700,9654675,-2937025,SELL
22-09-20 11:34,11:34,12628325,9407300,-3221025,SELL
22-09-20 11:35,11:35,12689425,9338075,-3351350,SELL
22-09-20 11:36,11:36,12098500,9577700,-2520800,SELL
22-09-20 11:37,11:37,12885150,9701000,-3184150,SELL
22-09-20 11:38,11:38,12894275,9731500,-3162775,SELL
22-09-20 11:39,11:39,12864150,9469875,-3394275,SELL
22-09-20 11:40,11:40,12432050,9473975,-2958075,SELL
22-09-20 11:41,11:41,12900650,9393275,-3507375,SELL
22-09-20 11:42,11:42,12753700,8840850,-3912850,SELL
22-09-20 11:43,11:43,12568850,9213425,-3355425,SELL
22-09-20 11:44,11:44,13006625,9294775,-3711850,SELL
22-09-20 11:45,11:45,13019450,9905775,-3113675,SELL
22-09-20 11:46,11:46,12937650,8862525,-4075125,SELL
22-09-20 11:47,11:47,12733025,9442450,-3290575,SELL
22-09-20 11:48,11:48,11709300,9047300,-2662000,SELL
22-09-20 11:49,11:49,12555075,9037750,-3517325,SELL
22-09-20 11:50,11:50,12846625,9562700,-3283925,SELL
22-09-20 11:51,11:51,12935825,9522325,-3413500,SELL
22-09-20 11:52,11:52,12656725,9374000,-3282725,SELL
22-09-20 11:53,11:53,12943825,9067000,-3876825,SELL
22-09-20 11:54,11:54,12881750,9420475,-3461275,SELL
22-09-20 11:55,11:55,12854350,9206800,-3647550,SELL
22-09-20 11:56,11:56,12935400,9440250,-3495150,SELL
22-09-20 11:57,11:57,12487125,9445625,-3041500,SELL
22-09-20 11:58,11:58,12936375,9687225,-3249150,SELL
22-09-20 11:59,11:59,12598825,9556700,-3042125,SELL
22-09-20 12:00,12:00,12398125,9368425,-3029700,SELL
22-09-20 12:01,12:01,12735775,9872850,-2862925,SELL
22-09-20 12:02,12:02,12543375,9328675,-3214700,SELL
22-09-20 12:03,12:03,13017300,9415200,-3602100,SELL
22-09-20 12:04,12:04,12848350,9277575,-3570775,SELL
22-09-20 12:05,12:05,13070250,9384425,-3685825,SELL
22-09-20 12:06,12:06,12425625,9424175,-3001450,SELL
22-09-20 12:07,12:07,11765900,9134800,-2631100,SELL
22-09-20 12:08,12:08,12329025,9474925,-2854100,SELL
22-09-20 12:09,12:09,12601375,9440175,-3161200,SELL
22-09-20 12:10,12:10,12762550,9224725,-3537825,SELL
22-09-20 12:11,12:11,12483950,8943675,-3540275,SELL
22-09-20 12:12,12:12,13105725,9277975,-3827750,SELL
22-09-20 12:13,12:13,12788675,9509775,-3278900,SELL
22-09-20 12:14,12:14,12759400,9449300,-3310100,SELL
22-09-20 12:15,12:15,12759175,9310100,-3449075,SELL
22-09-20 12:16,12:16,12791500,9495075,-3296425,SELL
22-09-20 12:17,12:17,11691825,9107950,-2583875,SELL
22-09-20 12:18,12:18,12969100,9667900,-3301200,SELL
22-09-20 12:19,12:19,13170925,10036725,-3134200,SELL
22-09-20 12:20,12:20,13142900,9566550,-3576350,SELL
22-09-20 12:21,12:21,13069300,9707400,-3361900,SELL
22-09-20 12:22,12:22,12958375,9934575,-3023800,SELL
22-09-20 12:23,12:23,13181325,9531050,-3650275,SELL
22-09-20 12:24,12:24,13220750,9848575,-3372175,SELL
22-09-20 12:25,12:25,12894200,9468150,-3426050,SELL
22-09-20 12:26,12:26,13166400,9559000,-3607400,SELL
22-09-20 12:27,12:27,12835850,9430050,-3405800,SELL
22-09-20 12:28,12:28,12247225,9394825,-2852400,SELL
22-09-20 12:29,12:29,13094700,9303300,-3791400,SELL
22-09-20 12:30,12:30,12879325,9371850,-3507475,SELL
22-09-20 12:31,12:31,13116750,9169025,-3947725,SELL
22-09-20 12:32,12:32,13098425,9601825,-3496600,SELL
22-09-20 12:33,12:33,13088800,9545625,-3543175,SELL
22-09-20 12:34,12:34,12883825,9291800,-3592025,SELL
22-09-20 12:35,12:35,13113325,9644400,-3468925,SELL
22-09-20 12:36,12:36,13092375,9275825,-3816550,SELL
22-09-20 12:37,12:37,13123975,8864325,-4259650,SELL
22-09-20 12:38,12:38,13139200,9702600,-3436600,SELL
22-09-20 12:39,12:39,13111150,9574275,-3536875,SELL
22-09-20 12:40,12:40,12890600,9518900,-3371700,SELL
22-09-20 12:41,12:41,12965400,9462550,-3502850,SELL
22-09-20 12:42,12:42,13027375,9477475,-3549900,SELL
22-09-20 12:43,12:43,13129900,8952050,-4177850,SELL
22-09-20 12:44,12:44,12648575,8932350,-3716225,SELL
22-09-20 12:45,12:45,12846200,9356375,-3489825,SELL
22-09-20 12:46,12:46,12872375,9546750,-3325625,SELL
22-09-20 12:47,12:47,13044925,9174650,-3870275,SELL
22-09-20 12:48,12:48,13044050,9169200,-3874850,SELL
22-09-20 12:49,12:49,12631150,9487350,-3143800,SELL
22-09-20 12:50,12:50,12868600,9705350,-3163250,SELL
22-09-20 12:51,12:51,13184850,9291800,-3893050,SELL
22-09-20 12:52,12:52,13197925,9492375,-3705550,SELL
22-09-20 12:53,12:53,12886250,9237625,-3648625,SELL
22-09-20 12:54,12:54,13182500,9276700,-3905800,SELL
22-09-20 12:55,12:55,13201775,9353225,-3848550,SELL
22-09-20 12:56,12:56,13210275,9741950,-3468325,SELL
22-09-20 12:57,12:57,12694275,9295150,-3399125,SELL
22-09-20 12:58,12:58,12695275,9561700,-3133575,SELL
22-09-20 12:59,12:59,13223350,9627300,-3596050,SELL
22-09-20 13:00,13:00,13269275,9970950,-3298325,SELL
22-09-20 13:01,13:01,13006125,9448750,-3557375,SELL
22-09-20 13:02,13:02,13131350,9549975,-3581375,SELL
22-09-20 13:03,13:03,13096400,9709100,-3387300,SELL
22-09-20 13:04,13:04,12797375,9486100,-3311275,SELL
22-09-20 13:05,13:05,12788025,9371575,-3416450,SELL
22-09-20 13:06,13:06,13086650,9489975,-3596675,SELL
22-09-20 13:07,13:07,13102000,9546075,-3555925,SELL
22-09-20 13:08,13:08,13204025,9638525,-3565500,SELL
22-09-20 13:09,13:09,12801700,9612525,-3189175,SELL
22-09-20 13:10,13:10,12924650,9474700,-3449950,SELL
22-09-20 13:11,13:11,12701500,9560375,-3141125,SELL
22-09-20 13:12,13:12,12949275,8966625,-3982650,SELL
22-09-20 13:13,13:13,13026525,9748025,-3278500,SELL
22-09-20 13:14,13:14,12678050,9269275,-3408775,SELL
22-09-20 13:15,13:15,13215500,9816025,-3399475,SELL
22-09-20 13:16,13:16,12835825,9609975,-3225850,SELL
22-09-20 13:17,13:17,13025175,9381925,-3643250,SELL
22-09-20 13:18,13:18,13125650,9461325,-3664325,SELL
22-09-20 13:19,13:19,13220350,9378350,-3842000,SELL
22-09-20 13:20,13:20,13268225,9597675,-3670550,SELL
22-09-20 13:21,13:21,13216725,9794950,-3421775,SELL
22-09-20 13:22,13:22,12871375,9181950,-3689425,SELL
22-09-20 13:23,13:23,13282400,9677050,-3605350,SELL
22-09-20 13:24,13:24,13421700,9539150,-3882550,SELL
22-09-20 13:25,13:25,13303925,9569725,-3734200,SELL
22-09-20 13:26,13:26,12984025,9733425,-3250600,SELL
22-09-20 13:27,13:27,13320700,9533150,-3787550,SELL
22-09-20 13:28,13:28,13348275,9624525,-3723750,SELL
22-09-20 13:29,13:29,12858750,9452775,-3405975,SELL
22-09-20 13:30,13:30,12770200,9382850,-3387350,SELL
22-09-20 13:31,13:31,13423250,9646800,-3776450,SELL
22-09-20 13:32,13:32,13463575,9949450,-3514125,SELL
22-09-20 13:33,13:33,13011125,9620450,-3390675,SELL
22-09-20 13:34,13:34,13090500,9551725,-3538775,SELL
22-09-20 13:35,13:35,13095650,9864900,-3230750,SELL
22-09-20 13:36,13:36,13350975,9598650,-3752325,SELL
22-09-20 13:37,13:37,13206525,9529675,-3676850,SELL
22-09-20 13:38,13:38,13120225,10011950,-3108275,SELL
22-09-20 13:39,13:39,13287625,9662100,-3625525,SELL
22-09-20 13:40,13:40,13264825,9711075,-3553750,SELL
22-09-20 13:41,13:41,13177375,9494950,-3682425,SELL
22-09-20 13:42,13:42,12500050,9972300,-2527750,SELL
22-09-20 13:43,13:43,12481825,9551750,-2930075,SELL
22-09-20 13:44,13:44,13137900,9744475,-3393425,SELL
22-09-20 13:45,13:45,13306825,9945475,-3361350,SELL
22-09-20 13:46,13:46,13421850,10219025,-3202825,SELL
22-09-20 13:47,13:47,13026100,9708825,-3317275,SELL
22-09-20 13:48,13:48,13201400,9385950,-3815450,SELL
22-09-20 13:49,13:49,13168500,9585800,-3582700,SELL
22-09-20 13:50,13:50,12831025,9585525,-3245500,SELL
22-09-20 13:51,13:51,13240275,9583850,-3656425,SELL
22-09-20 13:52,13:52,12839700,9530925,-3308775,SELL
22-09-20 13:53,13:53,13081200,9647150,-3434050,SELL
22-09-20 13:54,13:54,13252375,9581025,-3671350,SELL
22-09-20 13:55,13:55,13343175,9844275,-3498900,SELL
22-09-20 13:56,13:56,13299925,9566125,-3733800,SELL
22-09-20 13:57,13:57,13375375,9470350,-3905025,SELL
22-09-20 13:58,13:58,13238825,9572900,-3665925,SELL
22-09-20 13:59,13:59,13304675,9261525,-4043150,SELL
22-09-20 14:00,14:00,13229675,9390075,-3839600,SELL
22-09-20 14:01,14:01,13243725,9376900,-3866825,SELL
22-09-20 14:02,14:02,13287050,9400550,-3886500,SELL
22-09-20 14:03,14:03,13406450,9141425,-4265025,SELL
22-09-20 14:04,14:04,13344575,9346350,-3998225,SELL
22-09-20 14:05,14:05,13427375,9623150,-3804225,SELL
22-09-20 14:06,14:06,12955675,9294250,-3661425,SELL
22-09-20 14:07,14:07,13149625,9525025,-3624600,SELL
22-09-20 14:08,14:08,13297350,9113925,-4183425,SELL
22-09-20 14:09,14:09,13256625,9308075,-3948550,SELL
22-09-20 14:10,14:10,13135425,9304250,-3831175,SELL
22-09-20 14:11,14:11,13395000,9471025,-3923975,SELL
22-09-20 14:12,14:12,13518200,9443025,-4075175,SELL
22-09-20 14:13,14:13,13478650,9131700,-4346950,SELL
22-09-20 14:14,14:14,13471700,9466225,-4005475,SELL
22-09-20 14:15,14:15,13462725,9366425,-4096300,SELL
22-09-20 14:16,14:16,13452150,9165675,-4286475,SELL
22-09-20 14:17,14:17,13425200,9048875,-4376325,SELL
22-09-20 14:18,14:18,13434475,9185275,-4249200,SELL
22-09-20 14:19,14:19,13243850,9354375,-3889475,SELL
22-09-20 14:20,14:20,13477700,9448675,-4029025,SELL
22-09-20 14:21,14:21,13168675,9316625,-3852050,SELL
22-09-20 14:22,14:22,13455425,9276800,-4178625,SELL
22-09-20 14:23,14:23,13569850,9206500,-4363350,SELL
22-09-20 14:24,14:24,13420125,9365175,-4054950,SELL
22-09-20 14:25,14:25,13442775,9154250,-4288525,SELL
22-09-20 14:26,14:26,13463275,9184075,-4279200,SELL
22-09-20 14:27,14:27,13607300,9051925,-4555375,SELL
22-09-20 14:28,14:28,13663325,9149275,-4514050,SELL
22-09-20 14:29,14:29,13681975,9133750,-4548225,SELL
22-09-20 14:30,14:30,13529675,8877425,-4652250,SELL
22-09-20 14:31,14:31,13513150,8971150,-4542000,SELL
22-09-20 14:32,14:32,13092300,8836800,-4255500,SELL
22-09-20 14:33,14:33,13450150,8715450,-4734700,SELL
22-09-20 14:34,14:34,13413400,8559275,-4854125,SELL
22-09-20 14:35,14:35,13541175,8739150,-4802025,SELL
22-09-20 14:36,14:36,13489575,8903875,-4585700,SELL
22-09-20 14:37,14:37,13556475,9181350,-4375125,SELL
22-09-20 14:38,14:38,13512675,8968225,-4544450,SELL
22-09-20 14:39,14:39,13425275,8621475,-4803800,SELL
22-09-20 14:40,14:40,13438875,8567325,-4871550,SELL
22-09-20 14:41,14:41,13122100,8459550,-4662550,SELL
22-09-20 14:42,14:42,13534550,8370400,-5164150,SELL
22-09-20 14:43,14:43,13490775,8531625,-4959150,SELL
22-09-20 14:44,14:44,13488150,8501675,-4986475,SELL
22-09-20 14:45,14:45,13555575,8477625,-5077950,SELL
22-09-20 14:46,14:46,13355075,8731000,-4624075,SELL
22-09-20 14:47,14:47,13378300,8703900,-4674400,SELL
22-09-20 14:48,14:48,13151250,8644075,-4507175,SELL
22-09-20 14:49,14:49,13320500,8177450,-5143050,SELL
22-09-20 14:50,14:50,13464875,8030600,-5434275,SELL
22-09-20 14:51,14:51,12879975,8261025,-4618950,SELL
22-09-20 14:52,14:52,13251800,8442450,-4809350,SELL
22-09-20 14:53,14:53,13345525,8138925,-5206600,SELL
22-09-20 14:54,14:54,13296450,8288700,-5007750,SELL
22-09-20 14:55,14:55,13386700,8537200,-4849500,SELL
22-09-20 14:56,14:56,13295075,8386800,-4908275,SELL
22-09-20 14:57,14:57,13253975,8368400,-4885575,SELL
22-09-20 14:58,14:58,13336650,8254850,-5081800,SELL
22-09-20 14:59,14:59,13368275,8417775,-4950500,SELL
22-09-20 15:00,15:00,13234925,8516650,-4718275,SELL
22-09-20 15:01,15:01,13328425,8509825,-4818600,SELL
22-09-20 15:02,15:02,13316225,8307275,-5008950,SELL
22-09-20 15:03,15:03,13306575,8109050,-5197525,SELL
22-09-20 15:04,15:04,13234150,8034475,-5199675,SELL
22-09-20 15:05,15:05,13398575,8475850,-4922725,SELL
22-09-20 15:06,15:06,13212700,8015425,-5197275,SELL
22-09-20 15:07,15:07,13155175,8040225,-5114950,SELL
22-09-20 15:08,15:08,13289100,8061100,-5228000,SELL
22-09-20 15:09,15:09,13151025,8193025,-4958000,SELL
22-09-20 15:10,15:10,13187075,8432500,-4754575,SELL
22-09-20 15:11,15:11,13199100,8094150,-5104950,SELL
22-09-20 15:12,15:12,12883650,8088275,-4795375,SELL
22-09-20 15:13,15:13,12929800,8234200,-4695600,SELL
22-09-20 15:14,15:14,13052650,8234600,-4818050,SELL
22-09-20 15:15,15:15,12988725,8047775,-4940950,SELL
22-09-20 15:16,15:16,12855625,7686500,-5169125,SELL
22-09-20 15:17,15:17,12919950,7827125,-5092825,SELL
22-09-20 15:18,15:18,12663625,7775900,-4887725,SELL
22-09-20 15:19,15:19,12745775,7870225,-4875550,SELL
22-09-20 15:20,15:20,12836300,7766600,-5069700,SELL
22-09-20 15:21,15:21,12576350,7844175,-4732175,SELL
22-09-20 15:22,15:22,12535425,7839000,-4696425,SELL
22-09-20 15:23,15:23,12658150,7586150,-5072000,SELL
22-09-20 15:24,15:24,12455450,7381150,-5074300,SELL
22-09-20 15:25,15:25,12450325,7721000,-4729325,SELL
22-09-20 15:26,15:26,12382450,7712750,-4669700,SELL
22-09-20 15:27,15:27,12407950,7475275,-4932675,SELL
22-09-20 15:28,15:28,12200700,7588775,-4611925,SELL
22-09-20 15:29,15:29,12367350,7650525,-4716825,SELL
23-09-20 9:15,9:15,12026225,7046550,-4979675,SELL
23-09-20 9:16,9:16,11861400,6999650,-4861750,SELL
23-09-20 9:17,9:17,12263975,7296950,-4967025,SELL
23-09-20 9:18,9:18,12343325,7465600,-4877725,SELL
23-09-20 9:19,9:19,12265300,7562175,-4703125,SELL
23-09-20 9:20,9:20,12698950,7995900,-4703050,SELL
23-09-20 9:21,9:21,12581475,7859500,-4721975,SELL
23-09-20 9:22,9:22,12526975,7904275,-4622700,SELL
23-09-20 9:23,9:23,12648750,8007075,-4641675,SELL
23-09-20 9:24,9:24,13062075,8111600,-4950475,SELL
23-09-20 9:25,9:25,13042150,8214875,-4827275,SELL
23-09-20 9:26,9:26,13079875,8202225,-4877650,SELL
23-09-20 9:27,9:27,12834175,8272925,-4561250,SELL
23-09-20 9:28,9:28,13165525,7924325,-5241200,SELL
23-09-20 9:29,9:29,13182100,8309225,-4872875,SELL
23-09-20 9:30,9:30,12872000,8410025,-4461975,SELL
23-09-20 9:31,9:31,12893550,8218125,-4675425,SELL
23-09-20 9:32,9:32,13317050,8705425,-4611625,SELL
23-09-20 9:33,9:33,13304650,8601175,-4703475,SELL
23-09-20 9:34,9:34,13355425,8699600,-4655825,SELL
23-09-20 9:35,9:35,13688800,8767900,-4920900,SELL
23-09-20 9:36,9:36,13398475,8688675,-4709800,SELL
23-09-20 9:37,9:37,13579450,8650675,-4928775,SELL
23-09-20 9:38,9:38,13805100,8823525,-4981575,SELL
23-09-20 9:39,9:39,13702400,8648725,-5053675,SELL
23-09-20 9:40,9:40,13896900,8876800,-5020100,SELL
23-09-20 9:41,9:41,13814925,8966725,-4848200,SELL
23-09-20 9:42,9:42,13825625,8728350,-5097275,SELL
23-09-20 9:43,9:43,12820375,8547375,-4273000,SELL
23-09-20 9:44,9:44,13758800,8490925,-5267875,SELL
23-09-20 9:45,9:45,14081450,8917375,-5164075,SELL
23-09-20 9:46,9:46,14116925,9022125,-5094800,SELL
23-09-20 9:47,9:47,14191975,9060275,-5131700,SELL
23-09-20 9:48,9:48,14265800,8893575,-5372225,SELL
23-09-20 9:49,9:49,14164950,9295325,-4869625,SELL
23-09-20 9:50,9:50,14323925,8879575,-5444350,SELL
23-09-20 9:51,9:51,14017950,8839425,-5178525,SELL
23-09-20 9:52,9:52,14350425,8685550,-5664875,SELL
23-09-20 9:53,9:53,14089575,9139000,-4950575,SELL
23-09-20 9:54,9:54,13644925,8916175,-4728750,SELL
23-09-20 9:55,9:55,13866125,8900725,-4965400,SELL
23-09-20 9:56,9:56,14443325,8878625,-5564700,SELL
23-09-20 9:57,9:57,14514775,8928625,-5586150,SELL
23-09-20 9:58,9:58,14363500,9042925,-5320575,SELL
23-09-20 9:59,9:59,14027975,8825625,-5202350,SELL
23-09-20 10:00,10:00,14223625,8871550,-5352075,SELL
23-09-20 10:01,10:01,14432600,8930775,-5501825,SELL
23-09-20 10:02,10:02,13826475,9007550,-4818925,SELL
23-09-20 10:03,10:03,14267500,9243075,-5024425,SELL
23-09-20 10:04,10:04,14339750,9364500,-4975250,SELL
23-09-20 10:05,10:05,14492800,9103350,-5389450,SELL
23-09-20 10:06,10:06,14306375,9331750,-4974625,SELL
23-09-20 10:07,10:07,14238525,9253450,-4985075,SELL
23-09-20 10:08,10:08,14606525,9077600,-5528925,SELL
23-09-20 10:09,10:09,14593325,9002450,-5590875,SELL
23-09-20 10:10,10:10,14370125,9336325,-5033800,SELL
23-09-20 10:11,10:11,14616525,9364300,-5252225,SELL
23-09-20 10:12,10:12,14435725,9128925,-5306800,SELL
23-09-20 10:13,10:13,14278550,9007350,-5271200,SELL
23-09-20 10:14,10:14,14421925,9378700,-5043225,SELL
23-09-20 10:15,10:15,14494450,9354675,-5139775,SELL
23-09-20 10:16,10:16,14665575,9183450,-5482125,SELL
23-09-20 10:17,10:17,14334150,9336925,-4997225,SELL
23-09-20 10:18,10:18,14532000,9260200,-5271800,SELL
23-09-20 10:19,10:19,14566275,9297675,-5268600,SELL
23-09-20 10:20,10:20,14769200,9432575,-5336625,SELL
23-09-20 10:21,10:21,14637950,9208075,-5429875,SELL
23-09-20 10:22,10:22,14487150,9269225,-5217925,SELL
23-09-20 10:23,10:23,14729025,9832800,-4896225,SELL
23-09-20 10:24,10:24,14658900,9247125,-5411775,SELL
23-09-20 10:25,10:25,14383475,9383400,-5000075,SELL
23-09-20 10:26,10:26,14713575,9520100,-5193475,SELL
23-09-20 10:27,10:27,14255825,9541950,-4713875,SELL
23-09-20 10:28,10:28,14596450,9591125,-5005325,SELL
23-09-20 10:29,10:29,14420975,9467950,-4953025,SELL
23-09-20 10:30,10:30,14479125,9597350,-4881775,SELL
23-09-20 10:31,10:31,14635375,9161075,-5474300,SELL
23-09-20 10:32,10:32,13823450,9579200,-4244250,SELL
23-09-20 10:33,10:33,14566825,9356250,-5210575,SELL
23-09-20 10:34,10:34,14476425,9319850,-5156575,SELL
23-09-20 10:35,10:35,13714200,9651925,-4062275,SELL
23-09-20 10:36,10:36,13909325,9117550,-4791775,SELL
23-09-20 10:37,10:37,14425225,9559075,-4866150,SELL
23-09-20 10:38,10:38,14480125,9436875,-5043250,SELL
23-09-20 10:39,10:39,14376900,9550925,-4825975,SELL
23-09-20 10:40,10:40,14641650,9584050,-5057600,SELL
23-09-20 10:41,10:41,14846825,9462475,-5384350,SELL
23-09-20 10:42,10:42,14726950,9474675,-5252275,SELL
23-09-20 10:43,10:43,13855750,9369275,-4486475,SELL
23-09-20 10:44,10:44,14614825,9443475,-5171350,SELL
23-09-20 10:45,10:45,14141500,9406925,-4734575,SELL
23-09-20 10:46,10:46,14280775,9171575,-5109200,SELL
23-09-20 10:47,10:47,13367225,9444550,-3922675,SELL
23-09-20 10:48,10:48,14466375,9436950,-5029425,SELL
23-09-20 10:49,10:49,14359025,9184500,-5174525,SELL
23-09-20 10:50,10:50,14335125,9414500,-4920625,SELL
23-09-20 10:51,10:51,14788100,9322775,-5465325,SELL
23-09-20 10:52,10:52,14425625,9218350,-5207275,SELL
23-09-20 10:53,10:53,13915200,9497100,-4418100,SELL
23-09-20 10:54,10:54,13965650,9377925,-4587725,SELL
23-09-20 10:55,10:55,14833325,9809225,-5024100,SELL
23-09-20 10:56,10:56,14629625,9655075,-4974550,SELL
23-09-20 10:57,10:57,13726575,9552950,-4173625,SELL
23-09-20 10:58,10:58,14607350,9387075,-5220275,SELL
23-09-20 10:59,10:59,14576075,9461450,-5114625,SELL
23-09-20 11:00,11:00,14676525,9540975,-5135550,SELL
23-09-20 11:01,11:01,14755950,9871050,-4884900,SELL
23-09-20 11:02,11:02,14689725,9171475,-5518250,SELL
23-09-20 11:03,11:03,14560400,9422550,-5137850,SELL
23-09-20 11:04,11:04,14069275,9561750,-4507525,SELL
23-09-20 11:05,11:05,14348375,9563050,-4785325,SELL
23-09-20 11:06,11:06,14395100,9367625,-5027475,SELL
23-09-20 11:07,11:07,14181500,9568275,-4613225,SELL
23-09-20 11:08,11:08,14617525,10240800,-4376725,SELL
23-09-20 11:09,11:09,14025450,9733925,-4291525,SELL
23-09-20 11:10,11:10,14649700,9615125,-5034575,SELL
23-09-20 11:11,11:11,14913775,9483200,-5430575,SELL
23-09-20 11:12,11:12,14701750,9486950,-5214800,SELL
23-09-20 11:13,11:13,13541500,9611250,-3930250,SELL
23-09-20 11:14,11:14,15038125,9613400,-5424725,SELL
23-09-20 11:15,11:15,14145850,9643325,-4502525,SELL
23-09-20 11:16,11:16,14531850,9446300,-5085550,SELL
23-09-20 11:17,11:17,14911900,9724900,-5187000,SELL
23-09-20 11:18,11:18,14682675,9315750,-5366925,SELL
23-09-20 11:19,11:19,14524000,9695475,-4828525,SELL
23-09-20 11:20,11:20,14868550,9436625,-5431925,SELL
23-09-20 11:21,11:21,14705450,9614875,-5090575,SELL
23-09-20 11:22,11:22,14662000,9419625,-5242375,SELL
23-09-20 11:23,11:23,14557525,9882575,-4674950,SELL
23-09-20 11:24,11:24,13967600,9431650,-4535950,SELL
23-09-20 11:25,11:25,14484400,10177025,-4307375,SELL
23-09-20 11:26,11:26,13967625,9618975,-4348650,SELL
23-09-20 11:27,11:27,14584425,9669900,-4914525,SELL
23-09-20 11:28,11:28,14708725,10226150,-4482575,SELL
23-09-20 11:29,11:29,14564475,9754975,-4809500,SELL
23-09-20 11:30,11:30,14719850,10370125,-4349725,SELL
23-09-20 11:31,11:31,14715675,9762550,-4953125,SELL
23-09-20 11:32,11:32,13872125,9513300,-4358825,SELL
23-09-20 11:33,11:33,14299100,9705800,-4593300,SELL
23-09-20 11:34,11:34,13685250,9734550,-3950700,SELL
23-09-20 11:35,11:35,14567400,9516050,-5051350,SELL
23-09-20 11:36,11:36,14307775,10080750,-4227025,SELL
23-09-20 11:37,11:37,14537950,9504725,-5033225,SELL
23-09-20 11:38,11:38,14495375,9846725,-4648650,SELL
23-09-20 11:39,11:39,14900825,9499575,-5401250,SELL
23-09-20 11:40,11:40,14665850,9602050,-5063800,SELL
23-09-20 11:41,11:41,14466300,9712250,-4754050,SELL
23-09-20 11:42,11:42,14488325,9839075,-4649250,SELL
23-09-20 11:43,11:43,14437525,9780400,-4657125,SELL
23-09-20 11:44,11:44,14410625,9514075,-4896550,SELL
23-09-20 11:45,11:45,14276350,9898750,-4377600,SELL
23-09-20 11:46,11:46,14676225,9635300,-5040925,SELL
23-09-20 11:47,11:47,14543475,9585425,-4958050,SELL
23-09-20 11:48,11:48,14639650,9583200,-5056450,SELL
23-09-20 11:49,11:49,14812675,9627150,-5185525,SELL
23-09-20 11:50,11:50,13180975,10231050,-2949925,SELL
23-09-20 11:51,11:51,14726700,9845600,-4881100,SELL
23-09-20 11:52,11:52,14680775,10080225,-4600550,SELL
23-09-20 11:53,11:53,14901600,9661650,-5239950,SELL
23-09-20 11:54,11:54,15018775,9424825,-5593950,SELL
23-09-20 11:55,11:55,15075350,10052550,-5022800,SELL
23-09-20 11:56,11:56,15095550,9957125,-5138425,SELL
23-09-20 11:57,11:57,15051225,10158425,-4892800,SELL
23-09-20 11:58,11:58,15022950,9937250,-5085700,SELL
23-09-20 11:59,11:59,15087875,10001800,-5086075,SELL
23-09-20 12:00,12:00,15076125,10229625,-4846500,SELL
23-09-20 12:01,12:01,14988125,10431050,-4557075,SELL
23-09-20 12:02,12:02,15210775,10062200,-5148575,SELL
23-09-20 12:03,12:03,14913275,9885100,-5028175,SELL
23-09-20 12:04,12:04,14749675,9952050,-4797625,SELL
23-09-20 12:05,12:05,14877775,9595275,-5282500,SELL
23-09-20 12:06,12:06,14981600,9797675,-5183925,SELL
23-09-20 12:07,12:07,14799325,9607450,-5191875,SELL
23-09-20 12:08,12:08,14532925,9489725,-5043200,SELL
23-09-20 12:09,12:09,14903725,9649950,-5253775,SELL
23-09-20 12:10,12:10,14836250,9455325,-5380925,SELL
23-09-20 12:11,12:11,14867725,10000675,-4867050,SELL
23-09-20 12:12,12:12,14831600,9536775,-5294825,SELL
23-09-20 12:13,12:13,14582750,9761450,-4821300,SELL
23-09-20 12:14,12:14,14503500,9453275,-5050225,SELL
23-09-20 12:15,12:15,14824375,9900275,-4924100,SELL
23-09-20 12:16,12:16,14808900,9616950,-5191950,SELL
23-09-20 12:17,12:17,14671800,9527675,-5144125,SELL
23-09-20 12:18,12:18,14653475,9383700,-5269775,SELL
23-09-20 12:19,12:19,14704950,9507700,-5197250,SELL
23-09-20 12:20,12:20,13895325,9029725,-4865600,SELL
23-09-20 12:21,12:21,14785700,9012275,-5773425,SELL
23-09-20 12:22,12:22,13865775,9356600,-4509175,SELL
23-09-20 12:23,12:23,14430250,9283650,-5146600,SELL
23-09-20 12:24,12:24,14559375,9621000,-4938375,SELL
23-09-20 12:25,12:25,13644200,9324475,-4319725,SELL
23-09-20 12:26,12:26,14867450,9721700,-5145750,SELL
23-09-20 12:27,12:27,14896550,9968975,-4927575,SELL
23-09-20 12:28,12:28,14611925,9470475,-5141450,SELL
23-09-20 12:29,12:29,14764275,9308150,-5456125,SELL
23-09-20 12:30,12:30,14647150,9431200,-5215950,SELL
23-09-20 12:31,12:31,14559375,9333600,-5225775,SELL
23-09-20 12:32,12:32,14337850,9311675,-5026175,SELL
23-09-20 12:33,12:33,14519875,9684250,-4835625,SELL
23-09-20 12:34,12:34,14472650,9661650,-4811000,SELL
23-09-20 12:35,12:35,14515400,9795250,-4720150,SELL
23-09-20 12:36,12:36,14119100,9401325,-4717775,SELL
23-09-20 12:37,12:37,13647800,9186275,-4461525,SELL
23-09-20 12:38,12:38,14717850,9435725,-5282125,SELL
23-09-20 12:39,12:39,14621675,9451025,-5170650,SELL
23-09-20 12:40,12:40,14476050,9804300,-4671750,SELL
23-09-20 12:41,12:41,14503050,9618700,-4884350,SELL
23-09-20 12:42,12:42,14652250,9549600,-5102650,SELL
23-09-20 12:43,12:43,14361450,9768100,-4593350,SELL
23-09-20 12:44,12:44,14673350,9456125,-5217225,SELL
23-09-20 12:45,12:45,14885950,9877675,-5008275,SELL
23-09-20 12:46,12:46,14248275,9760975,-4487300,SELL
23-09-20 12:47,12:47,13920325,9629225,-4291100,SELL
23-09-20 12:48,12:48,14437175,9430675,-5006500,SELL
23-09-20 12:49,12:49,14646875,9385950,-5260925,SELL
23-09-20 12:50,12:50,14811200,9304250,-5506950,SELL
23-09-20 12:51,12:51,14651450,9750100,-4901350,SELL
23-09-20 12:52,12:52,14792675,9382550,-5410125,SELL
23-09-20 12:53,12:53,14658500,9557575,-5100925,SELL
23-09-20 12:54,12:54,14053175,9564575,-4488600,SELL
23-09-20 12:55,12:55,14767900,9448925,-5318975,SELL
23-09-20 12:56,12:56,14596100,9245525,-5350575,SELL
23-09-20 12:57,12:57,14465900,8977425,-5488475,SELL
23-09-20 12:58,12:58,14116350,9369925,-4746425,SELL
23-09-20 12:59,12:59,14176775,8855125,-5321650,SELL
23-09-20 13:00,13:00,13572675,9417750,-4154925,SELL
23-09-20 13:01,13:01,13987275,9472500,-4514775,SELL
23-09-20 13:02,13:02,14008825,9146025,-4862800,SELL
23-09-20 13:03,13:03,13407750,9170725,-4237025,SELL
23-09-20 13:04,13:04,13994325,8699325,-5295000,SELL
23-09-20 13:05,13:05,13323050,9003700,-4319350,SELL
23-09-20 13:06,13:06,14555225,8982125,-5573100,SELL
23-09-20 13:07,13:07,14455250,9045350,-5409900,SELL
23-09-20 13:08,13:08,14680300,9439350,-5240950,SELL
23-09-20 13:09,13:09,14168650,8909550,-5259100,SELL
23-09-20 13:10,13:10,14676475,9178200,-5498275,SELL
23-09-20 13:11,13:11,13911475,9259475,-4652000,SELL
23-09-20 13:12,13:12,14509600,9169275,-5340325,SELL
23-09-20 13:13,13:13,14393025,8912650,-5480375,SELL
23-09-20 13:14,13:14,14337375,8989000,-5348375,SELL
23-09-20 13:15,13:15,13617475,9083025,-4534450,SELL
23-09-20 13:16,13:16,14216650,9229450,-4987200,SELL
23-09-20 13:17,13:17,14156825,9182300,-4974525,SELL
23-09-20 13:18,13:18,14402450,9261725,-5140725,SELL
23-09-20 13:19,13:19,14205125,9104925,-5100200,SELL
23-09-20 13:20,13:20,14071375,9295050,-4776325,SELL
23-09-20 13:21,13:21,13988700,9400950,-4587750,SELL
23-09-20 13:22,13:22,13737075,9111475,-4625600,SELL
23-09-20 13:23,13:23,14161500,9046625,-5114875,SELL
23-09-20 13:24,13:24,14323750,9306400,-5017350,SELL
23-09-20 13:25,13:25,14954575,9175200,-5779375,SELL
23-09-20 13:26,13:26,14503700,9358100,-5145600,SELL
23-09-20 13:27,13:27,14698725,9132675,-5566050,SELL
23-09-20 13:28,13:28,14831575,8876400,-5955175,SELL
23-09-20 13:29,13:29,14238050,9111550,-5126500,SELL
23-09-20 13:30,13:30,14699500,9230700,-5468800,SELL
23-09-20 13:31,13:31,14793700,9319775,-5473925,SELL
23-09-20 13:32,13:32,14415850,9106375,-5309475,SELL
23-09-20 13:33,13:33,14157825,8877275,-5280550,SELL
23-09-20 13:34,13:34,14028400,8786450,-5241950,SELL
23-09-20 13:35,13:35,14555900,9324800,-5231100,SELL
23-09-20 13:36,13:36,14494400,9286700,-5207700,SELL
23-09-20 13:37,13:37,14265575,8867450,-5398125,SELL
23-09-20 13:38,13:38,14666975,8780250,-5886725,SELL
23-09-20 13:39,13:39,14850175,9136950,-5713225,SELL
23-09-20 13:40,13:40,14548550,9309000,-5239550,SELL
23-09-20 13:41,13:41,14472925,9837450,-4635475,SELL
23-09-20 13:42,13:42,14911175,8867625,-6043550,SELL
23-09-20 13:43,13:43,14838800,8638500,-6200300,SELL
23-09-20 13:44,13:44,14760950,8779175,-5981775,SELL
23-09-20 13:45,13:45,14675900,8455375,-6220525,SELL
23-09-20 13:46,13:46,14501975,8526625,-5975350,SELL
23-09-20 13:47,13:47,14438725,8422975,-6015750,SELL
23-09-20 13:48,13:48,14193425,8564725,-5628700,SELL
23-09-20 13:49,13:49,14676000,8085750,-6590250,SELL
23-09-20 13:50,13:50,14699275,8613775,-6085500,SELL
23-09-20 13:51,13:51,14818950,8415325,-6403625,SELL
23-09-20 13:52,13:52,14690075,8258400,-6431675,SELL
23-09-20 13:53,13:53,14761000,8275250,-6485750,SELL
23-09-20 13:54,13:54,14703050,8137075,-6565975,SELL
23-09-20 13:55,13:55,14595575,8336575,-6259000,SELL
23-09-20 13:56,13:56,14642175,8420650,-6221525,SELL
23-09-20 13:57,13:57,14615150,8251250,-6363900,SELL
23-09-20 13:58,13:58,14526425,8143075,-6383350,SELL
23-09-20 13:59,13:59,14114850,8083650,-6031200,SELL
23-09-20 14:00,14:00,14651475,8363100,-6288375,SELL
23-09-20 14:01,14:01,14622950,7929800,-6693150,SELL
23-09-20 14:02,14:02,14646325,8312775,-6333550,SELL
23-09-20 14:03,14:03,14537550,8394300,-6143250,SELL
23-09-20 14:04,14:04,14783975,8310000,-6473975,SELL
23-09-20 14:05,14:05,14597575,8162575,-6435000,SELL
23-09-20 14:06,14:06,14345150,8414600,-5930550,SELL
23-09-20 14:07,14:07,14737050,7943900,-6793150,SELL
23-09-20 14:08,14:08,14617600,8051250,-6566350,SELL
23-09-20 14:09,14:09,14726300,8174675,-6551625,SELL
23-09-20 14:10,14:10,14549675,8252150,-6297525,SELL
23-09-20 14:11,14:11,14508675,8474950,-6033725,SELL
23-09-20 14:12,14:12,14828475,8500075,-6328400,SELL
23-09-20 14:13,14:13,14814200,8536500,-6277700,SELL
23-09-20 14:14,14:14,14358775,7937275,-6421500,SELL
23-09-20 14:15,14:15,14674425,8432850,-6241575,SELL
23-09-20 14:16,14:16,14534375,8382325,-6152050,SELL
23-09-20 14:17,14:17,14123775,8256325,-5867450,SELL
23-09-20 14:18,14:18,14467425,7830675,-6636750,SELL
23-09-20 14:19,14:19,14760175,8204450,-6555725,SELL
23-09-20 14:20,14:20,14520975,8259525,-6261450,SELL
23-09-20 14:21,14:21,14790775,8134050,-6656725,SELL
23-09-20 14:22,14:22,14821875,8165425,-6656450,SELL
23-09-20 14:23,14:23,14794750,8302575,-6492175,SELL
23-09-20 14:24,14:24,14552850,8519250,-6033600,SELL
23-09-20 14:25,14:25,14341325,8696725,-5644600,SELL
23-09-20 14:26,14:26,14617350,8601375,-6015975,SELL
23-09-20 14:27,14:27,13912225,8392300,-5519925,SELL
23-09-20 14:28,14:28,13890025,8152175,-5737850,SELL
23-09-20 14:29,14:29,13996575,8270150,-5726425,SELL
23-09-20 14:30,14:30,13772550,7924100,-5848450,SELL
23-09-20 14:31,14:31,13790475,8149100,-5641375,SELL
23-09-20 14:32,14:32,13872725,8132575,-5740150,SELL
23-09-20 14:33,14:33,13819525,8343450,-5476075,SELL
23-09-20 14:34,14:34,13877250,8222925,-5654325,SELL
23-09-20 14:35,14:35,13761450,8197750,-5563700,SELL
23-09-20 14:36,14:36,13228850,8088525,-5140325,SELL
23-09-20 14:37,14:37,13527025,8003075,-5523950,SELL
23-09-20 14:38,14:38,13452625,7863675,-5588950,SELL
23-09-20 14:39,14:39,13558950,7832150,-5726800,SELL
23-09-20 14:40,14:40,13644775,8170250,-5474525,SELL
23-09-20 14:41,14:41,13435575,8062125,-5373450,SELL
23-09-20 14:42,14:42,13540900,7849325,-5691575,SELL
23-09-20 14:43,14:43,13527450,7772050,-5755400,SELL
23-09-20 14:44,14:44,13640500,7837800,-5802700,SELL
23-09-20 14:45,14:45,13701375,8049875,-5651500,SELL
23-09-20 14:46,14:46,13700600,8133825,-5566775,SELL
23-09-20 14:47,14:47,13698925,8047700,-5651225,SELL
23-09-20 14:48,14:48,13649775,8086775,-5563000,SELL
23-09-20 14:49,14:49,13680875,8345350,-5335525,SELL
23-09-20 14:50,14:50,13744800,8476725,-5268075,SELL
23-09-20 14:51,14:51,13027650,8014850,-5012800,SELL
23-09-20 14:52,14:52,13535450,8088875,-5446575,SELL
23-09-20 14:53,14:53,13502025,7923550,-5578475,SELL
23-09-20 14:54,14:54,13135250,8126825,-5008425,SELL
23-09-20 14:55,14:55,12889675,8013675,-4876000,SELL
23-09-20 14:56,14:56,13162350,8004850,-5157500,SELL
23-09-20 14:57,14:57,12932150,8024675,-4907475,SELL
23-09-20 14:58,14:58,13275525,7981225,-5294300,SELL
23-09-20 14:59,14:59,13282975,8200525,-5082450,SELL
23-09-20 15:00,15:00,13175325,7907025,-5268300,SELL
23-09-20 15:01,15:01,13263400,8117625,-5145775,SELL
23-09-20 15:02,15:02,13045550,8065225,-4980325,SELL
23-09-20 15:03,15:03,13074000,7558500,-5515500,SELL
23-09-20 15:04,15:04,13128650,8155125,-4973525,SELL
23-09-20 15:05,15:05,13121075,7973650,-5147425,SELL
23-09-20 15:06,15:06,12509725,7926025,-4583700,SELL
23-09-20 15:07,15:07,12931025,7839950,-5091075,SELL
23-09-20 15:08,15:08,13061175,8014725,-5046450,SELL
23-09-20 15:09,15:09,12910125,8071600,-4838525,SELL
23-09-20 15:10,15:10,12961850,8132175,-4829675,SELL
23-09-20 15:11,15:11,12474850,7990725,-4484125,SELL
23-09-20 15:12,15:12,12684225,7956900,-4727325,SELL
23-09-20 15:13,15:13,12679525,7597500,-5082025,SELL
23-09-20 15:14,15:14,12388825,7674175,-4714650,SELL
23-09-20 15:15,15:15,12877500,7782500,-5095000,SELL
23-09-20 15:16,15:16,12867925,7717650,-5150275,SELL
23-09-20 15:17,15:17,12833400,7587675,-5245725,SELL
23-09-20 15:18,15:18,12801600,7745500,-5056100,SELL
23-09-20 15:19,15:19,12731875,7786050,-4945825,SELL
23-09-20 15:20,15:20,12833950,7640550,-5193400,SELL
23-09-20 15:21,15:21,12512700,7522875,-4989825,SELL
23-09-20 15:22,15:22,12145825,7573850,-4571975,SELL
23-09-20 15:23,15:23,12490475,7618150,-4872325,SELL
23-09-20 15:24,15:24,12269750,7623075,-4646675,SELL
23-09-20 15:25,15:25,12275100,7745275,-4529825,SELL
23-09-20 15:26,15:26,12200350,7575350,-4625000,SELL
23-09-20 15:27,15:27,11943600,7690775,-4252825,SELL
23-09-20 15:28,15:28,11845750,7717400,-4128350,SELL
23-09-20 15:29,15:29,12012800,7717400,-4295400,SELL
24-09-20 9:15,9:15,11736325,6212075,-5524250,SELL
24-09-20 9:16,9:16,11688725,7227250,-4461475,SELL
24-09-20 9:17,9:17,11828475,7442375,-4386100,SELL
24-09-20 9:18,9:18,11844050,7206125,-4637925,SELL
24-09-20 9:19,9:19,11787950,7420025,-4367925,SELL
24-09-20 9:20,9:20,12309450,7855700,-4453750,SELL
24-09-20 9:21,9:21,12327775,7979475,-4348300,SELL
24-09-20 9:22,9:22,12174775,7759825,-4414950,SELL
24-09-20 9:23,9:23,13333000,8350075,-4982925,SELL
24-09-20 9:24,9:24,13256875,8688550,-4568325,SELL
24-09-20 9:25,9:25,13256525,8702375,-4554150,SELL
24-09-20 9:26,9:26,13963325,8811025,-5152300,SELL
24-09-20 9:27,9:27,13809400,8678275,-5131125,SELL
24-09-20 9:28,9:28,14057800,8816150,-5241650,SELL
24-09-20 9:29,9:29,14814225,9439125,-5375100,SELL
24-09-20 9:30,9:30,14635425,8959500,-5675925,SELL
24-09-20 9:31,9:31,14852750,9574000,-5278750,SELL
24-09-20 9:32,9:32,15849075,9878700,-5970375,SELL
24-09-20 9:33,9:33,15845625,9788450,-6057175,SELL
24-09-20 9:34,9:34,15966250,10151000,-5815250,SELL
24-09-20 9:35,9:35,16029500,10487075,-5542425,SELL
24-09-20 9:36,9:36,15953100,10347525,-5605575,SELL
24-09-20 9:37,9:37,16328150,10257850,-6070300,SELL
24-09-20 9:38,9:38,16475800,10349475,-6126325,SELL
24-09-20 9:39,9:39,16450300,10619200,-5831100,SELL
24-09-20 9:40,9:40,16339400,10361925,-5977475,SELL
24-09-20 9:41,9:41,16825750,11033950,-5791800,SELL
24-09-20 9:42,9:42,16967125,11141425,-5825700,SELL
24-09-20 9:43,9:43,16679000,10874800,-5804200,SELL
24-09-20 9:44,9:44,17129150,11018725,-6110425,SELL
24-09-20 9:45,9:45,17406975,11039225,-6367750,SELL
24-09-20 9:47,9:47,16744000,11437050,-5306950,SELL
24-09-20 9:48,9:48,17117225,11163825,-5953400,SELL
24-09-20 9:49,9:49,17424525,11352450,-6072075,SELL
24-09-20 9:50,9:50,17376925,11787475,-5589450,SELL
24-09-20 9:51,9:51,17532500,11202675,-6329825,SELL
24-09-20 9:52,9:52,17569025,11502200,-6066825,SELL
24-09-20 9:53,9:53,17087400,11543925,-5543475,SELL
24-09-20 9:54,9:54,17845425,11468900,-6376525,SELL
24-09-20 9:55,9:55,17756575,11373550,-6383025,SELL
24-09-20 9:56,9:56,18050425,11602150,-6448275,SELL
24-09-20 9:57,9:57,18147650,11791050,-6356600,SELL
24-09-20 9:58,9:58,17943025,11643025,-6300000,SELL
24-09-20 9:59,9:59,17925225,11883750,-6041475,SELL
24-09-20 10:00,10:00,18224825,12056850,-6167975,SELL
24-09-20 10:01,10:01,17600750,11886700,-5714050,SELL
24-09-20 10:02,10:02,18538550,11848950,-6689600,SELL
24-09-20 10:03,10:03,18406150,11647450,-6758700,SELL
24-09-20 10:04,10:04,18309475,11952750,-6356725,SELL
24-09-20 10:05,10:05,18189825,12181175,-6008650,SELL
24-09-20 10:06,10:06,18670925,12030100,-6640825,SELL
24-09-20 10:07,10:07,18730800,11198075,-7532725,SELL
24-09-20 10:08,10:08,18711050,12252525,-6458525,SELL
24-09-20 10:09,10:09,18900875,12021875,-6879000,SELL
24-09-20 10:10,10:10,18552925,12602000,-5950925,SELL
24-09-20 10:11,10:11,18828575,12255500,-6573075,SELL
24-09-20 10:12,10:12,18720975,11916475,-6804500,SELL
24-09-20 10:13,10:13,18709750,12005475,-6704275,SELL
24-09-20 10:14,10:14,18945700,12408500,-6537200,SELL
24-09-20 10:15,10:15,18932650,12294875,-6637775,SELL
24-09-20 10:16,10:16,18953375,12260350,-6693025,SELL
24-09-20 10:17,10:17,19373350,12326475,-7046875,SELL
24-09-20 10:18,10:18,19300050,12429800,-6870250,SELL
24-09-20 10:19,10:19,19245750,12104825,-7140925,SELL
24-09-20 10:20,10:20,19353500,12179575,-7173925,SELL
24-09-20 10:21,10:21,19519475,12453450,-7066025,SELL
24-09-20 10:22,10:22,18889550,12184750,-6704800,SELL
24-09-20 10:23,10:23,19313625,12335525,-6978100,SELL
24-09-20 10:24,10:24,18137625,12688750,-5448875,SELL
24-09-20 10:25,10:25,19952950,12308825,-7644125,SELL
24-09-20 10:26,10:26,19608800,12696625,-6912175,SELL
24-09-20 10:27,10:27,19883200,12829700,-7053500,SELL
24-09-20 10:28,10:28,19863025,12813425,-7049600,SELL
24-09-20 10:29,10:29,19968875,12324800,-7644075,SELL
24-09-20 10:30,10:30,20463300,12395650,-8067650,SELL
24-09-20 10:31,10:31,20053250,11911425,-8141825,SELL
24-09-20 10:32,10:32,20531475,12495950,-8035525,SELL
24-09-20 10:33,10:33,20560900,12645200,-7915700,SELL
24-09-20 10:34,10:34,20360000,12607500,-7752500,SELL
24-09-20 10:35,10:35,20472850,12791375,-7681475,SELL
24-09-20 10:36,10:36,20826375,11935925,-8890450,SELL
24-09-20 10:37,10:37,20853175,12430200,-8422975,SELL
24-09-20 10:38,10:38,20894950,12474050,-8420900,SELL
24-09-20 10:39,10:39,20267700,12485075,-7782625,SELL
24-09-20 10:40,10:40,20043200,12696925,-7346275,SELL
24-09-20 10:41,10:41,20892625,12674775,-8217850,SELL
24-09-20 10:42,10:42,20751400,12627675,-8123725,SELL
24-09-20 10:43,10:43,20505950,12654000,-7851950,SELL
24-09-20 10:44,10:44,21080050,12548375,-8531675,SELL
24-09-20 10:45,10:45,20647175,12638000,-8009175,SELL
24-09-20 10:46,10:46,20881700,12368475,-8513225,SELL
24-09-20 10:47,10:47,20658150,13003275,-7654875,SELL
24-09-20 10:48,10:48,20655175,12830650,-7824525,SELL
24-09-20 10:49,10:49,20485400,12522450,-7962950,SELL
24-09-20 10:50,10:50,21053875,12970300,-8083575,SELL
24-09-20 10:51,10:51,21017225,12786475,-8230750,SELL
24-09-20 10:52,10:52,20698400,13087950,-7610450,SELL
24-09-20 10:53,10:53,21579525,12527225,-9052300,SELL
24-09-20 10:54,10:54,21758550,12862775,-8895775,SELL
24-09-20 10:55,10:55,21788500,13261625,-8526875,SELL
24-09-20 10:56,10:56,21506500,13001350,-8505150,SELL
24-09-20 10:57,10:57,21813250,12877475,-8935775,SELL
24-09-20 10:58,10:58,21581625,13107925,-8473700,SELL
24-09-20 10:59,10:59,21548075,13151200,-8396875,SELL
24-09-20 11:00,11:00,21353600,13403650,-7949950,SELL
24-09-20 11:01,11:01,21189475,13255400,-7934075,SELL
24-09-20 11:02,11:02,21430100,13296675,-8133425,SELL
24-09-20 11:03,11:03,21458775,12879275,-8579500,SELL
24-09-20 11:04,11:04,21713150,12432775,-9280375,SELL
24-09-20 11:05,11:05,21618475,13437575,-8180900,SELL
24-09-20 11:06,11:06,21706250,13577750,-8128500,SELL
24-09-20 11:07,11:07,21697200,13437500,-8259700,SELL
24-09-20 11:08,11:08,21544750,13045125,-8499625,SELL
24-09-20 11:09,11:09,21281975,12650250,-8631725,SELL
24-09-20 11:10,11:10,20735375,13282800,-7452575,SELL
24-09-20 11:11,11:11,21015225,13295025,-7720200,SELL
24-09-20 11:12,11:12,21981725,13550300,-8431425,SELL
24-09-20 11:13,11:13,21740225,13219050,-8521175,SELL
24-09-20 11:14,11:14,20995425,13054050,-7941375,SELL
24-09-20 11:15,11:15,21992800,13604750,-8388050,SELL
24-09-20 11:16,11:16,22195500,13066750,-9128750,SELL
24-09-20 11:17,11:17,22138875,13574200,-8564675,SELL
24-09-20 11:18,11:18,21333700,13367175,-7966525,SELL
24-09-20 11:19,11:19,22007450,13426550,-8580900,SELL
24-09-20 11:20,11:20,21135900,13763300,-7372600,SELL
24-09-20 11:21,11:21,21517700,13770675,-7747025,SELL
24-09-20 11:22,11:22,22676000,13636725,-9039275,SELL
24-09-20 11:23,11:23,22302075,13174225,-9127850,SELL
24-09-20 11:24,11:24,22491175,13196975,-9294200,SELL
24-09-20 11:25,11:25,21516475,13551700,-7964775,SELL
24-09-20 11:26,11:26,22519900,13534200,-8985700,SELL
24-09-20 11:27,11:27,21850975,13461875,-8389100,SELL
24-09-20 11:28,11:28,22395350,13501200,-8894150,SELL
24-09-20 11:29,11:29,22507775,13856850,-8650925,SELL
24-09-20 11:30,11:30,21010700,13243775,-7766925,SELL
24-09-20 11:31,11:31,22311350,13607775,-8703575,SELL
24-09-20 11:32,11:32,21949250,14060600,-7888650,SELL
24-09-20 11:33,11:33,22409850,14105500,-8304350,SELL
24-09-20 11:34,11:34,21672775,13730000,-7942775,SELL
24-09-20 11:35,11:35,22449175,13979275,-8469900,SELL
24-09-20 11:36,11:36,22336850,13585225,-8751625,SELL
24-09-20 11:37,11:37,21452850,13050450,-8402400,SELL
24-09-20 11:38,11:38,21781500,13708675,-8072825,SELL
24-09-20 11:39,11:39,22839150,13656450,-9182700,SELL
24-09-20 11:40,11:40,21949450,13891200,-8058250,SELL
24-09-20 11:41,11:41,21532500,13843550,-7688950,SELL
24-09-20 11:42,11:42,22311500,13959350,-8352150,SELL
24-09-20 11:43,11:43,22824625,13335425,-9489200,SELL
24-09-20 11:44,11:44,23107350,13570750,-9536600,SELL
24-09-20 11:45,11:45,23230700,13890625,-9340075,SELL
24-09-20 11:46,11:46,23274775,14215975,-9058800,SELL
24-09-20 11:47,11:47,23378450,14057475,-9320975,SELL
24-09-20 11:48,11:48,23022650,13509725,-9512925,SELL
24-09-20 11:49,11:49,22863250,14334525,-8528725,SELL
24-09-20 11:50,11:50,23461825,13625475,-9836350,SELL
24-09-20 11:51,11:51,23064325,13405225,-9659100,SELL
24-09-20 11:52,11:52,22936900,13240850,-9696050,SELL
24-09-20 11:53,11:53,23294450,13756425,-9538025,SELL
24-09-20 11:54,11:54,22884625,13883750,-9000875,SELL
24-09-20 11:55,11:55,22455175,14027725,-8427450,SELL
24-09-20 11:56,11:56,23560025,13512675,-10047350,SELL
24-09-20 11:57,11:57,23265550,13924625,-9340925,SELL
24-09-20 11:58,11:58,22923750,13811375,-9112375,SELL
24-09-20 11:59,11:59,23384825,13444125,-9940700,SELL
24-09-20 12:00,12:00,23666800,14148300,-9518500,SELL
24-09-20 12:01,12:01,23769400,14005700,-9763700,SELL
24-09-20 12:02,12:02,23085375,14426150,-8659225,SELL
24-09-20 12:03,12:03,23263350,14083750,-9179600,SELL
24-09-20 12:04,12:04,23735700,13969975,-9765725,SELL
24-09-20 12:05,12:05,23562975,13607525,-9955450,SELL
24-09-20 12:06,12:06,22932900,14049575,-8883325,SELL
24-09-20 12:07,12:07,23308650,13938575,-9370075,SELL
24-09-20 12:08,12:08,23758175,14034575,-9723600,SELL
24-09-20 12:09,12:09,22667500,13938100,-8729400,SELL
24-09-20 12:10,12:10,21880750,14060050,-7820700,SELL
24-09-20 12:11,12:11,23329675,14078575,-9251100,SELL
24-09-20 12:12,12:12,23166025,13792625,-9373400,SELL
24-09-20 12:13,12:13,22930100,13528475,-9401625,SELL
24-09-20 12:14,12:14,23390100,14328375,-9061725,SELL
24-09-20 12:15,12:15,23523000,13982900,-9540100,SELL
24-09-20 12:16,12:16,23082500,13633725,-9448775,SELL
24-09-20 12:17,12:17,22647325,13851300,-8796025,SELL
24-09-20 12:18,12:18,23664550,14469425,-9195125,SELL
24-09-20 12:19,12:19,23083375,14139150,-8944225,SELL
24-09-20 12:20,12:20,23447350,14245675,-9201675,SELL
24-09-20 12:21,12:21,22817100,13486500,-9330600,SELL
24-09-20 12:22,12:22,23124500,13552300,-9572200,SELL
24-09-20 12:23,12:23,22264000,13627525,-8636475,SELL
24-09-20 12:24,12:24,23607525,13950150,-9657375,SELL
24-09-20 12:25,12:25,23557625,13884575,-9673050,SELL
24-09-20 12:26,12:26,23502600,13963525,-9539075,SELL
24-09-20 12:27,12:27,22785900,13854525,-8931375,SELL
24-09-20 12:28,12:28,23482350,13743175,-9739175,SELL
24-09-20 12:29,12:29,23468050,13892500,-9575550,SELL
24-09-20 12:30,12:30,23706275,13746675,-9959600,SELL
24-09-20 12:31,12:31,23015350,14086750,-8928600,SELL
24-09-20 12:32,12:32,23757950,13540475,-10217475,SELL
24-09-20 12:33,12:33,23798025,13537150,-10260875,SELL
24-09-20 12:34,12:34,22918600,12801575,-10117025,SELL
24-09-20 12:35,12:35,24050575,13752425,-10298150,SELL
24-09-20 12:36,12:36,23934500,13539875,-10394625,SELL
24-09-20 12:37,12:37,24159575,14068700,-10090875,SELL
24-09-20 12:38,12:38,23710250,13940575,-9769675,SELL
24-09-20 12:39,12:39,23967275,13957450,-10009825,SELL
24-09-20 12:40,12:40,23735650,13599200,-10136450,SELL
24-09-20 12:41,12:41,22986150,13324025,-9662125,SELL
24-09-20 12:42,12:42,23839175,13677525,-10161650,SELL
24-09-20 12:43,12:43,22650150,13822825,-8827325,SELL
24-09-20 12:44,12:44,23032525,13852350,-9180175,SELL
24-09-20 12:45,12:45,23055275,13963450,-9091825,SELL
24-09-20 12:46,12:46,22628750,13735725,-8893025,SELL
24-09-20 12:47,12:47,22971050,13672825,-9298225,SELL
24-09-20 12:48,12:48,22254850,13101050,-9153800,SELL
24-09-20 12:49,12:49,23578375,14094350,-9484025,SELL
24-09-20 12:50,12:50,23460500,14115225,-9345275,SELL
24-09-20 12:51,12:51,24469700,13843775,-10625925,SELL
24-09-20 12:52,12:52,24235675,14155350,-10080325,SELL
24-09-20 12:53,12:53,23927150,14245425,-9681725,SELL
24-09-20 12:54,12:54,23331975,14613300,-8718675,SELL
24-09-20 12:55,12:55,24000900,13036650,-10964250,SELL
24-09-20 12:56,12:56,23813800,14869325,-8944475,SELL
24-09-20 12:57,12:57,24101775,14603225,-9498550,SELL
24-09-20 12:58,12:58,22968925,14069200,-8899725,SELL
24-09-20 12:59,12:59,24116225,14280800,-9835425,SELL
24-09-20 13:00,13:00,22956450,14637700,-8318750,SELL
24-09-20 13:01,13:01,23425925,14439700,-8986225,SELL
24-09-20 13:02,13:02,23112600,14659850,-8452750,SELL
24-09-20 13:03,13:03,24200625,14989675,-9210950,SELL
24-09-20 13:04,13:04,23530450,14665050,-8865400,SELL
24-09-20 13:05,13:05,23044300,14575425,-8468875,SELL
24-09-20 13:06,13:06,23835525,14847450,-8988075,SELL
24-09-20 13:07,13:07,23606100,13906125,-9699975,SELL
24-09-20 13:08,13:08,23924900,14918025,-9006875,SELL
24-09-20 13:09,13:09,24114825,14800975,-9313850,SELL
24-09-20 13:10,13:10,23481150,14622875,-8858275,SELL
24-09-20 13:11,13:11,22795775,14301225,-8494550,SELL
24-09-20 13:12,13:12,23728075,14787525,-8940550,SELL
24-09-20 13:13,13:13,23562475,14674150,-8888325,SELL
24-09-20 13:14,13:14,24063200,14559675,-9503525,SELL
24-09-20 13:15,13:15,23671675,14988350,-8683325,SELL
24-09-20 13:16,13:16,23961400,14648975,-9312425,SELL
24-09-20 13:17,13:17,24336475,15059750,-9276725,SELL
24-09-20 13:18,13:18,22821250,14478225,-8343025,SELL
24-09-20 13:19,13:19,23033625,14265175,-8768450,SELL
24-09-20 13:20,13:20,22778125,14565700,-8212425,SELL
24-09-20 13:21,13:21,23541350,14321425,-9219925,SELL
24-09-20 13:22,13:22,22994475,14544875,-8449600,SELL
24-09-20 13:23,13:23,22966125,13717075,-9249050,SELL
24-09-20 13:24,13:24,24149925,14252100,-9897825,SELL
24-09-20 13:25,13:25,23798500,14497175,-9301325,SELL
24-09-20 13:26,13:26,23977325,14300425,-9676900,SELL
24-09-20 13:27,13:27,23523625,14329425,-9194200,SELL
24-09-20 13:28,13:28,23730925,13759700,-9971225,SELL
24-09-20 13:29,13:29,23559450,14308450,-9251000,SELL
24-09-20 13:30,13:30,23489575,14106300,-9383275,SELL
24-09-20 13:31,13:31,23167250,14042125,-9125125,SELL
24-09-20 13:32,13:32,24226975,14272075,-9954900,SELL
24-09-20 13:33,13:33,23755225,14651000,-9104225,SELL
24-09-20 13:34,13:34,22933925,13858100,-9075825,SELL
24-09-20 13:35,13:35,23504350,14216425,-9287925,SELL
24-09-20 13:36,13:36,23645600,13842175,-9803425,SELL
24-09-20 13:37,13:37,23999900,13447275,-10552625,SELL
24-09-20 13:38,13:38,24009875,13311750,-10698125,SELL
24-09-20 13:39,13:39,22911000,13225250,-9685750,SELL
24-09-20 13:40,13:40,23987500,14045575,-9941925,SELL
24-09-20 13:41,13:41,24003000,13704875,-10298125,SELL
24-09-20 13:42,13:42,24275925,13364850,-10911075,SELL
24-09-20 13:43,13:43,23771200,13742625,-10028575,SELL
24-09-20 13:44,13:44,24018250,13957825,-10060425,SELL
24-09-20 13:45,13:45,24299450,13808025,-10491425,SELL
24-09-20 13:46,13:46,24409825,12879725,-11530100,SELL
24-09-20 13:47,13:47,22726450,13328075,-9398375,SELL
24-09-20 13:48,13:48,23982375,13042225,-10940150,SELL
24-09-20 13:49,13:49,24002025,13650275,-10351750,SELL
24-09-20 13:50,13:50,24401850,13484200,-10917650,SELL
24-09-20 13:51,13:51,22889600,13393825,-9495775,SELL
24-09-20 13:52,13:52,24219200,13352625,-10866575,SELL
24-09-20 13:53,13:53,24075250,13063100,-11012150,SELL
24-09-20 13:54,13:54,24059325,13460325,-10599000,SELL
24-09-20 13:55,13:55,23886625,13977775,-9908850,SELL
24-09-20 13:56,13:56,24043550,13922700,-10120850,SELL
24-09-20 13:57,13:57,24623400,12703050,-11920350,SELL
24-09-20 13:58,13:58,24776300,12900900,-11875400,SELL
24-09-20 13:59,13:59,24264925,12762625,-11502300,SELL
24-09-20 14:00,14:00,24608550,12852350,-11756200,SELL
24-09-20 14:01,14:01,25216175,12538475,-12677700,SELL
24-09-20 14:02,14:02,24693700,12911050,-11782650,SELL
24-09-20 14:03,14:03,24776325,12385175,-12391150,SELL
24-09-20 14:04,14:04,24946575,12127200,-12819375,SELL
24-09-20 14:05,14:05,25299300,11936250,-13363050,SELL
24-09-20 14:06,14:06,25119950,12340275,-12779675,SELL
24-09-20 14:07,14:07,25154050,12042575,-13111475,SELL
24-09-20 14:08,14:08,25156625,12289150,-12867475,SELL
24-09-20 14:09,14:09,24596350,12036425,-12559925,SELL
24-09-20 14:10,14:10,24755675,12312325,-12443350,SELL
24-09-20 14:11,14:11,24873700,12221450,-12652250,SELL
24-09-20 14:12,14:12,23552400,12063800,-11488600,SELL
24-09-20 14:13,14:13,25130850,12665150,-12465700,SELL
24-09-20 14:14,14:14,24795725,12719125,-12076600,SELL
24-09-20 14:15,14:15,24888700,13067850,-11820850,SELL
24-09-20 14:16,14:16,24969125,13017475,-11951650,SELL
24-09-20 14:17,14:17,24815450,13136500,-11678950,SELL
24-09-20 14:18,14:18,24609125,12165600,-12443525,SELL
24-09-20 14:19,14:19,24269875,12714350,-11555525,SELL
24-09-20 14:20,14:20,24788750,13156625,-11632125,SELL
24-09-20 14:21,14:21,23167400,12756300,-10411100,SELL
24-09-20 14:22,14:22,23942525,12359000,-11583525,SELL
24-09-20 14:23,14:23,23990375,12735100,-11255275,SELL
24-09-20 14:24,14:24,24188275,12829200,-11359075,SELL
24-09-20 14:25,14:25,23965525,13113575,-10851950,SELL
24-09-20 14:26,14:26,23963675,12586675,-11377000,SELL
24-09-20 14:27,14:27,24252900,12689200,-11563700,SELL
24-09-20 14:28,14:28,24400075,12675675,-11724400,SELL
24-09-20 14:29,14:29,23808175,12582600,-11225575,SELL
24-09-20 14:30,14:30,24246525,12507725,-11738800,SELL
24-09-20 14:31,14:31,24044275,12315300,-11728975,SELL
24-09-20 14:32,14:32,24504250,12788400,-11715850,SELL
24-09-20 14:33,14:33,24138525,13271500,-10867025,SELL
24-09-20 14:34,14:34,24361000,12839225,-11521775,SELL
24-09-20 14:35,14:35,24872175,13074050,-11798125,SELL
24-09-20 14:36,14:36,24680075,12681775,-11998300,SELL
24-09-20 14:37,14:37,23963175,12643475,-11319700,SELL
24-09-20 14:38,14:38,24211100,12786675,-11424425,SELL
24-09-20 14:39,14:39,24565475,13071875,-11493600,SELL
24-09-20 14:40,14:40,24714125,12573750,-12140375,SELL
24-09-20 14:41,14:41,23340900,12320150,-11020750,SELL
24-09-20 14:42,14:42,23580900,12594425,-10986475,SELL
24-09-20 14:43,14:43,23978175,12321575,-11656600,SELL
24-09-20 14:44,14:44,24704650,12248225,-12456425,SELL
24-09-20 14:45,14:45,24295275,12673300,-11621975,SELL
24-09-20 14:46,14:46,24336100,12656750,-11679350,SELL
24-09-20 14:47,14:47,24207450,12700850,-11506600,SELL
24-09-20 14:48,14:48,24552175,12469175,-12083000,SELL
24-09-20 14:49,14:49,24522800,12443775,-12079025,SELL
24-09-20 14:50,14:50,24155500,12750650,-11404850,SELL
24-09-20 14:51,14:51,23506050,12601275,-10904775,SELL
24-09-20 14:52,14:52,24240000,12639975,-11600025,SELL
24-09-20 14:53,14:53,24268375,12896875,-11371500,SELL
24-09-20 14:54,14:54,24042000,12627975,-11414025,SELL
24-09-20 14:55,14:55,23713000,12593700,-11119300,SELL
24-09-20 14:56,14:56,24059425,12824125,-11235300,SELL
24-09-20 14:57,14:57,23834450,11957625,-11876825,SELL
24-09-20 14:58,14:58,23782200,11992675,-11789525,SELL
24-09-20 14:59,14:59,23763725,11979650,-11784075,SELL
24-09-20 15:00,15:00,23244425,11846300,-11398125,SELL
24-09-20 15:01,15:01,23536225,11779975,-11756250,SELL
24-09-20 15:02,15:02,23556975,11891475,-11665500,SELL
24-09-20 15:03,15:03,23665625,12107925,-11557700,SELL
24-09-20 15:04,15:04,23556025,12040275,-11515750,SELL
24-09-20 15:05,15:05,23598850,11772650,-11826200,SELL
24-09-20 15:06,15:06,23285125,11353950,-11931175,SELL
24-09-20 15:07,15:07,23574825,11401100,-12173725,SELL
24-09-20 15:08,15:08,23423850,11394475,-12029375,SELL
24-09-20 15:09,15:09,23079550,10136725,-12942825,SELL
24-09-20 15:10,15:10,23141175,9923825,-13217350,SELL
24-09-20 15:11,15:11,22844675,8881750,-13962925,SELL
24-09-20 15:12,15:12,22749850,9907175,-12842675,SELL
24-09-20 15:13,15:13,22921500,9721850,-13199650,SELL
24-09-20 15:14,15:14,23018875,9769650,-13249225,SELL
24-09-20 15:15,15:15,22448725,9436575,-13012150,SELL
24-09-20 15:16,15:16,22088450,9250400,-12838050,SELL
24-09-20 15:17,15:17,22302600,9403650,-12898950,SELL
24-09-20 15:18,15:18,21036625,8724550,-12312075,SELL
24-09-20 15:19,15:19,21022800,8270400,-12752400,SELL
24-09-20 15:20,15:20,20887175,8478025,-12409150,SELL
24-09-20 15:21,15:21,18537625,7556200,-10981425,SELL
24-09-20 15:22,15:22,18356850,7791825,-10565025,SELL
24-09-20 15:23,15:23,18591100,6992500,-11598600,SELL
24-09-20 15:24,15:24,17718975,6778475,-10940500,SELL
24-09-20 15:25,15:25,17610600,7221225,-10389375,SELL
24-09-20 15:26,15:26,17763250,6743050,-11020200,SELL
24-09-20 15:27,15:27,15816075,6054225,-9761850,SELL
24-09-20 15:28,15:28,16038100,6502350,-9535750,SELL
24-09-20 15:29,15:29,15865525,6467925,-9397600,SELL
25-09-20 9:15,9:15,4420200,2262225,-2157975,SELL
25-09-20 9:16,9:16,4420200,2121425,-2298775,SELL
25-09-20 9:17,9:17,4523975,2327150,-2196825,SELL
25-09-20 9:18,9:18,4523025,2325750,-2197275,SELL
25-09-20 9:19,9:19,4524425,2331050,-2193375,SELL
25-09-20 9:20,9:20,4805325,2762425,-2042900,SELL
25-09-20 9:21,9:21,4806725,2703775,-2102950,SELL
25-09-20 9:22,9:22,4806725,2688275,-2118450,SELL
25-09-20 9:23,9:23,4939825,2839850,-2099975,SELL
25-09-20 9:24,9:24,4939800,2769925,-2169875,SELL
25-09-20 9:25,9:25,4939800,2881850,-2057950,SELL
25-09-20 9:26,9:26,5022725,2937950,-2084775,SELL
25-09-20 9:27,9:27,5013925,2937225,-2076700,SELL
25-09-20 9:28,9:28,5021675,2950900,-2070775,SELL
25-09-20 9:29,9:29,5068975,3034425,-2034550,SELL
25-09-20 9:30,9:30,5066875,3031550,-2035325,SELL
25-09-20 9:31,9:31,5067375,3049775,-2017600,SELL
25-09-20 9:32,9:32,5136925,3175575,-1961350,SELL
25-09-20 9:33,9:33,5137400,3195300,-1942100,SELL
25-09-20 9:34,9:34,5137425,3067675,-2069750,SELL
25-09-20 9:35,9:35,5093750,3129350,-1964400,SELL
25-09-20 9:36,9:36,5092125,3162775,-1929350,SELL
25-09-20 9:37,9:37,5092125,3190025,-1902100,SELL
25-09-20 9:38,9:38,5180725,3135375,-2045350,SELL
25-09-20 9:39,9:39,5193125,3247075,-1946050,SELL
25-09-20 9:40,9:40,5190875,3160675,-2030200,SELL
25-09-20 9:41,9:41,5248900,3265075,-1983825,SELL
25-09-20 9:42,9:42,5250025,3219175,-2030850,SELL
25-09-20 9:43,9:43,5248400,3300675,-1947725,SELL
25-09-20 9:44,9:44,5306325,3231175,-2075150,SELL
25-09-20 9:45,9:45,5305350,3297550,-2007800,SELL
25-09-20 9:46,9:46,5304175,3297750,-2006425,SELL
25-09-20 9:47,9:47,5387625,3340400,-2047225,SELL
25-09-20 9:48,9:48,5380400,3180275,-2200125,SELL
25-09-20 9:49,9:49,5391275,3358050,-2033225,SELL
25-09-20 9:50,9:50,5449750,3465300,-1984450,SELL
25-09-20 9:51,9:51,5444725,3425450,-2019275,SELL
25-09-20 9:52,9:52,5444725,3338675,-2106050,SELL
25-09-20 9:53,9:53,5459850,3366950,-2092900,SELL
25-09-20 9:54,9:54,5499025,3467475,-2031550,SELL
25-09-20 9:55,9:55,5505275,3430975,-2074300,SELL
25-09-20 9:56,9:56,5519725,3495925,-2023800,SELL
25-09-20 9:57,9:57,5559025,3522525,-2036500,SELL
25-09-20 9:58,9:58,5548150,3511950,-2036200,SELL
25-09-20 9:59,9:59,5588975,3428050,-2160925,SELL
25-09-20 10:00,10:00,5580850,3506075,-2074775,SELL
25-09-20 10:01,10:01,5586100,3438775,-2147325,SELL
25-09-20 10:02,10:02,5666450,3364225,-2302225,SELL
25-09-20 10:03,10:03,5659350,3426375,-2232975,SELL
25-09-20 10:04,10:04,5670375,3593025,-2077350,SELL
25-09-20 10:05,10:05,5695750,3531750,-2164000,SELL
25-09-20 10:06,10:06,5694525,3537775,-2156750,SELL
25-09-20 10:07,10:07,5698775,3455000,-2243775,SELL
25-09-20 10:08,10:08,5784950,3556250,-2228700,SELL
25-09-20 10:09,10:09,5789075,3521525,-2267550,SELL
25-09-20 10:10,10:10,5777775,3521525,-2256250,SELL
25-09-20 10:11,10:11,5820775,3634075,-2186700,SELL
25-09-20 10:12,10:12,5817175,3565575,-2251600,SELL
25-09-20 10:13,10:13,5816525,3540225,-2276300,SELL
25-09-20 10:14,10:14,5804575,3423350,-2381225,SELL
25-09-20 10:15,10:15,5836625,3567450,-2269175,SELL
25-09-20 10:16,10:16,5831000,3537175,-2293825,SELL
25-09-20 10:17,10:17,5845975,3698425,-2147550,SELL
25-09-20 10:18,10:18,5887675,3745950,-2141725,SELL
25-09-20 10:19,10:19,5883325,3725750,-2157575,SELL
25-09-20 10:20,10:20,5937350,3711200,-2226150,SELL
25-09-20 10:21,10:21,5935925,3509000,-2426925,SELL
25-09-20 10:22,10:22,5935925,3706125,-2229800,SELL
25-09-20 10:23,10:23,5916025,3698875,-2217150,SELL
25-09-20 10:24,10:24,5928150,3645125,-2283025,SELL
25-09-20 10:25,10:25,5896825,3760875,-2135950,SELL
25-09-20 10:26,10:26,5875350,3675975,-2199375,SELL
25-09-20 10:27,10:27,5860100,3583250,-2276850,SELL
25-09-20 10:28,10:28,5860100,3662350,-2197750,SELL
25-09-20 10:29,10:29,5867950,3791450,-2076500,SELL
25-09-20 10:30,10:30,5881275,3820075,-2061200,SELL
25-09-20 10:31,10:31,5877600,3809475,-2068125,SELL
25-09-20 10:32,10:32,5854025,3666600,-2187425,SELL
25-09-20 10:33,10:33,5840375,3691625,-2148750,SELL
25-09-20 10:34,10:34,5883100,3676375,-2206725,SELL
25-09-20 10:35,10:35,5941450,3677700,-2263750,SELL
25-09-20 10:36,10:36,5945825,3560800,-2385025,SELL
25-09-20 10:37,10:37,5899450,3677700,-2221750,SELL
25-09-20 10:38,10:38,5933725,3713625,-2220100,SELL
25-09-20 10:39,10:39,5937950,3723375,-2214575,SELL
25-09-20 10:40,10:40,5916500,3738825,-2177675,SELL
25-09-20 10:41,10:41,5949100,3698425,-2250675,SELL
25-09-20 10:42,10:42,5861350,3920300,-1941050,SELL
25-09-20 10:43,10:43,5898550,3763075,-2135475,SELL
25-09-20 10:44,10:44,5947075,3810200,-2136875,SELL
25-09-20 10:45,10:45,5947950,3732950,-2215000,SELL
25-09-20 10:46,10:46,5965150,3732950,-2232200,SELL
25-09-20 10:47,10:47,5993975,3879325,-2114650,SELL
25-09-20 10:48,10:48,5925650,3838875,-2086775,SELL
25-09-20 10:49,10:49,5950050,3692225,-2257825,SELL
25-09-20 10:50,10:50,5994700,3860075,-2134625,SELL
25-09-20 10:51,10:51,5960800,3865325,-2095475,SELL
25-09-20 10:52,10:52,6007100,3960900,-2046200,SELL
25-09-20 10:53,10:53,6019175,3873350,-2145825,SELL
25-09-20 10:54,10:54,5981350,3934200,-2047150,SELL
25-09-20 10:55,10:55,6028325,3956925,-2071400,SELL
25-09-20 10:56,10:56,5998200,3853225,-2144975,SELL
25-09-20 10:57,10:57,5990275,4015475,-1974800,SELL
25-09-20 10:58,10:58,5970825,3754150,-2216675,SELL
25-09-20 10:59,10:59,6072275,3923075,-2149200,SELL
25-09-20 11:00,11:00,6098850,3929775,-2169075,SELL
25-09-20 11:01,11:01,6122400,3860675,-2261725,SELL
25-09-20 11:02,11:02,6059300,4020700,-2038600,SELL
25-09-20 11:03,11:03,6053350,3929850,-2123500,SELL
25-09-20 11:04,11:04,6127000,3943500,-2183500,SELL
25-09-20 11:05,11:05,6099275,3946350,-2152925,SELL
25-09-20 11:06,11:06,6070025,3862500,-2207525,SELL
25-09-20 11:07,11:07,6088125,4019750,-2068375,SELL
25-09-20 11:08,11:08,6104525,4039625,-2064900,SELL
25-09-20 11:09,11:09,6136250,4008925,-2127325,SELL
25-09-20 11:10,11:10,6119800,4132225,-1987575,SELL
25-09-20 11:11,11:11,6148725,4132275,-2016450,SELL
25-09-20 11:12,11:12,6190125,4134250,-2055875,SELL
25-09-20 11:13,11:13,6177800,4089375,-2088425,SELL
25-09-20 11:14,11:14,6177200,4181475,-1995725,SELL
25-09-20 11:15,11:15,6189600,4139550,-2050050,SELL
25-09-20 11:16,11:16,6185925,4145150,-2040775,SELL
25-09-20 11:17,11:17,6227700,4204575,-2023125,SELL
25-09-20 11:18,11:18,6237525,4312275,-1925250,SELL
25-09-20 11:19,11:19,6182100,4189150,-1992950,SELL
25-09-20 11:20,11:20,6256525,4162325,-2094200,SELL
25-09-20 11:21,11:21,6242525,4234850,-2007675,SELL
25-09-20 11:22,11:22,6234275,4212125,-2022150,SELL
25-09-20 11:23,11:23,6265625,4197425,-2068200,SELL
25-09-20 11:24,11:24,6213200,4329425,-1883775,SELL
25-09-20 11:25,11:25,6266225,4221925,-2044300,SELL
25-09-20 11:26,11:26,6277475,4196650,-2080825,SELL
25-09-20 11:27,11:27,6325175,4357775,-1967400,SELL
25-09-20 11:28,11:28,6325050,4242600,-2082450,SELL
25-09-20 11:29,11:29,6208950,4263825,-1945125,SELL
25-09-20 11:30,11:30,6209025,4360800,-1848225,SELL
25-09-20 11:31,11:31,6205575,4259075,-1946500,SELL
25-09-20 11:32,11:32,6231975,4301425,-1930550,SELL
25-09-20 11:33,11:33,6214775,4138350,-2076425,SELL
25-09-20 11:34,11:34,6160950,4270000,-1890950,SELL
25-09-20 11:35,11:35,6266650,4366825,-1899825,SELL
25-09-20 11:36,11:36,6267925,4403450,-1864475,SELL
25-09-20 11:37,11:37,6274650,4224350,-2050300,SELL
25-09-20 11:38,11:38,6340950,4368425,-1972525,SELL
25-09-20 11:39,11:39,6312775,4320225,-1992550,SELL
25-09-20 11:40,11:40,6281600,4282200,-1999400,SELL
25-09-20 11:41,11:41,6326075,4284500,-2041575,SELL
25-09-20 11:42,11:42,6314750,4307025,-2007725,SELL
25-09-20 11:43,11:43,6320775,4269525,-2051250,SELL
25-09-20 11:44,11:44,6339925,4172600,-2167325,SELL
25-09-20 11:45,11:45,6372550,4362725,-2009825,SELL
25-09-20 11:46,11:46,6356500,4204375,-2152125,SELL
25-09-20 11:47,11:47,6319825,4226625,-2093200,SELL
25-09-20 11:48,11:48,6401600,4327125,-2074475,SELL
25-09-20 11:49,11:49,6379525,4282425,-2097100,SELL
25-09-20 11:50,11:50,6340700,4343775,-1996925,SELL
25-09-20 11:51,11:51,6389675,4177450,-2212225,SELL
25-09-20 11:52,11:52,6363500,4237225,-2126275,SELL
25-09-20 11:53,11:53,6435250,4271650,-2163600,SELL
25-09-20 11:54,11:54,6414575,4334300,-2080275,SELL
25-09-20 11:55,11:55,6408450,4303700,-2104750,SELL
25-09-20 11:56,11:56,6331500,4379925,-1951575,SELL
25-09-20 11:57,11:57,6398575,4286025,-2112550,SELL
25-09-20 11:58,11:58,6367625,4162450,-2205175,SELL
25-09-20 11:59,11:59,6481850,4426225,-2055625,SELL
25-09-20 12:00,12:00,6441025,4294550,-2146475,SELL
25-09-20 12:01,12:01,6483175,4343400,-2139775,SELL
25-09-20 12:02,12:02,6477375,4342675,-2134700,SELL
25-09-20 12:03,12:03,6462450,4425250,-2037200,SELL
25-09-20 12:04,12:04,6459725,4303725,-2156000,SELL
25-09-20 12:05,12:05,6516675,4308225,-2208450,SELL
25-09-20 12:06,12:06,6452700,4350625,-2102075,SELL
25-09-20 12:07,12:07,6484200,4328325,-2155875,SELL
25-09-20 12:08,12:08,6516950,4413100,-2103850,SELL
25-09-20 12:09,12:09,6505325,4459525,-2045800,SELL
25-09-20 12:10,12:10,6505325,4450550,-2054775,SELL
25-09-20 12:11,12:11,6512925,4392925,-2120000,SELL
25-09-20 12:12,12:12,6540350,4516625,-2023725,SELL
25-09-20 12:13,12:13,6524200,4486025,-2038175,SELL
25-09-20 12:14,12:14,6528025,4556000,-1972025,SELL
25-09-20 12:15,12:15,6533775,4515750,-2018025,SELL
25-09-20 12:16,12:16,6526425,4498325,-2028100,SELL
25-09-20 12:17,12:17,6389325,4495075,-1894250,SELL
25-09-20 12:18,12:18,6388875,4398450,-1990425,SELL
25-09-20 12:19,12:19,6388050,4401050,-1987000,SELL
25-09-20 12:20,12:20,6433425,4649675,-1783750,SELL
25-09-20 12:21,12:21,6433425,4617275,-1816150,SELL
25-09-20 12:22,12:22,6429025,4581950,-1847075,SELL
25-09-20 12:23,12:23,6049075,4520025,-1529050,SELL
25-09-20 12:24,12:24,6050950,4446700,-1604250,SELL
25-09-20 12:25,12:25,6050950,4535325,-1515625,SELL
25-09-20 12:26,12:26,6144300,4529525,-1614775,SELL
25-09-20 12:27,12:27,6149950,4609350,-1540600,SELL
25-09-20 12:28,12:28,6144725,4542300,-1602425,SELL
25-09-20 12:29,12:29,5941375,4613375,-1328000,SELL
25-09-20 12:30,12:30,5948575,4644100,-1304475,SELL
25-09-20 12:31,12:31,5943975,4526050,-1417925,SELL
25-09-20 12:32,12:32,6035825,4666350,-1369475,SELL
25-09-20 12:33,12:33,6036775,4630850,-1405925,SELL
25-09-20 12:34,12:34,6035800,4624250,-1411550,SELL
25-09-20 12:35,12:35,6081700,4664475,-1417225,SELL
25-09-20 12:36,12:36,6078100,4695100,-1383000,SELL
25-09-20 12:37,12:37,6075475,4659575,-1415900,SELL
25-09-20 12:38,12:38,6118600,4598900,-1519700,SELL
25-09-20 12:39,12:39,6119050,4605125,-1513925,SELL
25-09-20 12:40,12:40,6119050,4641425,-1477625,SELL
25-09-20 12:41,12:41,6143350,4615000,-1528350,SELL
25-09-20 12:42,12:42,6132850,4629575,-1503275,SELL
25-09-20 12:43,12:43,6123450,4637000,-1486450,SELL
25-09-20 12:44,12:44,6051450,4743900,-1307550,SELL
25-09-20 12:45,12:45,6051300,4710675,-1340625,SELL
25-09-20 12:46,12:46,6057150,4628425,-1428725,SELL
25-09-20 12:47,12:47,6067300,4609775,-1457525,SELL
25-09-20 12:48,12:48,6068900,4655425,-1413475,SELL
25-09-20 12:49,12:49,6068900,4647250,-1421650,SELL
25-09-20 12:50,12:50,6082525,4748075,-1334450,SELL
25-09-20 12:51,12:51,6083525,4676475,-1407050,SELL
25-09-20 12:52,12:52,6089050,4634550,-1454500,SELL
25-09-20 12:53,12:53,6091425,4776625,-1314800,SELL
25-09-20 12:54,12:54,6055925,4738825,-1317100,SELL
25-09-20 12:55,12:55,6084900,4691100,-1393800,SELL
25-09-20 12:56,12:56,6129400,4696950,-1432450,SELL
25-09-20 12:57,12:57,6122825,4753450,-1369375,SELL
25-09-20 12:58,12:58,6126125,4662125,-1464000,SELL
25-09-20 12:59,12:59,6148275,4779950,-1368325,SELL
25-09-20 13:00,13:00,6153300,4780300,-1373000,SELL
25-09-20 13:01,13:01,6115350,4707925,-1407425,SELL
25-09-20 13:02,13:02,6071500,4740150,-1331350,SELL
25-09-20 13:03,13:03,6151000,4670425,-1480575,SELL
25-09-20 13:04,13:04,6118325,4752275,-1366050,SELL
25-09-20 13:05,13:05,6174150,4802850,-1371300,SELL
25-09-20 13:06,13:06,6142875,4730075,-1412800,SELL
25-09-20 13:07,13:07,6154325,4668250,-1486075,SELL
25-09-20 13:08,13:08,6152825,4674975,-1477850,SELL
25-09-20 13:09,13:09,6109875,4730500,-1379375,SELL
25-09-20 13:10,13:10,6151450,4698375,-1453075,SELL
25-09-20 13:11,13:11,6130050,4732975,-1397075,SELL
25-09-20 13:12,13:12,6196725,4676700,-1520025,SELL
25-09-20 13:13,13:13,6162825,4673850,-1488975,SELL
25-09-20 13:14,13:14,6203400,4676275,-1527125,SELL
25-09-20 13:15,13:15,6216900,4672475,-1544425,SELL
25-09-20 13:16,13:16,6222975,4713250,-1509725,SELL
25-09-20 13:17,13:17,6222975,4635825,-1587150,SELL
25-09-20 13:18,13:18,6242400,4670100,-1572300,SELL
25-09-20 13:19,13:19,6224625,4478675,-1745950,SELL
25-09-20 13:20,13:20,6245750,4710025,-1535725,SELL
25-09-20 13:21,13:21,6258600,4661250,-1597350,SELL
25-09-20 13:22,13:22,6271175,4628750,-1642425,SELL
25-09-20 13:23,13:23,6245175,4661250,-1583925,SELL
25-09-20 13:24,13:24,6310025,4715400,-1594625,SELL
25-09-20 13:25,13:25,6305575,4655850,-1649725,SELL
25-09-20 13:26,13:26,6310025,4659650,-1650375,SELL
25-09-20 13:27,13:27,6289675,4803775,-1485900,SELL
25-09-20 13:28,13:28,6325050,4670975,-1654075,SELL
25-09-20 13:29,13:29,6338625,4684725,-1653900,SELL
25-09-20 13:30,13:30,6324825,4689350,-1635475,SELL
25-09-20 13:31,13:31,6307325,4708775,-1598550,SELL
25-09-20 13:32,13:32,6323775,4681550,-1642225,SELL
25-09-20 13:33,13:33,6313725,4690975,-1622750,SELL
25-09-20 13:34,13:34,6313725,4781525,-1532200,SELL
25-09-20 13:35,13:35,6318225,4663775,-1654450,SELL
25-09-20 13:36,13:36,6302850,4744550,-1558300,SELL
25-09-20 13:37,13:37,6308525,4749650,-1558875,SELL
25-09-20 13:38,13:38,6302850,4755950,-1546900,SELL
25-09-20 13:39,13:39,6355200,4788825,-1566375,SELL
25-09-20 13:40,13:40,6362975,4714750,-1648225,SELL
25-09-20 13:41,13:41,6377650,4801350,-1576300,SELL
25-09-20 13:42,13:42,6376850,4752500,-1624350,SELL
25-09-20 13:43,13:43,6373700,4684275,-1689425,SELL
25-09-20 13:44,13:44,6376850,4685025,-1691825,SELL
25-09-20 13:45,13:45,6431875,4785250,-1646625,SELL
25-09-20 13:46,13:46,6434550,4785250,-1649300,SELL
25-09-20 13:47,13:47,6439450,4707525,-1731925,SELL
25-09-20 13:48,13:48,6388550,4759175,-1629375,SELL
25-09-20 13:49,13:49,6388550,4660175,-1728375,SELL
25-09-20 13:50,13:50,6290550,4722275,-1568275,SELL
25-09-20 13:51,13:51,6374625,4695550,-1679075,SELL
25-09-20 13:52,13:52,6360025,4690400,-1669625,SELL
25-09-20 13:53,13:53,6375375,4685200,-1690175,SELL
25-09-20 13:54,13:54,6424500,4795275,-1629225,SELL
25-09-20 13:55,13:55,6433400,4792350,-1641050,SELL
25-09-20 13:56,13:56,6386450,4714300,-1672150,SELL
25-09-20 13:57,13:57,6381325,4809100,-1572225,SELL
25-09-20 13:58,13:58,6326075,4761850,-1564225,SELL
25-09-20 13:59,13:59,6407900,4580700,-1827200,SELL
25-09-20 14:00,14:00,6453350,4794725,-1658625,SELL
25-09-20 14:01,14:01,6445675,4720550,-1725125,SELL
25-09-20 14:02,14:02,6445675,4818875,-1626800,SELL
25-09-20 14:03,14:03,6397650,4820250,-1577400,SELL
25-09-20 14:04,14:04,6380950,4803175,-1577775,SELL
25-09-20 14:05,14:05,6447925,4737225,-1710700,SELL
25-09-20 14:06,14:06,6390925,4769425,-1621500,SELL
25-09-20 14:07,14:07,6415975,4781000,-1634975,SELL
25-09-20 14:08,14:08,6360375,4894100,-1466275,SELL
25-09-20 14:09,14:09,6419075,4794000,-1625075,SELL
25-09-20 14:10,14:10,6475800,4913850,-1561950,SELL
25-09-20 14:11,14:11,6475500,4911200,-1564300,SELL
25-09-20 14:12,14:12,6347700,4729900,-1617800,SELL
25-09-20 14:13,14:13,6345125,4810100,-1535025,SELL
25-09-20 14:14,14:14,6353875,4810200,-1543675,SELL
25-09-20 14:15,14:15,6337975,4889375,-1448600,SELL
25-09-20 14:16,14:16,6330375,4846825,-1483550,SELL
25-09-20 14:17,14:17,6325275,4879625,-1445650,SELL
25-09-20 14:18,14:18,6316100,4863225,-1452875,SELL
25-09-20 14:19,14:19,6317275,4864550,-1452725,SELL
25-09-20 14:20,14:20,6309700,4780850,-1528850,SELL
25-09-20 14:21,14:21,6340525,4912075,-1428450,SELL
25-09-20 14:22,14:22,6340525,4877400,-1463125,SELL
25-09-20 14:23,14:23,6308175,4853025,-1455150,SELL
25-09-20 14:24,14:24,6357250,4915375,-1441875,SELL
25-09-20 14:25,14:25,6349625,4830150,-1519475,SELL
25-09-20 14:26,14:26,6358600,4951550,-1407050,SELL
25-09-20 14:27,14:27,6277125,4932775,-1344350,SELL
25-09-20 14:28,14:28,6269550,4962575,-1306975,SELL
25-09-20 14:29,14:29,6277450,5000725,-1276725,SELL
25-09-20 14:30,14:30,6229675,4983150,-1246525,SELL
25-09-20 14:31,14:31,6236175,4982600,-1253575,SELL
25-09-20 14:32,14:32,6236175,4950475,-1285700,SELL
25-09-20 14:33,14:33,6268900,4958475,-1310425,SELL
25-09-20 14:34,14:34,6261325,4912250,-1349075,SELL
25-09-20 14:35,14:35,6271250,4949100,-1322150,SELL
25-09-20 14:36,14:36,6285725,4957950,-1327775,SELL
25-09-20 14:37,14:37,6280150,4957525,-1322625,SELL
25-09-20 14:38,14:38,6288050,4961825,-1326225,SELL
25-09-20 14:39,14:39,6320325,4997175,-1323150,SELL
25-09-20 14:40,14:40,6328875,5051325,-1277550,SELL
25-09-20 14:41,14:41,6328875,5012475,-1316400,SELL
25-09-20 14:42,14:42,6157600,4912825,-1244775,SELL
25-09-20 14:43,14:43,6147750,4973775,-1173975,SELL
25-09-20 14:44,14:44,6141650,4973550,-1168100,SELL
25-09-20 14:45,14:45,6218250,4817875,-1400375,SELL
25-09-20 14:46,14:46,6211225,4804350,-1406875,SELL
25-09-20 14:47,14:47,6206275,4813775,-1392500,SELL
25-09-20 14:48,14:48,6305900,4756425,-1549475,SELL
25-09-20 14:49,14:49,6264350,4819300,-1445050,SELL
25-09-20 14:50,14:50,6287850,4756475,-1531375,SELL
25-09-20 14:51,14:51,6323125,4707850,-1615275,SELL
25-09-20 14:52,14:52,6323200,4778575,-1544625,SELL
25-09-20 14:53,14:53,6307225,4735875,-1571350,SELL
25-09-20 14:54,14:54,6312250,4701300,-1610950,SELL
25-09-20 14:55,14:55,6318575,4732300,-1586275,SELL
25-09-20 14:56,14:56,6318575,4650925,-1667650,SELL
25-09-20 14:57,14:57,6328400,4728875,-1599525,SELL
25-09-20 14:58,14:58,6330200,4690800,-1639400,SELL
25-09-20 14:59,14:59,6329450,4695425,-1634025,SELL
25-09-20 15:00,15:00,6319950,4689775,-1630175,SELL
25-09-20 15:01,15:01,6326400,4651725,-1674675,SELL
25-09-20 15:02,15:02,6323100,4685250,-1637850,SELL
25-09-20 15:03,15:03,6237400,4541525,-1695875,SELL
25-09-20 15:04,15:04,6226075,4500275,-1725800,SELL
25-09-20 15:05,15:05,6225675,4538100,-1687575,SELL
25-09-20 15:06,15:06,6207275,4529250,-1678025,SELL
25-09-20 15:07,15:07,6214700,4539200,-1675500,SELL
25-09-20 15:08,15:08,6211575,4533900,-1677675,SELL
25-09-20 15:09,15:09,6186350,4440575,-1745775,SELL
25-09-20 15:10,15:10,6165450,4543575,-1621875,SELL
25-09-20 15:11,15:11,6186550,4437225,-1749325,SELL
25-09-20 15:12,15:12,6187650,4555550,-1632100,SELL
25-09-20 15:13,15:13,6192025,4488700,-1703325,SELL
25-09-20 15:14,15:14,6195350,4486375,-1708975,SELL
25-09-20 15:15,15:15,6129450,4433375,-1696075,SELL
25-09-20 15:16,15:16,6129325,4430300,-1699025,SELL
25-09-20 15:17,15:17,6132125,4437775,-1694350,SELL
25-09-20 15:18,15:18,6065350,4370000,-1695350,SELL
25-09-20 15:19,15:19,6057925,4373950,-1683975,SELL
25-09-20 15:20,15:20,6078675,4399925,-1678750,SELL
25-09-20 15:21,15:21,5961025,4297575,-1663450,SELL
25-09-20 15:22,15:22,5953475,4269875,-1683600,SELL
25-09-20 15:23,15:23,5935250,4256025,-1679225,SELL
25-09-20 15:24,15:24,5905150,4260300,-1644850,SELL
25-09-20 15:25,15:25,5917300,4298425,-1618875,SELL
25-09-20 15:26,15:26,5903625,4208775,-1694850,SELL
25-09-20 15:27,15:27,5829175,4215175,-1614000,SELL
25-09-20 15:28,15:28,5840825,4205575,-1635250,SELL
25-09-20 15:29,15:29,5840825,4243500,-1597325,SELL
28-09-20 9:15,9:15,5599375,3939275,-1660100,SELL
28-09-20 9:16,9:16,5601275,3966825,-1634450,SELL
28-09-20 9:17,9:17,5638375,4177325,-1461050,SELL
28-09-20 9:18,9:18,5638375,4176425,-1461950,SELL
28-09-20 9:19,9:19,5630825,4177100,-1453725,SELL
28-09-20 9:20,9:20,5829125,4485700,-1343425,SELL
28-09-20 9:21,9:21,5812725,4483225,-1329500,SELL
28-09-20 9:22,9:22,5819400,4480325,-1339075,SELL
28-09-20 9:23,9:23,5995525,4620350,-1375175,SELL
28-09-20 9:24,9:24,5985900,4620350,-1365550,SELL
28-09-20 9:25,9:25,5984800,4622275,-1362525,SELL
28-09-20 9:26,9:26,5985525,4759325,-1226200,SELL
28-09-20 9:27,9:27,5993100,4737375,-1255725,SELL
28-09-20 9:28,9:28,5985525,4732250,-1253275,SELL
28-09-20 9:29,9:29,6114950,4782575,-1332375,SELL
28-09-20 9:30,9:30,6113600,4830050,-1283550,SELL
28-09-20 9:31,9:31,6121125,4857325,-1263800,SELL
28-09-20 9:32,9:32,6028025,4920150,-1107875,SELL
28-09-20 9:33,9:33,6062375,4929125,-1133250,SELL
28-09-20 9:34,9:34,6061850,4923250,-1138600,SELL
28-09-20 9:35,9:35,5960950,4978625,-982325,SELL
28-09-20 9:36,9:36,5961825,4943725,-1018100,SELL
28-09-20 9:37,9:37,5944200,4952850,-991350,SELL
28-09-20 9:38,9:38,6001875,5081100,-920775,SELL
28-09-20 9:39,9:39,5984950,5078875,-906075,SELL
28-09-20 9:40,9:40,6005900,5149575,-856325,SELL
28-09-20 9:41,9:41,5911875,5269875,-642000,SELL
28-09-20 9:42,9:42,5928550,5269875,-658675,SELL
28-09-20 9:43,9:43,5918525,5269875,-648650,SELL
28-09-20 9:44,9:44,6064125,5371275,-692850,SELL
28-09-20 9:45,9:45,6052325,5405700,-646625,SELL
28-09-20 9:46,9:46,6052325,5375425,-676900,SELL
28-09-20 9:47,9:47,6084300,5421850,-662450,SELL
28-09-20 9:48,9:48,6078100,5423625,-654475,SELL
28-09-20 9:49,9:49,6091775,5480650,-611125,SELL
28-09-20 9:50,9:50,6002525,5478275,-524250,SELL
28-09-20 9:51,9:51,6047150,5481075,-566075,SELL
28-09-20 9:52,9:52,6047700,5531375,-516325,SELL
28-09-20 9:53,9:53,6083750,5515550,-568200,SELL
28-09-20 9:54,9:54,6083750,5571125,-512625,SELL
28-09-20 9:55,9:55,6100325,5516525,-583800,SELL
28-09-20 9:56,9:56,6184475,5600425,-584050,SELL
28-09-20 9:57,9:57,6170800,5573650,-597150,SELL
28-09-20 9:58,9:58,6071600,5569375,-502225,SELL
28-09-20 9:59,9:59,6188125,5591225,-596900,SELL
28-09-20 10:00,10:00,6215175,5603600,-611575,SELL
28-09-20 10:01,10:01,6241600,5599325,-642275,SELL
28-09-20 10:02,10:02,6177600,5645575,-532025,SELL
28-09-20 10:03,10:03,6194550,5645575,-548975,SELL
28-09-20 10:04,10:04,6244600,5646250,-598350,SELL
28-09-20 10:05,10:05,6205425,5623750,-581675,SELL
28-09-20 10:06,10:06,6184650,5621725,-562925,SELL
28-09-20 10:07,10:07,6282225,5654025,-628200,SELL
28-09-20 10:08,10:08,6273875,5721300,-552575,SELL
28-09-20 10:09,10:09,6264675,5707325,-557350,SELL
28-09-20 10:10,10:10,6274725,5771275,-503450,SELL
28-09-20 10:11,10:11,6323225,5820075,-503150,SELL
28-09-20 10:12,10:12,6287200,5792500,-494700,SELL
28-09-20 10:13,10:13,6197475,5789050,-408425,SELL
28-09-20 10:14,10:14,6319600,5858225,-461375,SELL
28-09-20 10:15,10:15,6319600,5857925,-461675,SELL
28-09-20 10:16,10:16,6348475,5828325,-520150,SELL
28-09-20 10:17,10:17,6420475,5902350,-518125,SELL
28-09-20 10:18,10:18,6417500,5923850,-493650,SELL
28-09-20 10:19,10:19,6346075,5917100,-428975,SELL
28-09-20 10:20,10:20,6350225,5882250,-467975,SELL
28-09-20 10:21,10:21,6314375,5824175,-490200,SELL
28-09-20 10:22,10:22,6330625,5860025,-470600,SELL
28-09-20 10:23,10:23,6331150,5908500,-422650,SELL
28-09-20 10:24,10:24,6353800,5908775,-445025,SELL
28-09-20 10:25,10:25,6330900,5904850,-426050,SELL
28-09-20 10:26,10:26,6356000,5906800,-449200,SELL
28-09-20 10:27,10:27,6347025,5846925,-500100,SELL
28-09-20 10:28,10:28,6373800,5843125,-530675,SELL
28-09-20 10:29,10:29,6386925,5903600,-483325,SELL
28-09-20 10:30,10:30,6418700,5913125,-505575,SELL
28-09-20 10:31,10:31,6287800,5914175,-373625,SELL
28-09-20 10:32,10:32,6382200,5947150,-435050,SELL
28-09-20 10:33,10:33,6379225,5970425,-408800,SELL
28-09-20 10:34,10:34,6402025,5927025,-475000,SELL
28-09-20 10:35,10:35,6400900,5952700,-448200,SELL
28-09-20 10:36,10:36,6333100,5952700,-380400,SELL
28-09-20 10:37,10:37,6373675,5945950,-427725,SELL
28-09-20 10:38,10:38,6416300,6021150,-395150,SELL
28-09-20 10:39,10:39,6437075,6050250,-386825,SELL
28-09-20 10:40,10:40,6435925,5990375,-445550,SELL
28-09-20 10:41,10:41,6381025,6049025,-332000,SELL
28-09-20 10:42,10:42,6345475,6042225,-303250,SELL
28-09-20 10:43,10:43,6204425,6018575,-185850,SELL
28-09-20 10:44,10:44,6305050,6049200,-255850,SELL
28-09-20 10:45,10:45,6490575,6049200,-441375,SELL
28-09-20 10:46,10:46,6463800,6042375,-421425,SELL
28-09-20 10:47,10:47,6491625,6045925,-445700,SELL
28-09-20 10:48,10:48,6533575,6195775,-337800,SELL
28-09-20 10:49,10:49,6500425,6164450,-335975,SELL
28-09-20 10:50,10:50,6368775,6176050,-192725,SELL
28-09-20 10:51,10:51,6384350,6209975,-174375,SELL
28-09-20 10:52,10:52,6363175,6174475,-188700,SELL
28-09-20 10:53,10:53,6274600,6247300,-27300,SELL
28-09-20 10:54,10:54,6267850,6312950,45100,BUY
28-09-20 10:55,10:55,6259050,6250450,-8600,SELL
28-09-20 10:56,10:56,6366300,6386600,20300,BUY
28-09-20 10:57,10:57,6332675,6392125,59450,BUY
28-09-20 10:58,10:58,6299825,6354050,54225,BUY
28-09-20 10:59,10:59,6423800,6405050,-18750,SELL
28-09-20 11:00,11:00,6440150,6404025,-36125,SELL
28-09-20 11:01,11:01,6443100,6433600,-9500,SELL
28-09-20 11:02,11:02,6443625,6469475,25850,BUY
28-09-20 11:03,11:03,6431125,6504625,73500,BUY
28-09-20 11:04,11:04,6443625,6507400,63775,BUY
28-09-20 11:05,11:05,6459500,6587925,128425,BUY
28-09-20 11:06,11:06,6425200,6517175,91975,BUY
28-09-20 11:07,11:07,6421600,6547725,126125,BUY
28-09-20 11:08,11:08,6562525,6604175,41650,BUY
28-09-20 11:09,11:09,6550025,6640750,90725,BUY
28-09-20 11:10,11:10,6576325,6641725,65400,BUY
28-09-20 11:11,11:11,6514950,6680025,165075,BUY
28-09-20 11:12,11:12,6463850,6651250,187400,BUY
28-09-20 11:13,11:13,6496300,6649450,153150,BUY
28-09-20 11:14,11:14,6561075,6708150,147075,BUY
28-09-20 11:15,11:15,6513500,6701225,187725,BUY
28-09-20 11:16,11:16,6561075,6704675,143600,BUY
28-09-20 11:17,11:17,6575050,6776350,201300,BUY
28-09-20 11:18,11:18,6606325,6776350,170025,BUY
28-09-20 11:19,11:19,6611425,6810625,199200,BUY
28-09-20 11:20,11:20,6590825,6810325,219500,BUY
28-09-20 11:21,11:21,6616150,6776900,160750,BUY
28-09-20 11:22,11:22,6611100,6780250,169150,BUY
28-09-20 11:23,11:23,6631575,6821425,189850,BUY
28-09-20 11:24,11:24,6633150,6855775,222625,BUY
28-09-20 11:25,11:25,6612025,6857450,245425,BUY
28-09-20 11:26,11:26,6611525,6940575,329050,BUY
28-09-20 11:27,11:27,6583400,6956900,373500,BUY
28-09-20 11:28,11:28,6614800,6934275,319475,BUY
28-09-20 11:29,11:29,6361975,6956450,594475,BUY
28-09-20 11:30,11:30,6310600,6891100,580500,BUY
28-09-20 11:31,11:31,6358375,6926750,568375,BUY
28-09-20 11:32,11:32,6414850,7023700,608850,BUY
28-09-20 11:33,11:33,6412025,6991150,579125,BUY
28-09-20 11:34,11:34,6403300,6991150,587850,BUY
28-09-20 11:35,11:35,6422750,7053675,630925,BUY
28-09-20 11:36,11:36,6460850,7059400,598550,BUY
28-09-20 11:37,11:37,6446000,7125525,679525,BUY
28-09-20 11:38,11:38,6511125,7085200,574075,BUY
28-09-20 11:39,11:39,6489375,7085200,595825,BUY
28-09-20 11:40,11:40,6486675,7118000,631325,BUY
28-09-20 11:41,11:41,6462150,7159325,697175,BUY
28-09-20 11:42,11:42,6486175,7156050,669875,BUY
28-09-20 11:43,11:43,6547300,7126525,579225,BUY
28-09-20 11:44,11:44,6503000,7158550,655550,BUY
28-09-20 11:45,11:45,6511150,7180550,669400,BUY
28-09-20 11:46,11:46,6457875,7157550,699675,BUY
28-09-20 11:47,11:47,6492775,7171225,678450,BUY
28-09-20 11:48,11:48,6403575,7106325,702750,BUY
28-09-20 11:49,11:49,6460650,7140500,679850,BUY
28-09-20 11:50,11:50,6548525,7124700,576175,BUY
28-09-20 11:51,11:51,6454950,7158725,703775,BUY
28-09-20 11:52,11:52,6454950,7152525,697575,BUY
28-09-20 11:53,11:53,6600400,7108375,507975,BUY
28-09-20 11:54,11:54,6588975,7065925,476950,BUY
28-09-20 11:55,11:55,6519975,7065925,545950,BUY
28-09-20 11:56,11:56,6638725,7055100,416375,BUY
28-09-20 11:57,11:57,6645625,7089500,443875,BUY
28-09-20 11:58,11:58,6539400,7041075,501675,BUY
28-09-20 11:59,11:59,6636725,7115200,478475,BUY
28-09-20 12:00,12:00,6636775,7053550,416775,BUY
28-09-20 12:01,12:01,6624450,7091075,466625,BUY
28-09-20 12:02,12:02,6679075,7090100,411025,BUY
28-09-20 12:03,12:03,6655475,7090100,434625,BUY
28-09-20 12:04,12:04,6655475,7059500,404025,BUY
28-09-20 12:05,12:05,6636175,7050125,413950,BUY
28-09-20 12:06,12:06,6642050,7037750,395700,BUY
28-09-20 12:07,12:07,6578325,7051950,473625,BUY
28-09-20 12:08,12:08,6645850,7091950,446100,BUY
28-09-20 12:09,12:09,6584050,7092050,508000,BUY
28-09-20 12:10,12:10,6565000,7123850,558850,BUY
28-09-20 12:11,12:11,6564300,7079500,515200,BUY
28-09-20 12:12,12:12,6621300,7117250,495950,BUY
28-09-20 12:13,12:13,6570750,7105800,535050,BUY
28-09-20 12:14,12:14,6630950,7164225,533275,BUY
28-09-20 12:15,12:15,6641900,7130700,488800,BUY
28-09-20 12:16,12:16,6672125,7128225,456100,BUY
28-09-20 12:17,12:17,6672225,7182175,509950,BUY
28-09-20 12:18,12:18,6632475,7124600,492125,BUY
28-09-20 12:19,12:19,6568700,7119900,551200,BUY
28-09-20 12:20,12:20,6638475,7129125,490650,BUY
28-09-20 12:21,12:21,6389150,7149875,760725,BUY
28-09-20 12:22,12:22,6581425,7131000,549575,BUY
28-09-20 12:23,12:23,6640250,7140050,499800,BUY
28-09-20 12:24,12:24,6655375,7109900,454525,BUY
28-09-20 12:25,12:25,6592125,7109900,517775,BUY
28-09-20 12:26,12:26,6409975,7213125,803150,BUY
28-09-20 12:27,12:27,6676150,7182800,506650,BUY
28-09-20 12:28,12:28,6652600,7150825,498225,BUY
28-09-20 12:29,12:29,6655375,7157375,502000,BUY
28-09-20 12:30,12:30,6660400,7188675,528275,BUY
28-09-20 12:31,12:31,6660400,7147725,487325,BUY
28-09-20 12:32,12:32,6592275,7182375,590100,BUY
28-09-20 12:33,12:33,6646425,7198050,551625,BUY
28-09-20 12:34,12:34,6646425,7204725,558300,BUY
28-09-20 12:35,12:35,6714475,7218625,504150,BUY
28-09-20 12:36,12:36,6648825,7174900,526075,BUY
28-09-20 12:37,12:37,6685525,7188650,503125,BUY
28-09-20 12:38,12:38,6613725,7193275,579550,BUY
28-09-20 12:39,12:39,6604500,7184875,580375,BUY
28-09-20 12:40,12:40,6613625,7210400,596775,BUY
28-09-20 12:41,12:41,6396500,7222800,826300,BUY
28-09-20 12:42,12:42,6747900,7267175,519275,BUY
28-09-20 12:43,12:43,6737825,7255775,517950,BUY
28-09-20 12:44,12:44,6680125,7184725,504600,BUY
28-09-20 12:45,12:45,6688450,7212500,524050,BUY
28-09-20 12:46,12:46,6686300,7239475,553175,BUY
28-09-20 12:47,12:47,6693550,7213125,519575,BUY
28-09-20 12:48,12:48,6663500,7173575,510075,BUY
28-09-20 12:49,12:49,6716875,7201525,484650,BUY
28-09-20 12:50,12:50,6716525,7207775,491250,BUY
28-09-20 12:51,12:51,6684175,7173775,489600,BUY
28-09-20 12:52,12:52,6582225,7208250,626025,BUY
28-09-20 12:53,12:53,6764800,7183625,418825,BUY
28-09-20 12:54,12:54,6692475,7183625,491150,BUY
28-09-20 12:55,12:55,6732350,7188500,456150,BUY
28-09-20 12:56,12:56,6736050,7259150,523100,BUY
28-09-20 12:57,12:57,6712250,7260425,548175,BUY
28-09-20 12:58,12:58,6771100,7272700,501600,BUY
28-09-20 12:59,12:59,6750900,7263025,512125,BUY
28-09-20 13:00,13:00,6705750,7293250,587500,BUY
28-09-20 13:01,13:01,6728775,7234250,505475,BUY
28-09-20 13:02,13:02,6686225,7273475,587250,BUY
28-09-20 13:03,13:03,6682225,7238925,556700,BUY
28-09-20 13:04,13:04,6673100,7263225,590125,BUY
28-09-20 13:05,13:05,6719300,7276075,556775,BUY
28-09-20 13:06,13:06,6684200,7311675,627475,BUY
28-09-20 13:07,13:07,6681700,7306275,624575,BUY
28-09-20 13:08,13:08,6729350,7239800,510450,BUY
28-09-20 13:09,13:09,6618475,7253725,635250,BUY
28-09-20 13:10,13:10,6690225,7251450,561225,BUY
28-09-20 13:11,13:11,6670900,7303350,632450,BUY
28-09-20 13:12,13:12,6682600,7313300,630700,BUY
28-09-20 13:13,13:13,6533125,7313300,780175,BUY
28-09-20 13:14,13:14,6677300,7291375,614075,BUY
28-09-20 13:15,13:15,6756050,7307425,551375,BUY
28-09-20 13:16,13:16,6706475,7332625,626150,BUY
28-09-20 13:17,13:17,6768850,7301925,533075,BUY
28-09-20 13:18,13:18,6680775,7369300,688525,BUY
28-09-20 13:19,13:19,6768575,7388650,620075,BUY
28-09-20 13:20,13:20,6679425,7380100,700675,BUY
28-09-20 13:21,13:21,6699825,7337700,637875,BUY
28-09-20 13:22,13:22,6661600,7337700,676100,BUY
28-09-20 13:23,13:23,6677875,7408525,730650,BUY
28-09-20 13:24,13:24,6661450,7410000,748550,BUY
28-09-20 13:25,13:25,6676350,7453075,776725,BUY
28-09-20 13:26,13:26,6578225,7434425,856200,BUY
28-09-20 13:27,13:27,6592650,7424925,832275,BUY
28-09-20 13:28,13:28,6586100,7390525,804425,BUY
28-09-20 13:29,13:29,6525125,7428125,903000,BUY
28-09-20 13:30,13:30,6583075,7448675,865600,BUY
28-09-20 13:31,13:31,6583075,7477925,894850,BUY
28-09-20 13:32,13:32,6461075,7463975,1002900,BUY
28-09-20 13:33,13:33,6564800,7469225,904425,BUY
28-09-20 13:34,13:34,6472700,7434450,961750,BUY
28-09-20 13:35,13:35,6244200,7467150,1222950,BUY
28-09-20 13:36,13:36,6571750,7488500,916750,BUY
28-09-20 13:37,13:37,6523950,7455900,931950,BUY
28-09-20 13:38,13:38,6547700,7497400,949700,BUY
28-09-20 13:39,13:39,6499600,7483350,983750,BUY
28-09-20 13:40,13:40,6559725,7551150,991425,BUY
28-09-20 13:41,13:41,6374600,7509525,1134925,BUY
28-09-20 13:42,13:42,6346050,7502525,1156475,BUY
28-09-20 13:43,13:43,6583900,7540300,956400,BUY
28-09-20 13:44,13:44,6602775,7507450,904675,BUY
28-09-20 13:45,13:45,6613300,7503675,890375,BUY
28-09-20 13:46,13:46,6589175,7538400,949225,BUY
28-09-20 13:47,13:47,6559475,7541475,982000,BUY
28-09-20 13:48,13:48,6607750,7556225,948475,BUY
28-09-20 13:49,13:49,6497525,7510325,1012800,BUY
28-09-20 13:50,13:50,6551125,7547400,996275,BUY
28-09-20 13:51,13:51,6448450,7500175,1051725,BUY
28-09-20 13:52,13:52,6563125,7513500,950375,BUY
28-09-20 13:53,13:53,6634575,7583975,949400,BUY
28-09-20 13:54,13:54,6556125,7511350,955225,BUY
28-09-20 13:55,13:55,6644450,7548550,904100,BUY
28-09-20 13:56,13:56,6612175,7542675,930500,BUY
28-09-20 13:57,13:57,6517350,7543100,1025750,BUY
28-09-20 13:58,13:58,6589100,7580450,991350,BUY
28-09-20 13:59,13:59,6582575,7546825,964250,BUY
28-09-20 14:00,14:00,6506575,7563725,1057150,BUY
28-09-20 14:01,14:01,6574875,7610775,1035900,BUY
28-09-20 14:02,14:02,6560100,7563725,1003625,BUY
28-09-20 14:03,14:03,6590175,7614350,1024175,BUY
28-09-20 14:04,14:04,6583650,7581675,998025,BUY
28-09-20 14:05,14:05,6606900,7614350,1007450,BUY
28-09-20 14:06,14:06,6618825,7665300,1046475,BUY
28-09-20 14:07,14:07,6558025,7663500,1105475,BUY
28-09-20 14:08,14:08,6630775,7685350,1054575,BUY
28-09-20 14:09,14:09,6570675,7594775,1024100,BUY
28-09-20 14:10,14:10,6678500,7656900,978400,BUY
28-09-20 14:11,14:11,6593950,7637225,1043275,BUY
28-09-20 14:12,14:12,6595000,7616775,1021775,BUY
28-09-20 14:13,14:13,6561925,7633950,1072025,BUY
28-09-20 14:14,14:14,6485450,7610000,1124550,BUY
28-09-20 14:15,14:15,6593700,7669450,1075750,BUY
28-09-20 14:16,14:16,6596325,7634675,1038350,BUY
28-09-20 14:17,14:17,6596325,7634675,1038350,BUY
28-09-20 14:18,14:18,6682700,7689875,1007175,BUY
28-09-20 14:19,14:19,6719675,7688075,968400,BUY
28-09-20 14:20,14:20,6640450,7653250,1012800,BUY
28-09-20 14:21,14:21,6530950,7749300,1218350,BUY
28-09-20 14:22,14:22,6570425,7677050,1106625,BUY
28-09-20 14:23,14:23,6669550,7677050,1007500,BUY
28-09-20 14:24,14:24,6706225,7687325,981100,BUY
28-09-20 14:25,14:25,6696350,7764525,1068175,BUY
28-09-20 14:26,14:26,6687325,7731875,1044550,BUY
28-09-20 14:27,14:27,6698775,7729175,1030400,BUY
28-09-20 14:28,14:28,6580600,7724700,1144100,BUY
28-09-20 14:29,14:29,6701100,7750550,1049450,BUY
28-09-20 14:30,14:30,6654725,7765000,1110275,BUY
28-09-20 14:31,14:31,6747900,7799750,1051850,BUY
28-09-20 14:32,14:32,6784900,7833675,1048775,BUY
28-09-20 14:33,14:33,6631500,7803475,1171975,BUY
28-09-20 14:34,14:34,6735450,7803475,1068025,BUY
28-09-20 14:35,14:35,6716575,7824900,1108325,BUY
28-09-20 14:36,14:36,6761200,7850575,1089375,BUY
28-09-20 14:37,14:37,6763600,7855600,1092000,BUY
28-09-20 14:38,14:38,6784425,7847025,1062600,BUY
28-09-20 14:39,14:39,6819600,7895375,1075775,BUY
28-09-20 14:40,14:40,6842825,7898075,1055250,BUY
28-09-20 14:41,14:41,6805825,7894475,1088650,BUY
28-09-20 14:42,14:42,6761975,7873575,1111600,BUY
28-09-20 14:43,14:43,6778875,7876200,1097325,BUY
28-09-20 14:44,14:44,6642650,7884225,1241575,BUY
28-09-20 14:45,14:45,6769625,7841000,1071375,BUY
28-09-20 14:46,14:46,6836250,7885750,1049500,BUY
28-09-20 14:47,14:47,6902775,7890750,987975,BUY
28-09-20 14:48,14:48,6851125,7881425,1030300,BUY
28-09-20 14:49,14:49,6864950,7883275,1018325,BUY
28-09-20 14:50,14:50,6827975,7907500,1079525,BUY
28-09-20 14:51,14:51,6838125,7810075,971950,BUY
28-09-20 14:52,14:52,6666250,7853550,1187300,BUY
28-09-20 14:53,14:53,6611050,7855375,1244325,BUY
28-09-20 14:54,14:54,6814300,7840525,1026225,BUY
28-09-20 14:55,14:55,6800550,7843925,1043375,BUY
28-09-20 14:56,14:56,6899300,7868150,968850,BUY
28-09-20 14:57,14:57,6879225,7798875,919650,BUY
28-09-20 14:58,14:58,6792900,7798875,1005975,BUY
28-09-20 14:59,14:59,6870250,7792125,921875,BUY
28-09-20 15:00,15:00,6868750,7813875,945125,BUY
28-09-20 15:01,15:01,6892250,7846725,954475,BUY
28-09-20 15:02,15:02,6868750,7820675,951925,BUY
28-09-20 15:03,15:03,6699950,7656675,956725,BUY
28-09-20 15:04,15:04,6714525,7623075,908550,BUY
28-09-20 15:05,15:05,6660850,7652775,991925,BUY
28-09-20 15:06,15:06,6683900,7603500,919600,BUY
28-09-20 15:07,15:07,6632375,7591825,959450,BUY
28-09-20 15:08,15:08,6690450,7627075,936625,BUY
28-09-20 15:09,15:09,6625625,7526975,901350,BUY
28-09-20 15:10,15:10,6671525,7524300,852775,BUY
28-09-20 15:11,15:11,6474125,7494875,1020750,BUY
28-09-20 15:12,15:12,6673650,7537000,863350,BUY
28-09-20 15:13,15:13,6682850,7566625,883775,BUY
28-09-20 15:14,15:14,6685800,7500475,814675,BUY
28-09-20 15:15,15:15,6579800,7439625,859825,BUY
28-09-20 15:16,15:16,6367725,7403100,1035375,BUY
28-09-20 15:17,15:17,6564475,7404825,840350,BUY
28-09-20 15:18,15:18,6529925,7289525,759600,BUY
28-09-20 15:19,15:19,6498775,7277675,778900,BUY
28-09-20 15:20,15:20,6510875,7281375,770500,BUY
28-09-20 15:21,15:21,6362825,7169600,806775,BUY
28-09-20 15:22,15:22,6201925,7165025,963100,BUY
28-09-20 15:23,15:23,6199625,7158700,959075,BUY
28-09-20 15:24,15:24,6318625,7072825,754200,BUY
28-09-20 15:25,15:25,6349800,7087800,738000,BUY
28-09-20 15:26,15:26,6312225,7083625,771400,BUY
28-09-20 15:27,15:27,6180800,6983400,802600,BUY
28-09-20 15:28,15:28,6195100,6976275,781175,BUY
28-09-20 15:29,15:29,6203875,7004475,800600,BUY
29-09-20 9:15,9:15,5856450,6687800,831350,BUY
29-09-20 9:16,9:16,5896550,6690100,793550,BUY
29-09-20 9:17,9:17,6441425,7014400,572975,BUY
29-09-20 9:18,9:18,6450225,7011025,560800,BUY
29-09-20 9:19,9:19,6410125,7040125,630000,BUY
29-09-20 9:20,9:20,6773725,7304900,531175,BUY
29-09-20 9:21,9:21,6773750,7299350,525600,BUY
29-09-20 9:22,9:22,6800850,7303875,503025,BUY
29-09-20 9:23,9:23,7141450,7495075,353625,BUY
29-09-20 9:24,9:24,6999825,7498175,498350,BUY
29-09-20 9:25,9:25,7137025,7500775,363750,BUY
29-09-20 9:26,9:26,7380950,7609825,228875,BUY
29-09-20 9:27,9:27,7332725,7616625,283900,BUY
29-09-20 9:28,9:28,7400250,7643850,243600,BUY
29-09-20 9:29,9:29,7465600,7574025,108425,BUY
29-09-20 9:30,9:30,7499325,7575325,76000,BUY
29-09-20 9:31,9:31,7476500,7572725,96225,BUY
29-09-20 9:32,9:32,7574350,7688925,114575,BUY
29-09-20 9:33,9:33,7597525,7681775,84250,BUY
29-09-20 9:34,9:34,7596475,7715225,118750,BUY
29-09-20 9:35,9:35,7631050,7700450,69400,BUY
29-09-20 9:36,9:36,7644425,7709075,64650,BUY
29-09-20 9:37,9:37,7644425,7704200,59775,BUY
29-09-20 9:38,9:38,7736600,7715950,-20650,SELL
29-09-20 9:39,9:39,7700175,7691625,-8550,SELL
29-09-20 9:40,9:40,7755600,7694050,-61550,SELL
29-09-20 9:41,9:41,7883275,7797200,-86075,SELL
29-09-20 9:42,9:42,7860125,7797200,-62925,SELL
29-09-20 9:43,9:43,7860125,7797200,-62925,SELL
29-09-20 9:44,9:44,7911550,7872950,-38600,SELL
29-09-20 9:45,9:45,7950400,7836425,-113975,SELL
29-09-20 9:46,9:46,7860425,7878150,17725,BUY
29-09-20 9:47,9:47,8067050,7967975,-99075,SELL
29-09-20 9:48,9:48,8053800,7966025,-87775,SELL
29-09-20 9:49,9:49,7914975,7962425,47450,BUY
29-09-20 9:50,9:50,8032900,7977275,-55625,SELL
29-09-20 9:51,9:51,8070450,7974425,-96025,SELL
29-09-20 9:52,9:52,8122125,8005600,-116525,SELL
29-09-20 9:53,9:53,8124525,7958450,-166075,SELL
29-09-20 9:54,9:54,8016925,7959500,-57425,SELL
29-09-20 9:55,9:55,8132425,7931175,-201250,SELL
29-09-20 9:56,9:56,8114725,7920800,-193925,SELL
29-09-20 9:57,9:57,8104750,7920750,-184000,SELL
29-09-20 9:58,9:58,8044325,7950850,-93475,SELL
29-09-20 9:59,9:59,8038725,8050650,11925,BUY
29-09-20 10:00,10:00,8122575,8047775,-74800,SELL
29-09-20 10:01,10:01,8065600,8023275,-42325,SELL
29-09-20 10:02,10:02,8213925,8088600,-125325,SELL
29-09-20 10:03,10:03,8285925,8092450,-193475,SELL
29-09-20 10:04,10:04,8160025,8091400,-68625,SELL
29-09-20 10:05,10:05,8286150,8187575,-98575,SELL
29-09-20 10:06,10:06,8286675,8192900,-93775,SELL
29-09-20 10:07,10:07,8252325,8192900,-59425,SELL
29-09-20 10:08,10:08,8371450,8279075,-92375,SELL
29-09-20 10:09,10:09,8418200,8304200,-114000,SELL
29-09-20 10:10,10:10,8424550,8261975,-162575,SELL
29-09-20 10:11,10:11,8563425,8205325,-358100,SELL
29-09-20 10:12,10:12,8462400,8209850,-252550,SELL
29-09-20 10:13,10:13,8470675,8256775,-213900,SELL
29-09-20 10:14,10:14,8567775,8328625,-239150,SELL
29-09-20 10:15,10:15,8590675,8316100,-274575,SELL
29-09-20 10:16,10:16,8544400,8328425,-215975,SELL
29-09-20 10:17,10:17,8741400,8358725,-382675,SELL
29-09-20 10:18,10:18,8649250,8361075,-288175,SELL
29-09-20 10:19,10:19,8748625,8358650,-389975,SELL
29-09-20 10:20,10:20,8776700,8270675,-506025,SELL
29-09-20 10:21,10:21,8776700,8247800,-528900,SELL
29-09-20 10:22,10:22,8622750,8242425,-380325,SELL
29-09-20 10:23,10:23,8705700,8200825,-504875,SELL
29-09-20 10:24,10:24,8577200,8179000,-398200,SELL
29-09-20 10:25,10:25,8731025,8191200,-539825,SELL
29-09-20 10:26,10:26,8745475,8242450,-503025,SELL
29-09-20 10:27,10:27,8744250,8200675,-543575,SELL
29-09-20 10:28,10:28,8761325,8246800,-514525,SELL
29-09-20 10:29,10:29,8888525,8297700,-590825,SELL
29-09-20 10:30,10:30,8585500,8297775,-287725,SELL
29-09-20 10:31,10:31,8783550,8300175,-483375,SELL
29-09-20 10:32,10:32,8859100,8350625,-508475,SELL
29-09-20 10:33,10:33,8715150,8336925,-378225,SELL
29-09-20 10:34,10:34,8883050,8338575,-544475,SELL
29-09-20 10:35,10:35,8722200,8384625,-337575,SELL
29-09-20 10:36,10:36,8874425,8367075,-507350,SELL
29-09-20 10:37,10:37,8845350,8404575,-440775,SELL
29-09-20 10:38,10:38,8956325,8375075,-581250,SELL
29-09-20 10:39,10:39,8956325,8375325,-581000,SELL
29-09-20 10:40,10:40,8909600,8375325,-534275,SELL
29-09-20 10:41,10:41,8947725,8385750,-561975,SELL
29-09-20 10:42,10:42,8793675,8390825,-402850,SELL
29-09-20 10:43,10:43,8993875,8367850,-626025,SELL
29-09-20 10:44,10:44,8887375,8406350,-481025,SELL
29-09-20 10:45,10:45,9055850,8429425,-626425,SELL
29-09-20 10:46,10:46,9069625,8430250,-639375,SELL
29-09-20 10:47,10:47,9052000,8264575,-787425,SELL
29-09-20 10:48,10:48,9051850,8270125,-781725,SELL
29-09-20 10:49,10:49,8972825,8291850,-680975,SELL
29-09-20 10:50,10:50,9023250,8188000,-835250,SELL
29-09-20 10:51,10:51,9036725,8193575,-843150,SELL
29-09-20 10:52,10:52,8960000,8137375,-822625,SELL
29-09-20 10:53,10:53,9006325,8169375,-836950,SELL
29-09-20 10:54,10:54,9055450,8118725,-936725,SELL
29-09-20 10:55,10:55,9064150,8116700,-947450,SELL
29-09-20 10:56,10:56,9045125,8160275,-884850,SELL
29-09-20 10:57,10:57,9070225,8153525,-916700,SELL
29-09-20 10:58,10:58,9090875,8166900,-923975,SELL
29-09-20 10:59,10:59,9160175,8176450,-983725,SELL
29-09-20 11:00,11:00,8998125,8150400,-847725,SELL
29-09-20 11:01,11:01,9151600,8222500,-929100,SELL
29-09-20 11:02,11:02,9060400,8124875,-935525,SELL
29-09-20 11:03,11:03,9110000,8160975,-949025,SELL
29-09-20 11:04,11:04,9238375,8190125,-1048250,SELL
29-09-20 11:05,11:05,9146475,8004600,-1141875,SELL
29-09-20 11:06,11:06,9067200,7957000,-1110200,SELL
29-09-20 11:07,11:07,9159550,8033100,-1126450,SELL
29-09-20 11:08,11:08,9137425,7944275,-1193150,SELL
29-09-20 11:09,11:09,9088850,7963475,-1125375,SELL
29-09-20 11:10,11:10,9101100,7966525,-1134575,SELL
29-09-20 11:11,11:11,9144250,7946275,-1197975,SELL
29-09-20 11:12,11:12,9061925,7891825,-1170100,SELL
29-09-20 11:13,11:13,9173825,7880975,-1292850,SELL
29-09-20 11:14,11:14,9010850,7993250,-1017600,SELL
29-09-20 11:15,11:15,9122800,8014225,-1108575,SELL
29-09-20 11:16,11:16,9139800,8024775,-1115025,SELL
29-09-20 11:17,11:17,8993875,8011350,-982525,SELL
29-09-20 11:18,11:18,9103700,7968875,-1134825,SELL
29-09-20 11:19,11:19,9012325,7952950,-1059375,SELL
29-09-20 11:20,11:20,9167675,8021725,-1145950,SELL
29-09-20 11:21,11:21,9040525,7975650,-1064875,SELL
29-09-20 11:22,11:22,9166975,7986500,-1180475,SELL
29-09-20 11:23,11:23,9163950,8064600,-1099350,SELL
29-09-20 11:24,11:24,9202550,8039850,-1162700,SELL
29-09-20 11:25,11:25,9277775,8034525,-1243250,SELL
29-09-20 11:26,11:26,9191975,8066550,-1125425,SELL
29-09-20 11:27,11:27,9146300,8082875,-1063425,SELL
29-09-20 11:28,11:28,9237050,8017725,-1219325,SELL
29-09-20 11:29,11:29,9023400,8093125,-930275,SELL
29-09-20 11:30,11:30,9148700,8052800,-1095900,SELL
29-09-20 11:31,11:31,9179400,8063650,-1115750,SELL
29-09-20 11:32,11:32,9104225,8121525,-982700,SELL
29-09-20 11:33,11:33,9195425,8110450,-1084975,SELL
29-09-20 11:34,11:34,9148850,8072100,-1076750,SELL
29-09-20 11:35,11:35,9323100,8091300,-1231800,SELL
29-09-20 11:36,11:36,9306425,8129525,-1176900,SELL
29-09-20 11:37,11:37,9197800,8116400,-1081400,SELL
29-09-20 11:38,11:38,9284825,8160275,-1124550,SELL
29-09-20 11:39,11:39,9284550,8184950,-1099600,SELL
29-09-20 11:40,11:40,9307675,8165700,-1141975,SELL
29-09-20 11:41,11:41,9168150,8061250,-1106900,SELL
29-09-20 11:42,11:42,8994350,7995700,-998650,SELL
29-09-20 11:43,11:43,9066600,8036600,-1030000,SELL
29-09-20 11:44,11:44,8999850,8075625,-924225,SELL
29-09-20 11:45,11:45,9151425,8055000,-1096425,SELL
29-09-20 11:46,11:46,9107875,8032525,-1075350,SELL
29-09-20 11:47,11:47,8863925,8036725,-827200,SELL
29-09-20 11:48,11:48,9173775,8087825,-1085950,SELL
29-09-20 11:49,11:49,9217325,8117925,-1099400,SELL
29-09-20 11:50,11:50,9190975,8138625,-1052350,SELL
29-09-20 11:51,11:51,9147550,8121300,-1026250,SELL
29-09-20 11:52,11:52,9192725,8158275,-1034450,SELL
29-09-20 11:53,11:53,9026300,8145150,-881150,SELL
29-09-20 11:54,11:54,9204900,8146950,-1057950,SELL
29-09-20 11:55,11:55,9204900,8128425,-1076475,SELL
29-09-20 11:56,11:56,9172775,8160050,-1012725,SELL
29-09-20 11:57,11:57,9165925,8154350,-1011575,SELL
29-09-20 11:58,11:58,9185250,8118700,-1066550,SELL
29-09-20 11:59,11:59,9010075,8163675,-846400,SELL
29-09-20 12:00,12:00,9163325,8175625,-987700,SELL
29-09-20 12:01,12:01,9261175,8188475,-1072700,SELL
29-09-20 12:02,12:02,9201175,8172825,-1028350,SELL
29-09-20 12:03,12:03,9155975,8221275,-934700,SELL
29-09-20 12:04,12:04,9157550,8219400,-938150,SELL
29-09-20 12:05,12:05,9334300,8241300,-1093000,SELL
29-09-20 12:06,12:06,9334100,8252150,-1081950,SELL
29-09-20 12:07,12:07,9125275,8192725,-932550,SELL
29-09-20 12:08,12:08,9136100,8134200,-1001900,SELL
29-09-20 12:09,12:09,9136150,8213325,-922825,SELL
29-09-20 12:10,12:10,9314000,8246425,-1067575,SELL
29-09-20 12:11,12:11,9336900,8194975,-1141925,SELL
29-09-20 12:12,12:12,9311875,8152325,-1159550,SELL
29-09-20 12:13,12:13,9333100,8069400,-1263700,SELL
29-09-20 12:14,12:14,9325700,8148350,-1177350,SELL
29-09-20 12:15,12:15,9289500,8158375,-1131125,SELL
29-09-20 12:16,12:16,9219025,8152750,-1066275,SELL
29-09-20 12:17,12:17,9195350,8211275,-984075,SELL
29-09-20 12:18,12:18,9351725,8213725,-1138000,SELL
29-09-20 12:19,12:19,9364450,8175525,-1188925,SELL
29-09-20 12:20,12:20,9325075,8202250,-1122825,SELL
29-09-20 12:21,12:21,9381450,8214900,-1166550,SELL
29-09-20 12:22,12:22,9262075,8214900,-1047175,SELL
29-09-20 12:23,12:23,9275300,8167750,-1107550,SELL
29-09-20 12:24,12:24,9337625,8149250,-1188375,SELL
29-09-20 12:25,12:25,9425600,8182825,-1242775,SELL
29-09-20 12:26,12:26,9262700,8193075,-1069625,SELL
29-09-20 12:27,12:27,9199725,8208125,-991600,SELL
29-09-20 12:28,12:28,9326225,8193025,-1133200,SELL
29-09-20 12:29,12:29,9193000,8204225,-988775,SELL
29-09-20 12:30,12:30,9191150,8138575,-1052575,SELL
29-09-20 12:31,12:31,9191150,8198275,-992875,SELL
29-09-20 12:32,12:32,9233300,8218075,-1015225,SELL
29-09-20 12:33,12:33,9365550,8204450,-1161100,SELL
29-09-20 12:34,12:34,9297225,8206975,-1090250,SELL
29-09-20 12:35,12:35,9212875,8231000,-981875,SELL
29-09-20 12:36,12:36,9389250,8309075,-1080175,SELL
29-09-20 12:37,12:37,9344400,8309075,-1035325,SELL
29-09-20 12:38,12:38,9366675,8224550,-1142125,SELL
29-09-20 12:39,12:39,9277650,8278850,-998800,SELL
29-09-20 12:40,12:40,9279700,8320175,-959525,SELL
29-09-20 12:41,12:41,9385850,8303900,-1081950,SELL
29-09-20 12:42,12:42,9447175,8238200,-1208975,SELL
29-09-20 12:43,12:43,9291250,8292250,-999000,SELL
29-09-20 12:44,12:44,9427050,8288675,-1138375,SELL
29-09-20 12:45,12:45,9489400,8324150,-1165250,SELL
29-09-20 12:46,12:46,9471525,8348975,-1122550,SELL
29-09-20 12:47,12:47,9452250,8235300,-1216950,SELL
29-09-20 12:48,12:48,9370375,8282775,-1087600,SELL
29-09-20 12:49,12:49,9431250,8282775,-1148475,SELL
29-09-20 12:50,12:50,9442300,8207725,-1234575,SELL
29-09-20 12:51,12:51,9443825,8205925,-1237900,SELL
29-09-20 12:52,12:52,9500550,8187775,-1312775,SELL
29-09-20 12:53,12:53,9198575,8245200,-953375,SELL
29-09-20 12:54,12:54,9450025,8269525,-1180500,SELL
29-09-20 12:55,12:55,9384050,8227350,-1156700,SELL
29-09-20 12:56,12:56,9390325,8231650,-1158675,SELL
29-09-20 12:57,12:57,9230300,8207000,-1023300,SELL
29-09-20 12:58,12:58,9238750,8284875,-953875,SELL
29-09-20 12:59,12:59,9291950,8269925,-1022025,SELL
29-09-20 13:00,13:00,9392375,8244525,-1147850,SELL
29-09-20 13:01,13:01,9286650,8244525,-1042125,SELL
29-09-20 13:02,13:02,9380025,8351925,-1028100,SELL
29-09-20 13:03,13:03,9239325,8320150,-919175,SELL
29-09-20 13:04,13:04,9237275,8310800,-926475,SELL
29-09-20 13:05,13:05,9381350,8344500,-1036850,SELL
29-09-20 13:06,13:06,9447325,8350500,-1096825,SELL
29-09-20 13:07,13:07,9336100,8337925,-998175,SELL
29-09-20 13:08,13:08,9243100,8290600,-952500,SELL
29-09-20 13:09,13:09,9362300,8338250,-1024050,SELL
29-09-20 13:10,13:10,9405625,8335250,-1070375,SELL
29-09-20 13:11,13:11,9234175,8370625,-863550,SELL
29-09-20 13:12,13:12,9194450,8276850,-917600,SELL
29-09-20 13:13,13:13,9325375,8276850,-1048525,SELL
29-09-20 13:14,13:14,9219450,8276850,-942600,SELL
29-09-20 13:15,13:15,9442650,8325900,-1116750,SELL
29-09-20 13:16,13:16,9369300,8324500,-1044800,SELL
29-09-20 13:17,13:17,9085100,8273550,-811550,SELL
29-09-20 13:18,13:18,9455450,8259525,-1195925,SELL
29-09-20 13:19,13:19,9420975,8276775,-1144200,SELL
29-09-20 13:20,13:20,9311825,8283650,-1028175,SELL
29-09-20 13:21,13:21,9315125,8307225,-1007900,SELL
29-09-20 13:22,13:22,9357150,8259775,-1097375,SELL
29-09-20 13:23,13:23,9465100,8294775,-1170325,SELL
29-09-20 13:24,13:24,9549800,8338575,-1211225,SELL
29-09-20 13:25,13:25,9541475,8297100,-1244375,SELL
29-09-20 13:26,13:26,9450375,8337575,-1112800,SELL
29-09-20 13:27,13:27,9492425,8277725,-1214700,SELL
29-09-20 13:28,13:28,9250375,8272200,-978175,SELL
29-09-20 13:29,13:29,9275450,8272200,-1003250,SELL
29-09-20 13:30,13:30,9242075,8315125,-926950,SELL
29-09-20 13:31,13:31,9448875,8368675,-1080200,SELL
29-09-20 13:32,13:32,9462425,8334850,-1127575,SELL
29-09-20 13:33,13:33,9546225,8262350,-1283875,SELL
29-09-20 13:34,13:34,9486475,8218400,-1268075,SELL
29-09-20 13:35,13:35,9444375,8212375,-1232000,SELL
29-09-20 13:36,13:36,9448050,8186250,-1261800,SELL
29-09-20 13:37,13:37,9405075,8180775,-1224300,SELL
29-09-20 13:38,13:38,9448050,8227200,-1220850,SELL
29-09-20 13:39,13:39,9428475,8212750,-1215725,SELL
29-09-20 13:40,13:40,9384300,8271925,-1112375,SELL
29-09-20 13:41,13:41,9408700,8293650,-1115050,SELL
29-09-20 13:42,13:42,9431475,8277525,-1153950,SELL
29-09-20 13:43,13:43,9418875,8290350,-1128525,SELL
29-09-20 13:44,13:44,9374650,8301875,-1072775,SELL
29-09-20 13:45,13:45,9363600,8316000,-1047600,SELL
29-09-20 13:46,13:46,9473425,8362775,-1110650,SELL
29-09-20 13:47,13:47,9481725,8306750,-1174975,SELL
29-09-20 13:48,13:48,9183000,8222175,-960825,SELL
29-09-20 13:49,13:49,9350525,8288600,-1061925,SELL
29-09-20 13:50,13:50,9297150,8293300,-1003850,SELL
29-09-20 13:51,13:51,9281450,8289200,-992250,SELL
29-09-20 13:52,13:52,9119975,8235800,-884175,SELL
29-09-20 13:53,13:53,9313475,8299000,-1014475,SELL
29-09-20 13:54,13:54,9343225,8393575,-949650,SELL
29-09-20 13:55,13:55,9320225,8385475,-934750,SELL
29-09-20 13:56,13:56,9296700,8288025,-1008675,SELL
29-09-20 13:57,13:57,9106925,8297325,-809600,SELL
29-09-20 13:58,13:58,9120425,8278675,-841750,SELL
29-09-20 13:59,13:59,9182025,8291625,-890400,SELL
29-09-20 14:00,14:00,9306875,8347825,-959050,SELL
29-09-20 14:01,14:01,9264075,8342675,-921400,SELL
29-09-20 14:02,14:02,9220225,8311225,-909000,SELL
29-09-20 14:03,14:03,9185400,8327425,-857975,SELL
29-09-20 14:04,14:04,9161375,8313750,-847625,SELL
29-09-20 14:05,14:05,9253275,8299300,-953975,SELL
29-09-20 14:06,14:06,9175650,8341600,-834050,SELL
29-09-20 14:07,14:07,9345775,8334825,-1010950,SELL
29-09-20 14:08,14:08,9322900,8348500,-974400,SELL
29-09-20 14:09,14:09,9290550,8391925,-898625,SELL
29-09-20 14:10,14:10,9290550,8350075,-940475,SELL
29-09-20 14:11,14:11,9142350,8313025,-829325,SELL
29-09-20 14:12,14:12,9017450,8290075,-727375,SELL
29-09-20 14:13,14:13,9252475,8379600,-872875,SELL
29-09-20 14:14,14:14,9357800,8367375,-990425,SELL
29-09-20 14:15,14:15,9379425,8459225,-920200,SELL
29-09-20 14:16,14:16,9379425,8459275,-920150,SELL
29-09-20 14:17,14:17,9344025,8452700,-891325,SELL
29-09-20 14:18,14:18,8862350,8106675,-755675,SELL
29-09-20 14:19,14:19,8843600,8109725,-733875,SELL
29-09-20 14:20,14:20,8799725,8135850,-663875,SELL
29-09-20 14:21,14:21,8768675,8115850,-652825,SELL
29-09-20 14:22,14:22,8636550,8114400,-522150,SELL
29-09-20 14:23,14:23,8814775,8115850,-698925,SELL
29-09-20 14:24,14:24,8783050,8116450,-666600,SELL
29-09-20 14:25,14:25,8795450,8089000,-706450,SELL
29-09-20 14:26,14:26,8633775,8089000,-544775,SELL
29-09-20 14:27,14:27,8817925,8121600,-696325,SELL
29-09-20 14:28,14:28,8672000,8097125,-574875,SELL
29-09-20 14:29,14:29,8744500,8053275,-691225,SELL
29-09-20 14:30,14:30,8842200,8070675,-771525,SELL
29-09-20 14:31,14:31,8793725,8048500,-745225,SELL
29-09-20 14:32,14:32,8793725,8045025,-748700,SELL
29-09-20 14:33,14:33,8771750,7880825,-890925,SELL
29-09-20 14:34,14:34,8796800,7944425,-852375,SELL
29-09-20 14:35,14:35,8767000,7903350,-863650,SELL
29-09-20 14:36,14:36,8798300,7860600,-937700,SELL
29-09-20 14:37,14:37,8779700,7852825,-926875,SELL
29-09-20 14:38,14:38,8835350,7864650,-970700,SELL
29-09-20 14:39,14:39,8689350,7852525,-836825,SELL
29-09-20 14:40,14:40,8816100,7852450,-963650,SELL
29-09-20 14:41,14:41,8653000,7798925,-854075,SELL
29-09-20 14:42,14:42,8774350,7813325,-961025,SELL
29-09-20 14:43,14:43,8741350,7819175,-922175,SELL
29-09-20 14:44,14:44,8778550,7813225,-965325,SELL
29-09-20 14:45,14:45,8827850,7731650,-1096200,SELL
29-09-20 14:46,14:46,8814250,7725725,-1088525,SELL
29-09-20 14:47,14:47,8790925,7725725,-1065200,SELL
29-09-20 14:48,14:48,8742750,7714425,-1028325,SELL
29-09-20 14:49,14:49,8557225,7647525,-909700,SELL
29-09-20 14:50,14:50,8723750,7683300,-1040450,SELL
29-09-20 14:51,14:51,8652300,7675700,-976600,SELL
29-09-20 14:52,14:52,8601475,7620525,-980950,SELL
29-09-20 14:53,14:53,8812400,7701975,-1110425,SELL
29-09-20 14:54,14:54,8734575,7578500,-1156075,SELL
29-09-20 14:55,14:55,8766975,7584475,-1182500,SELL
29-09-20 14:56,14:56,8706375,7580950,-1125425,SELL
29-09-20 14:57,14:57,8572825,7325300,-1247525,SELL
29-09-20 14:58,14:58,8633375,7371950,-1261425,SELL
29-09-20 14:59,14:59,8647075,7367300,-1279775,SELL
29-09-20 15:00,15:00,8622275,7297650,-1324625,SELL
29-09-20 15:01,15:01,8640375,7301125,-1339250,SELL
29-09-20 15:02,15:02,8658950,7295150,-1363800,SELL
29-09-20 15:03,15:03,8526900,7416350,-1110550,SELL
29-09-20 15:04,15:04,8509225,7418525,-1090700,SELL
29-09-20 15:05,15:05,8575175,7375575,-1199600,SELL
29-09-20 15:06,15:06,8483650,7360400,-1123250,SELL
29-09-20 15:07,15:07,8483375,7378325,-1105050,SELL
29-09-20 15:08,15:08,8422850,7375625,-1047225,SELL
29-09-20 15:09,15:09,8492675,7288750,-1203925,SELL
29-09-20 15:10,15:10,8407300,7285050,-1122250,SELL
29-09-20 15:11,15:11,8454675,7278350,-1176325,SELL
29-09-20 15:12,15:12,8360625,7167725,-1192900,SELL
29-09-20 15:13,15:13,8273550,7202750,-1070800,SELL
29-09-20 15:14,15:14,8426875,7208675,-1218200,SELL
29-09-20 15:15,15:15,8365350,7121775,-1243575,SELL
29-09-20 15:16,15:16,8308500,7095750,-1212750,SELL
29-09-20 15:17,15:17,8364750,7101900,-1262850,SELL
29-09-20 15:18,15:18,8144725,6983675,-1161050,SELL
29-09-20 15:19,15:19,8167675,6983550,-1184125,SELL
29-09-20 15:20,15:20,8125100,7023150,-1101950,SELL
29-09-20 15:21,15:21,8090025,6909050,-1180975,SELL
29-09-20 15:22,15:22,8060800,6896800,-1164000,SELL
29-09-20 15:23,15:23,8116550,6911525,-1205025,SELL
29-09-20 15:24,15:24,8037850,6875775,-1162075,SELL
29-09-20 15:25,15:25,8056625,6868950,-1187675,SELL
29-09-20 15:26,15:26,7930850,6834000,-1096850,SELL
29-09-20 15:27,15:27,7880450,6701675,-1178775,SELL
29-09-20 15:28,15:28,7843975,6680700,-1163275,SELL
29-09-20 15:29,15:29,7856100,6703100,-1153000,SELL
30-09-20 9:15,9:15,7697750,6437550,-1260200,SELL
30-09-20 9:16,9:16,7705975,6455025,-1250950,SELL
30-09-20 9:17,9:17,8024850,6857050,-1167800,SELL
30-09-20 9:18,9:18,8021575,6832450,-1189125,SELL
30-09-20 9:19,9:19,8024850,6781000,-1243850,SELL
30-09-20 9:20,9:20,8462750,7246000,-1216750,SELL
30-09-20 9:21,9:21,8462750,7248350,-1214400,SELL
30-09-20 9:22,9:22,8462825,7264950,-1197875,SELL
30-09-20 9:23,9:23,8634925,7267350,-1367575,SELL
30-09-20 9:24,9:24,8635300,7217325,-1417975,SELL
30-09-20 9:25,9:25,8648850,7253575,-1395275,SELL
30-09-20 9:26,9:26,8848925,7502575,-1346350,SELL
30-09-20 9:27,9:27,8856975,7516775,-1340200,SELL
30-09-20 9:28,9:28,8848925,7494550,-1354375,SELL
30-09-20 9:29,9:29,9041850,7608525,-1433325,SELL
30-09-20 9:30,9:30,9052450,7682325,-1370125,SELL
30-09-20 9:31,9:31,9028825,7631225,-1397600,SELL
30-09-20 9:32,9:32,9160725,7846375,-1314350,SELL
30-09-20 9:33,9:33,9104350,7844600,-1259750,SELL
30-09-20 9:34,9:34,9145050,7871175,-1273875,SELL
30-09-20 9:35,9:35,9310075,7979300,-1330775,SELL
30-09-20 9:36,9:36,9330300,8002975,-1327325,SELL
30-09-20 9:37,9:37,9310075,8013775,-1296300,SELL
30-09-20 9:38,9:38,9407000,8021450,-1385550,SELL
30-09-20 9:39,9:39,9426200,8059400,-1366800,SELL
30-09-20 9:40,9:40,9412700,8036275,-1376425,SELL
30-09-20 9:41,9:41,9561550,8213025,-1348525,SELL
30-09-20 9:42,9:42,9542300,8200400,-1341900,SELL
30-09-20 9:43,9:43,9528825,8218550,-1310275,SELL
30-09-20 9:44,9:44,9598175,8203825,-1394350,SELL
30-09-20 9:45,9:45,9630800,8225875,-1404925,SELL
30-09-20 9:46,9:46,9623725,8264850,-1358875,SELL
30-09-20 9:47,9:47,9724250,8152325,-1571925,SELL
30-09-20 9:48,9:48,9716225,8176725,-1539500,SELL
30-09-20 9:49,9:49,9688625,8152325,-1536300,SELL
30-09-20 9:50,9:50,9718625,8297825,-1420800,SELL
30-09-20 9:51,9:51,9736925,8311375,-1425550,SELL
30-09-20 9:52,9:52,9761250,8285125,-1476125,SELL
30-09-20 9:53,9:53,9892850,8354775,-1538075,SELL
30-09-20 9:54,9:54,9930350,8394700,-1535650,SELL
30-09-20 9:55,9:55,9905900,8379500,-1526400,SELL
30-09-20 9:56,9:56,10005750,8462600,-1543150,SELL
30-09-20 9:57,9:57,9992850,8498900,-1493950,SELL
30-09-20 9:58,9:58,9986475,8458700,-1527775,SELL
30-09-20 9:59,9:59,10071200,8332650,-1738550,SELL
30-09-20 10:00,10:00,10103050,8332650,-1770400,SELL
30-09-20 10:01,10:01,10098175,8356000,-1742175,SELL
30-09-20 10:02,10:02,10144300,8432500,-1711800,SELL
30-09-20 10:03,10:03,10124325,8466575,-1657750,SELL
30-09-20 10:04,10:04,10137775,8416025,-1721750,SELL
30-09-20 10:05,10:05,10225700,8559100,-1666600,SELL
30-09-20 10:06,10:06,10262775,8498375,-1764400,SELL
30-09-20 10:07,10:07,10233800,8547350,-1686450,SELL
30-09-20 10:08,10:08,10171325,8528250,-1643075,SELL
30-09-20 10:09,10:09,10211725,8563975,-1647750,SELL
30-09-20 10:10,10:10,10183750,8568675,-1615075,SELL
30-09-20 10:11,10:11,10314375,8611800,-1702575,SELL
30-09-20 10:12,10:12,10286650,8575975,-1710675,SELL
30-09-20 10:13,10:13,10246025,8554025,-1692000,SELL
30-09-20 10:14,10:14,10330375,8612600,-1717775,SELL
30-09-20 10:15,10:15,10323350,8625725,-1697625,SELL
30-09-20 10:16,10:16,10270300,8623900,-1646400,SELL
30-09-20 10:17,10:17,10304675,8756125,-1548550,SELL
30-09-20 10:18,10:18,10372975,8731425,-1641550,SELL
30-09-20 10:19,10:19,10360750,8775900,-1584850,SELL
30-09-20 10:20,10:20,10359275,8781300,-1577975,SELL
30-09-20 10:21,10:21,10322700,8781850,-1540850,SELL
30-09-20 10:22,10:22,10326900,8759300,-1567600,SELL
30-09-20 10:23,10:23,10430300,8834875,-1595425,SELL
30-09-20 10:24,10:24,10430325,8845300,-1585025,SELL
30-09-20 10:25,10:25,10211275,8796125,-1415150,SELL
30-09-20 10:26,10:26,10410725,8943600,-1467125,SELL
30-09-20 10:27,10:27,10451325,8968800,-1482525,SELL
30-09-20 10:28,10:28,10463700,8897950,-1565750,SELL
30-09-20 10:29,10:29,10347575,9056675,-1290900,SELL
30-09-20 10:30,10:30,10337000,9028675,-1308325,SELL
30-09-20 10:31,10:31,10327650,9027475,-1300175,SELL
30-09-20 10:32,10:32,9354475,8683225,-671250,SELL
30-09-20 10:33,10:33,9322800,8644075,-678725,SELL
30-09-20 10:34,10:34,9337475,8683175,-654300,SELL
30-09-20 10:35,10:35,9250900,8676250,-574650,SELL
30-09-20 10:36,10:36,9232250,8621250,-611000,SELL
30-09-20 10:37,10:37,9244575,8625825,-618750,SELL
30-09-20 10:38,10:38,9314550,8753125,-561425,SELL
30-09-20 10:39,10:39,9346900,8801925,-544975,SELL
30-09-20 10:40,10:40,9364925,8812650,-552275,SELL
30-09-20 10:41,10:41,9281700,8832850,-448850,SELL
30-09-20 10:42,10:42,9279425,8818775,-460650,SELL
30-09-20 10:43,10:43,9248500,8803875,-444625,SELL
30-09-20 10:44,10:44,9301675,8773725,-527950,SELL
30-09-20 10:45,10:45,9307475,8808575,-498900,SELL
30-09-20 10:46,10:46,9307475,8837525,-469950,SELL
30-09-20 10:47,10:47,9388800,8885325,-503475,SELL
30-09-20 10:48,10:48,9422000,8899375,-522625,SELL
30-09-20 10:49,10:49,9422000,8885325,-536675,SELL
30-09-20 10:50,10:50,9510975,8987625,-523350,SELL
30-09-20 10:51,10:51,9533375,9043250,-490125,SELL
30-09-20 10:52,10:52,9515075,9046475,-468600,SELL
30-09-20 10:53,10:53,9525850,9145600,-380250,SELL
30-09-20 10:54,10:54,9481950,9169925,-312025,SELL
30-09-20 10:55,10:55,9549025,9201300,-347725,SELL
30-09-20 10:56,10:56,9491250,9278675,-212575,SELL
30-09-20 10:57,10:57,9491275,9250925,-240350,SELL
30-09-20 10:58,10:58,9418100,9244175,-173925,SELL
30-09-20 10:59,10:59,9243050,9283350,40300,BUY
30-09-20 11:00,11:00,9248700,9267700,19000,BUY
30-09-20 11:01,11:01,9208700,9300775,92075,BUY
30-09-20 11:02,11:02,9252075,9258600,6525,BUY
30-09-20 11:03,11:03,9262800,9298050,35250,BUY
30-09-20 11:04,11:04,9264700,9232825,-31875,SELL
30-09-20 11:05,11:05,9396600,9219150,-177450,SELL
30-09-20 11:06,11:06,9353675,9157150,-196525,SELL
30-09-20 11:07,11:07,9361000,9194000,-167000,SELL
30-09-20 11:08,11:08,9422925,9226075,-196850,SELL
30-09-20 11:09,11:09,9443150,9226300,-216850,SELL
30-09-20 11:10,11:10,9422925,9226300,-196625,SELL
30-09-20 11:11,11:11,9543050,9265725,-277325,SELL
30-09-20 11:12,11:12,9540050,9295800,-244250,SELL
30-09-20 11:13,11:13,9541250,9281550,-259700,SELL
30-09-20 11:14,11:14,9501550,9318150,-183400,SELL
30-09-20 11:15,11:15,9623250,9283550,-339700,SELL
30-09-20 11:16,11:16,9610375,9349000,-261375,SELL
30-09-20 11:17,11:17,9567900,9365625,-202275,SELL
30-09-20 11:18,11:18,9580725,9379400,-201325,SELL
30-09-20 11:19,11:19,9590300,9414425,-175875,SELL
30-09-20 11:20,11:20,9616025,9325125,-290900,SELL
30-09-20 11:21,11:21,9636175,9273700,-362475,SELL
30-09-20 11:22,11:22,9581700,9276075,-305625,SELL
30-09-20 11:23,11:23,9617500,9263025,-354475,SELL
30-09-20 11:24,11:24,9619525,9298100,-321425,SELL
30-09-20 11:25,11:25,9673975,9246725,-427250,SELL
30-09-20 11:26,11:26,9648200,9323250,-324950,SELL
30-09-20 11:27,11:27,9719675,9346125,-373550,SELL
30-09-20 11:28,11:28,9720375,9378600,-341775,SELL
30-09-20 11:29,11:29,9697250,9066475,-630775,SELL
30-09-20 11:30,11:30,9720700,9095950,-624750,SELL
30-09-20 11:31,11:31,9697475,9062550,-634925,SELL
30-09-20 11:32,11:32,9753125,8872050,-881075,SELL
30-09-20 11:33,11:33,9758500,8877900,-880600,SELL
30-09-20 11:34,11:34,9748725,8868250,-880475,SELL
30-09-20 11:35,11:35,9776900,8898475,-878425,SELL
30-09-20 11:36,11:36,9764175,8895050,-869125,SELL
30-09-20 11:37,11:37,9823975,8895050,-928925,SELL
30-09-20 11:38,11:38,9849375,8880000,-969375,SELL
30-09-20 11:39,11:39,9862925,8879825,-983100,SELL
30-09-20 11:40,11:40,9873500,8870100,-1003400,SELL
30-09-20 11:41,11:41,9768575,8874150,-894425,SELL
30-09-20 11:42,11:42,9914225,8822725,-1091500,SELL
30-09-20 11:43,11:43,9867575,8809525,-1058050,SELL
30-09-20 11:44,11:44,9891325,8816175,-1075150,SELL
30-09-20 11:45,11:45,9900625,8809725,-1090900,SELL
30-09-20 11:46,11:46,9852700,8803050,-1049650,SELL
30-09-20 11:47,11:47,9933575,8828225,-1105350,SELL
30-09-20 11:48,11:48,9915900,8864000,-1051900,SELL
30-09-20 11:49,11:49,9879425,8828150,-1051275,SELL
30-09-20 11:50,11:50,9944600,8858925,-1085675,SELL
30-09-20 11:51,11:51,9926950,8900550,-1026400,SELL
30-09-20 11:52,11:52,9909375,8871950,-1037425,SELL
30-09-20 11:53,11:53,9933775,8795875,-1137900,SELL
30-09-20 11:54,11:54,9841675,8810950,-1030725,SELL
30-09-20 11:55,11:55,9932925,8797975,-1134950,SELL
30-09-20 11:56,11:56,9818900,8673225,-1145675,SELL
30-09-20 11:57,11:57,9919150,8737600,-1181550,SELL
30-09-20 11:58,11:58,9963525,8779475,-1184050,SELL
30-09-20 11:59,11:59,10020775,8949200,-1071575,SELL
30-09-20 12:00,12:00,9994875,8882175,-1112700,SELL
30-09-20 12:01,12:01,9953375,8869300,-1084075,SELL
30-09-20 12:02,12:02,9968775,8821000,-1147775,SELL
30-09-20 12:03,12:03,10024925,8820000,-1204925,SELL
30-09-20 12:04,12:04,9994750,8851650,-1143100,SELL
30-09-20 12:05,12:05,10008575,8768425,-1240150,SELL
30-09-20 12:06,12:06,10069825,8789250,-1280575,SELL
30-09-20 12:07,12:07,10044650,8864300,-1180350,SELL
30-09-20 12:08,12:08,10040050,8857050,-1183000,SELL
30-09-20 12:09,12:09,10050875,8854750,-1196125,SELL
30-09-20 12:10,12:10,10004200,8908300,-1095900,SELL
30-09-20 12:11,12:11,10046325,8961375,-1084950,SELL
30-09-20 12:12,12:12,9966550,8853175,-1113375,SELL
30-09-20 12:13,12:13,9950275,8920200,-1030075,SELL
30-09-20 12:14,12:14,10137500,8880375,-1257125,SELL
30-09-20 12:15,12:15,10122700,8874775,-1247925,SELL
30-09-20 12:16,12:16,10047725,8833100,-1214625,SELL
30-09-20 12:17,12:17,10222950,8898025,-1324925,SELL
30-09-20 12:18,12:18,10206525,8831375,-1375150,SELL
30-09-20 12:19,12:19,10206525,8876250,-1330275,SELL
30-09-20 12:20,12:20,10311450,8909650,-1401800,SELL
30-09-20 12:21,12:21,10304850,8929475,-1375375,SELL
30-09-20 12:22,12:22,10304850,8948250,-1356600,SELL
30-09-20 12:23,12:23,10301500,8945975,-1355525,SELL
30-09-20 12:24,12:24,10297475,8916050,-1381425,SELL
30-09-20 12:25,12:25,10279850,8885250,-1394600,SELL
30-09-20 12:26,12:26,10292575,8999625,-1292950,SELL
30-09-20 12:27,12:27,9463725,8909550,-554175,SELL
30-09-20 12:28,12:28,10289100,9022125,-1266975,SELL
30-09-20 12:29,12:29,10309375,9062775,-1246600,SELL
30-09-20 12:30,12:30,10292675,9034675,-1258000,SELL
30-09-20 12:31,12:31,10310350,9021675,-1288675,SELL
30-09-20 12:32,12:32,10317225,9121075,-1196150,SELL
30-09-20 12:33,12:33,10326225,9076750,-1249475,SELL
30-09-20 12:34,12:34,10349175,9128550,-1220625,SELL
30-09-20 12:35,12:35,10225575,9179175,-1046400,SELL
30-09-20 12:36,12:36,10175725,9151975,-1023750,SELL
30-09-20 12:37,12:37,10173750,9203325,-970425,SELL
30-09-20 12:38,12:38,10202950,9195675,-1007275,SELL
30-09-20 12:39,12:39,10242325,9194225,-1048100,SELL
30-09-20 12:40,12:40,10272700,9228875,-1043825,SELL
30-09-20 12:41,12:41,10210500,9205600,-1004900,SELL
30-09-20 12:42,12:42,10126300,9184875,-941425,SELL
30-09-20 12:43,12:43,10191000,9167650,-1023350,SELL
30-09-20 12:44,12:44,10212300,9231975,-980325,SELL
30-09-20 12:45,12:45,10253250,9221925,-1031325,SELL
30-09-20 12:46,12:46,10261675,9225900,-1035775,SELL
30-09-20 12:47,12:47,10147725,9335000,-812725,SELL
30-09-20 12:48,12:48,10214650,9283275,-931375,SELL
30-09-20 12:49,12:49,10214650,9252600,-962050,SELL
30-09-20 12:50,12:50,10219600,9267175,-952425,SELL
30-09-20 12:51,12:51,10230450,9275675,-954775,SELL
30-09-20 12:52,12:52,10189350,9299900,-889450,SELL
30-09-20 12:53,12:53,10199950,9335200,-864750,SELL
30-09-20 12:54,12:54,10293800,9381625,-912175,SELL
30-09-20 12:55,12:55,10235075,9318700,-916375,SELL
30-09-20 12:56,12:56,10288525,9329175,-959350,SELL
30-09-20 12:57,12:57,10308050,9265825,-1042225,SELL
30-09-20 12:58,12:58,10266850,9265675,-1001175,SELL
30-09-20 12:59,12:59,10310000,9275800,-1034200,SELL
30-09-20 13:00,13:00,10297000,9397350,-899650,SELL
30-09-20 13:01,13:01,10314525,9322500,-992025,SELL
30-09-20 13:02,13:02,10315200,9311625,-1003575,SELL
30-09-20 13:03,13:03,10232850,9420950,-811900,SELL
30-09-20 13:04,13:04,10304225,9502650,-801575,SELL
30-09-20 13:05,13:05,10291500,9478950,-812550,SELL
30-09-20 13:06,13:06,9978625,9509875,-468750,SELL
30-09-20 13:07,13:07,9937400,9462375,-475025,SELL
30-09-20 13:08,13:08,9978625,9459900,-518725,SELL
30-09-20 13:09,13:09,10033175,9467900,-565275,SELL
30-09-20 13:10,13:10,9997075,9503650,-493425,SELL
30-09-20 13:11,13:11,9979375,9460375,-519000,SELL
30-09-20 13:12,13:12,10031850,9419725,-612125,SELL
30-09-20 13:13,13:13,10072925,9350225,-722700,SELL
30-09-20 13:14,13:14,10072925,9415325,-657600,SELL
30-09-20 13:15,13:15,10132750,9398475,-734275,SELL
30-09-20 13:16,13:16,10158750,9416100,-742650,SELL
30-09-20 13:17,13:17,10091625,9397875,-693750,SELL
30-09-20 13:18,13:18,10167575,9315000,-852575,SELL
30-09-20 13:19,13:19,10083325,9379750,-703575,SELL
30-09-20 13:20,13:20,10143975,9366700,-777275,SELL
30-09-20 13:21,13:21,10236925,9409225,-827700,SELL
30-09-20 13:22,13:22,10169725,9429325,-740400,SELL
30-09-20 13:23,13:23,9955525,9408375,-547150,SELL
30-09-20 13:24,13:24,10091525,9401850,-689675,SELL
30-09-20 13:25,13:25,10166550,9414825,-751725,SELL
30-09-20 13:26,13:26,10225300,9401800,-823500,SELL
30-09-20 13:27,13:27,10239150,9497175,-741975,SELL
30-09-20 13:28,13:28,10249525,9484825,-764700,SELL
30-09-20 13:29,13:29,10172075,9420125,-751950,SELL
30-09-20 13:30,13:30,10149250,9346000,-803250,SELL
30-09-20 13:31,13:31,10149250,9358900,-790350,SELL
30-09-20 13:32,13:32,10172550,9348925,-823625,SELL
30-09-20 13:33,13:33,10198300,9311125,-887175,SELL
30-09-20 13:34,13:34,10171050,9328250,-842800,SELL
30-09-20 13:35,13:35,10198300,9311125,-887175,SELL
30-09-20 13:36,13:36,10178325,9383050,-795275,SELL
30-09-20 13:37,13:37,10178325,9396000,-782325,SELL
30-09-20 13:38,13:38,10178325,9400150,-778175,SELL
30-09-20 13:39,13:39,9992975,9415500,-577475,SELL
30-09-20 13:40,13:40,10115125,9392275,-722850,SELL
30-09-20 13:41,13:41,10199750,9405200,-794550,SELL
30-09-20 13:42,13:42,10310125,9383850,-926275,SELL
30-09-20 13:43,13:43,10256550,9400950,-855600,SELL
30-09-20 13:44,13:44,10212800,9337300,-875500,SELL
30-09-20 13:45,13:45,10277400,9456175,-821225,SELL
30-09-20 13:46,13:46,10266425,9359225,-907200,SELL
30-09-20 13:47,13:47,10279125,9439075,-840050,SELL
30-09-20 13:48,13:48,10338200,9474750,-863450,SELL
30-09-20 13:49,13:49,10296675,9491900,-804775,SELL
30-09-20 13:50,13:50,10266325,9488350,-777975,SELL
30-09-20 13:51,13:51,10231375,9599325,-632050,SELL
30-09-20 13:52,13:52,10311475,9623325,-688150,SELL
30-09-20 13:53,13:53,10272450,9566425,-706025,SELL
30-09-20 13:54,13:54,10165300,9659950,-505350,SELL
30-09-20 13:55,13:55,10206400,9623950,-582450,SELL
30-09-20 13:56,13:56,10232725,9594425,-638300,SELL
30-09-20 13:57,13:57,10190650,9675250,-515400,SELL
30-09-20 13:58,13:58,10175475,9664475,-511000,SELL
30-09-20 13:59,13:59,10203300,9599750,-603550,SELL
30-09-20 14:00,14:00,10194575,9728975,-465600,SELL
30-09-20 14:01,14:01,10247800,9746725,-501075,SELL
30-09-20 14:02,14:02,10222925,9709325,-513600,SELL
30-09-20 14:03,14:03,10182525,9713525,-469000,SELL
30-09-20 14:04,14:04,10223500,9624300,-599200,SELL
30-09-20 14:05,14:05,10182525,9666225,-516300,SELL
30-09-20 14:06,14:06,10175575,9741250,-434325,SELL
30-09-20 14:07,14:07,10241400,9712800,-528600,SELL
30-09-20 14:08,14:08,10233125,9707700,-525425,SELL
30-09-20 14:09,14:09,10253375,9820200,-433175,SELL
30-09-20 14:10,14:10,10217775,9831700,-386075,SELL
30-09-20 14:11,14:11,10217775,9789675,-428100,SELL
30-09-20 14:12,14:12,9889425,9733725,-155700,SELL
30-09-20 14:13,14:13,9882075,9774075,-108000,SELL
30-09-20 14:14,14:14,9907625,9799625,-108000,SELL
30-09-20 14:15,14:15,9437650,9850050,412400,BUY
30-09-20 14:16,14:16,9437650,9797525,359875,BUY
30-09-20 14:17,14:17,9383425,9762950,379525,BUY
30-09-20 14:18,14:18,9240500,9734050,493550,BUY
30-09-20 14:19,14:19,9181275,9720625,539350,BUY
30-09-20 14:20,14:20,9258575,9770225,511650,BUY
30-09-20 14:21,14:21,9272225,9774800,502575,BUY
30-09-20 14:22,14:22,9243350,9735350,492000,BUY
30-09-20 14:23,14:23,9243350,9748325,504975,BUY
30-09-20 14:24,14:24,9323675,9785900,462225,BUY
30-09-20 14:25,14:25,9331050,9763425,432375,BUY
30-09-20 14:26,14:26,9331050,9796625,465575,BUY
30-09-20 14:27,14:27,9293100,9778625,485525,BUY
30-09-20 14:28,14:28,9293025,9789875,496850,BUY
30-09-20 14:29,14:29,9248100,9789875,541775,BUY
30-09-20 14:30,14:30,9396700,9772425,375725,BUY
30-09-20 14:31,14:31,9425400,9772425,347025,BUY
30-09-20 14:32,14:32,9443050,9804300,361250,BUY
30-09-20 14:33,14:33,9242525,9845625,603100,BUY
30-09-20 14:34,14:34,9261025,9853625,592600,BUY
30-09-20 14:35,14:35,9261025,9853625,592600,BUY
30-09-20 14:36,14:36,9107575,9751625,644050,BUY
30-09-20 14:37,14:37,9103075,9767925,664850,BUY
30-09-20 14:38,14:38,9090325,9781050,690725,BUY
30-09-20 14:39,14:39,9137500,9710800,573300,BUY
30-09-20 14:40,14:40,9137550,9739425,601875,BUY
30-09-20 14:41,14:41,9137550,9769475,631925,BUY
30-09-20 14:42,14:42,9168275,9693675,525400,BUY
30-09-20 14:43,14:43,9098150,9705175,607025,BUY
30-09-20 14:44,14:44,9110950,9712650,601700,BUY
30-09-20 14:45,14:45,9167925,9650025,482100,BUY
30-09-20 14:46,14:46,9237800,9725600,487800,BUY
30-09-20 14:47,14:47,9161075,9682875,521800,BUY
30-09-20 14:48,14:48,9277325,9709075,431750,BUY
30-09-20 14:49,14:49,9178725,9640275,461550,BUY
30-09-20 14:50,14:50,9264625,9696025,431400,BUY
30-09-20 14:51,14:51,9264050,9735075,471025,BUY
30-09-20 14:52,14:52,9276800,9740975,464175,BUY
30-09-20 14:53,14:53,9178075,9688525,510450,BUY
30-09-20 14:54,14:54,9224000,9603550,379550,BUY
30-09-20 14:55,14:55,9241350,9592900,351550,BUY
30-09-20 14:56,14:56,9211175,9604425,393250,BUY
30-09-20 14:57,14:57,9121150,9556850,435700,BUY
30-09-20 14:58,14:58,9092400,9549075,456675,BUY
30-09-20 14:59,14:59,9152275,9621225,468950,BUY
30-09-20 15:00,15:00,9006525,9433575,427050,BUY
30-09-20 15:01,15:01,8925075,9470150,545075,BUY
30-09-20 15:02,15:02,8998325,9426875,428550,BUY
30-09-20 15:03,15:03,8902525,9404450,501925,BUY
30-09-20 15:04,15:04,8902475,9404150,501675,BUY
30-09-20 15:05,15:05,8931225,9337800,406575,BUY
30-09-20 15:06,15:06,8817425,9315250,497825,BUY
30-09-20 15:07,15:07,8846175,9311875,465700,BUY
30-09-20 15:08,15:08,8802000,9342325,540325,BUY
30-09-20 15:09,15:09,8708575,9274400,565825,BUY
30-09-20 15:10,15:10,8780875,9313700,532825,BUY
30-09-20 15:11,15:11,8780875,9260375,479500,BUY
30-09-20 15:12,15:12,8577775,9143150,565375,BUY
30-09-20 15:13,15:13,8747650,9189125,441475,BUY
30-09-20 15:14,15:14,8675275,9184775,509500,BUY
30-09-20 15:15,15:15,8653125,9159050,505925,BUY
30-09-20 15:16,15:16,8594325,9110275,515950,BUY
30-09-20 15:17,15:17,8656650,9154550,497900,BUY
30-09-20 15:18,15:18,8448025,8947500,499475,BUY
30-09-20 15:19,15:19,8416825,8998850,582025,BUY
30-09-20 15:20,15:20,8492075,8965525,473450,BUY
30-09-20 15:21,15:21,8189750,8701450,511700,BUY
30-09-20 15:22,15:22,8199950,8661300,461350,BUY
30-09-20 15:23,15:23,8025450,8687975,662525,BUY
30-09-20 15:24,15:24,7925875,8517750,591875,BUY
30-09-20 15:25,15:25,8040050,8580400,540350,BUY
30-09-20 15:26,15:26,7938250,8543175,604925,BUY
30-09-20 15:27,15:27,7762750,8178950,416200,BUY
30-09-20 15:28,15:28,7687300,8163775,476475,BUY
30-09-20 15:29,15:29,7787675,8136700,349025,BUY
01-10-20 9:15,9:15,7544350,7907600,363250,BUY
01-10-20 9:16,9:16,7536250,7928875,392625,BUY
01-10-20 9:17,9:17,7915600,8424300,508700,BUY
01-10-20 9:18,9:18,7907450,8404175,496725,BUY
01-10-20 9:19,9:19,7866800,8423325,556525,BUY
01-10-20 9:20,9:20,8820925,10490575,1669650,BUY
01-10-20 9:21,9:21,8856000,10509475,1653475,BUY
01-10-20 9:22,9:22,8873325,10489550,1616225,BUY
01-10-20 9:23,9:23,9391375,11394925,2003550,BUY
01-10-20 9:24,9:24,9335900,11418350,2082450,BUY
01-10-20 9:25,9:25,9399525,11421725,2022200,BUY
01-10-20 9:26,9:26,9594375,12545725,2951350,BUY
01-10-20 9:27,9:27,9586150,12521550,2935400,BUY
01-10-20 9:28,9:28,9580575,12544650,2964075,BUY
01-10-20 9:29,9:29,9935650,13201925,3266275,BUY
01-10-20 9:30,9:30,9820975,13216225,3395250,BUY
01-10-20 9:31,9:31,9841850,13212000,3370150,BUY
01-10-20 9:32,9:32,10371875,13652800,3280925,BUY
01-10-20 9:33,9:33,10341250,13673200,3331950,BUY
01-10-20 9:34,9:34,10432525,13673200,3240675,BUY
01-10-20 9:35,9:35,10706150,14204800,3498650,BUY
01-10-20 9:36,9:36,10633600,14184250,3550650,BUY
01-10-20 9:37,9:37,10549925,14145525,3595600,BUY
01-10-20 9:38,9:38,10749125,14551750,3802625,BUY
01-10-20 9:39,9:39,10829850,14465450,3635600,BUY
01-10-20 9:40,9:40,10860175,14550700,3690525,BUY
01-10-20 9:41,9:41,11208600,14902025,3693425,BUY
01-10-20 9:42,9:42,11232600,14877450,3644850,BUY
01-10-20 9:43,9:43,11224375,14934300,3709925,BUY
01-10-20 9:44,9:44,11452100,15254925,3802825,BUY
01-10-20 9:45,9:45,11523650,15234625,3710975,BUY
01-10-20 9:46,9:46,11354750,14808100,3453350,BUY
01-10-20 9:47,9:47,11643575,15468900,3825325,BUY
01-10-20 9:48,9:48,11604050,15618200,4014150,BUY
01-10-20 9:49,9:49,11662500,15622175,3959675,BUY
01-10-20 9:50,9:50,11766950,16104600,4337650,BUY
01-10-20 9:51,9:51,11871450,16101650,4230200,BUY
01-10-20 9:52,9:52,11541050,16026775,4485725,BUY
01-10-20 9:53,9:53,11958400,16200575,4242175,BUY
01-10-20 9:54,9:54,12037225,16215150,4177925,BUY
01-10-20 9:55,9:55,12166025,16194675,4028650,BUY
01-10-20 9:56,9:56,12102000,16227825,4125825,BUY
01-10-20 9:57,9:57,12022775,15887975,3865200,BUY
01-10-20 9:58,9:58,12280450,16226200,3945750,BUY
01-10-20 9:59,9:59,12319400,16444700,4125300,BUY
01-10-20 10:00,10:00,12495750,16436150,3940400,BUY
01-10-20 10:01,10:01,12435750,16447650,4011900,BUY
01-10-20 10:02,10:02,12318550,16613150,4294600,BUY
01-10-20 10:03,10:03,12238500,16612875,4374375,BUY
01-10-20 10:04,10:04,12241675,16633100,4391425,BUY
01-10-20 10:05,10:05,12190325,16706175,4515850,BUY
01-10-20 10:06,10:06,12333375,16719975,4386600,BUY
01-10-20 10:07,10:07,12246950,16678600,4431650,BUY
01-10-20 10:08,10:08,12638900,17059025,4420125,BUY
01-10-20 10:09,10:09,12470700,16397075,3926375,BUY
01-10-20 10:10,10:10,12649675,17039000,4389325,BUY
01-10-20 10:11,10:11,12369200,17275525,4906325,BUY
01-10-20 10:12,10:12,12361850,17243325,4881475,BUY
01-10-20 10:13,10:13,12485775,17241650,4755875,BUY
01-10-20 10:14,10:14,12737300,17439050,4701750,BUY
01-10-20 10:15,10:15,12763400,17439425,4676025,BUY
01-10-20 10:16,10:16,12891500,17441625,4550125,BUY
01-10-20 10:17,10:17,12882100,17606150,4724050,BUY
01-10-20 10:18,10:18,12887400,17604650,4717250,BUY
01-10-20 10:19,10:19,12869700,17502250,4632550,BUY
01-10-20 10:20,10:20,13056900,17702475,4645575,BUY
01-10-20 10:21,10:21,12801325,17597500,4796175,BUY
01-10-20 10:22,10:22,13020650,17516225,4495575,BUY
01-10-20 10:23,10:23,13082500,17927425,4844925,BUY
01-10-20 10:24,10:24,13070325,17541900,4471575,BUY
01-10-20 10:25,10:25,13070325,17949075,4878750,BUY
01-10-20 10:26,10:26,13044500,18211850,5167350,BUY
01-10-20 10:27,10:27,13228625,18214225,4985600,BUY
01-10-20 10:28,10:28,13183775,18020975,4837200,BUY
01-10-20 10:29,10:29,13281350,18526025,5244675,BUY
01-10-20 10:30,10:30,13241425,18544350,5302925,BUY
01-10-20 10:31,10:31,13283950,18184925,4900975,BUY
01-10-20 10:32,10:32,13343300,18506450,5163150,BUY
01-10-20 10:33,10:33,13130925,18403700,5272775,BUY
01-10-20 10:34,10:34,13154925,18716200,5561275,BUY
01-10-20 10:35,10:35,13421000,18833650,5412650,BUY
01-10-20 10:36,10:36,13271725,18159975,4888250,BUY
01-10-20 10:37,10:37,13356525,18830100,5473575,BUY
01-10-20 10:38,10:38,13326250,18246800,4920550,BUY
01-10-20 10:39,10:39,13611675,18974375,5362700,BUY
01-10-20 10:40,10:40,13519550,18932300,5412750,BUY
01-10-20 10:41,10:41,12913450,19177175,6263725,BUY
01-10-20 10:42,10:42,12927100,19177800,6250700,BUY
01-10-20 10:43,10:43,12898725,19177800,6279075,BUY
01-10-20 10:44,10:44,11258725,19438175,8179450,BUY
01-10-20 10:45,10:45,11132325,19429375,8297050,BUY
01-10-20 10:46,10:46,11058800,19476975,8418175,BUY
01-10-20 10:47,10:47,11554400,19690275,8135875,BUY
01-10-20 10:48,10:48,11386850,19655400,8268550,BUY
01-10-20 10:49,10:49,11335200,19621075,8285875,BUY
01-10-20 10:50,10:50,11638550,19868950,8230400,BUY
01-10-20 10:51,10:51,11714675,19874875,8160200,BUY
01-10-20 10:52,10:52,11731450,19800850,8069400,BUY
01-10-20 10:53,10:53,12147000,19992200,7845200,BUY
01-10-20 10:54,10:54,11993325,19991350,7998025,BUY
01-10-20 10:55,10:55,11928025,19898250,7970225,BUY
01-10-20 10:56,10:56,12170925,20181600,8010675,BUY
01-10-20 10:57,10:57,12150850,20177600,8026750,BUY
01-10-20 10:58,10:58,12385000,20195725,7810725,BUY
01-10-20 10:59,10:59,12550475,20325675,7775200,BUY
01-10-20 11:00,11:00,12471825,20350075,7878250,BUY
01-10-20 11:01,11:01,12482925,20301600,7818675,BUY
01-10-20 11:02,11:02,12571975,20530575,7958600,BUY
01-10-20 11:03,11:03,12600650,20455825,7855175,BUY
01-10-20 11:04,11:04,12844025,20555925,7711900,BUY
01-10-20 11:05,11:05,12628250,20442575,7814325,BUY
01-10-20 11:06,11:06,12660075,20426875,7766800,BUY
01-10-20 11:07,11:07,12765425,20427400,7661975,BUY
01-10-20 11:08,11:08,13006000,20535750,7529750,BUY
01-10-20 11:09,11:09,12966400,20567125,7600725,BUY
01-10-20 11:10,11:10,12892575,20623150,7730575,BUY
01-10-20 11:11,11:11,12841050,19676600,6835550,BUY
01-10-20 11:12,11:12,12793150,20579350,7786200,BUY
01-10-20 11:13,11:13,12876350,20222200,7345850,BUY
01-10-20 11:14,11:14,12846225,20535525,7689300,BUY
01-10-20 11:15,11:15,12958050,20157675,7199625,BUY
01-10-20 11:16,11:16,12932900,20613575,7680675,BUY
01-10-20 11:17,11:17,12988125,20832625,7844500,BUY
01-10-20 11:18,11:18,13089100,20838050,7748950,BUY
01-10-20 11:19,11:19,13166150,20886975,7720825,BUY
01-10-20 11:20,11:20,13335025,20591025,7256000,BUY
01-10-20 11:21,11:21,13297700,20844275,7546575,BUY
01-10-20 11:22,11:22,13285350,20912200,7626850,BUY
01-10-20 11:23,11:23,13075675,21001425,7925750,BUY
01-10-20 11:24,11:24,13201775,20998150,7796375,BUY
01-10-20 11:25,11:25,13301775,20837775,7536000,BUY
01-10-20 11:26,11:26,13514825,20804750,7289925,BUY
01-10-20 11:27,11:27,13430275,20394550,6964275,BUY
01-10-20 11:28,11:28,13532175,20838325,7306150,BUY
01-10-20 11:29,11:29,13686575,20841250,7154675,BUY
01-10-20 11:30,11:30,13804875,20985450,7180575,BUY
01-10-20 11:31,11:31,13723900,20982925,7259025,BUY
01-10-20 11:32,11:32,13667100,20949700,7282600,BUY
01-10-20 11:33,11:33,13756600,20834925,7078325,BUY
01-10-20 11:34,11:34,13708500,20248075,6539575,BUY
01-10-20 11:35,11:35,13741425,20539425,6798000,BUY
01-10-20 11:36,11:36,13692350,20593625,6901275,BUY
01-10-20 11:37,11:37,13633275,20884000,7250725,BUY
01-10-20 11:38,11:38,13881825,21166825,7285000,BUY
01-10-20 11:39,11:39,13820675,21142775,7322100,BUY
01-10-20 11:40,11:40,13882950,21163000,7280050,BUY
01-10-20 11:41,11:41,13763700,20956525,7192825,BUY
01-10-20 11:42,11:42,13692475,21025275,7332800,BUY
01-10-20 11:43,11:43,13711175,21124600,7413425,BUY
01-10-20 11:44,11:44,13892550,21174375,7281825,BUY
01-10-20 11:45,11:45,13998750,21001675,7002925,BUY
01-10-20 11:46,11:46,13962625,21225600,7262975,BUY
01-10-20 11:47,11:47,14023250,21218100,7194850,BUY
01-10-20 11:48,11:48,14030250,21214650,7184400,BUY
01-10-20 11:49,11:49,13765225,21228800,7463575,BUY
01-10-20 11:50,11:50,13925175,21250975,7325800,BUY
01-10-20 11:51,11:51,13839925,20868700,7028775,BUY
01-10-20 11:52,11:52,13912225,20790825,6878600,BUY
01-10-20 11:53,11:53,14203725,20963800,6760075,BUY
01-10-20 11:54,11:54,14061225,21295650,7234425,BUY
01-10-20 11:55,11:55,13771150,21218975,7447825,BUY
01-10-20 11:56,11:56,13975375,21232825,7257450,BUY
01-10-20 11:57,11:57,14116225,21185800,7069575,BUY
01-10-20 11:58,11:58,14016850,21133400,7116550,BUY
01-10-20 11:59,11:59,14104125,21270675,7166550,BUY
01-10-20 12:00,12:00,14252400,21227475,6975075,BUY
01-10-20 12:01,12:01,14250850,21308525,7057675,BUY
01-10-20 12:02,12:02,14101750,21346800,7245050,BUY
01-10-20 12:03,12:03,14350600,21361825,7011225,BUY
01-10-20 12:04,12:04,14353800,20886075,6532275,BUY
01-10-20 12:05,12:05,14383325,21490650,7107325,BUY
01-10-20 12:06,12:06,14368875,21504125,7135250,BUY
01-10-20 12:07,12:07,14345475,21456300,7110825,BUY
01-10-20 12:08,12:08,14576075,21204400,6628325,BUY
01-10-20 12:09,12:09,14495350,21335450,6840100,BUY
01-10-20 12:10,12:10,14458450,21558025,7099575,BUY
01-10-20 12:11,12:11,14447825,21719100,7271275,BUY
01-10-20 12:12,12:12,14295425,21572750,7277325,BUY
01-10-20 12:13,12:13,14389500,20908850,6519350,BUY
01-10-20 12:14,12:14,14620250,21383200,6762950,BUY
01-10-20 12:15,12:15,14548075,21654100,7106025,BUY
01-10-20 12:16,12:16,14532600,20584475,6051875,BUY
01-10-20 12:17,12:17,14366975,21055250,6688275,BUY
01-10-20 12:18,12:18,14489400,22026725,7537325,BUY
01-10-20 12:19,12:19,14425875,21531875,7106000,BUY
01-10-20 12:20,12:20,14362325,21798450,7436125,BUY
01-10-20 12:21,12:21,14512150,22004175,7492025,BUY
01-10-20 12:22,12:22,14521525,22189150,7667625,BUY
01-10-20 12:23,12:23,14762325,22169025,7406700,BUY
01-10-20 12:24,12:24,14437500,22126150,7688650,BUY
01-10-20 12:25,12:25,14419425,22131900,7712475,BUY
01-10-20 12:26,12:26,14784675,22198925,7414250,BUY
01-10-20 12:27,12:27,14631875,22183975,7552100,BUY
01-10-20 12:28,12:28,14657575,21868000,7210425,BUY
01-10-20 12:29,12:29,14693925,21834250,7140325,BUY
01-10-20 12:30,12:30,14828075,22325650,7497575,BUY
01-10-20 12:31,12:31,14835275,22108175,7272900,BUY
01-10-20 12:32,12:32,14805325,22421950,7616625,BUY
01-10-20 12:33,12:33,14905175,22431900,7526725,BUY
01-10-20 12:34,12:34,14879200,22093800,7214600,BUY
01-10-20 12:35,12:35,15045100,22468625,7423525,BUY
01-10-20 12:36,12:36,15058775,21827575,6768800,BUY
01-10-20 12:37,12:37,14868900,22231925,7363025,BUY
01-10-20 12:38,12:38,15128375,22459100,7330725,BUY
01-10-20 12:39,12:39,15050200,22539950,7489750,BUY
01-10-20 12:40,12:40,14800725,22533425,7732700,BUY
01-10-20 12:41,12:41,14392525,22306525,7914000,BUY
01-10-20 12:42,12:42,14284225,22243700,7959475,BUY
01-10-20 12:43,12:43,14521225,22413525,7892300,BUY
01-10-20 12:44,12:44,14243375,22387800,8144425,BUY
01-10-20 12:45,12:45,14480400,21605225,7124825,BUY
01-10-20 12:46,12:46,14306850,22100325,7793475,BUY
01-10-20 12:47,12:47,14406575,22124900,7718325,BUY
01-10-20 12:48,12:48,14560975,22111450,7550475,BUY
01-10-20 12:49,12:49,14468400,22072350,7603950,BUY
01-10-20 12:50,12:50,14681575,22148875,7467300,BUY
01-10-20 12:51,12:51,14686900,22021550,7334650,BUY
01-10-20 12:52,12:52,14585850,22089400,7503550,BUY
01-10-20 12:53,12:53,14731975,21970525,7238550,BUY
01-10-20 12:54,12:54,14839850,22022975,7183125,BUY
01-10-20 12:55,12:55,14618850,21796450,7177600,BUY
01-10-20 12:56,12:56,14705000,22067375,7362375,BUY
01-10-20 12:57,12:57,14831225,21935475,7104250,BUY
01-10-20 12:58,12:58,14929075,21935475,7006400,BUY
01-10-20 12:59,12:59,14817050,21936250,7119200,BUY
01-10-20 13:00,13:00,15146975,21532725,6385750,BUY
01-10-20 13:01,13:01,15009175,21885775,6876600,BUY
01-10-20 13:02,13:02,14996925,21883475,6886550,BUY
01-10-20 13:03,13:03,15108125,21805700,6697575,BUY
01-10-20 13:04,13:04,15054475,21753875,6699400,BUY
01-10-20 13:05,13:05,15153175,21789975,6636800,BUY
01-10-20 13:06,13:06,15321125,21560175,6239050,BUY
01-10-20 13:07,13:07,15274775,21560175,6285400,BUY
01-10-20 13:08,13:08,14972350,21287400,6315050,BUY
01-10-20 13:09,13:09,15112050,21621025,6508975,BUY
01-10-20 13:10,13:10,15078500,21453125,6374625,BUY
01-10-20 13:11,13:11,15087100,21594775,6507675,BUY
01-10-20 13:12,13:12,15089950,21673825,6583875,BUY
01-10-20 13:13,13:13,15175850,21741500,6565650,BUY
01-10-20 13:14,13:14,15247075,21726725,6479650,BUY
01-10-20 13:15,13:15,15201625,21771300,6569675,BUY
01-10-20 13:16,13:16,15216725,21767875,6551150,BUY
01-10-20 13:17,13:17,15313825,21767875,6454050,BUY
01-10-20 13:18,13:18,15450800,21885100,6434300,BUY
01-10-20 13:19,13:19,15138500,21865825,6727325,BUY
01-10-20 13:20,13:20,15314725,21887400,6572675,BUY
01-10-20 13:21,13:21,15470725,21845700,6374975,BUY
01-10-20 13:22,13:22,15539175,21861900,6322725,BUY
01-10-20 13:23,13:23,15426325,21684925,6258600,BUY
01-10-20 13:24,13:24,15544450,21893750,6349300,BUY
01-10-20 13:25,13:25,15621850,21902925,6281075,BUY
01-10-20 13:26,13:26,15641475,21925850,6284375,BUY
01-10-20 13:27,13:27,15749525,21817825,6068300,BUY
01-10-20 13:28,13:28,15717475,21816000,6098525,BUY
01-10-20 13:29,13:29,15829700,21794775,5965075,BUY
01-10-20 13:30,13:30,15692825,21962725,6269900,BUY
01-10-20 13:31,13:31,15789825,21958825,6169000,BUY
01-10-20 13:32,13:32,15714500,21940625,6226125,BUY
01-10-20 13:33,13:33,15957275,22081725,6124450,BUY
01-10-20 13:34,13:34,16028225,22088875,6060650,BUY
01-10-20 13:35,13:35,15803925,22046825,6242900,BUY
01-10-20 13:36,13:36,15301625,21801375,6499750,BUY
01-10-20 13:37,13:37,15162925,21985100,6822175,BUY
01-10-20 13:38,13:38,15269825,21985100,6715275,BUY
01-10-20 13:39,13:39,15422050,22169950,6747900,BUY
01-10-20 13:40,13:40,15491125,21728550,6237425,BUY
01-10-20 13:41,13:41,15528950,21858550,6329600,BUY
01-10-20 13:42,13:42,15552475,21478075,5925600,BUY
01-10-20 13:43,13:43,15385325,22114525,6729200,BUY
01-10-20 13:44,13:44,15555525,22170025,6614500,BUY
01-10-20 13:45,13:45,15381975,22242050,6860075,BUY
01-10-20 13:46,13:46,15329100,22216500,6887400,BUY
01-10-20 13:47,13:47,15322625,22217850,6895225,BUY
01-10-20 13:48,13:48,15246100,22173550,6927450,BUY
01-10-20 13:49,13:49,15118125,21739925,6621800,BUY
01-10-20 13:50,13:50,15259225,21756150,6496925,BUY
01-10-20 13:51,13:51,15338125,22213225,6875100,BUY
01-10-20 13:52,13:52,15435875,21918600,6482725,BUY
01-10-20 13:53,13:53,15346675,22207850,6861175,BUY
01-10-20 13:54,13:54,15461775,21985050,6523275,BUY
01-10-20 13:55,13:55,15669150,22265025,6595875,BUY
01-10-20 13:56,13:56,15758250,22331875,6573625,BUY
01-10-20 13:57,13:57,15689775,22230125,6540350,BUY
01-10-20 13:58,13:58,15520000,22248100,6728100,BUY
01-10-20 13:59,13:59,15605725,22207975,6602250,BUY
01-10-20 14:00,14:00,15799000,22230775,6431775,BUY
01-10-20 14:01,14:01,15619600,21916250,6296650,BUY
01-10-20 14:02,14:02,15635100,22233475,6598375,BUY
01-10-20 14:03,14:03,14941625,22023700,7082075,BUY
01-10-20 14:04,14:04,14960150,22037800,7077650,BUY
01-10-20 14:05,14:05,14874750,22000375,7125625,BUY
01-10-20 14:06,14:06,15329200,22041475,6712275,BUY
01-10-20 14:07,14:07,15087825,22070575,6982750,BUY
01-10-20 14:08,14:08,15284775,21965850,6681075,BUY
01-10-20 14:09,14:09,15433175,22092050,6658875,BUY
01-10-20 14:10,14:10,15321025,21918950,6597925,BUY
01-10-20 14:11,14:11,15286100,22136750,6850650,BUY
01-10-20 14:12,14:12,15423175,21728950,6305775,BUY
01-10-20 14:13,14:13,15416425,22211725,6795300,BUY
01-10-20 14:14,14:14,15453575,21947450,6493875,BUY
01-10-20 14:15,14:15,13691975,21534150,7842175,BUY
01-10-20 14:16,14:16,13550250,21816900,8266650,BUY
01-10-20 14:17,14:17,13537300,21549950,8012650,BUY
01-10-20 14:18,14:18,12440425,21711225,9270800,BUY
01-10-20 14:19,14:19,12587525,21711275,9123750,BUY
01-10-20 14:20,14:20,12601900,21668450,9066550,BUY
01-10-20 14:21,14:21,12208825,21800075,9591250,BUY
01-10-20 14:22,14:22,12342575,21667175,9324600,BUY
01-10-20 14:23,14:23,12233950,21710875,9476925,BUY
01-10-20 14:24,14:24,12595925,21722625,9126700,BUY
01-10-20 14:25,14:25,12541250,21456125,8914875,BUY
01-10-20 14:26,14:26,12758475,21419300,8660825,BUY
01-10-20 14:27,14:27,12533375,20963775,8430400,BUY
01-10-20 14:28,14:28,12687250,21479825,8792575,BUY
01-10-20 14:29,14:29,12565350,21607950,9042600,BUY
01-10-20 14:30,14:30,12820525,21803525,8983000,BUY
01-10-20 14:31,14:31,12692675,21131700,8439025,BUY
01-10-20 14:32,14:32,12602350,21802300,9199950,BUY
01-10-20 14:33,14:33,12927850,21658150,8730300,BUY
01-10-20 14:34,14:34,12909300,21671775,8762475,BUY
01-10-20 14:35,14:35,12886550,21692375,8805825,BUY
01-10-20 14:36,14:36,13212225,21276450,8064225,BUY
01-10-20 14:37,14:37,13318400,21673900,8355500,BUY
01-10-20 14:38,14:38,13231825,21543400,8311575,BUY
01-10-20 14:39,14:39,13446550,21481375,8034825,BUY
01-10-20 14:40,14:40,13337250,21432275,8095025,BUY
01-10-20 14:41,14:41,13231575,21177350,7945775,BUY
01-10-20 14:42,14:42,13311700,21639000,8327300,BUY
01-10-20 14:43,14:43,13397500,21373275,7975775,BUY
01-10-20 14:44,14:44,13331525,21253450,7921925,BUY
01-10-20 14:45,14:45,13684275,21382150,7697875,BUY
01-10-20 14:46,14:46,13584775,21450125,7865350,BUY
01-10-20 14:47,14:47,13712925,21511975,7799050,BUY
01-10-20 14:48,14:48,13023125,20912800,7889675,BUY
01-10-20 14:49,14:49,13015775,21264525,8248750,BUY
01-10-20 14:50,14:50,13145225,20817375,7672150,BUY
01-10-20 14:51,14:51,13371850,21174250,7802400,BUY
01-10-20 14:52,14:52,13206150,21087075,7880925,BUY
01-10-20 14:53,14:53,13428500,21201025,7772525,BUY
01-10-20 14:54,14:54,13665700,20888200,7222500,BUY
01-10-20 14:55,14:55,13400775,20807800,7407025,BUY
01-10-20 14:56,14:56,13482150,20816225,7334075,BUY
01-10-20 14:57,14:57,13703525,20309075,6605550,BUY
01-10-20 14:58,14:58,13571075,20281625,6710550,BUY
01-10-20 14:59,14:59,13681450,20174525,6493075,BUY
01-10-20 15:00,15:00,13464725,20344750,6880025,BUY
01-10-20 15:01,15:01,13487900,20158100,6670200,BUY
01-10-20 15:02,15:02,13486625,20243725,6757100,BUY
01-10-20 15:03,15:03,13478175,19535900,6057725,BUY
01-10-20 15:04,15:04,13500275,19577950,6077675,BUY
01-10-20 15:05,15:05,13563675,19755125,6191450,BUY
01-10-20 15:06,15:06,13630100,19157725,5527625,BUY
01-10-20 15:07,15:07,13505775,19327325,5821550,BUY
01-10-20 15:08,15:08,13521175,18985375,5464200,BUY
01-10-20 15:09,15:09,13112250,18873575,5761325,BUY
01-10-20 15:10,15:10,12943975,18845650,5901675,BUY
01-10-20 15:11,15:11,13004475,18847475,5843000,BUY
01-10-20 15:12,15:12,12250900,17991550,5740650,BUY
01-10-20 15:13,15:13,12354500,17713975,5359475,BUY
01-10-20 15:14,15:14,12371925,18026125,5654200,BUY
01-10-20 15:15,15:15,12125550,17097825,4972275,BUY
01-10-20 15:16,15:16,12034825,17140500,5105675,BUY
01-10-20 15:17,15:17,12080075,17222475,5142400,BUY
01-10-20 15:18,15:18,11682425,16301350,4618925,BUY
01-10-20 15:19,15:19,11677050,16025650,4348600,BUY
01-10-20 15:20,15:20,11507750,15813575,4305825,BUY
01-10-20 15:21,15:21,10818375,15171775,4353400,BUY
01-10-20 15:22,15:22,10604475,15024850,4420375,BUY
01-10-20 15:23,15:23,10588950,15117075,4528125,BUY
01-10-20 15:24,15:24,9485625,13671775,4186150,BUY
01-10-20 15:25,15:25,9771450,14213175,4441725,BUY
01-10-20 15:26,15:26,9593925,14027475,4433550,BUY
01-10-20 15:27,15:27,7749500,12736225,4986725,BUY
01-10-20 15:28,15:28,7880400,12882900,5002500,BUY
01-10-20 15:29,15:29,7885475,12596575,4711100,BUY
05-10-20 9:15,9:15,3080725,3706125,625400,BUY
05-10-20 9:16,9:16,3088800,3703000,614200,BUY
05-10-20 9:17,9:17,3470425,3999675,529250,BUY
05-10-20 9:18,9:18,3464675,4002925,538250,BUY
05-10-20 9:19,9:19,3479175,4003100,523925,BUY
05-10-20 9:20,9:20,3971350,4312775,341425,BUY
05-10-20 9:21,9:21,3959325,4317025,357700,BUY
05-10-20 9:22,9:22,3974550,4316075,341525,BUY
05-10-20 9:23,9:23,4127650,4667825,540175,BUY
05-10-20 9:24,9:24,4133800,4675025,541225,BUY
05-10-20 9:25,9:25,4072925,4675975,603050,BUY
05-10-20 9:26,9:26,4311950,4913025,601075,BUY
05-10-20 9:27,9:27,4322750,4917800,595050,BUY
05-10-20 9:28,9:28,4263500,4916775,653275,BUY
05-10-20 9:29,9:29,4490775,5050250,559475,BUY
05-10-20 9:30,9:30,4495775,5055175,559400,BUY
05-10-20 9:31,9:31,4490775,5052350,561575,BUY
05-10-20 9:32,9:32,4620875,5208725,587850,BUY
05-10-20 9:33,9:33,4629425,5208725,579300,BUY
05-10-20 9:34,9:34,4620875,5207850,586975,BUY
05-10-20 9:35,9:35,4643950,5368550,724600,BUY
05-10-20 9:36,9:36,4643950,5367600,723650,BUY
05-10-20 9:37,9:37,4617125,5347450,730325,BUY
05-10-20 9:38,9:38,4716175,5434125,717950,BUY
05-10-20 9:39,9:39,4729825,5429475,699650,BUY
05-10-20 9:40,9:40,4719650,5428525,708875,BUY
05-10-20 9:41,9:41,4735900,5562875,826975,BUY
05-10-20 9:42,9:42,4741950,5565350,823400,BUY
05-10-20 9:43,9:43,4707225,5573525,866300,BUY
05-10-20 9:44,9:44,4790175,5669400,879225,BUY
05-10-20 9:45,9:45,4812200,5670175,857975,BUY
05-10-20 9:46,9:46,4824100,5665150,841050,BUY
05-10-20 9:47,9:47,4856125,5709000,852875,BUY
05-10-20 9:48,9:48,4838025,5685325,847300,BUY
05-10-20 9:49,9:49,4856125,5729725,873600,BUY
05-10-20 9:50,9:50,4974775,5822875,848100,BUY
05-10-20 9:51,9:51,4974500,5866150,891650,BUY
05-10-20 9:52,9:52,4893025,5866150,973125,BUY
05-10-20 9:53,9:53,5002250,5890575,888325,BUY
05-10-20 9:54,9:54,4934525,5884100,949575,BUY
05-10-20 9:55,9:55,4936300,5829775,893475,BUY
05-10-20 9:56,9:56,4947200,5909925,962725,BUY
05-10-20 9:57,9:57,4883550,5900650,1017100,BUY
05-10-20 9:58,9:58,4892750,5901975,1009225,BUY
05-10-20 9:59,9:59,4964525,5954700,990175,BUY
05-10-20 10:00,10:00,4952325,5942150,989825,BUY
05-10-20 10:01,10:01,5052650,5956925,904275,BUY
05-10-20 10:02,10:02,5077200,6033100,955900,BUY
05-10-20 10:03,10:03,5054900,6021450,966550,BUY
05-10-20 10:04,10:04,5086625,6027600,940975,BUY
05-10-20 10:05,10:05,5094550,6121175,1026625,BUY
05-10-20 10:06,10:06,5097550,6096350,998800,BUY
05-10-20 10:07,10:07,5110850,6119450,1008600,BUY
05-10-20 10:08,10:08,5142025,6188625,1046600,BUY
05-10-20 10:09,10:09,5107900,6190100,1082200,BUY
05-10-20 10:10,10:10,5183150,6173250,990100,BUY
05-10-20 10:11,10:11,5198350,6243475,1045125,BUY
05-10-20 10:12,10:12,5197400,6243475,1046075,BUY
05-10-20 10:13,10:13,5210675,6230225,1019550,BUY
05-10-20 10:14,10:14,5251800,6301875,1050075,BUY
05-10-20 10:15,10:15,5228600,6307900,1079300,BUY
05-10-20 10:16,10:16,5320575,6296225,975650,BUY
05-10-20 10:17,10:17,5336650,6380975,1044325,BUY
05-10-20 10:18,10:18,5258025,6385375,1127350,BUY
05-10-20 10:19,10:19,5305275,6382450,1077175,BUY
05-10-20 10:20,10:20,5338425,6401925,1063500,BUY
05-10-20 10:21,10:21,5349175,6392525,1043350,BUY
05-10-20 10:22,10:22,5406850,6433725,1026875,BUY
05-10-20 10:23,10:23,5388375,6397725,1009350,BUY
05-10-20 10:24,10:24,5323250,6402375,1079125,BUY
05-10-20 10:25,10:25,5351325,6395450,1044125,BUY
05-10-20 10:26,10:26,5440675,6460250,1019575,BUY
05-10-20 10:27,10:27,5387375,6481600,1094225,BUY
05-10-20 10:28,10:28,5431050,6459225,1028175,BUY
05-10-20 10:29,10:29,5420050,6432925,1012875,BUY
05-10-20 10:30,10:30,5447075,6527650,1080575,BUY
05-10-20 10:31,10:31,5452975,6531825,1078850,BUY
05-10-20 10:32,10:32,5417025,6532000,1114975,BUY
05-10-20 10:33,10:33,5402700,6499425,1096725,BUY
05-10-20 10:34,10:34,5422850,6532000,1109150,BUY
05-10-20 10:35,10:35,5509050,6535000,1025950,BUY
05-10-20 10:36,10:36,5498800,6520600,1021800,BUY
05-10-20 10:37,10:37,5435800,6528800,1093000,BUY
05-10-20 10:38,10:38,5507425,6548150,1040725,BUY
05-10-20 10:39,10:39,5471625,6541675,1070050,BUY
05-10-20 10:40,10:40,5408900,6541025,1132125,BUY
05-10-20 10:41,10:41,5509025,6612625,1103600,BUY
05-10-20 10:42,10:42,5357850,6609450,1251600,BUY
05-10-20 10:43,10:43,5454825,6594725,1139900,BUY
05-10-20 10:44,10:44,5491175,6589300,1098125,BUY
05-10-20 10:45,10:45,5564500,6665400,1100900,BUY
05-10-20 10:46,10:46,5454375,6606575,1152200,BUY
05-10-20 10:47,10:47,5465250,6630300,1165050,BUY
05-10-20 10:48,10:48,5523000,6669075,1146075,BUY
05-10-20 10:49,10:49,5551500,6628850,1077350,BUY
05-10-20 10:50,10:50,5529000,6709650,1180650,BUY
05-10-20 10:51,10:51,5464350,6712500,1248150,BUY
05-10-20 10:52,10:52,5455225,6700475,1245250,BUY
05-10-20 10:53,10:53,5489550,6736575,1247025,BUY
05-10-20 10:54,10:54,5600650,6743675,1143025,BUY
05-10-20 10:55,10:55,5453300,6699925,1246625,BUY
05-10-20 10:56,10:56,5517650,6736250,1218600,BUY
05-10-20 10:57,10:57,5623350,6757300,1133950,BUY
05-10-20 10:58,10:58,5658000,6732750,1074750,BUY
05-10-20 10:59,10:59,5628525,6815400,1186875,BUY
05-10-20 11:00,11:00,5501775,6804050,1302275,BUY
05-10-20 11:01,11:01,5674850,6813000,1138150,BUY
05-10-20 11:02,11:02,5653000,6855100,1202100,BUY
05-10-20 11:03,11:03,5645650,6864975,1219325,BUY
05-10-20 11:04,11:04,5692725,6847650,1154925,BUY
05-10-20 11:05,11:05,5743525,7008050,1264525,BUY
05-10-20 11:06,11:06,5804700,7013950,1209250,BUY
05-10-20 11:07,11:07,5721825,7006025,1284200,BUY
05-10-20 11:08,11:08,5689750,7096475,1406725,BUY
05-10-20 11:09,11:09,5736975,7094075,1357100,BUY
05-10-20 11:10,11:10,5691425,7097300,1405875,BUY
05-10-20 11:11,11:11,5768050,7127650,1359600,BUY
05-10-20 11:12,11:12,5685300,7128650,1443350,BUY
05-10-20 11:13,11:13,5648375,7128650,1480275,BUY
05-10-20 11:14,11:14,5638400,7142325,1503925,BUY
05-10-20 11:15,11:15,5689525,7160575,1471050,BUY
05-10-20 11:16,11:16,5701025,7180575,1479550,BUY
05-10-20 11:17,11:17,5759900,7230650,1470750,BUY
05-10-20 11:18,11:18,5652050,7229125,1577075,BUY
05-10-20 11:19,11:19,5719425,7222150,1502725,BUY
05-10-20 11:20,11:20,5619125,7284575,1665450,BUY
05-10-20 11:21,11:21,5738075,7290075,1552000,BUY
05-10-20 11:22,11:22,5470625,7287300,1816675,BUY
05-10-20 11:23,11:23,5726525,7301675,1575150,BUY
05-10-20 11:24,11:24,5760250,7332575,1572325,BUY
05-10-20 11:25,11:25,5709875,7330100,1620225,BUY
05-10-20 11:26,11:26,5802575,7356275,1553700,BUY
05-10-20 11:27,11:27,5765725,7330350,1564625,BUY
05-10-20 11:28,11:28,5836625,7384325,1547700,BUY
05-10-20 11:29,11:29,5788300,7327475,1539175,BUY
05-10-20 11:30,11:30,5785500,7333975,1548475,BUY
05-10-20 11:31,11:31,5757900,7324700,1566800,BUY
05-10-20 11:32,11:32,5754450,7353250,1598800,BUY
05-10-20 11:33,11:33,5793925,7383025,1589100,BUY
05-10-20 11:34,11:34,5776575,7375925,1599350,BUY
05-10-20 11:35,11:35,5785925,7384950,1599025,BUY
05-10-20 11:36,11:36,5835175,7387050,1551875,BUY
05-10-20 11:37,11:37,5746525,7382600,1636075,BUY
05-10-20 11:38,11:38,5906350,7417975,1511625,BUY
05-10-20 11:39,11:39,5963875,7431250,1467375,BUY
05-10-20 11:40,11:40,5951925,7436875,1484950,BUY
05-10-20 11:41,11:41,5782125,7092475,1310350,BUY
05-10-20 11:42,11:42,5747800,7092475,1344675,BUY
05-10-20 11:43,11:43,5784675,7083525,1298850,BUY
05-10-20 11:44,11:44,5845375,7154450,1309075,BUY
05-10-20 11:45,11:45,5853600,7137425,1283825,BUY
05-10-20 11:46,11:46,5875575,7153925,1278350,BUY
05-10-20 11:47,11:47,5935925,7169675,1233750,BUY
05-10-20 11:48,11:48,5981025,7190825,1209800,BUY
05-10-20 11:49,11:49,5972250,7187900,1215650,BUY
05-10-20 11:50,11:50,6049675,7210650,1160975,BUY
05-10-20 11:51,11:51,6029725,7214775,1185050,BUY
05-10-20 11:52,11:52,6045200,7173675,1128475,BUY
05-10-20 11:53,11:53,5994050,7151000,1156950,BUY
05-10-20 11:54,11:54,5975825,7197575,1221750,BUY
05-10-20 11:55,11:55,5976450,7202125,1225675,BUY
05-10-20 11:56,11:56,6049800,7225400,1175600,BUY
05-10-20 11:57,11:57,6118650,7222600,1103950,BUY
05-10-20 11:58,11:58,6068075,7211250,1143175,BUY
05-10-20 11:59,11:59,6166175,7173800,1007625,BUY
05-10-20 12:00,12:00,6040550,7117850,1077300,BUY
05-10-20 12:01,12:01,6080525,7156225,1075700,BUY
05-10-20 12:02,12:02,6232175,7165550,933375,BUY
05-10-20 12:03,12:03,6214875,7148325,933450,BUY
05-10-20 12:04,12:04,6232000,7162750,930750,BUY
05-10-20 12:05,12:05,6085350,7152600,1067250,BUY
05-10-20 12:06,12:06,6199550,7171150,971600,BUY
05-10-20 12:07,12:07,6331375,7180650,849275,BUY
05-10-20 12:08,12:08,6269950,7151275,881325,BUY
05-10-20 12:09,12:09,6239450,7158225,918775,BUY
05-10-20 12:10,12:10,6238350,7198425,960075,BUY
05-10-20 12:11,12:11,6165650,7216850,1051200,BUY
05-10-20 12:12,12:12,6297575,7231075,933500,BUY
05-10-20 12:13,12:13,6180825,7209200,1028375,BUY
05-10-20 12:14,12:14,6250075,7229875,979800,BUY
05-10-20 12:15,12:15,6192425,7156675,964250,BUY
05-10-20 12:16,12:16,6314275,7207975,893700,BUY
05-10-20 12:17,12:17,6342700,7246550,903850,BUY
05-10-20 12:18,12:18,6361600,7170275,808675,BUY
05-10-20 12:19,12:19,6179550,7161250,981700,BUY
05-10-20 12:20,12:20,6317625,7182825,865200,BUY
05-10-20 12:21,12:21,6272050,7258300,986250,BUY
05-10-20 12:22,12:22,6191875,6896400,704525,BUY
05-10-20 12:23,12:23,6252025,7260450,1008425,BUY
05-10-20 12:24,12:24,6394325,7264300,869975,BUY
05-10-20 12:25,12:25,6385300,7229525,844225,BUY
05-10-20 12:26,12:26,6396550,7287000,890450,BUY
05-10-20 12:27,12:27,6267975,7263200,995225,BUY
05-10-20 12:28,12:28,6323400,7287250,963850,BUY
05-10-20 12:29,12:29,6298475,7316550,1018075,BUY
05-10-20 12:30,12:30,6435725,7322550,886825,BUY
05-10-20 12:31,12:31,6442475,7316000,873525,BUY
05-10-20 12:32,12:32,6427500,7245950,818450,BUY
05-10-20 12:33,12:33,6336875,7240975,904100,BUY
05-10-20 12:34,12:34,6349525,7210075,860550,BUY
05-10-20 12:35,12:35,6421600,7347675,926075,BUY
05-10-20 12:36,12:36,6437500,7356500,919000,BUY
05-10-20 12:37,12:37,6411350,7359150,947800,BUY
05-10-20 12:38,12:38,6455400,7375350,919950,BUY
05-10-20 12:39,12:39,6438700,7379400,940700,BUY
05-10-20 12:40,12:40,6460775,7359550,898775,BUY
05-10-20 12:41,12:41,6457100,7331775,874675,BUY
05-10-20 12:42,12:42,6571000,7359750,788750,BUY
05-10-20 12:43,12:43,6528275,7364300,836025,BUY
05-10-20 12:44,12:44,6545600,7336200,790600,BUY
05-10-20 12:45,12:45,6494450,7307925,813475,BUY
05-10-20 12:46,12:46,6544700,7322925,778225,BUY
05-10-20 12:47,12:47,6518750,7213225,694475,BUY
05-10-20 12:48,12:48,6492400,7249175,756775,BUY
05-10-20 12:49,12:49,6458975,7330550,871575,BUY
05-10-20 12:50,12:50,6547675,7369025,821350,BUY
05-10-20 12:51,12:51,6608925,7376500,767575,BUY
05-10-20 12:52,12:52,6549675,7248675,699000,BUY
05-10-20 12:53,12:53,6563975,7376675,812700,BUY
05-10-20 12:54,12:54,6385525,7301425,915900,BUY
05-10-20 12:55,12:55,6568500,7372175,803675,BUY
05-10-20 12:56,12:56,6622525,7278900,656375,BUY
05-10-20 12:57,12:57,6605500,7368625,763125,BUY
05-10-20 12:58,12:58,6656100,7413875,757775,BUY
05-10-20 12:59,12:59,6688000,7295575,607575,BUY
05-10-20 13:00,13:00,6674850,7295000,620150,BUY
05-10-20 13:01,13:01,6666950,7284225,617275,BUY
05-10-20 13:02,13:02,6589675,7208825,619150,BUY
05-10-20 13:03,13:03,6646600,7208875,562275,BUY
05-10-20 13:04,13:04,6571700,7119425,547725,BUY
05-10-20 13:05,13:05,6719575,7233300,513725,BUY
05-10-20 13:06,13:06,6589875,7220625,630750,BUY
05-10-20 13:07,13:07,6715250,7234525,519275,BUY
05-10-20 13:08,13:08,6730100,7206050,475950,BUY
05-10-20 13:09,13:09,6694150,7196600,502450,BUY
05-10-20 13:10,13:10,6614825,7190450,575625,BUY
05-10-20 13:11,13:11,6638300,7141225,502925,BUY
05-10-20 13:12,13:12,6833300,7228875,395575,BUY
05-10-20 13:13,13:13,6789750,7226450,436700,BUY
05-10-20 13:14,13:14,6735925,7186325,450400,BUY
05-10-20 13:15,13:15,6732225,7006075,273850,BUY
05-10-20 13:16,13:16,6692175,6990925,298750,BUY
05-10-20 13:17,13:17,6713725,7005800,292075,BUY
05-10-20 13:18,13:18,6681750,7033825,352075,BUY
05-10-20 13:19,13:19,6764875,7019225,254350,BUY
05-10-20 13:20,13:20,6779550,7044975,265425,BUY
05-10-20 13:21,13:21,6747200,6865125,117925,BUY
05-10-20 13:22,13:22,6725975,6865125,139150,BUY
05-10-20 13:23,13:23,6772500,6874900,102400,BUY
05-10-20 13:24,13:24,6804375,6835550,31175,BUY
05-10-20 13:25,13:25,6750125,6828200,78075,BUY
05-10-20 13:26,13:26,6812175,6828200,16025,BUY
05-10-20 13:27,13:27,6839300,6740275,-99025,SELL
05-10-20 13:28,13:28,6821025,6728325,-92700,SELL
05-10-20 13:29,13:29,6792550,6742700,-49850,SELL
05-10-20 13:30,13:30,6845900,6674275,-171625,SELL
05-10-20 13:31,13:31,6860375,6671550,-188825,SELL
05-10-20 13:32,13:32,6839075,6695600,-143475,SELL
05-10-20 13:33,13:33,7022425,6739725,-282700,SELL
05-10-20 13:34,13:34,7025975,6735000,-290975,SELL
05-10-20 13:35,13:35,6989725,6739725,-250000,SELL
05-10-20 13:36,13:36,7069500,6775175,-294325,SELL
05-10-20 13:37,13:37,7061275,6762800,-298475,SELL
05-10-20 13:38,13:38,7070600,6757475,-313125,SELL
05-10-20 13:39,13:39,7121050,6690200,-430850,SELL
05-10-20 13:40,13:40,7174950,6789100,-385850,SELL
05-10-20 13:41,13:41,7188550,6783625,-404925,SELL
05-10-20 13:42,13:42,7144750,6768100,-376650,SELL
05-10-20 13:43,13:43,7134750,6765675,-369075,SELL
05-10-20 13:44,13:44,7197575,6768125,-429450,SELL
05-10-20 13:45,13:45,7258325,6810925,-447400,SELL
05-10-20 13:46,13:46,7217150,6801300,-415850,SELL
05-10-20 13:47,13:47,7213200,6778025,-435175,SELL
05-10-20 13:48,13:48,7293575,6822875,-470700,SELL
05-10-20 13:49,13:49,7294125,6842575,-451550,SELL
05-10-20 13:50,13:50,7243100,6847775,-395325,SELL
05-10-20 13:51,13:51,7286600,6822500,-464100,SELL
05-10-20 13:52,13:52,7286600,6798625,-487975,SELL
05-10-20 13:53,13:53,7254775,6828125,-426650,SELL
05-10-20 13:54,13:54,7305975,6838450,-467525,SELL
05-10-20 13:55,13:55,7304525,6864950,-439575,SELL
05-10-20 13:56,13:56,7323100,6864950,-458150,SELL
05-10-20 13:57,13:57,7115600,6899675,-215925,SELL
05-10-20 13:58,13:58,7253225,6890300,-362925,SELL
05-10-20 13:59,13:59,7218850,6898825,-320025,SELL
05-10-20 14:00,14:00,7323775,6915200,-408575,SELL
05-10-20 14:01,14:01,7284825,6912800,-372025,SELL
05-10-20 14:02,14:02,7311675,6898550,-413125,SELL
05-10-20 14:03,14:03,7374475,6939925,-434550,SELL
05-10-20 14:04,14:04,7344400,6925675,-418725,SELL
05-10-20 14:05,14:05,7337850,6892225,-445625,SELL
05-10-20 14:06,14:06,7358225,6991525,-366700,SELL
05-10-20 14:07,14:07,7404725,6993950,-410775,SELL
05-10-20 14:08,14:08,7332075,6994200,-337875,SELL
05-10-20 14:09,14:09,7292625,6945675,-346950,SELL
05-10-20 14:10,14:10,7226100,6870075,-356025,SELL
05-10-20 14:11,14:11,7292625,6920150,-372475,SELL
05-10-20 14:12,14:12,7357475,6949225,-408250,SELL
05-10-20 14:13,14:13,7300975,6949425,-351550,SELL
05-10-20 14:14,14:14,7202475,6945850,-256625,SELL
05-10-20 14:15,14:15,7381850,6995350,-386500,SELL
05-10-20 14:16,14:16,7355175,6991000,-364175,SELL
05-10-20 14:17,14:17,7298825,6979950,-318875,SELL
05-10-20 14:18,14:18,7314900,6973700,-341200,SELL
05-10-20 14:19,14:19,7331300,6964300,-367000,SELL
05-10-20 14:20,14:20,7375600,6976225,-399375,SELL
05-10-20 14:21,14:21,7321050,6915350,-405700,SELL
05-10-20 14:22,14:22,7296125,6911475,-384650,SELL
05-10-20 14:23,14:23,7340150,6913525,-426625,SELL
05-10-20 14:24,14:24,7345675,6973150,-372525,SELL
05-10-20 14:25,14:25,7368625,6979550,-389075,SELL
05-10-20 14:26,14:26,7344175,6957275,-386900,SELL
05-10-20 14:27,14:27,7464450,6973775,-490675,SELL
05-10-20 14:28,14:28,7472400,6985675,-486725,SELL
05-10-20 14:29,14:29,7455425,6977425,-478000,SELL
05-10-20 14:30,14:30,7487250,6867525,-619725,SELL
05-10-20 14:31,14:31,7426675,6882400,-544275,SELL
05-10-20 14:32,14:32,7288250,6872475,-415775,SELL
05-10-20 14:33,14:33,7519150,6927300,-591850,SELL
05-10-20 14:34,14:34,7464975,6921425,-543550,SELL
05-10-20 14:35,14:35,7471950,6889650,-582300,SELL
05-10-20 14:36,14:36,7419075,6875525,-543550,SELL
05-10-20 14:37,14:37,7505525,6925425,-580100,SELL
05-10-20 14:38,14:38,7483450,6910950,-572500,SELL
05-10-20 14:39,14:39,7459575,6910525,-549050,SELL
05-10-20 14:40,14:40,7544750,6910525,-634225,SELL
05-10-20 14:41,14:41,7465725,6910525,-555200,SELL
05-10-20 14:42,14:42,7491325,6886400,-604925,SELL
05-10-20 14:43,14:43,7348875,6821500,-527375,SELL
05-10-20 14:44,14:44,7444550,6869250,-575300,SELL
05-10-20 14:45,14:45,7564575,6875800,-688775,SELL
05-10-20 14:46,14:46,7592175,6886375,-705800,SELL
05-10-20 14:47,14:47,7560650,6854950,-705700,SELL
05-10-20 14:48,14:48,7394375,6783475,-610900,SELL
05-10-20 14:49,14:49,7428400,6858975,-569425,SELL
05-10-20 14:50,14:50,7476025,6864625,-611400,SELL
05-10-20 14:51,14:51,7370625,6864225,-506400,SELL
05-10-20 14:52,14:52,7473450,6875225,-598225,SELL
05-10-20 14:53,14:53,7439100,6873125,-565975,SELL
05-10-20 14:54,14:54,7426350,6780750,-645600,SELL
05-10-20 14:55,14:55,7424875,6728475,-696400,SELL
05-10-20 14:56,14:56,7339875,6764000,-575875,SELL
05-10-20 14:57,14:57,7378350,6771400,-606950,SELL
05-10-20 14:58,14:58,7411525,6780350,-631175,SELL
05-10-20 14:59,14:59,7426100,6768225,-657875,SELL
05-10-20 15:00,15:00,7378350,6698075,-680275,SELL
05-10-20 15:01,15:01,7404300,6717850,-686450,SELL
05-10-20 15:02,15:02,7341800,6730875,-610925,SELL
05-10-20 15:03,15:03,7337175,6732850,-604325,SELL
05-10-20 15:04,15:04,7327650,6723450,-604200,SELL
05-10-20 15:05,15:05,7352250,6729475,-622775,SELL
05-10-20 15:06,15:06,7142325,6625625,-516700,SELL
05-10-20 15:07,15:07,7174100,6567775,-606325,SELL
05-10-20 15:08,15:08,7203925,6608500,-595425,SELL
05-10-20 15:09,15:09,7206150,6619375,-586775,SELL
05-10-20 15:10,15:10,7238625,6609000,-629625,SELL
05-10-20 15:11,15:11,7216800,6622850,-593950,SELL
05-10-20 15:12,15:12,7186325,6520825,-665500,SELL
05-10-20 15:13,15:13,7170900,6535325,-635575,SELL
05-10-20 15:14,15:14,7196950,6551975,-644975,SELL
05-10-20 15:15,15:15,7117950,6499075,-618875,SELL
05-10-20 15:16,15:16,6987875,6480475,-507400,SELL
05-10-20 15:17,15:17,7132375,6488850,-643525,SELL
05-10-20 15:18,15:18,7003225,6379725,-623500,SELL
05-10-20 15:19,15:19,7073550,6384300,-689250,SELL
05-10-20 15:20,15:20,7081175,6409350,-671825,SELL
05-10-20 15:21,15:21,6881075,6261850,-619225,SELL
05-10-20 15:22,15:22,6872875,6249425,-623450,SELL
05-10-20 15:23,15:23,6872875,6258225,-614650,SELL
05-10-20 15:24,15:24,6751875,6147025,-604850,SELL
05-10-20 15:25,15:25,6797825,6176900,-620925,SELL
05-10-20 15:26,15:26,6771100,6144675,-626425,SELL
05-10-20 15:27,15:27,6579800,6048075,-531725,SELL
05-10-20 15:28,15:28,6560625,6026725,-533900,SELL
05-10-20 15:29,15:29,6597750,6048075,-549675,SELL
06-10-20 9:15,9:15,6314400,5740175,-574225,SELL
06-10-20 9:16,9:16,6268750,5740000,-528750,SELL
06-10-20 9:17,9:17,6473925,5902900,-571025,SELL
06-10-20 9:18,9:18,6450625,5902425,-548200,SELL
06-10-20 9:19,9:19,6455200,5908400,-546800,SELL
06-10-20 9:20,9:20,6905000,6628300,-276700,SELL
06-10-20 9:21,9:21,6902300,6628300,-274000,SELL
06-10-20 9:22,9:22,6894550,6632225,-262325,SELL
06-10-20 9:23,9:23,7187100,7119625,-67475,SELL
06-10-20 9:24,9:24,7172425,7125850,-46575,SELL
06-10-20 9:25,9:25,7171800,7122875,-48925,SELL
06-10-20 9:26,9:26,7393250,6998400,-394850,SELL
06-10-20 9:27,9:27,7344125,7022075,-322050,SELL
06-10-20 9:28,9:28,7423250,7024525,-398725,SELL
06-10-20 9:29,9:29,7527875,7155200,-372675,SELL
06-10-20 9:30,9:30,7556275,7185250,-371025,SELL
06-10-20 9:31,9:31,7526575,7155200,-371375,SELL
06-10-20 9:32,9:32,7608375,7314150,-294225,SELL
06-10-20 9:33,9:33,7622675,7320775,-301900,SELL
06-10-20 9:34,9:34,7617600,7324475,-293125,SELL
06-10-20 9:35,9:35,7752075,7376225,-375850,SELL
06-10-20 9:36,9:36,7752125,7389150,-362975,SELL
06-10-20 9:37,9:37,7722950,7357825,-365125,SELL
06-10-20 9:38,9:38,7840675,7459200,-381475,SELL
06-10-20 9:39,9:39,7797150,7360750,-436400,SELL
06-10-20 9:40,9:40,7824250,7440775,-383475,SELL
06-10-20 9:41,9:41,7921300,7447175,-474125,SELL
06-10-20 9:42,9:42,7920050,7456250,-463800,SELL
06-10-20 9:43,9:43,7937250,7449075,-488175,SELL
06-10-20 9:44,9:44,7904075,7529675,-374400,SELL
06-10-20 9:45,9:45,7911775,7516700,-395075,SELL
06-10-20 9:46,9:46,8027000,7518325,-508675,SELL
06-10-20 9:47,9:47,8024900,7613125,-411775,SELL
06-10-20 9:48,9:48,8079075,7629875,-449200,SELL
06-10-20 9:49,9:49,8031100,7552000,-479100,SELL
06-10-20 9:50,9:50,8094750,7550425,-544325,SELL
06-10-20 9:51,9:51,8081900,7566125,-515775,SELL
06-10-20 9:52,9:52,8002250,7496750,-505500,SELL
06-10-20 9:53,9:53,8136200,7709150,-427050,SELL
06-10-20 9:54,9:54,8088700,7688475,-400225,SELL
06-10-20 9:55,9:55,8145100,7721775,-423325,SELL
06-10-20 9:56,9:56,8275725,7811325,-464400,SELL
06-10-20 9:57,9:57,8301800,7824400,-477400,SELL
06-10-20 9:58,9:58,8275725,7839375,-436350,SELL
06-10-20 9:59,9:59,8352900,7892750,-460150,SELL
06-10-20 10:00,10:00,8353825,7912675,-441150,SELL
06-10-20 10:01,10:01,8279850,7902750,-377100,SELL
06-10-20 10:02,10:02,8328550,7970725,-357825,SELL
06-10-20 10:03,10:03,8329800,7953825,-375975,SELL
06-10-20 10:04,10:04,8336250,7962650,-373600,SELL
06-10-20 10:05,10:05,8265150,7931600,-333550,SELL
06-10-20 10:06,10:06,8272450,7906825,-365625,SELL
06-10-20 10:07,10:07,8297200,7858350,-438850,SELL
06-10-20 10:08,10:08,8321000,7989625,-331375,SELL
06-10-20 10:09,10:09,8321000,7970325,-350675,SELL
06-10-20 10:10,10:10,8384725,8001575,-383150,SELL
06-10-20 10:11,10:11,8362075,7996000,-366075,SELL
06-10-20 10:12,10:12,8341200,7993175,-348025,SELL
06-10-20 10:13,10:13,8275250,7947350,-327900,SELL
06-10-20 10:14,10:14,8368250,8030300,-337950,SELL
06-10-20 10:15,10:15,8385375,8055075,-330300,SELL
06-10-20 10:16,10:16,8338150,8051000,-287150,SELL
06-10-20 10:17,10:17,8318600,8016300,-302300,SELL
06-10-20 10:18,10:18,8343575,8054775,-288800,SELL
06-10-20 10:19,10:19,8380650,8070075,-310575,SELL
06-10-20 10:20,10:20,8411425,8116375,-295050,SELL
06-10-20 10:21,10:21,8442975,8074850,-368125,SELL
06-10-20 10:22,10:22,8344500,8067400,-277100,SELL
06-10-20 10:23,10:23,8386225,8083700,-302525,SELL
06-10-20 10:24,10:24,8477225,8108800,-368425,SELL
06-10-20 10:25,10:25,8431375,8105100,-326275,SELL
06-10-20 10:26,10:26,8330100,8133150,-196950,SELL
06-10-20 10:27,10:27,8396125,8107500,-288625,SELL
06-10-20 10:28,10:28,8264950,8059200,-205750,SELL
06-10-20 10:29,10:29,8334800,8118625,-216175,SELL
06-10-20 10:30,10:30,8473500,8186525,-286975,SELL
06-10-20 10:31,10:31,8428150,8171350,-256800,SELL
06-10-20 10:32,10:32,8458825,8160075,-298750,SELL
06-10-20 10:33,10:33,8458675,8214875,-243800,SELL
06-10-20 10:34,10:34,8429575,8163875,-265700,SELL
06-10-20 10:35,10:35,8358525,8202000,-156525,SELL
06-10-20 10:36,10:36,8378225,8195700,-182525,SELL
06-10-20 10:37,10:37,8378225,8054425,-323800,SELL
06-10-20 10:38,10:38,8405325,8115025,-290300,SELL
06-10-20 10:39,10:39,8343700,8208600,-135100,SELL
06-10-20 10:40,10:40,8467750,8099525,-368225,SELL
06-10-20 10:41,10:41,8413075,8261600,-151475,SELL
06-10-20 10:42,10:42,8470050,8240175,-229875,SELL
06-10-20 10:43,10:43,8494150,8250900,-243250,SELL
06-10-20 10:44,10:44,8520525,8305050,-215475,SELL
06-10-20 10:45,10:45,8535300,8324700,-210600,SELL
06-10-20 10:46,10:46,8514975,8305075,-209900,SELL
06-10-20 10:47,10:47,8381900,8339175,-42725,SELL
06-10-20 10:48,10:48,8427725,8385350,-42375,SELL
06-10-20 10:49,10:49,8344400,8352725,8325,BUY
06-10-20 10:50,10:50,8445850,8418125,-27725,SELL
06-10-20 10:51,10:51,8429650,8419875,-9775,SELL
06-10-20 10:52,10:52,8307975,8419475,111500,BUY
06-10-20 10:53,10:53,8471675,8388125,-83550,SELL
06-10-20 10:54,10:54,8381900,8353650,-28250,SELL
06-10-20 10:55,10:55,8411875,8350850,-61025,SELL
06-10-20 10:56,10:56,8538900,8387050,-151850,SELL
06-10-20 10:57,10:57,8506075,8086100,-419975,SELL
06-10-20 10:58,10:58,8382100,8406050,23950,BUY
06-10-20 10:59,10:59,8495375,8400300,-95075,SELL
06-10-20 11:00,11:00,8473175,8435250,-37925,SELL
06-10-20 11:01,11:01,8481400,8443150,-38250,SELL
06-10-20 11:02,11:02,8527825,8489525,-38300,SELL
06-10-20 11:03,11:03,8394450,8379400,-15050,SELL
06-10-20 11:04,11:04,8357300,8305650,-51650,SELL
06-10-20 11:05,11:05,8540150,8529650,-10500,SELL
06-10-20 11:06,11:06,8463875,8506800,42925,BUY
06-10-20 11:07,11:07,8498500,8516800,18300,BUY
06-10-20 11:08,11:08,8466050,8472925,6875,BUY
06-10-20 11:09,11:09,8477250,8528150,50900,BUY
06-10-20 11:10,11:10,8437200,8528425,91225,BUY
06-10-20 11:11,11:11,8366675,8520600,153925,BUY
06-10-20 11:12,11:12,8271775,8448825,177050,BUY
06-10-20 11:13,11:13,8478900,8565025,86125,BUY
06-10-20 11:14,11:14,8399400,8573375,173975,BUY
06-10-20 11:15,11:15,8380400,8587075,206675,BUY
06-10-20 11:16,11:16,8327200,8587075,259875,BUY
06-10-20 11:17,11:17,8465725,8595200,129475,BUY
06-10-20 11:18,11:18,8415975,8595000,179025,BUY
06-10-20 11:19,11:19,8392300,8397750,5450,BUY
06-10-20 11:20,11:20,8507375,8728200,220825,BUY
06-10-20 11:21,11:21,8370850,8668300,297450,BUY
06-10-20 11:22,11:22,8396375,8674525,278150,BUY
06-10-20 11:23,11:23,8589450,8717950,128500,BUY
06-10-20 11:24,11:24,8557100,8743600,186500,BUY
06-10-20 11:25,11:25,8463075,8708850,245775,BUY
06-10-20 11:26,11:26,8490025,8423375,-66650,SELL
06-10-20 11:27,11:27,8592525,8774150,181625,BUY
06-10-20 11:28,11:28,8470325,8456450,-13875,SELL
06-10-20 11:29,11:29,8471550,8745525,273975,BUY
06-10-20 11:30,11:30,8513100,8814500,301400,BUY
06-10-20 11:31,11:31,8513100,8713650,200550,BUY
06-10-20 11:32,11:32,8439350,8727775,288425,BUY
06-10-20 11:33,11:33,8621950,8819900,197950,BUY
06-10-20 11:34,11:34,8518325,8774600,256275,BUY
06-10-20 11:35,11:35,8533425,8904325,370900,BUY
06-10-20 11:36,11:36,8449225,8572625,123400,BUY
06-10-20 11:37,11:37,8396300,8878550,482250,BUY
06-10-20 11:38,11:38,8564000,9001300,437300,BUY
06-10-20 11:39,11:39,8523900,8975600,451700,BUY
06-10-20 11:40,11:40,8489725,8991225,501500,BUY
06-10-20 11:41,11:41,8534675,8993950,459275,BUY
06-10-20 11:42,11:42,8536325,9012400,476075,BUY
06-10-20 11:43,11:43,8503375,8955550,452175,BUY
06-10-20 11:44,11:44,8569175,9024650,455475,BUY
06-10-20 11:45,11:45,8525575,9001750,476175,BUY
06-10-20 11:46,11:46,8414525,8956225,541700,BUY
06-10-20 11:47,11:47,8446475,9026275,579800,BUY
06-10-20 11:48,11:48,8480900,9033875,552975,BUY
06-10-20 11:49,11:49,8409600,8974250,564650,BUY
06-10-20 11:50,11:50,8450050,9003700,553650,BUY
06-10-20 11:51,11:51,8448925,8839725,390800,BUY
06-10-20 11:52,11:52,8525625,9008875,483250,BUY
06-10-20 11:53,11:53,8418825,8979075,560250,BUY
06-10-20 11:54,11:54,8577500,9012525,435025,BUY
06-10-20 11:55,11:55,8523925,8967750,443825,BUY
06-10-20 11:56,11:56,8486525,9091325,604800,BUY
06-10-20 11:57,11:57,8493525,8994175,500650,BUY
06-10-20 11:58,11:58,8490825,9025175,534350,BUY
06-10-20 11:59,11:59,8521950,9156875,634925,BUY
06-10-20 12:00,12:00,8598100,9191875,593775,BUY
06-10-20 12:01,12:01,8510350,9078950,568600,BUY
06-10-20 12:02,12:02,8594725,9192475,597750,BUY
06-10-20 12:03,12:03,8521000,9151650,630650,BUY
06-10-20 12:04,12:04,8470800,9205700,734900,BUY
06-10-20 12:05,12:05,8544175,9126225,582050,BUY
06-10-20 12:06,12:06,8674650,9126825,452175,BUY
06-10-20 12:07,12:07,8532425,9130375,597950,BUY
06-10-20 12:08,12:08,8501100,9130475,629375,BUY
06-10-20 12:09,12:09,8544650,9143425,598775,BUY
06-10-20 12:10,12:10,8630825,9182650,551825,BUY
06-10-20 12:11,12:11,8488600,9156125,667525,BUY
06-10-20 12:12,12:12,8669325,9175025,505700,BUY
06-10-20 12:13,12:13,8622600,9215075,592475,BUY
06-10-20 12:14,12:14,8523700,9207975,684275,BUY
06-10-20 12:15,12:15,8601325,9145300,543975,BUY
06-10-20 12:16,12:16,8570925,9147850,576925,BUY
06-10-20 12:17,12:17,8557500,9176025,618525,BUY
06-10-20 12:18,12:18,8476825,9212575,735750,BUY
06-10-20 12:19,12:19,8414075,9225425,811350,BUY
06-10-20 12:20,12:20,8493675,8856575,362900,BUY
06-10-20 12:21,12:21,8666825,9247525,580700,BUY
06-10-20 12:22,12:22,8620525,9241750,621225,BUY
06-10-20 12:23,12:23,8535575,9303775,768200,BUY
06-10-20 12:24,12:24,8383700,9285800,902100,BUY
06-10-20 12:25,12:25,8340000,9284800,944800,BUY
06-10-20 12:26,12:26,8437150,9303725,866575,BUY
06-10-20 12:27,12:27,8431750,9121825,690075,BUY
06-10-20 12:28,12:28,8446650,9297350,850700,BUY
06-10-20 12:29,12:29,8552725,9176025,623300,BUY
06-10-20 12:30,12:30,8484825,9253375,768550,BUY
06-10-20 12:31,12:31,8443700,9268025,824325,BUY
06-10-20 12:32,12:32,8504100,9295675,791575,BUY
06-10-20 12:33,12:33,8537950,9170850,632900,BUY
06-10-20 12:34,12:34,8518975,9263900,744925,BUY
06-10-20 12:35,12:35,8526325,9259875,733550,BUY
06-10-20 12:36,12:36,8559175,9067225,508050,BUY
06-10-20 12:37,12:37,8401425,9159175,757750,BUY
06-10-20 12:38,12:38,8454025,9235850,781825,BUY
06-10-20 12:39,12:39,8484125,8874650,390525,BUY
06-10-20 12:40,12:40,8425650,9208375,782725,BUY
06-10-20 12:41,12:41,8592200,9199300,607100,BUY
06-10-20 12:42,12:42,8503700,9198675,694975,BUY
06-10-20 12:43,12:43,8628975,9206275,577300,BUY
06-10-20 12:44,12:44,8522075,9135550,613475,BUY
06-10-20 12:45,12:45,8605200,9191825,586625,BUY
06-10-20 12:46,12:46,8569325,9174525,605200,BUY
06-10-20 12:47,12:47,8518325,9200350,682025,BUY
06-10-20 12:48,12:48,8594125,9196325,602200,BUY
06-10-20 12:49,12:49,8540350,9099575,559225,BUY
06-10-20 12:50,12:50,8594300,9133125,538825,BUY
06-10-20 12:51,12:51,8516900,9201625,684725,BUY
06-10-20 12:52,12:52,8503075,9066475,563400,BUY
06-10-20 12:53,12:53,8584100,9091350,507250,BUY
06-10-20 12:54,12:54,8544300,9079475,535175,BUY
06-10-20 12:55,12:55,8552400,9090800,538400,BUY
06-10-20 12:56,12:56,8688725,9178525,489800,BUY
06-10-20 12:57,12:57,8575000,9050275,475275,BUY
06-10-20 12:58,12:58,8643950,9130000,486050,BUY
06-10-20 12:59,12:59,8648825,9122525,473700,BUY
06-10-20 13:00,13:00,8587250,9158975,571725,BUY
06-10-20 13:01,13:01,8707575,9203875,496300,BUY
06-10-20 13:02,13:02,8643325,9243000,599675,BUY
06-10-20 13:03,13:03,8663350,9227075,563725,BUY
06-10-20 13:04,13:04,8775750,9252000,476250,BUY
06-10-20 13:05,13:05,8691700,9158800,467100,BUY
06-10-20 13:06,13:06,8612250,9054800,442550,BUY
06-10-20 13:07,13:07,8599075,9109450,510375,BUY
06-10-20 13:08,13:08,8622600,9060825,438225,BUY
06-10-20 13:09,13:09,8600625,8833250,232625,BUY
06-10-20 13:10,13:10,8636325,9133075,496750,BUY
06-10-20 13:11,13:11,8606525,9189750,583225,BUY
06-10-20 13:12,13:12,8634175,9144225,510050,BUY
06-10-20 13:13,13:13,8657325,9175550,518225,BUY
06-10-20 13:14,13:14,8620075,9065000,444925,BUY
06-10-20 13:15,13:15,8588800,9152875,564075,BUY
06-10-20 13:16,13:16,8620450,9165375,544925,BUY
06-10-20 13:17,13:17,8581575,9139600,558025,BUY
06-10-20 13:18,13:18,8619950,9093000,473050,BUY
06-10-20 13:19,13:19,8684725,9187725,503000,BUY
06-10-20 13:20,13:20,8819700,9157750,338050,BUY
06-10-20 13:21,13:21,8751275,9215250,463975,BUY
06-10-20 13:22,13:22,8794925,9133350,338425,BUY
06-10-20 13:23,13:23,8640750,9188325,547575,BUY
06-10-20 13:24,13:24,8663400,8672825,9425,BUY
06-10-20 13:25,13:25,8774975,9167900,392925,BUY
06-10-20 13:26,13:26,8701350,9220150,518800,BUY
06-10-20 13:27,13:27,8610775,9243700,632925,BUY
06-10-20 13:28,13:28,8643950,9218400,574450,BUY
06-10-20 13:29,13:29,8678450,9150550,472100,BUY
06-10-20 13:30,13:30,8689200,9191275,502075,BUY
06-10-20 13:31,13:31,8749925,9161875,411950,BUY
06-10-20 13:32,13:32,8789425,9162650,373225,BUY
06-10-20 13:33,13:33,8914625,9233275,318650,BUY
06-10-20 13:34,13:34,8818200,9226875,408675,BUY
06-10-20 13:35,13:35,8793500,9182375,388875,BUY
06-10-20 13:36,13:36,8765925,9063200,297275,BUY
06-10-20 13:37,13:37,8775675,9164775,389100,BUY
06-10-20 13:38,13:38,8736425,9105050,368625,BUY
06-10-20 13:39,13:39,8696825,9159950,463125,BUY
06-10-20 13:40,13:40,8769800,9184975,415175,BUY
06-10-20 13:41,13:41,8752825,9170350,417525,BUY
06-10-20 13:42,13:42,8846075,9206375,360300,BUY
06-10-20 13:43,13:43,8845650,9249125,403475,BUY
06-10-20 13:44,13:44,8778300,9071275,292975,BUY
06-10-20 13:45,13:45,8847850,9276250,428400,BUY
06-10-20 13:46,13:46,8816450,9300425,483975,BUY
06-10-20 13:47,13:47,8947850,9340725,392875,BUY
06-10-20 13:48,13:48,8734200,9223250,489050,BUY
06-10-20 13:49,13:49,8814700,8982575,167875,BUY
06-10-20 13:50,13:50,8783275,9254600,471325,BUY
06-10-20 13:51,13:51,8864450,9198075,333625,BUY
06-10-20 13:52,13:52,8710425,9246550,536125,BUY
06-10-20 13:53,13:53,8801425,9295725,494300,BUY
06-10-20 13:54,13:54,8791775,9259600,467825,BUY
06-10-20 13:55,13:55,8669575,9245575,576000,BUY
06-10-20 13:56,13:56,8813475,9211000,397525,BUY
06-10-20 13:57,13:57,8699325,9192325,493000,BUY
06-10-20 13:58,13:58,8864450,9292725,428275,BUY
06-10-20 13:59,13:59,8761025,9234850,473825,BUY
06-10-20 14:00,14:00,8911450,9274150,362700,BUY
06-10-20 14:01,14:01,8910625,9252675,342050,BUY
06-10-20 14:02,14:02,8959975,9321200,361225,BUY
06-10-20 14:03,14:03,8812325,9355675,543350,BUY
06-10-20 14:04,14:04,8812325,9315275,502950,BUY
06-10-20 14:05,14:05,8851975,9340250,488275,BUY
06-10-20 14:06,14:06,8811650,9353275,541625,BUY
06-10-20 14:07,14:07,8792225,9308100,515875,BUY
06-10-20 14:08,14:08,8777825,9400100,622275,BUY
06-10-20 14:09,14:09,8785750,9287200,501450,BUY
06-10-20 14:10,14:10,8821500,9064375,242875,BUY
06-10-20 14:11,14:11,8831150,9322725,491575,BUY
06-10-20 14:12,14:12,8763775,9283750,519975,BUY
06-10-20 14:13,14:13,8845425,9367575,522150,BUY
06-10-20 14:14,14:14,8876900,9387700,510800,BUY
06-10-20 14:15,14:15,8698125,9317075,618950,BUY
06-10-20 14:16,14:16,8698125,9341975,643850,BUY
06-10-20 14:17,14:17,8844500,9381725,537225,BUY
06-10-20 14:18,14:18,8921150,9353400,432250,BUY
06-10-20 14:19,14:19,8810500,9329450,518950,BUY
06-10-20 14:20,14:20,8874600,9348600,474000,BUY
06-10-20 14:21,14:21,8872475,9308150,435675,BUY
06-10-20 14:22,14:22,8843850,9319700,475850,BUY
06-10-20 14:23,14:23,8867875,9297550,429675,BUY
06-10-20 14:24,14:24,8701950,9154800,452850,BUY
06-10-20 14:25,14:25,8898125,9355975,457850,BUY
06-10-20 14:26,14:26,8847675,9204875,357200,BUY
06-10-20 14:27,14:27,8909675,9343325,433650,BUY
06-10-20 14:28,14:28,8906700,9297600,390900,BUY
06-10-20 14:29,14:29,8889025,9347600,458575,BUY
06-10-20 14:30,14:30,8821825,9316575,494750,BUY
06-10-20 14:31,14:31,8803950,9316575,512625,BUY
06-10-20 14:32,14:32,8777050,9290650,513600,BUY
06-10-20 14:33,14:33,8372700,9133200,760500,BUY
06-10-20 14:34,14:34,8485425,9138150,652725,BUY
06-10-20 14:35,14:35,8469075,9123125,654050,BUY
06-10-20 14:36,14:36,7919700,9095725,1176025,BUY
06-10-20 14:37,14:37,7939125,9060875,1121750,BUY
06-10-20 14:38,14:38,7913800,9092500,1178700,BUY
06-10-20 14:39,14:39,7949000,9082375,1133375,BUY
06-10-20 14:40,14:40,7917950,9113550,1195600,BUY
06-10-20 14:41,14:41,7916025,9094250,1178225,BUY
06-10-20 14:42,14:42,7737525,9020575,1283050,BUY
06-10-20 14:43,14:43,7719100,8977200,1258100,BUY
06-10-20 14:44,14:44,7674100,9021625,1347525,BUY
06-10-20 14:45,14:45,7630025,9116050,1486025,BUY
06-10-20 14:46,14:46,7607875,9062800,1454925,BUY
06-10-20 14:47,14:47,7685150,9133800,1448650,BUY
06-10-20 14:48,14:48,7620050,9090450,1470400,BUY
06-10-20 14:49,14:49,7629700,9153925,1524225,BUY
06-10-20 14:50,14:50,7499900,9156675,1656775,BUY
06-10-20 14:51,14:51,7512800,9006875,1494075,BUY
06-10-20 14:52,14:52,7436900,9004350,1567450,BUY
06-10-20 14:53,14:53,7479925,9002000,1522075,BUY
06-10-20 14:54,14:54,7498250,9028775,1530525,BUY
06-10-20 14:55,14:55,7541475,9036225,1494750,BUY
06-10-20 14:56,14:56,7573800,9034500,1460700,BUY
06-10-20 14:57,14:57,7473625,8996500,1522875,BUY
06-10-20 14:58,14:58,7509350,8994325,1484975,BUY
06-10-20 14:59,14:59,7412725,8951850,1539125,BUY
06-10-20 15:00,15:00,7498700,9040675,1541975,BUY
06-10-20 15:01,15:01,7585400,9053900,1468500,BUY
06-10-20 15:02,15:02,7533450,9031900,1498450,BUY
06-10-20 15:03,15:03,7398625,9036100,1637475,BUY
06-10-20 15:04,15:04,7419425,9050250,1630825,BUY
06-10-20 15:05,15:05,7347125,9047975,1700850,BUY
06-10-20 15:06,15:06,7344900,8984250,1639350,BUY
06-10-20 15:07,15:07,7326400,8935850,1609450,BUY
06-10-20 15:08,15:08,7377875,9001225,1623350,BUY
06-10-20 15:09,15:09,7379800,8935375,1555575,BUY
06-10-20 15:10,15:10,7327375,8953575,1626200,BUY
06-10-20 15:11,15:11,7275675,8947025,1671350,BUY
06-10-20 15:12,15:12,7186850,8881600,1694750,BUY
06-10-20 15:13,15:13,7270375,8884350,1613975,BUY
06-10-20 15:14,15:14,7276825,8855100,1578275,BUY
06-10-20 15:15,15:15,7141100,8693725,1552625,BUY
06-10-20 15:16,15:16,7108750,8675025,1566275,BUY
06-10-20 15:17,15:17,7130675,8707200,1576525,BUY
06-10-20 15:18,15:18,7082675,8493725,1411050,BUY
06-10-20 15:19,15:19,6993675,8484825,1491150,BUY
06-10-20 15:20,15:20,7037475,8499275,1461800,BUY
06-10-20 15:21,15:21,6870275,8234925,1364650,BUY
06-10-20 15:22,15:22,6806725,8229475,1422750,BUY
06-10-20 15:23,15:23,6720675,8219200,1498525,BUY
06-10-20 15:24,15:24,6646325,8017250,1370925,BUY
06-10-20 15:25,15:25,6687675,8022650,1334975,BUY
06-10-20 15:26,15:26,6651450,7997800,1346350,BUY
06-10-20 15:27,15:27,6374925,7779500,1404575,BUY
06-10-20 15:28,15:28,6388325,7799875,1411550,BUY
06-10-20 15:29,15:29,6415700,7793000,1377300,BUY
07-10-20 9:15,9:15,6137375,7465375,1328000,BUY
07-10-20 9:16,9:16,6076400,7456950,1380550,BUY
07-10-20 9:17,9:17,6468450,8096525,1628075,BUY
07-10-20 9:18,9:18,6484375,8085000,1600625,BUY
07-10-20 9:19,9:19,6499425,8099200,1599775,BUY
07-10-20 9:20,9:20,6927700,8715000,1787300,BUY
07-10-20 9:21,9:21,6838700,8718100,1879400,BUY
07-10-20 9:22,9:22,6891975,8715975,1824000,BUY
07-10-20 9:23,9:23,7433600,8952750,1519150,BUY
07-10-20 9:24,9:24,7409550,8946775,1537225,BUY
07-10-20 9:25,9:25,7469825,9006125,1536300,BUY
07-10-20 9:26,9:26,7760825,9207825,1447000,BUY
07-10-20 9:27,9:27,7661350,9211225,1549875,BUY
07-10-20 9:28,9:28,7731700,9204700,1473000,BUY
07-10-20 9:29,9:29,7828850,9276400,1447550,BUY
07-10-20 9:30,9:30,7913050,9259350,1346300,BUY
07-10-20 9:31,9:31,7919250,9252800,1333550,BUY
07-10-20 9:32,9:32,8097450,9453550,1356100,BUY
07-10-20 9:33,9:33,8163525,9453550,1290025,BUY
07-10-20 9:34,9:34,8124650,9436250,1311600,BUY
07-10-20 9:35,9:35,8309225,9563375,1254150,BUY
07-10-20 9:36,9:36,8378925,9608350,1229425,BUY
07-10-20 9:37,9:37,8470375,9558775,1088400,BUY
07-10-20 9:38,9:38,8485500,9566500,1081000,BUY
07-10-20 9:39,9:39,8566800,9566950,1000150,BUY
07-10-20 9:40,9:40,8523800,9548625,1024825,BUY
07-10-20 9:41,9:41,8470075,9552825,1082750,BUY
07-10-20 9:42,9:42,8488475,9573925,1085450,BUY
07-10-20 9:43,9:43,8461975,9537200,1075225,BUY
07-10-20 9:44,9:44,8612450,9570325,957875,BUY
07-10-20 9:45,9:45,8598575,9615925,1017350,BUY
07-10-20 9:46,9:46,8507925,9611925,1104000,BUY
07-10-20 9:47,9:47,8550275,9676700,1126425,BUY
07-10-20 9:48,9:48,8567875,9607675,1039800,BUY
07-10-20 9:49,9:49,8593725,9664600,1070875,BUY
07-10-20 9:50,9:50,8644925,9592400,947475,BUY
07-10-20 9:51,9:51,8701175,9678425,977250,BUY
07-10-20 9:52,9:52,8838475,9670850,832375,BUY
07-10-20 9:53,9:53,8317075,9780450,1463375,BUY
07-10-20 9:54,9:54,8263375,9780450,1517075,BUY
07-10-20 9:55,9:55,8282125,9775250,1493125,BUY
07-10-20 9:56,9:56,7828700,9734275,1905575,BUY
07-10-20 9:57,9:57,7779500,9734600,1955100,BUY
07-10-20 9:58,9:58,7805600,9745450,1939850,BUY
07-10-20 9:59,9:59,7614650,9903150,2288500,BUY
07-10-20 10:00,10:00,7697875,9899275,2201400,BUY
07-10-20 10:01,10:01,7698500,9906150,2207650,BUY
07-10-20 10:02,10:02,7728475,10159650,2431175,BUY
07-10-20 10:03,10:03,7781025,10156875,2375850,BUY
07-10-20 10:04,10:04,7745150,10121050,2375900,BUY
07-10-20 10:05,10:05,7953775,10287850,2334075,BUY
07-10-20 10:06,10:06,7937050,10300125,2363075,BUY
07-10-20 10:07,10:07,7937050,10246225,2309175,BUY
07-10-20 10:08,10:08,8043850,10350600,2306750,BUY
07-10-20 10:09,10:09,7994200,10344200,2350000,BUY
07-10-20 10:10,10:10,8034700,10384425,2349725,BUY
07-10-20 10:11,10:11,8187100,10367550,2180450,BUY
07-10-20 10:12,10:12,8158250,10263900,2105650,BUY
07-10-20 10:13,10:13,8250075,10428150,2178075,BUY
07-10-20 10:14,10:14,8153025,10480125,2327100,BUY
07-10-20 10:15,10:15,8201100,10465150,2264050,BUY
07-10-20 10:16,10:16,8239600,10499150,2259550,BUY
07-10-20 10:17,10:17,8314325,10521050,2206725,BUY
07-10-20 10:18,10:18,8344700,10500775,2156075,BUY
07-10-20 10:19,10:19,8361425,10465625,2104200,BUY
07-10-20 10:20,10:20,8452550,10597975,2145425,BUY
07-10-20 10:21,10:21,8478050,10540900,2062850,BUY
07-10-20 10:22,10:22,8419700,10581925,2162225,BUY
07-10-20 10:23,10:23,8419075,10592900,2173825,BUY
07-10-20 10:24,10:24,8450975,10513475,2062500,BUY
07-10-20 10:25,10:25,8409075,10592900,2183825,BUY
07-10-20 10:26,10:26,8420200,10663200,2243000,BUY
07-10-20 10:27,10:27,8414650,10720825,2306175,BUY
07-10-20 10:28,10:28,8397575,10708925,2311350,BUY
07-10-20 10:29,10:29,8256675,10702300,2445625,BUY
07-10-20 10:30,10:30,8420500,10717825,2297325,BUY
07-10-20 10:31,10:31,8493850,10832275,2338425,BUY
07-10-20 10:32,10:32,8135700,10856875,2721175,BUY
07-10-20 10:33,10:33,8338075,10569375,2231300,BUY
07-10-20 10:34,10:34,8439950,10697675,2257725,BUY
07-10-20 10:35,10:35,8530225,10571550,2041325,BUY
07-10-20 10:36,10:36,8440025,10801175,2361150,BUY
07-10-20 10:37,10:37,8452625,10516475,2063850,BUY
07-10-20 10:38,10:38,8545825,10737800,2191975,BUY
07-10-20 10:39,10:39,8665200,10812450,2147250,BUY
07-10-20 10:40,10:40,8648975,10756825,2107850,BUY
07-10-20 10:41,10:41,8491350,10710275,2218925,BUY
07-10-20 10:42,10:42,8543625,10738650,2195025,BUY
07-10-20 10:43,10:43,8564975,10356700,1791725,BUY
07-10-20 10:44,10:44,8824225,10915400,2091175,BUY
07-10-20 10:45,10:45,8742975,10553300,1810325,BUY
07-10-20 10:46,10:46,8696075,10895950,2199875,BUY
07-10-20 10:47,10:47,8711725,10935400,2223675,BUY
07-10-20 10:48,10:48,8721250,10877800,2156550,BUY
07-10-20 10:49,10:49,8491775,10895700,2403925,BUY
07-10-20 10:50,10:50,8801650,10825350,2023700,BUY
07-10-20 10:51,10:51,8714250,10809750,2095500,BUY
07-10-20 10:52,10:52,8793675,10869550,2075875,BUY
07-10-20 10:53,10:53,8878725,10865550,1986825,BUY
07-10-20 10:54,10:54,8886775,10860050,1973275,BUY
07-10-20 10:55,10:55,9001075,10949075,1948000,BUY
07-10-20 10:56,10:56,8979525,10773875,1794350,BUY
07-10-20 10:57,10:57,9003500,10757000,1753500,BUY
07-10-20 10:58,10:58,8857075,10720325,1863250,BUY
07-10-20 10:59,10:59,8966500,10809425,1842925,BUY
07-10-20 11:00,11:00,9075325,10806100,1730775,BUY
07-10-20 11:01,11:01,9071725,10763575,1691850,BUY
07-10-20 11:02,11:02,9281450,10689650,1408200,BUY
07-10-20 11:03,11:03,9140600,10636000,1495400,BUY
07-10-20 11:04,11:04,9140600,10666275,1525675,BUY
07-10-20 11:05,11:05,9129025,10614875,1485850,BUY
07-10-20 11:06,11:06,9113775,10586150,1472375,BUY
07-10-20 11:07,11:07,9096100,10638425,1542325,BUY
07-10-20 11:08,11:08,9200300,10730800,1530500,BUY
07-10-20 11:09,11:09,9215100,10726850,1511750,BUY
07-10-20 11:10,11:10,9241125,10706275,1465150,BUY
07-10-20 11:11,11:11,9103375,10627950,1524575,BUY
07-10-20 11:12,11:12,9137400,10651800,1514400,BUY
07-10-20 11:13,11:13,9200600,10588100,1387500,BUY
07-10-20 11:14,11:14,9275700,10363025,1087325,BUY
07-10-20 11:15,11:15,9239475,10588925,1349450,BUY
07-10-20 11:16,11:16,9278500,10632050,1353550,BUY
07-10-20 11:17,11:17,9310025,10638025,1328000,BUY
07-10-20 11:18,11:18,9288500,10555025,1266525,BUY
07-10-20 11:19,11:19,9388175,10667025,1278850,BUY
07-10-20 11:20,11:20,9374525,10629475,1254950,BUY
07-10-20 11:21,11:21,9390700,10617550,1226850,BUY
07-10-20 11:22,11:22,9161450,10605300,1443850,BUY
07-10-20 11:23,11:23,9163500,10511525,1348025,BUY
07-10-20 11:24,11:24,9363500,10545675,1182175,BUY
07-10-20 11:25,11:25,9422325,10472925,1050600,BUY
07-10-20 11:26,11:26,9456100,10540675,1084575,BUY
07-10-20 11:27,11:27,9276850,10618700,1341850,BUY
07-10-20 11:28,11:28,9407025,10589925,1182900,BUY
07-10-20 11:29,11:29,9508725,10659750,1151025,BUY
07-10-20 11:30,11:30,9611975,10533500,921525,BUY
07-10-20 11:31,11:31,9496200,10631600,1135400,BUY
07-10-20 11:32,11:32,9589750,9944125,354375,BUY
07-10-20 11:33,11:33,9538850,10234650,695800,BUY
07-10-20 11:34,11:34,9538850,10624550,1085700,BUY
07-10-20 11:35,11:35,9717025,10693075,976050,BUY
07-10-20 11:36,11:36,9690450,10671650,981200,BUY
07-10-20 11:37,11:37,9623475,10688300,1064825,BUY
07-10-20 11:38,11:38,9796375,10738675,942300,BUY
07-10-20 11:39,11:39,9556325,9979275,422950,BUY
07-10-20 11:40,11:40,9868425,10733850,865425,BUY
07-10-20 11:41,11:41,9767250,10767650,1000400,BUY
07-10-20 11:42,11:42,9764825,10705725,940900,BUY
07-10-20 11:43,11:43,9641525,10800175,1158650,BUY
07-10-20 11:44,11:44,9751175,10811425,1060250,BUY
07-10-20 11:45,11:45,9792650,10670825,878175,BUY
07-10-20 11:46,11:46,9823950,10739200,915250,BUY
07-10-20 11:47,11:47,9757600,10743725,986125,BUY
07-10-20 11:48,11:48,9755275,10871575,1116300,BUY
07-10-20 11:49,11:49,9590425,10733625,1143200,BUY
07-10-20 11:50,11:50,9559475,10805025,1245550,BUY
07-10-20 11:51,11:51,9484225,10431500,947275,BUY
07-10-20 11:52,11:52,9719425,10222500,503075,BUY
07-10-20 11:53,11:53,9738475,10803475,1065000,BUY
07-10-20 11:54,11:54,9579750,10724425,1144675,BUY
07-10-20 11:55,11:55,9796900,10876725,1079825,BUY
07-10-20 11:56,11:56,9738075,10895050,1156975,BUY
07-10-20 11:57,11:57,9738100,10773225,1035125,BUY
07-10-20 11:58,11:58,9797075,10756450,959375,BUY
07-10-20 11:59,11:59,9758525,10473075,714550,BUY
07-10-20 12:00,12:00,9836050,10915175,1079125,BUY
07-10-20 12:01,12:01,9660025,10883625,1223600,BUY
07-10-20 12:02,12:02,9745250,10909000,1163750,BUY
07-10-20 12:03,12:03,9720925,10987125,1266200,BUY
07-10-20 12:04,12:04,9868300,10914675,1046375,BUY
07-10-20 12:05,12:05,9863850,11000025,1136175,BUY
07-10-20 12:06,12:06,9883175,10621050,737875,BUY
07-10-20 12:07,12:07,9684700,10874350,1189650,BUY
07-10-20 12:08,12:08,9729375,11059375,1330000,BUY
07-10-20 12:09,12:09,9642150,10950125,1307975,BUY
07-10-20 12:10,12:10,9827025,10968250,1141225,BUY
07-10-20 12:11,12:11,9794525,10885775,1091250,BUY
07-10-20 12:12,12:12,9936450,11094925,1158475,BUY
07-10-20 12:13,12:13,9864350,11072450,1208100,BUY
07-10-20 12:14,12:14,9876825,11128275,1251450,BUY
07-10-20 12:15,12:15,9846450,11049525,1203075,BUY
07-10-20 12:16,12:16,9766725,11055575,1288850,BUY
07-10-20 12:17,12:17,9780325,11068650,1288325,BUY
07-10-20 12:18,12:18,10022225,11113750,1091525,BUY
07-10-20 12:19,12:19,9637775,10978400,1340625,BUY
07-10-20 12:20,12:20,9962600,11077275,1114675,BUY
07-10-20 12:21,12:21,9882225,11052575,1170350,BUY
07-10-20 12:22,12:22,9880050,10708225,828175,BUY
07-10-20 12:23,12:23,9763275,10471525,708250,BUY
07-10-20 12:24,12:24,9956750,11182200,1225450,BUY
07-10-20 12:25,12:25,9884925,11124900,1239975,BUY
07-10-20 12:26,12:26,9944550,11195150,1250600,BUY
07-10-20 12:27,12:27,9905050,11179000,1273950,BUY
07-10-20 12:28,12:28,9930500,11089975,1159475,BUY
07-10-20 12:29,12:29,9923075,10885475,962400,BUY
07-10-20 12:30,12:30,9939475,11194275,1254800,BUY
07-10-20 12:31,12:31,10000225,11241375,1241150,BUY
07-10-20 12:32,12:32,9892950,11248600,1355650,BUY
07-10-20 12:33,12:33,9737225,11206850,1469625,BUY
07-10-20 12:34,12:34,9790900,11002900,1212000,BUY
07-10-20 12:35,12:35,9939000,11318200,1379200,BUY
07-10-20 12:36,12:36,9856950,11243875,1386925,BUY
07-10-20 12:37,12:37,9960125,11323900,1363775,BUY
07-10-20 12:38,12:38,9893475,11413350,1519875,BUY
07-10-20 12:39,12:39,9949325,11278525,1329200,BUY
07-10-20 12:40,12:40,9950725,11356550,1405825,BUY
07-10-20 12:41,12:41,9979175,11343400,1364225,BUY
07-10-20 12:42,12:42,9932800,11227125,1294325,BUY
07-10-20 12:43,12:43,9951800,11279350,1327550,BUY
07-10-20 12:44,12:44,9874950,11453700,1578750,BUY
07-10-20 12:45,12:45,9780525,11385250,1604725,BUY
07-10-20 12:46,12:46,9681500,11444175,1762675,BUY
07-10-20 12:47,12:47,9536375,11442375,1906000,BUY
07-10-20 12:48,12:48,9472375,11461375,1989000,BUY
07-10-20 12:49,12:49,9549675,11458100,1908425,BUY
07-10-20 12:50,12:50,9476825,11434475,1957650,BUY
07-10-20 12:51,12:51,9507900,11474950,1967050,BUY
07-10-20 12:52,12:52,9524475,11382725,1858250,BUY
07-10-20 12:53,12:53,9569650,11458800,1889150,BUY
07-10-20 12:54,12:54,9303250,11423900,2120650,BUY
07-10-20 12:55,12:55,9442275,11493250,2050975,BUY
07-10-20 12:56,12:56,9486050,11535025,2048975,BUY
07-10-20 12:57,12:57,9572100,11502025,1929925,BUY
07-10-20 12:58,12:58,9437150,11189100,1751950,BUY
07-10-20 12:59,12:59,9597325,11599100,2001775,BUY
07-10-20 13:00,13:00,9713350,11621925,1908575,BUY
07-10-20 13:01,13:01,9436850,11574550,2137700,BUY
07-10-20 13:02,13:02,9611650,11583175,1971525,BUY
07-10-20 13:03,13:03,9457350,11597400,2140050,BUY
07-10-20 13:04,13:04,9455275,11608900,2153625,BUY
07-10-20 13:05,13:05,9467250,11632150,2164900,BUY
07-10-20 13:06,13:06,9588625,11661750,2073125,BUY
07-10-20 13:07,13:07,9539125,11583800,2044675,BUY
07-10-20 13:08,13:08,9569500,11548700,1979200,BUY
07-10-20 13:09,13:09,9658250,11547225,1888975,BUY
07-10-20 13:10,13:10,9682925,11538925,1856000,BUY
07-10-20 13:11,13:11,9631475,11459575,1828100,BUY
07-10-20 13:12,13:12,9504525,11451850,1947325,BUY
07-10-20 13:13,13:13,9696425,11588750,1892325,BUY
07-10-20 13:14,13:14,9658525,11534600,1876075,BUY
07-10-20 13:15,13:15,9689550,11580050,1890500,BUY
07-10-20 13:16,13:16,9773200,11581050,1807850,BUY
07-10-20 13:17,13:17,9802750,11560675,1757925,BUY
07-10-20 13:18,13:18,9770300,11575375,1805075,BUY
07-10-20 13:19,13:19,9813750,11568000,1754250,BUY
07-10-20 13:20,13:20,9820875,11596050,1775175,BUY
07-10-20 13:21,13:21,9791525,11430600,1639075,BUY
07-10-20 13:22,13:22,9760275,11392050,1631775,BUY
07-10-20 13:23,13:23,9791875,11441800,1649925,BUY
07-10-20 13:24,13:24,9799750,11489425,1689675,BUY
07-10-20 13:25,13:25,9903900,11546450,1642550,BUY
07-10-20 13:26,13:26,9877425,11466450,1589025,BUY
07-10-20 13:27,13:27,9640350,11499450,1859100,BUY
07-10-20 13:28,13:28,9745800,11521650,1775850,BUY
07-10-20 13:29,13:29,9697050,11457525,1760475,BUY
07-10-20 13:30,13:30,9534825,11456375,1921550,BUY
07-10-20 13:31,13:31,9771075,11202850,1431775,BUY
07-10-20 13:32,13:32,9761275,11513975,1752700,BUY
07-10-20 13:33,13:33,9867450,11549925,1682475,BUY
07-10-20 13:34,13:34,9769525,11415900,1646375,BUY
07-10-20 13:35,13:35,9925375,11503875,1578500,BUY
07-10-20 13:36,13:36,9724700,11509850,1785150,BUY
07-10-20 13:37,13:37,9636675,11296575,1659900,BUY
07-10-20 13:38,13:38,9921475,11621575,1700100,BUY
07-10-20 13:39,13:39,9954725,11208075,1253350,BUY
07-10-20 13:40,13:40,9939325,11508175,1568850,BUY
07-10-20 13:41,13:41,9910775,11526775,1616000,BUY
07-10-20 13:42,13:42,10028475,11532275,1503800,BUY
07-10-20 13:43,13:43,9897350,11440750,1543400,BUY
07-10-20 13:44,13:44,9877900,11439150,1561250,BUY
07-10-20 13:45,13:45,10103375,11210225,1106850,BUY
07-10-20 13:46,13:46,9916850,11542725,1625875,BUY
07-10-20 13:47,13:47,10175825,11568400,1392575,BUY
07-10-20 13:48,13:48,10019450,11703475,1684025,BUY
07-10-20 13:49,13:49,9863800,11623025,1759225,BUY
07-10-20 13:50,13:50,10058250,11626025,1567775,BUY
07-10-20 13:51,13:51,9768375,11684350,1915975,BUY
07-10-20 13:52,13:52,9859075,11661075,1802000,BUY
07-10-20 13:53,13:53,9900000,11681150,1781150,BUY
07-10-20 13:54,13:54,9764600,11627100,1862500,BUY
07-10-20 13:55,13:55,10064225,11778900,1714675,BUY
07-10-20 13:56,13:56,10033075,11731325,1698250,BUY
07-10-20 13:57,13:57,9922925,11699900,1776975,BUY
07-10-20 13:58,13:58,9966125,11674425,1708300,BUY
07-10-20 13:59,13:59,10030175,11748600,1718425,BUY
07-10-20 14:00,14:00,10218025,11740925,1522900,BUY
07-10-20 14:01,14:01,10173075,11735900,1562825,BUY
07-10-20 14:02,14:02,10038850,11710975,1672125,BUY
07-10-20 14:03,14:03,10036550,11491025,1454475,BUY
07-10-20 14:04,14:04,9816750,11394375,1577625,BUY
07-10-20 14:05,14:05,9906525,11432200,1525675,BUY
07-10-20 14:06,14:06,10222300,11458025,1235725,BUY
07-10-20 14:07,14:07,10111000,11403500,1292500,BUY
07-10-20 14:08,14:08,10137475,11429750,1292275,BUY
07-10-20 14:09,14:09,10144800,11507550,1362750,BUY
07-10-20 14:10,14:10,10105900,11471300,1365400,BUY
07-10-20 14:11,14:11,10075350,11441950,1366600,BUY
07-10-20 14:12,14:12,10069275,11510125,1440850,BUY
07-10-20 14:13,14:13,10094900,11577525,1482625,BUY
07-10-20 14:14,14:14,9887025,11547675,1660650,BUY
07-10-20 14:15,14:15,10048800,11660975,1612175,BUY
07-10-20 14:16,14:16,10073025,11689075,1616050,BUY
07-10-20 14:17,14:17,10016150,11668275,1652125,BUY
07-10-20 14:18,14:18,9982500,11660525,1678025,BUY
07-10-20 14:19,14:19,9928875,11647675,1718800,BUY
07-10-20 14:20,14:20,10028950,11558250,1529300,BUY
07-10-20 14:21,14:21,9984200,11718725,1734525,BUY
07-10-20 14:22,14:22,9926875,11615200,1688325,BUY
07-10-20 14:23,14:23,9997025,11657350,1660325,BUY
07-10-20 14:24,14:24,10084750,11366625,1281875,BUY
07-10-20 14:25,14:25,9965350,11632075,1666725,BUY
07-10-20 14:26,14:26,10085050,11668375,1583325,BUY
07-10-20 14:27,14:27,10116700,11768850,1652150,BUY
07-10-20 14:28,14:28,10142025,11768000,1625975,BUY
07-10-20 14:29,14:29,10059825,11703250,1643425,BUY
07-10-20 14:30,14:30,10060325,11702025,1641700,BUY
07-10-20 14:31,14:31,10121700,11748375,1626675,BUY
07-10-20 14:32,14:32,10182025,11817925,1635900,BUY
07-10-20 14:33,14:33,9939025,11791225,1852200,BUY
07-10-20 14:34,14:34,9968150,11736525,1768375,BUY
07-10-20 14:35,14:35,9913050,11754275,1841225,BUY
07-10-20 14:36,14:36,9760675,11767125,2006450,BUY
07-10-20 14:37,14:37,9668850,11761750,2092900,BUY
07-10-20 14:38,14:38,9731350,11742850,2011500,BUY
07-10-20 14:39,14:39,9648150,11708325,2060175,BUY
07-10-20 14:40,14:40,9665400,11674300,2008900,BUY
07-10-20 14:41,14:41,9659800,11730825,2071025,BUY
07-10-20 14:42,14:42,9665425,11691050,2025625,BUY
07-10-20 14:43,14:43,9665175,11738600,2073425,BUY
07-10-20 14:44,14:44,9731675,11666900,1935225,BUY
07-10-20 14:45,14:45,9885750,11818150,1932400,BUY
07-10-20 14:46,14:46,9825750,11806800,1981050,BUY
07-10-20 14:47,14:47,9870975,11798625,1927650,BUY
07-10-20 14:48,14:48,9737375,11617300,1879925,BUY
07-10-20 14:49,14:49,9813000,11632125,1819125,BUY
07-10-20 14:50,14:50,9793175,11616825,1823650,BUY
07-10-20 14:51,14:51,9815775,11604250,1788475,BUY
07-10-20 14:52,14:52,9896825,11643975,1747150,BUY
07-10-20 14:53,14:53,9846750,11615650,1768900,BUY
07-10-20 14:54,14:54,9825425,11608775,1783350,BUY
07-10-20 14:55,14:55,9951275,11653175,1701900,BUY
07-10-20 14:56,14:56,9951300,11628575,1677275,BUY
07-10-20 14:57,14:57,10001675,11597450,1595775,BUY
07-10-20 14:58,14:58,10009375,11585675,1576300,BUY
07-10-20 14:59,14:59,10047125,11600450,1553325,BUY
07-10-20 15:00,15:00,9999525,11578975,1579450,BUY
07-10-20 15:01,15:01,9994350,11592000,1597650,BUY
07-10-20 15:02,15:02,9950300,11596425,1646125,BUY
07-10-20 15:03,15:03,9906275,11493775,1587500,BUY
07-10-20 15:04,15:04,9657975,11416075,1758100,BUY
07-10-20 15:05,15:05,9829475,11460200,1630725,BUY
07-10-20 15:06,15:06,9720725,11456425,1735700,BUY
07-10-20 15:07,15:07,9781925,11433550,1651625,BUY
07-10-20 15:08,15:08,9727275,11285400,1558125,BUY
07-10-20 15:09,15:09,9711650,11363350,1651700,BUY
07-10-20 15:10,15:10,9777125,11386625,1609500,BUY
07-10-20 15:11,15:11,9738125,11308775,1570650,BUY
07-10-20 15:12,15:12,9529175,11210700,1681525,BUY
07-10-20 15:13,15:13,9655000,11235125,1580125,BUY
07-10-20 15:14,15:14,9635450,11212225,1576775,BUY
07-10-20 15:15,15:15,9356850,10946250,1589400,BUY
07-10-20 15:16,15:16,9410325,10936525,1526200,BUY
07-10-20 15:17,15:17,9434025,10965200,1531175,BUY
07-10-20 15:18,15:18,9221900,10806000,1584100,BUY
07-10-20 15:19,15:19,9222150,10798000,1575850,BUY
07-10-20 15:20,15:20,9296975,10805900,1508925,BUY
07-10-20 15:21,15:21,8897150,10416975,1519825,BUY
07-10-20 15:22,15:22,8816475,10415500,1599025,BUY
07-10-20 15:23,15:23,8845975,10379775,1533800,BUY
07-10-20 15:24,15:24,8648600,10218100,1569500,BUY
07-10-20 15:25,15:25,8713100,10192950,1479850,BUY
07-10-20 15:26,15:26,8674775,10205700,1530925,BUY
07-10-20 15:27,15:27,8338375,9856425,1518050,BUY
07-10-20 15:28,15:28,8368500,9853975,1485475,BUY
07-10-20 15:29,15:29,8271950,9863225,1591275,BUY
08-10-20 9:15,9:15,7885500,9378725,1493225,BUY
08-10-20 9:16,9:16,7813125,9390675,1577550,BUY
08-10-20 9:17,9:17,8733050,10481575,1748525,BUY
08-10-20 9:18,9:18,8761450,10477575,1716125,BUY
08-10-20 9:19,9:19,8847150,10433600,1586450,BUY
08-10-20 9:20,9:20,9672350,11766250,2093900,BUY
08-10-20 9:21,9:21,9679050,11782425,2103375,BUY
08-10-20 9:22,9:22,9688825,11709250,2020425,BUY
08-10-20 9:23,9:23,10230825,12595775,2364950,BUY
08-10-20 9:24,9:24,10157575,12640900,2483325,BUY
08-10-20 9:25,9:25,10196725,12649150,2452425,BUY
08-10-20 9:26,9:26,10753075,13448900,2695825,BUY
08-10-20 9:27,9:27,10652225,13428600,2776375,BUY
08-10-20 9:28,9:28,10603525,13378300,2774775,BUY
08-10-20 9:29,9:29,11027075,13817525,2790450,BUY
08-10-20 9:30,9:30,11229550,13909575,2680025,BUY
08-10-20 9:31,9:31,11340675,13927825,2587150,BUY
08-10-20 9:32,9:32,11634450,14141875,2507425,BUY
08-10-20 9:33,9:33,11670875,14043600,2372725,BUY
08-10-20 9:34,9:34,11670875,14170825,2499950,BUY
08-10-20 9:35,9:35,11867075,14776750,2909675,BUY
08-10-20 9:36,9:36,11958250,14835125,2876875,BUY
08-10-20 9:37,9:37,11938075,14781050,2842975,BUY
08-10-20 9:38,9:38,11856150,15333750,3477600,BUY
08-10-20 9:39,9:39,11799750,15150350,3350600,BUY
08-10-20 9:40,9:40,11813275,14854750,3041475,BUY
08-10-20 9:41,9:41,11920925,15633675,3712750,BUY
08-10-20 9:42,9:42,11902325,15864725,3962400,BUY
08-10-20 9:43,9:43,11954650,15595025,3640375,BUY
08-10-20 9:44,9:44,11840950,16437550,4596600,BUY
08-10-20 9:45,9:45,11829350,16043275,4213925,BUY
08-10-20 9:46,9:46,11952950,16455400,4502450,BUY
08-10-20 9:47,9:47,11784250,16816700,5032450,BUY
08-10-20 9:48,9:48,11724225,16859150,5134925,BUY
08-10-20 9:49,9:49,11763925,16905425,5141500,BUY
08-10-20 9:50,9:50,11932050,17104775,5172725,BUY
08-10-20 9:51,9:51,11810825,16789850,4979025,BUY
08-10-20 9:52,9:52,11892200,17102675,5210475,BUY
08-10-20 9:53,9:53,11908150,17287325,5379175,BUY
08-10-20 9:54,9:54,11880675,17359250,5478575,BUY
08-10-20 9:55,9:55,12026175,17404050,5377875,BUY
08-10-20 9:56,9:56,12181875,17673600,5491725,BUY
08-10-20 9:57,9:57,12136000,17679750,5543750,BUY
08-10-20 9:58,9:58,12115375,17589925,5474550,BUY
08-10-20 9:59,9:59,12371225,17300250,4929025,BUY
08-10-20 10:00,10:00,12309200,17618175,5308975,BUY
08-10-20 10:01,10:01,12227450,17746675,5519225,BUY
08-10-20 10:02,10:02,12487025,17931400,5444375,BUY
08-10-20 10:03,10:03,12567150,18063250,5496100,BUY
08-10-20 10:04,10:04,12467225,18047125,5579900,BUY
08-10-20 10:05,10:05,12571750,18297575,5725825,BUY
08-10-20 10:06,10:06,12609400,18197800,5588400,BUY
08-10-20 10:07,10:07,12663900,17979075,5315175,BUY
08-10-20 10:08,10:08,12929700,18332225,5402525,BUY
08-10-20 10:09,10:09,12980800,18430150,5449350,BUY
08-10-20 10:10,10:10,12765450,18060000,5294550,BUY
08-10-20 10:11,10:11,12775325,18658075,5882750,BUY
08-10-20 10:12,10:12,12900550,18511900,5611350,BUY
08-10-20 10:13,10:13,12863375,18629450,5766075,BUY
08-10-20 10:14,10:14,13134175,18321400,5187225,BUY
08-10-20 10:15,10:15,13160275,18736000,5575725,BUY
08-10-20 10:16,10:16,13183075,18602550,5419475,BUY
08-10-20 10:17,10:17,12663300,18902025,6238725,BUY
08-10-20 10:18,10:18,12781325,18859000,6077675,BUY
08-10-20 10:19,10:19,12650950,18604950,5954000,BUY
08-10-20 10:20,10:20,12670700,18617500,5946800,BUY
08-10-20 10:21,10:21,12587400,18831900,6244500,BUY
08-10-20 10:22,10:22,12827750,18601650,5773900,BUY
08-10-20 10:23,10:23,12840900,19034225,6193325,BUY
08-10-20 10:24,10:24,12888975,19006875,6117900,BUY
08-10-20 10:25,10:25,12962025,19120100,6158075,BUY
08-10-20 10:26,10:26,12737975,18531500,5793525,BUY
08-10-20 10:27,10:27,12640950,19285900,6644950,BUY
08-10-20 10:28,10:28,12652950,19315075,6662125,BUY
08-10-20 10:29,10:29,12925675,19073325,6147650,BUY
08-10-20 10:30,10:30,12849325,19124050,6274725,BUY
08-10-20 10:31,10:31,12787250,19280175,6492925,BUY
08-10-20 10:32,10:32,12766925,19287975,6521050,BUY
08-10-20 10:33,10:33,12549000,19149750,6600750,BUY
08-10-20 10:34,10:34,12617150,19407825,6790675,BUY
08-10-20 10:35,10:35,12816200,19297100,6480900,BUY
08-10-20 10:36,10:36,12800875,19670750,6869875,BUY
08-10-20 10:37,10:37,12918000,19449850,6531850,BUY
08-10-20 10:38,10:38,12801150,19715925,6914775,BUY
08-10-20 10:39,10:39,12846200,19332150,6485950,BUY
08-10-20 10:40,10:40,12949750,19241350,6291600,BUY
08-10-20 10:41,10:41,12878525,19442100,6563575,BUY
08-10-20 10:42,10:42,12830425,19228000,6397575,BUY
08-10-20 10:43,10:43,12833200,19495975,6662775,BUY
08-10-20 10:44,10:44,13082800,19565225,6482425,BUY
08-10-20 10:45,10:45,13157400,19311850,6154450,BUY
08-10-20 10:46,10:46,13249275,19018200,5768925,BUY
08-10-20 10:47,10:47,13364575,19687800,6323225,BUY
08-10-20 10:48,10:48,12985725,18493625,5507900,BUY
08-10-20 10:49,10:49,13201825,19562325,6360500,BUY
08-10-20 10:50,10:50,13469400,19876075,6406675,BUY
08-10-20 10:51,10:51,13351525,19251350,5899825,BUY
08-10-20 10:52,10:52,13189875,19522025,6332150,BUY
08-10-20 10:53,10:53,13414700,20196175,6781475,BUY
08-10-20 10:54,10:54,13310475,19087400,5776925,BUY
08-10-20 10:55,10:55,13521725,19565575,6043850,BUY
08-10-20 10:56,10:56,13502225,20020525,6518300,BUY
08-10-20 10:57,10:57,13727150,19389975,5662825,BUY
08-10-20 10:58,10:58,13692875,19151825,5458950,BUY
08-10-20 10:59,10:59,13583550,19623475,6039925,BUY
08-10-20 11:00,11:00,13639175,19910750,6271575,BUY
08-10-20 11:01,11:01,13408750,19667850,6259100,BUY
08-10-20 11:02,11:02,13693125,19734675,6041550,BUY
08-10-20 11:03,11:03,13630575,19631925,6001350,BUY
08-10-20 11:04,11:04,13590325,20143850,6553525,BUY
08-10-20 11:05,11:05,13775325,19943225,6167900,BUY
08-10-20 11:06,11:06,13513850,19880250,6366400,BUY
08-10-20 11:07,11:07,13762600,20135775,6373175,BUY
08-10-20 11:08,11:08,13732075,20097625,6365550,BUY
08-10-20 11:09,11:09,13840425,20283300,6442875,BUY
08-10-20 11:10,11:10,13896325,20231200,6334875,BUY
08-10-20 11:11,11:11,13442000,20340150,6898150,BUY
08-10-20 11:12,11:12,13538875,20656300,7117425,BUY
08-10-20 11:13,11:13,13469250,20713500,7244250,BUY
08-10-20 11:14,11:14,13646450,20392925,6746475,BUY
08-10-20 11:15,11:15,13671575,20755525,7083950,BUY
08-10-20 11:16,11:16,13614600,20854100,7239500,BUY
08-10-20 11:17,11:17,13791500,21088075,7296575,BUY
08-10-20 11:18,11:18,13881225,20851100,6969875,BUY
08-10-20 11:19,11:19,13730025,20610550,6880525,BUY
08-10-20 11:20,11:20,13822625,20931100,7108475,BUY
08-10-20 11:21,11:21,13956475,21116725,7160250,BUY
08-10-20 11:22,11:22,13983200,21234700,7251500,BUY
08-10-20 11:23,11:23,13894375,21048175,7153800,BUY
08-10-20 11:24,11:24,13990700,21087325,7096625,BUY
08-10-20 11:25,11:25,14182275,20720050,6537775,BUY
08-10-20 11:26,11:26,14120575,20820750,6700175,BUY
08-10-20 11:27,11:27,14265025,20883650,6618625,BUY
08-10-20 11:28,11:28,14035750,21265650,7229900,BUY
08-10-20 11:29,11:29,13801175,21184175,7383000,BUY
08-10-20 11:30,11:30,14026100,21406250,7380150,BUY
08-10-20 11:31,11:31,14013925,20896450,6882525,BUY
08-10-20 11:32,11:32,13767725,20931400,7163675,BUY
08-10-20 11:33,11:33,14055175,20814450,6759275,BUY
08-10-20 11:34,11:34,13825000,20815900,6990900,BUY
08-10-20 11:35,11:35,13824425,20418050,6593625,BUY
08-10-20 11:36,11:36,13802400,20986300,7183900,BUY
08-10-20 11:37,11:37,13923225,21031725,7108500,BUY
08-10-20 11:38,11:38,13963750,21440350,7476600,BUY
08-10-20 11:39,11:39,13984050,21064900,7080850,BUY
08-10-20 11:40,11:40,14014100,21697750,7683650,BUY
08-10-20 11:41,11:41,13896100,20592250,6696150,BUY
08-10-20 11:42,11:42,13967550,21625375,7657825,BUY
08-10-20 11:43,11:43,13824300,21059925,7235625,BUY
08-10-20 11:44,11:44,13975975,21685100,7709125,BUY
08-10-20 11:45,11:45,13847450,20789800,6942350,BUY
08-10-20 11:46,11:46,13920125,21161050,7240925,BUY
08-10-20 11:47,11:47,13748675,21518400,7769725,BUY
08-10-20 11:48,11:48,14268975,21319600,7050625,BUY
08-10-20 11:49,11:49,13920500,21062375,7141875,BUY
08-10-20 11:50,11:50,13904100,21367425,7463325,BUY
08-10-20 11:51,11:51,14131325,21077525,6946200,BUY
08-10-20 11:52,11:52,14017225,21685150,7667925,BUY
08-10-20 11:53,11:53,14103200,21249850,7146650,BUY
08-10-20 11:54,11:54,13997975,21407925,7409950,BUY
08-10-20 11:55,11:55,14133350,20956725,6823375,BUY
08-10-20 11:56,11:56,13966275,21962150,7995875,BUY
08-10-20 11:57,11:57,14308550,21832325,7523775,BUY
08-10-20 11:58,11:58,14159175,21330275,7171100,BUY
08-10-20 11:59,11:59,14302175,21574250,7272075,BUY
08-10-20 12:00,12:00,14534525,21681175,7146650,BUY
08-10-20 12:01,12:01,14416475,21198575,6782100,BUY
08-10-20 12:02,12:02,14339400,21030575,6691175,BUY
08-10-20 12:03,12:03,14099950,21638375,7538425,BUY
08-10-20 12:04,12:04,14246050,21623125,7377075,BUY
08-10-20 12:05,12:05,14286175,22184000,7897825,BUY
08-10-20 12:06,12:06,14236225,22037825,7801600,BUY
08-10-20 12:07,12:07,14257025,21742325,7485300,BUY
08-10-20 12:08,12:08,14425375,22223400,7798025,BUY
08-10-20 12:09,12:09,14385925,22056425,7670500,BUY
08-10-20 12:10,12:10,13848850,21597275,7748425,BUY
08-10-20 12:11,12:11,14315175,21994875,7679700,BUY
08-10-20 12:12,12:12,14254375,22149650,7895275,BUY
08-10-20 12:13,12:13,14472600,21476925,7004325,BUY
08-10-20 12:14,12:14,14514225,21499525,6985300,BUY
08-10-20 12:15,12:15,14183625,21577225,7393600,BUY
08-10-20 12:16,12:16,14550500,21765750,7215250,BUY
08-10-20 12:17,12:17,14088150,21456900,7368750,BUY
08-10-20 12:18,12:18,14437850,22060500,7622650,BUY
08-10-20 12:19,12:19,14497025,21925525,7428500,BUY
08-10-20 12:20,12:20,14541775,22014275,7472500,BUY
08-10-20 12:21,12:21,14121500,22246250,8124750,BUY
08-10-20 12:22,12:22,14539100,21297875,6758775,BUY
08-10-20 12:23,12:23,14916075,22034075,7118000,BUY
08-10-20 12:24,12:24,14970300,22210350,7240050,BUY
08-10-20 12:25,12:25,14764300,22272950,7508650,BUY
08-10-20 12:26,12:26,14808625,21828625,7020000,BUY
08-10-20 12:27,12:27,15052350,22178025,7125675,BUY
08-10-20 12:28,12:28,14625200,21163075,6537875,BUY
08-10-20 12:29,12:29,14911350,22198350,7287000,BUY
08-10-20 12:30,12:30,14971525,21923800,6952275,BUY
08-10-20 12:31,12:31,14731775,22053675,7321900,BUY
08-10-20 12:32,12:32,14636050,21783975,7147925,BUY
08-10-20 12:33,12:33,14746100,21957575,7211475,BUY
08-10-20 12:34,12:34,14934375,21976050,7041675,BUY
08-10-20 12:35,12:35,14957675,22231275,7273600,BUY
08-10-20 12:36,12:36,14718175,22130175,7412000,BUY
08-10-20 12:37,12:37,14793925,21902825,7108900,BUY
08-10-20 12:38,12:38,15282975,21585950,6302975,BUY
08-10-20 12:39,12:39,15284100,21731275,6447175,BUY
08-10-20 12:40,12:40,15144500,22003575,6859075,BUY
08-10-20 12:41,12:41,15130050,22251850,7121800,BUY
08-10-20 12:42,12:42,14973325,22485550,7512225,BUY
08-10-20 12:43,12:43,14906325,22229025,7322700,BUY
08-10-20 12:44,12:44,15329200,22543425,7214225,BUY
08-10-20 12:45,12:45,15119750,22394950,7275200,BUY
08-10-20 12:46,12:46,15070525,22206125,7135600,BUY
08-10-20 12:47,12:47,15152900,21946225,6793325,BUY
08-10-20 12:48,12:48,15080275,22005575,6925300,BUY
08-10-20 12:49,12:49,15087700,22036000,6948300,BUY
08-10-20 12:50,12:50,14835450,22489775,7654325,BUY
08-10-20 12:51,12:51,15161075,22514750,7353675,BUY
08-10-20 12:52,12:52,15069200,21883475,6814275,BUY
08-10-20 12:53,12:53,15173075,22030850,6857775,BUY
08-10-20 12:54,12:54,15306500,22092450,6785950,BUY
08-10-20 12:55,12:55,15350075,22461550,7111475,BUY
08-10-20 12:56,12:56,14822350,22826350,8004000,BUY
08-10-20 12:57,12:57,15352875,22837225,7484350,BUY
08-10-20 12:58,12:58,15158775,22232425,7073650,BUY
08-10-20 12:59,12:59,15126250,22516750,7390500,BUY
08-10-20 13:00,13:00,15419625,21991175,6571550,BUY
08-10-20 13:01,13:01,15137875,22239275,7101400,BUY
08-10-20 13:02,13:02,15190125,22000375,6810250,BUY
08-10-20 13:03,13:03,15380775,22622225,7241450,BUY
08-10-20 13:04,13:04,15447225,21940375,6493150,BUY
08-10-20 13:05,13:05,15354700,22273950,6919250,BUY
08-10-20 13:06,13:06,15688925,22225150,6536225,BUY
08-10-20 13:07,13:07,15573250,22259450,6686200,BUY
08-10-20 13:08,13:08,15575675,22626400,7050725,BUY
08-10-20 13:09,13:09,15212300,22087500,6875200,BUY
08-10-20 13:10,13:10,15199525,22269375,7069850,BUY
08-10-20 13:11,13:11,15213575,21860575,6647000,BUY
08-10-20 13:12,13:12,15236125,22183500,6947375,BUY
08-10-20 13:13,13:13,15028025,21792975,6764950,BUY
08-10-20 13:14,13:14,15224700,21912625,6687925,BUY
08-10-20 13:15,13:15,15297975,21435325,6137350,BUY
08-10-20 13:16,13:16,15222625,21426225,6203600,BUY
08-10-20 13:17,13:17,15281525,21557175,6275650,BUY
08-10-20 13:18,13:18,15214425,21269275,6054850,BUY
08-10-20 13:19,13:19,15081325,21898900,6817575,BUY
08-10-20 13:20,13:20,15200825,21550850,6350025,BUY
08-10-20 13:21,13:21,15146600,21894075,6747475,BUY
08-10-20 13:22,13:22,15269100,22141475,6872375,BUY
08-10-20 13:23,13:23,15514525,21915300,6400775,BUY
08-10-20 13:24,13:24,15463525,21626425,6162900,BUY
08-10-20 13:25,13:25,15505125,20955000,5449875,BUY
08-10-20 13:26,13:26,15486425,21804275,6317850,BUY
08-10-20 13:27,13:27,15420900,21686800,6265900,BUY
08-10-20 13:28,13:28,15082300,21260100,6177800,BUY
08-10-20 13:29,13:29,15137450,21774375,6636925,BUY
08-10-20 13:30,13:30,14241200,21596200,7355000,BUY
08-10-20 13:31,13:31,14395775,21761250,7365475,BUY
08-10-20 13:32,13:32,14220100,21438875,7218775,BUY
08-10-20 13:33,13:33,14461225,21435675,6974450,BUY
08-10-20 13:34,13:34,14522025,21862800,7340775,BUY
08-10-20 13:35,13:35,14304375,21504875,7200500,BUY
08-10-20 13:36,13:36,14385675,21682400,7296725,BUY
08-10-20 13:37,13:37,14240325,21230425,6990100,BUY
08-10-20 13:38,13:38,14255550,21790850,7535300,BUY
08-10-20 13:39,13:39,14524475,21374575,6850100,BUY
08-10-20 13:40,13:40,14554100,21815900,7261800,BUY
08-10-20 13:41,13:41,14385925,21461300,7075375,BUY
08-10-20 13:42,13:42,14841375,21415200,6573825,BUY
08-10-20 13:43,13:43,14763350,21629775,6866425,BUY
08-10-20 13:44,13:44,14636000,21286000,6650000,BUY
08-10-20 13:45,13:45,14435975,21310475,6874500,BUY
08-10-20 13:46,13:46,14422000,21002700,6580700,BUY
08-10-20 13:47,13:47,14601250,20920225,6318975,BUY
08-10-20 13:48,13:48,14199675,20628050,6428375,BUY
08-10-20 13:49,13:49,14062250,21099225,7036975,BUY
08-10-20 13:50,13:50,14019025,21636225,7617200,BUY
08-10-20 13:51,13:51,13911825,21346875,7435050,BUY
08-10-20 13:52,13:52,13791025,21088175,7297150,BUY
08-10-20 13:53,13:53,13906175,21042025,7135850,BUY
08-10-20 13:54,13:54,14057975,21470325,7412350,BUY
08-10-20 13:55,13:55,14324025,21582375,7258350,BUY
08-10-20 13:56,13:56,14307350,21633050,7325700,BUY
08-10-20 13:57,13:57,14052150,19531125,5478975,BUY
08-10-20 13:58,13:58,14007700,19538125,5530425,BUY
08-10-20 13:59,13:59,14060275,19484875,5424600,BUY
08-10-20 14:00,14:00,13706600,17026325,3319725,BUY
08-10-20 14:01,14:01,13691500,17198850,3507350,BUY
08-10-20 14:02,14:02,13684100,17232650,3548550,BUY
08-10-20 14:03,14:03,13774850,16980975,3206125,BUY
08-10-20 14:04,14:04,13666375,16968050,3301675,BUY
08-10-20 14:05,14:05,13777550,16963000,3185450,BUY
08-10-20 14:06,14:06,13899375,17437125,3537750,BUY
08-10-20 14:07,14:07,13935325,17541800,3606475,BUY
08-10-20 14:08,14:08,13704975,17580250,3875275,BUY
08-10-20 14:09,14:09,13798825,17821350,4022525,BUY
08-10-20 14:10,14:10,13756125,17833850,4077725,BUY
08-10-20 14:11,14:11,13744825,17877375,4132550,BUY
08-10-20 14:12,14:12,13734300,18248400,4514100,BUY
08-10-20 14:13,14:13,13475075,18187725,4712650,BUY
08-10-20 14:14,14:14,13558750,18172275,4613525,BUY
08-10-20 14:15,14:15,13446650,18317225,4870575,BUY
08-10-20 14:16,14:16,13376075,18540725,5164650,BUY
08-10-20 14:17,14:17,13238425,18569325,5330900,BUY
08-10-20 14:18,14:18,13275400,18123025,4847625,BUY
08-10-20 14:19,14:19,13262925,18623950,5361025,BUY
08-10-20 14:20,14:20,13522225,18651950,5129725,BUY
08-10-20 14:21,14:21,13540350,18386475,4846125,BUY
08-10-20 14:22,14:22,13568100,18476200,4908100,BUY
08-10-20 14:23,14:23,13457450,18513925,5056475,BUY
08-10-20 14:24,14:24,13644025,18466675,4822650,BUY
08-10-20 14:25,14:25,13678675,18383225,4704550,BUY
08-10-20 14:26,14:26,13593175,18300425,4707250,BUY
08-10-20 14:27,14:27,14038575,18024800,3986225,BUY
08-10-20 14:28,14:28,14093625,18206575,4112950,BUY
08-10-20 14:29,14:29,13954900,18210200,4255300,BUY
08-10-20 14:30,14:30,14217800,17530525,3312725,BUY
08-10-20 14:31,14:31,14232350,17710075,3477725,BUY
08-10-20 14:32,14:32,14133375,17726050,3592675,BUY
08-10-20 14:33,14:33,14166050,16403825,2237775,BUY
08-10-20 14:34,14:34,14194550,16350850,2156300,BUY
08-10-20 14:35,14:35,14266475,16392725,2126250,BUY
08-10-20 14:36,14:36,14516625,16208325,1691700,BUY
08-10-20 14:37,14:37,14461025,15956350,1495325,BUY
08-10-20 14:38,14:38,14496900,15824550,1327650,BUY
08-10-20 14:39,14:39,14206600,15303450,1096850,BUY
08-10-20 14:40,14:40,14192875,15500475,1307600,BUY
08-10-20 14:41,14:41,14184775,15447325,1262550,BUY
08-10-20 14:42,14:42,14149550,15715800,1566250,BUY
08-10-20 14:43,14:43,14297875,15415500,1117625,BUY
08-10-20 14:44,14:44,14335050,15328625,993575,BUY
08-10-20 14:45,14:45,14788525,15729600,941075,BUY
08-10-20 14:46,14:46,14739550,15574350,834800,BUY
08-10-20 14:47,14:47,14782075,15670000,887925,BUY
08-10-20 14:48,14:48,14917125,14982225,65100,BUY
08-10-20 14:49,14:49,14867575,15147575,280000,BUY
08-10-20 14:50,14:50,14886350,15029750,143400,BUY
08-10-20 14:51,14:51,14534925,15148600,613675,BUY
08-10-20 14:52,14:52,14593725,15143000,549275,BUY
08-10-20 14:53,14:53,14588025,15376875,788850,BUY
08-10-20 14:54,14:54,14655075,15188050,532975,BUY
08-10-20 14:55,14:55,14723375,15301500,578125,BUY
08-10-20 14:56,14:56,14698525,14977650,279125,BUY
08-10-20 14:57,14:57,13913950,15107300,1193350,BUY
08-10-20 14:58,14:58,13914800,15371400,1456600,BUY
08-10-20 14:59,14:59,13900000,15188650,1288650,BUY
08-10-20 15:00,15:00,13723225,14832200,1108975,BUY
08-10-20 15:01,15:01,13744925,15215950,1471025,BUY
08-10-20 15:02,15:02,13790950,15331775,1540825,BUY
08-10-20 15:03,15:03,13648000,15609475,1961475,BUY
08-10-20 15:04,15:04,13704425,15711475,2007050,BUY
08-10-20 15:05,15:05,13690650,15236775,1546125,BUY
08-10-20 15:06,15:06,13645375,15584500,1939125,BUY
08-10-20 15:07,15:07,13604975,15256525,1651550,BUY
08-10-20 15:08,15:08,13702725,15520950,1818225,BUY
08-10-20 15:09,15:09,13213700,15134900,1921200,BUY
08-10-20 15:10,15:10,13236475,15082600,1846125,BUY
08-10-20 15:11,15:11,13151400,15281675,2130275,BUY
08-10-20 15:12,15:12,12918650,14355750,1437100,BUY
08-10-20 15:13,15:13,12853450,14411500,1558050,BUY
08-10-20 15:14,15:14,12859750,14722100,1862350,BUY
08-10-20 15:15,15:15,12419475,14081075,1661600,BUY
08-10-20 15:16,15:16,12462750,14206175,1743425,BUY
08-10-20 15:17,15:17,12462775,13833450,1370675,BUY
08-10-20 15:18,15:18,12028100,13132000,1103900,BUY
08-10-20 15:19,15:19,11916625,13044825,1128200,BUY
08-10-20 15:20,15:20,12040625,13190300,1149675,BUY
08-10-20 15:21,15:21,11321450,12370300,1048850,BUY
08-10-20 15:22,15:22,11308750,12318675,1009925,BUY
08-10-20 15:23,15:23,11322575,12339250,1016675,BUY
08-10-20 15:24,15:24,10805550,11408025,602475,BUY
08-10-20 15:25,15:25,10905825,11970075,1064250,BUY
08-10-20 15:26,15:26,10732025,11253250,521225,BUY
08-10-20 15:27,15:27,9447250,10022700,575450,BUY
08-10-20 15:28,15:28,9448650,10740950,1292300,BUY
08-10-20 15:29,15:29,9349725,10544000,1194275,BUY
09-10-20 9:15,9:15,2629050,2875625,246575,BUY
09-10-20 9:16,9:16,2629900,2875675,245775,BUY
09-10-20 9:17,9:17,2867700,3222975,355275,BUY
09-10-20 9:18,9:18,2869050,3222575,353525,BUY
09-10-20 9:19,9:19,2869050,3224625,355575,BUY
09-10-20 9:20,9:20,3219850,3569150,349300,BUY
09-10-20 9:21,9:21,3213900,3564825,350925,BUY
09-10-20 9:22,9:22,3216800,3563800,347000,BUY
09-10-20 9:23,9:23,3444150,3855275,411125,BUY
09-10-20 9:24,9:24,3466650,3870700,404050,BUY
09-10-20 9:25,9:25,3468575,3885225,416650,BUY
09-10-20 9:26,9:26,3559525,4041075,481550,BUY
09-10-20 9:27,9:27,3581550,4058000,476450,BUY
09-10-20 9:28,9:28,3585100,4058175,473075,BUY
09-10-20 9:29,9:29,3736350,4182950,446600,BUY
09-10-20 9:30,9:30,3733100,4201550,468450,BUY
09-10-20 9:31,9:31,3733100,4180900,447800,BUY
09-10-20 9:32,9:32,3872850,4326975,454125,BUY
09-10-20 9:33,9:33,3831525,4312350,480825,BUY
09-10-20 9:34,9:34,3870475,4331900,461425,BUY
09-10-20 9:35,9:35,3947725,4407125,459400,BUY
09-10-20 9:36,9:36,3950400,4416600,466200,BUY
09-10-20 9:37,9:37,3957875,4430675,472800,BUY
09-10-20 9:38,9:38,3984325,4511900,527575,BUY
09-10-20 9:39,9:39,3982975,4519575,536600,BUY
09-10-20 9:40,9:40,4012025,4520675,508650,BUY
09-10-20 9:41,9:41,4027925,4609425,581500,BUY
09-10-20 9:42,9:42,4022275,4611125,588850,BUY
09-10-20 9:43,9:43,4025000,4597950,572950,BUY
09-10-20 9:44,9:44,4181050,4733350,552300,BUY
09-10-20 9:45,9:45,4168650,4727400,558750,BUY
09-10-20 9:46,9:46,4125200,4721200,596000,BUY
09-10-20 9:47,9:47,4227525,4838750,611225,BUY
09-10-20 9:48,9:48,4221100,4845850,624750,BUY
09-10-20 9:49,9:49,4230750,4830000,599250,BUY
09-10-20 9:50,9:50,4327175,4897425,570250,BUY
09-10-20 9:51,9:51,4305250,4883750,578500,BUY
09-10-20 9:52,9:52,4322875,4877575,554700,BUY
09-10-20 9:53,9:53,4387825,4984925,597100,BUY
09-10-20 9:54,9:54,4388600,5013825,625225,BUY
09-10-20 9:55,9:55,4421725,5023825,602100,BUY
09-10-20 9:56,9:56,4464950,5072050,607100,BUY
09-10-20 9:57,9:57,4467625,5068350,600725,BUY
09-10-20 9:58,9:58,4432450,5069000,636550,BUY
09-10-20 9:59,9:59,4513350,5110025,596675,BUY
09-10-20 10:00,10:00,4547375,5108475,561100,BUY
09-10-20 10:01,10:01,4517650,5120075,602425,BUY
09-10-20 10:02,10:02,4612700,5166150,553450,BUY
09-10-20 10:03,10:03,4592725,5219450,626725,BUY
09-10-20 10:04,10:04,4585125,5225050,639925,BUY
09-10-20 10:05,10:05,4754225,5373275,619050,BUY
09-10-20 10:06,10:06,4752250,5368825,616575,BUY
09-10-20 10:07,10:07,4743325,5374625,631300,BUY
09-10-20 10:08,10:08,4787350,5547400,760050,BUY
09-10-20 10:09,10:09,4751225,5539100,787875,BUY
09-10-20 10:10,10:10,4790775,5546375,755600,BUY
09-10-20 10:11,10:11,4925850,5647250,721400,BUY
09-10-20 10:12,10:12,4930175,5677750,747575,BUY
09-10-20 10:13,10:13,4913350,5661200,747850,BUY
09-10-20 10:14,10:14,4999775,5766700,766925,BUY
09-10-20 10:15,10:15,4949850,5774825,824975,BUY
09-10-20 10:16,10:16,4987325,5766400,779075,BUY
09-10-20 10:17,10:17,5107850,5894200,786350,BUY
09-10-20 10:18,10:18,5134700,5909350,774650,BUY
09-10-20 10:19,10:19,5123875,5892925,769050,BUY
09-10-20 10:20,10:20,5159250,6019725,860475,BUY
09-10-20 10:21,10:21,5192950,5994050,801100,BUY
09-10-20 10:22,10:22,5187400,6016375,828975,BUY
09-10-20 10:23,10:23,5229725,6111525,881800,BUY
09-10-20 10:24,10:24,5229725,6117700,887975,BUY
09-10-20 10:25,10:25,5230425,6127825,897400,BUY
09-10-20 10:26,10:26,5228250,6220325,992075,BUY
09-10-20 10:27,10:27,5262400,6213150,950750,BUY
09-10-20 10:28,10:28,5266750,6231800,965050,BUY
09-10-20 10:29,10:29,5207325,6257225,1049900,BUY
09-10-20 10:30,10:30,5225700,6308700,1083000,BUY
09-10-20 10:31,10:31,5242400,6306800,1064400,BUY
09-10-20 10:32,10:32,5290650,6434425,1143775,BUY
09-10-20 10:33,10:33,5320500,6393775,1073275,BUY
09-10-20 10:34,10:34,5317850,6416400,1098550,BUY
09-10-20 10:35,10:35,5388925,6521200,1132275,BUY
09-10-20 10:36,10:36,5396000,6552475,1156475,BUY
09-10-20 10:37,10:37,5358300,6527950,1169650,BUY
09-10-20 10:38,10:38,5379325,6561675,1182350,BUY
09-10-20 10:39,10:39,5391525,6573025,1181500,BUY
09-10-20 10:40,10:40,5393000,6552000,1159000,BUY
09-10-20 10:41,10:41,5266450,6611875,1345425,BUY
09-10-20 10:42,10:42,5267150,6646625,1379475,BUY
09-10-20 10:43,10:43,5306700,6666725,1360025,BUY
09-10-20 10:44,10:44,5177550,6845125,1667575,BUY
09-10-20 10:45,10:45,5186050,6846075,1660025,BUY
09-10-20 10:46,10:46,5170250,6827700,1657450,BUY
09-10-20 10:47,10:47,5129250,7105375,1976125,BUY
09-10-20 10:48,10:48,5158750,7070475,1911725,BUY
09-10-20 10:49,10:49,5159975,7070050,1910075,BUY
09-10-20 10:50,10:50,5217775,7272775,2055000,BUY
09-10-20 10:51,10:51,5213900,7296075,2082175,BUY
09-10-20 10:52,10:52,5226950,7281075,2054125,BUY
09-10-20 10:53,10:53,5264100,7390050,2125950,BUY
09-10-20 10:54,10:54,5270275,7406425,2136150,BUY
09-10-20 10:55,10:55,5267925,7405025,2137100,BUY
09-10-20 10:56,10:56,5362700,7480625,2117925,BUY
09-10-20 10:57,10:57,5346925,7454825,2107900,BUY
09-10-20 10:58,10:58,5352025,7465625,2113600,BUY
09-10-20 10:59,10:59,5353050,7542825,2189775,BUY
09-10-20 11:00,11:00,5338775,7552450,2213675,BUY
09-10-20 11:01,11:01,5375125,7545025,2169900,BUY
09-10-20 11:02,11:02,5357575,7653700,2296125,BUY
09-10-20 11:03,11:03,5358000,7679025,2321025,BUY
09-10-20 11:04,11:04,5357450,7680850,2323400,BUY
09-10-20 11:05,11:05,4973750,7734850,2761100,BUY
09-10-20 11:06,11:06,4972700,7742050,2769350,BUY
09-10-20 11:07,11:07,4974200,7758425,2784225,BUY
09-10-20 11:08,11:08,4943650,7858550,2914900,BUY
09-10-20 11:09,11:09,4942125,7815525,2873400,BUY
09-10-20 11:10,11:10,4942725,7853150,2910425,BUY
09-10-20 11:11,11:11,4910175,8058275,3148100,BUY
09-10-20 11:12,11:12,4877525,8054575,3177050,BUY
09-10-20 11:13,11:13,4898550,8026550,3128000,BUY
09-10-20 11:14,11:14,4934150,8194000,3259850,BUY
09-10-20 11:15,11:15,4956775,8217175,3260400,BUY
09-10-20 11:16,11:16,4957000,8210350,3253350,BUY
09-10-20 11:17,11:17,5003350,8358750,3355400,BUY
09-10-20 11:18,11:18,5016175,8363500,3347325,BUY
09-10-20 11:19,11:19,4986250,8358900,3372650,BUY
09-10-20 11:20,11:20,4986875,8402650,3415775,BUY
09-10-20 11:21,11:21,5009700,8427600,3417900,BUY
09-10-20 11:22,11:22,4999000,8462675,3463675,BUY
09-10-20 11:23,11:23,5114225,8420350,3306125,BUY
09-10-20 11:24,11:24,5080450,8397925,3317475,BUY
09-10-20 11:25,11:25,5077525,8419675,3342150,BUY
09-10-20 11:26,11:26,5127625,8382475,3254850,BUY
09-10-20 11:27,11:27,5108200,8396200,3288000,BUY
09-10-20 11:28,11:28,5105100,8396925,3291825,BUY
09-10-20 11:29,11:29,5109125,8432550,3323425,BUY
09-10-20 11:30,11:30,5100025,8428600,3328575,BUY
09-10-20 11:31,11:31,5105975,8405250,3299275,BUY
09-10-20 11:32,11:32,5195700,8466375,3270675,BUY
09-10-20 11:33,11:33,5237150,8463675,3226525,BUY
09-10-20 11:34,11:34,5200075,8447725,3247650,BUY
09-10-20 11:35,11:35,5246475,8509350,3262875,BUY
09-10-20 11:36,11:36,5234175,8518375,3284200,BUY
09-10-20 11:37,11:37,5187450,8526350,3338900,BUY
09-10-20 11:38,11:38,5211500,8465700,3254200,BUY
09-10-20 11:39,11:39,5229975,8459350,3229375,BUY
09-10-20 11:40,11:40,5218950,8482925,3263975,BUY
09-10-20 11:41,11:41,5274050,8482650,3208600,BUY
09-10-20 11:42,11:42,5301125,8488350,3187225,BUY
09-10-20 11:43,11:43,5249475,8469300,3219825,BUY
09-10-20 11:44,11:44,5299925,8494125,3194200,BUY
09-10-20 11:45,11:45,5324550,8479625,3155075,BUY
09-10-20 11:46,11:46,5315525,8526900,3211375,BUY
09-10-20 11:47,11:47,5283450,8601475,3318025,BUY
09-10-20 11:48,11:48,5237500,8597100,3359600,BUY
09-10-20 11:49,11:49,5257900,8557700,3299800,BUY
09-10-20 11:50,11:50,5282525,8567950,3285425,BUY
09-10-20 11:51,11:51,5277550,8585975,3308425,BUY
09-10-20 11:52,11:52,5290900,8614125,3323225,BUY
09-10-20 11:53,11:53,5353700,8602675,3248975,BUY
09-10-20 11:54,11:54,5321425,8613250,3291825,BUY
09-10-20 11:55,11:55,5349150,8613375,3264225,BUY
09-10-20 11:56,11:56,5341000,8668225,3327225,BUY
09-10-20 11:57,11:57,5316750,8638500,3321750,BUY
09-10-20 11:58,11:58,5322625,8670175,3347550,BUY
09-10-20 11:59,11:59,5400250,8632575,3232325,BUY
09-10-20 12:00,12:00,5359550,8629675,3270125,BUY
09-10-20 12:01,12:01,5358075,8673825,3315750,BUY
09-10-20 12:02,12:02,5358500,8697675,3339175,BUY
09-10-20 12:03,12:03,5381400,8704075,3322675,BUY
09-10-20 12:04,12:04,5379625,8648350,3268725,BUY
09-10-20 12:05,12:05,5421275,8704000,3282725,BUY
09-10-20 12:06,12:06,5424050,8701500,3277450,BUY
09-10-20 12:07,12:07,5370525,8656150,3285625,BUY
09-10-20 12:08,12:08,5425325,8639200,3213875,BUY
09-10-20 12:09,12:09,5399225,8639850,3240625,BUY
09-10-20 12:10,12:10,5359400,8573250,3213850,BUY
09-10-20 12:11,12:11,5396200,8684550,3288350,BUY
09-10-20 12:12,12:12,5326150,8688575,3362425,BUY
09-10-20 12:13,12:13,5412200,8433650,3021450,BUY
09-10-20 12:14,12:14,5421725,8657875,3236150,BUY
09-10-20 12:15,12:15,5422125,8731000,3308875,BUY
09-10-20 12:16,12:16,5441025,8731000,3289975,BUY
09-10-20 12:17,12:17,5395025,8638050,3243025,BUY
09-10-20 12:18,12:18,5354500,8604100,3249600,BUY
09-10-20 12:19,12:19,5365400,8604450,3239050,BUY
09-10-20 12:20,12:20,5396850,8636825,3239975,BUY
09-10-20 12:21,12:21,5400675,8613400,3212725,BUY
09-10-20 12:22,12:22,5409625,8592550,3182925,BUY
09-10-20 12:23,12:23,5336400,8602400,3266000,BUY
09-10-20 12:24,12:24,5431175,8621750,3190575,BUY
09-10-20 12:25,12:25,5387725,8572750,3185025,BUY
09-10-20 12:26,12:26,5404000,8660025,3256025,BUY
09-10-20 12:27,12:27,5362950,8616875,3253925,BUY
09-10-20 12:28,12:28,5436775,8674150,3237375,BUY
09-10-20 12:29,12:29,5496700,8664750,3168050,BUY
09-10-20 12:30,12:30,5468875,8659900,3191025,BUY
09-10-20 12:31,12:31,5372275,8600825,3228550,BUY
09-10-20 12:32,12:32,5422875,8611375,3188500,BUY
09-10-20 12:33,12:33,5479375,8638850,3159475,BUY
09-10-20 12:34,12:34,5447275,8617150,3169875,BUY
09-10-20 12:35,12:35,5488825,8615350,3126525,BUY
09-10-20 12:36,12:36,5496675,8638725,3142050,BUY
09-10-20 12:37,12:37,5462250,8632075,3169825,BUY
09-10-20 12:38,12:38,5464775,8647950,3183175,BUY
09-10-20 12:39,12:39,5470625,8640225,3169600,BUY
09-10-20 12:40,12:40,5435000,8614150,3179150,BUY
09-10-20 12:41,12:41,5483825,8650550,3166725,BUY
09-10-20 12:42,12:42,5483250,8656300,3173050,BUY
09-10-20 12:43,12:43,5397250,8609250,3212000,BUY
09-10-20 12:44,12:44,5435375,8721225,3285850,BUY
09-10-20 12:45,12:45,5561425,8737000,3175575,BUY
09-10-20 12:46,12:46,5426400,8733625,3307225,BUY
09-10-20 12:47,12:47,5540675,8753275,3212600,BUY
09-10-20 12:48,12:48,5505300,8733300,3228000,BUY
09-10-20 12:49,12:49,5502700,8742725,3240025,BUY
09-10-20 12:50,12:50,5487125,8764725,3277600,BUY
09-10-20 12:51,12:51,5473175,8761825,3288650,BUY
09-10-20 12:52,12:52,5491225,8764900,3273675,BUY
09-10-20 12:53,12:53,5530975,8722400,3191425,BUY
09-10-20 12:54,12:54,5443675,8722350,3278675,BUY
09-10-20 12:55,12:55,5543875,8740475,3196600,BUY
09-10-20 12:56,12:56,5506900,8797675,3290775,BUY
09-10-20 12:57,12:57,5456925,8746075,3289150,BUY
09-10-20 12:58,12:58,5460400,8481825,3021425,BUY
09-10-20 12:59,12:59,5479650,8707275,3227625,BUY
09-10-20 13:00,13:00,5536175,8756400,3220225,BUY
09-10-20 13:01,13:01,5444675,8685075,3240400,BUY
09-10-20 13:02,13:02,5443825,8710325,3266500,BUY
09-10-20 13:03,13:03,5558475,8724775,3166300,BUY
09-10-20 13:04,13:04,5481875,8658350,3176475,BUY
09-10-20 13:05,13:05,5562375,8724825,3162450,BUY
09-10-20 13:06,13:06,5564600,8789875,3225275,BUY
09-10-20 13:07,13:07,5473800,8782775,3308975,BUY
09-10-20 13:08,13:08,5472425,8730350,3257925,BUY
09-10-20 13:09,13:09,5513375,8700100,3186725,BUY
09-10-20 13:10,13:10,5539400,8700100,3160700,BUY
09-10-20 13:11,13:11,5594400,8716850,3122450,BUY
09-10-20 13:12,13:12,5575700,8758250,3182550,BUY
09-10-20 13:13,13:13,5472175,8721175,3249000,BUY
09-10-20 13:14,13:14,5565600,8797425,3231825,BUY
09-10-20 13:15,13:15,5569125,8774825,3205700,BUY
09-10-20 13:16,13:16,5567500,8773050,3205550,BUY
09-10-20 13:17,13:17,5572850,8762475,3189625,BUY
09-10-20 13:18,13:18,5567875,8795600,3227725,BUY
09-10-20 13:19,13:19,5448600,8579275,3130675,BUY
09-10-20 13:20,13:20,5554575,8770350,3215775,BUY
09-10-20 13:21,13:21,5537000,8161750,2624750,BUY
09-10-20 13:22,13:22,5527475,8804650,3277175,BUY
09-10-20 13:23,13:23,5531525,8705025,3173500,BUY
09-10-20 13:24,13:24,5479850,8724875,3245025,BUY
09-10-20 13:25,13:25,5598525,8772200,3173675,BUY
09-10-20 13:26,13:26,5531700,8778750,3247050,BUY
09-10-20 13:27,13:27,5526725,8754175,3227450,BUY
09-10-20 13:28,13:28,5507925,8775400,3267475,BUY
09-10-20 13:29,13:29,5486900,8847875,3360975,BUY
09-10-20 13:30,13:30,5487575,8784450,3296875,BUY
09-10-20 13:31,13:31,5557950,8773500,3215550,BUY
09-10-20 13:32,13:32,5473950,8834925,3360975,BUY
09-10-20 13:33,13:33,5519775,8829475,3309700,BUY
09-10-20 13:34,13:34,5562825,8851025,3288200,BUY
09-10-20 13:35,13:35,5568225,8829850,3261625,BUY
09-10-20 13:36,13:36,5588175,8835025,3246850,BUY
09-10-20 13:37,13:37,5570675,8765475,3194800,BUY
09-10-20 13:38,13:38,5593000,8764000,3171000,BUY
09-10-20 13:39,13:39,5613750,8817625,3203875,BUY
09-10-20 13:40,13:40,5659475,8935975,3276500,BUY
09-10-20 13:41,13:41,5653675,8887650,3233975,BUY
09-10-20 13:42,13:42,5586875,8708050,3121175,BUY
09-10-20 13:43,13:43,5490200,8713875,3223675,BUY
09-10-20 13:44,13:44,5549100,8709575,3160475,BUY
09-10-20 13:45,13:45,5631075,8749275,3118200,BUY
09-10-20 13:46,13:46,5503075,8710550,3207475,BUY
09-10-20 13:47,13:47,5640125,8721700,3081575,BUY
09-10-20 13:48,13:48,5574150,8712925,3138775,BUY
09-10-20 13:49,13:49,5516900,8714875,3197975,BUY
09-10-20 13:50,13:50,5585575,8674600,3089025,BUY
09-10-20 13:51,13:51,5636300,8689125,3052825,BUY
09-10-20 13:52,13:52,5629275,8717700,3088425,BUY
09-10-20 13:53,13:53,5655325,8711550,3056225,BUY
09-10-20 13:54,13:54,5588600,8748100,3159500,BUY
09-10-20 13:55,13:55,5574025,8742600,3168575,BUY
09-10-20 13:56,13:56,5604850,8733150,3128300,BUY
09-10-20 13:57,13:57,5633625,8739925,3106300,BUY
09-10-20 13:58,13:58,5566075,8638775,3072700,BUY
09-10-20 13:59,13:59,5590550,8721675,3131125,BUY
09-10-20 14:00,14:00,5658250,8724075,3065825,BUY
09-10-20 14:01,14:01,5614675,8735375,3120700,BUY
09-10-20 14:02,14:02,5662225,8769075,3106850,BUY
09-10-20 14:03,14:03,5618175,8718100,3099925,BUY
09-10-20 14:04,14:04,5653425,8714600,3061175,BUY
09-10-20 14:05,14:05,5641425,8698800,3057375,BUY
09-10-20 14:06,14:06,5590425,8723850,3133425,BUY
09-10-20 14:07,14:07,5595175,8718175,3123000,BUY
09-10-20 14:08,14:08,5682125,8698775,3016650,BUY
09-10-20 14:09,14:09,5669875,8705675,3035800,BUY
09-10-20 14:10,14:10,5714300,8746150,3031850,BUY
09-10-20 14:11,14:11,5695350,8752425,3057075,BUY
09-10-20 14:12,14:12,5787125,8821275,3034150,BUY
09-10-20 14:13,14:13,5780375,8782675,3002300,BUY
09-10-20 14:14,14:14,5723750,8779650,3055900,BUY
09-10-20 14:15,14:15,5544050,8537300,2993250,BUY
09-10-20 14:16,14:16,5552950,8537350,2984400,BUY
09-10-20 14:17,14:17,5487350,8516750,3029400,BUY
09-10-20 14:18,14:18,5478650,8560825,3082175,BUY
09-10-20 14:19,14:19,5482625,8536175,3053550,BUY
09-10-20 14:20,14:20,5493950,8523975,3030025,BUY
09-10-20 14:21,14:21,5424400,8481750,3057350,BUY
09-10-20 14:22,14:22,5407050,8500925,3093875,BUY
09-10-20 14:23,14:23,5415250,8501250,3086000,BUY
09-10-20 14:24,14:24,5478475,8464050,2985575,BUY
09-10-20 14:25,14:25,5492050,8483200,2991150,BUY
09-10-20 14:26,14:26,5504700,8505225,3000525,BUY
09-10-20 14:27,14:27,5444250,8528550,3084300,BUY
09-10-20 14:28,14:28,5416275,8534675,3118400,BUY
09-10-20 14:29,14:29,5434475,8529325,3094850,BUY
09-10-20 14:30,14:30,5385725,8622600,3236875,BUY
09-10-20 14:31,14:31,5445600,8632375,3186775,BUY
09-10-20 14:32,14:32,5439700,8635125,3195425,BUY
09-10-20 14:33,14:33,5358725,8668350,3309625,BUY
09-10-20 14:34,14:34,5366450,8675025,3308575,BUY
09-10-20 14:35,14:35,5379400,8678200,3298800,BUY
09-10-20 14:36,14:36,5386525,8704950,3318425,BUY
09-10-20 14:37,14:37,5352000,8697125,3345125,BUY
09-10-20 14:38,14:38,5362375,8706300,3343925,BUY
09-10-20 14:39,14:39,5346875,8675500,3328625,BUY
09-10-20 14:40,14:40,5374625,8688700,3314075,BUY
09-10-20 14:41,14:41,5405050,8728925,3323875,BUY
09-10-20 14:42,14:42,5307275,8690075,3382800,BUY
09-10-20 14:43,14:43,5314525,8695325,3380800,BUY
09-10-20 14:44,14:44,5291325,8700775,3409450,BUY
09-10-20 14:45,14:45,5305200,8635450,3330250,BUY
09-10-20 14:46,14:46,5234850,8592800,3357950,BUY
09-10-20 14:47,14:47,5321825,8611300,3289475,BUY
09-10-20 14:48,14:48,5242150,8618475,3376325,BUY
09-10-20 14:49,14:49,5202600,8670700,3468100,BUY
09-10-20 14:50,14:50,5286700,8644100,3357400,BUY
09-10-20 14:51,14:51,5218775,8659000,3440225,BUY
09-10-20 14:52,14:52,5245825,8617375,3371550,BUY
09-10-20 14:53,14:53,5229150,8637025,3407875,BUY
09-10-20 14:54,14:54,5190500,8649050,3458550,BUY
09-10-20 14:55,14:55,5262125,8637025,3374900,BUY
09-10-20 14:56,14:56,5192575,8602550,3409975,BUY
09-10-20 14:57,14:57,5230425,8601875,3371450,BUY
09-10-20 14:58,14:58,5249675,8630050,3380375,BUY
09-10-20 14:59,14:59,5225025,8592425,3367400,BUY
09-10-20 15:00,15:00,5160325,8594450,3434125,BUY
09-10-20 15:01,15:01,5152225,8583350,3431125,BUY
09-10-20 15:02,15:02,5189500,8579200,3389700,BUY
09-10-20 15:03,15:03,5161725,8567225,3405500,BUY
09-10-20 15:04,15:04,5159025,8597575,3438550,BUY
09-10-20 15:05,15:05,5176225,8602775,3426550,BUY
09-10-20 15:06,15:06,5014850,8400275,3385425,BUY
09-10-20 15:07,15:07,5039350,8406000,3366650,BUY
09-10-20 15:08,15:08,5056475,8396800,3340325,BUY
09-10-20 15:09,15:09,4991775,8349150,3357375,BUY
09-10-20 15:10,15:10,5023725,8351300,3327575,BUY
09-10-20 15:11,15:11,4994500,8339375,3344875,BUY
09-10-20 15:12,15:12,4847225,8235050,3387825,BUY
09-10-20 15:13,15:13,4843550,8253800,3410250,BUY
09-10-20 15:14,15:14,4827850,8226150,3398300,BUY
09-10-20 15:15,15:15,4797350,8059950,3262600,BUY
09-10-20 15:16,15:16,4787950,8069600,3281650,BUY
09-10-20 15:17,15:17,4819875,8093550,3273675,BUY
09-10-20 15:18,15:18,4599725,7885550,3285825,BUY
09-10-20 15:19,15:19,4647675,7890100,3242425,BUY
09-10-20 15:20,15:20,4661875,7863075,3201200,BUY
09-10-20 15:21,15:21,4452725,7707100,3254375,BUY
09-10-20 15:22,15:22,4465350,7706200,3240850,BUY
09-10-20 15:23,15:23,4429600,7723475,3293875,BUY
09-10-20 15:24,15:24,4337450,7603175,3265725,BUY
09-10-20 15:25,15:25,4365250,7598250,3233000,BUY
09-10-20 15:26,15:26,4331275,7599075,3267800,BUY
09-10-20 15:27,15:27,4212275,7413400,3201125,BUY
09-10-20 15:28,15:28,4203850,7425750,3221900,BUY
09-10-20 15:29,15:29,4212375,7436025,3223650,BUY
12-10-20 9:15,9:15,3952125,7165925,3213800,BUY
12-10-20 9:16,9:16,3985325,7200950,3215625,BUY
12-10-20 9:17,9:17,4342350,7422675,3080325,BUY
12-10-20 9:18,9:18,4343350,7418950,3075600,BUY
12-10-20 9:19,9:19,4354975,7416800,3061825,BUY
12-10-20 9:20,9:20,4634300,7845800,3211500,BUY
12-10-20 9:21,9:21,4629075,7833075,3204000,BUY
12-10-20 9:22,9:22,4604900,7849950,3245050,BUY
12-10-20 9:23,9:23,4816975,8108550,3291575,BUY
12-10-20 9:24,9:24,4826575,8116050,3289475,BUY
12-10-20 9:25,9:25,4795200,8126175,3330975,BUY
12-10-20 9:26,9:26,4929225,8284700,3355475,BUY
12-10-20 9:27,9:27,4922650,8270350,3347700,BUY
12-10-20 9:28,9:28,4871325,8279625,3408300,BUY
12-10-20 9:29,9:29,4910475,8173100,3262625,BUY
12-10-20 9:30,9:30,4968775,8256575,3287800,BUY
12-10-20 9:31,9:31,4972600,8264225,3291625,BUY
12-10-20 9:32,9:32,5009525,8236325,3226800,BUY
12-10-20 9:33,9:33,5069975,8245950,3175975,BUY
12-10-20 9:34,9:34,5054575,8260475,3205900,BUY
12-10-20 9:35,9:35,5136075,8245775,3109700,BUY
12-10-20 9:36,9:36,5088975,8219675,3130700,BUY
12-10-20 9:37,9:37,5072650,8215875,3143225,BUY
12-10-20 9:38,9:38,5238725,8271125,3032400,BUY
12-10-20 9:39,9:39,5239350,8141600,2902250,BUY
12-10-20 9:40,9:40,5253725,8223250,2969525,BUY
12-10-20 9:41,9:41,5290625,8176800,2886175,BUY
12-10-20 9:42,9:42,5338950,8268425,2929475,BUY
12-10-20 9:43,9:43,5308375,8272450,2964075,BUY
12-10-20 9:44,9:44,5395300,8263625,2868325,BUY
12-10-20 9:45,9:45,5379025,8246175,2867150,BUY
12-10-20 9:46,9:46,5386625,8269300,2882675,BUY
12-10-20 9:47,9:47,5483600,8467425,2983825,BUY
12-10-20 9:48,9:48,5503925,8464500,2960575,BUY
12-10-20 9:49,9:49,5432325,8425650,2993325,BUY
12-10-20 9:50,9:50,5554450,8465675,2911225,BUY
12-10-20 9:51,9:51,5561800,8472575,2910775,BUY
12-10-20 9:52,9:52,5550200,8502925,2952725,BUY
12-10-20 9:53,9:53,5615275,8468700,2853425,BUY
12-10-20 9:54,9:54,5527175,8465925,2938750,BUY
12-10-20 9:55,9:55,5591350,8371225,2779875,BUY
12-10-20 9:56,9:56,5639975,8468975,2829000,BUY
12-10-20 9:57,9:57,5592250,8479650,2887400,BUY
12-10-20 9:58,9:58,5583125,8450525,2867400,BUY
12-10-20 9:59,9:59,5719800,8485850,2766050,BUY
12-10-20 10:00,10:00,5716850,8469150,2752300,BUY
12-10-20 10:01,10:01,5718825,8493900,2775075,BUY
12-10-20 10:02,10:02,5840450,8483875,2643425,BUY
12-10-20 10:03,10:03,5857250,8431550,2574300,BUY
12-10-20 10:04,10:04,5773275,8485975,2712700,BUY
12-10-20 10:05,10:05,5832675,8401550,2568875,BUY
12-10-20 10:06,10:06,5904925,8196925,2292000,BUY
12-10-20 10:07,10:07,5841825,8371450,2529625,BUY
12-10-20 10:08,10:08,5952050,8390575,2438525,BUY
12-10-20 10:09,10:09,5931750,8272175,2340425,BUY
12-10-20 10:10,10:10,5919025,8406575,2487550,BUY
12-10-20 10:11,10:11,5978750,8418250,2439500,BUY
12-10-20 10:12,10:12,5959000,8412025,2453025,BUY
12-10-20 10:13,10:13,5940825,8451150,2510325,BUY
12-10-20 10:14,10:14,5996775,8358750,2361975,BUY
12-10-20 10:15,10:15,6016075,8433800,2417725,BUY
12-10-20 10:16,10:16,5996575,8375125,2378550,BUY
12-10-20 10:17,10:17,6036750,8468375,2431625,BUY
12-10-20 10:18,10:18,6076600,8513525,2436925,BUY
12-10-20 10:19,10:19,6035250,8507925,2472675,BUY
12-10-20 10:20,10:20,6077100,8489000,2411900,BUY
12-10-20 10:21,10:21,6055950,8496375,2440425,BUY
12-10-20 10:22,10:22,6052200,8500175,2447975,BUY
12-10-20 10:23,10:23,6165625,8543325,2377700,BUY
12-10-20 10:24,10:24,5989750,8555850,2566100,BUY
12-10-20 10:25,10:25,6158075,8569325,2411250,BUY
12-10-20 10:26,10:26,6256725,8537650,2280925,BUY
12-10-20 10:27,10:27,6224100,8542575,2318475,BUY
12-10-20 10:28,10:28,6163650,8498725,2335075,BUY
12-10-20 10:29,10:29,6207725,8358925,2151200,BUY
12-10-20 10:30,10:30,6262675,8368625,2105950,BUY
12-10-20 10:31,10:31,6248225,8371325,2123100,BUY
12-10-20 10:32,10:32,6212100,8349125,2137025,BUY
12-10-20 10:33,10:33,6152050,8322850,2170800,BUY
12-10-20 10:34,10:34,6185825,8338975,2153150,BUY
12-10-20 10:35,10:35,6269100,8362500,2093400,BUY
12-10-20 10:36,10:36,6194200,8366475,2172275,BUY
12-10-20 10:37,10:37,6184475,8295600,2111125,BUY
12-10-20 10:38,10:38,6286075,8437925,2151850,BUY
12-10-20 10:39,10:39,6296825,8421700,2124875,BUY
12-10-20 10:40,10:40,6251750,8415450,2163700,BUY
12-10-20 10:41,10:41,6288925,8385675,2096750,BUY
12-10-20 10:42,10:42,6180150,8417425,2237275,BUY
12-10-20 10:43,10:43,6256550,8508575,2252025,BUY
12-10-20 10:44,10:44,6321825,8464250,2142425,BUY
12-10-20 10:45,10:45,6267125,8342975,2075850,BUY
12-10-20 10:46,10:46,6237100,8399800,2162700,BUY
12-10-20 10:47,10:47,5969050,8464625,2495575,BUY
12-10-20 10:48,10:48,5979075,8423475,2444400,BUY
12-10-20 10:49,10:49,6254875,8433525,2178650,BUY
12-10-20 10:50,10:50,6280050,8466800,2186750,BUY
12-10-20 10:51,10:51,6260600,8509450,2248850,BUY
12-10-20 10:52,10:52,6356050,8516175,2160125,BUY
12-10-20 10:53,10:53,6324325,8510450,2186125,BUY
12-10-20 10:54,10:54,6294300,8439875,2145575,BUY
12-10-20 10:55,10:55,6242550,8389625,2147075,BUY
12-10-20 10:56,10:56,6338125,8535725,2197600,BUY
12-10-20 10:57,10:57,6361250,8585700,2224450,BUY
12-10-20 10:58,10:58,6190275,8586775,2396500,BUY
12-10-20 10:59,10:59,6391375,8589150,2197775,BUY
12-10-20 11:00,11:00,6257250,8527450,2270200,BUY
12-10-20 11:01,11:01,6410825,8496450,2085625,BUY
12-10-20 11:02,11:02,6304450,8537900,2233450,BUY
12-10-20 11:03,11:03,6478150,8585500,2107350,BUY
12-10-20 11:04,11:04,6402375,8567700,2165325,BUY
12-10-20 11:05,11:05,6501450,8598225,2096775,BUY
12-10-20 11:06,11:06,6469350,8591325,2121975,BUY
12-10-20 11:07,11:07,6534825,8621075,2086250,BUY
12-10-20 11:08,11:08,6484275,8514425,2030150,BUY
12-10-20 11:09,11:09,6452775,8512150,2059375,BUY
12-10-20 11:10,11:10,6504975,8523000,2018025,BUY
12-10-20 11:11,11:11,6512725,8530775,2018050,BUY
12-10-20 11:12,11:12,6502200,8526775,2024575,BUY
12-10-20 11:13,11:13,6512725,8541500,2028775,BUY
12-10-20 11:14,11:14,6533925,8575100,2041175,BUY
12-10-20 11:15,11:15,6535925,8557250,2021325,BUY
12-10-20 11:16,11:16,6542825,8557375,2014550,BUY
12-10-20 11:17,11:17,6491675,8561450,2069775,BUY
12-10-20 11:18,11:18,6518050,8533900,2015850,BUY
12-10-20 11:19,11:19,6655125,8581650,1926525,BUY
12-10-20 11:20,11:20,6670700,8529200,1858500,BUY
12-10-20 11:21,11:21,6598200,8547550,1949350,BUY
12-10-20 11:22,11:22,6585725,8562575,1976850,BUY
12-10-20 11:23,11:23,6665400,8567050,1901650,BUY
12-10-20 11:24,11:24,6656425,8627025,1970600,BUY
12-10-20 11:25,11:25,6685850,8548700,1862850,BUY
12-10-20 11:26,11:26,6654300,8598925,1944625,BUY
12-10-20 11:27,11:27,6647600,8562500,1914900,BUY
12-10-20 11:28,11:28,6674225,8633125,1958900,BUY
12-10-20 11:29,11:29,6727600,8684250,1956650,BUY
12-10-20 11:30,11:30,6710100,8688625,1978525,BUY
12-10-20 11:31,11:31,6707600,8652875,1945275,BUY
12-10-20 11:32,11:32,6772875,8710600,1937725,BUY
12-10-20 11:33,11:33,6786350,8721400,1935050,BUY
12-10-20 11:34,11:34,6622800,8684350,2061550,BUY
12-10-20 11:35,11:35,6738250,8714200,1975950,BUY
12-10-20 11:36,11:36,6666175,8695650,2029475,BUY
12-10-20 11:37,11:37,6700225,8689325,1989100,BUY
12-10-20 11:38,11:38,6499150,8686850,2187700,BUY
12-10-20 11:39,11:39,6664175,8510500,1846325,BUY
12-10-20 11:40,11:40,6603825,8689600,2085775,BUY
12-10-20 11:41,11:41,6514450,8634625,2120175,BUY
12-10-20 11:42,11:42,6623275,8544325,1921050,BUY
12-10-20 11:43,11:43,6622600,8632025,2009425,BUY
12-10-20 11:44,11:44,6724900,8652900,1928000,BUY
12-10-20 11:45,11:45,6723450,8687800,1964350,BUY
12-10-20 11:46,11:46,6665975,8485775,1819800,BUY
12-10-20 11:47,11:47,6716675,8695700,1979025,BUY
12-10-20 11:48,11:48,6473600,8544750,2071150,BUY
12-10-20 11:49,11:49,6681575,8680825,1999250,BUY
12-10-20 11:50,11:50,6669425,8622600,1953175,BUY
12-10-20 11:51,11:51,6722950,8488650,1765700,BUY
12-10-20 11:52,11:52,6648900,8420650,1771750,BUY
12-10-20 11:53,11:53,6738300,8464250,1725950,BUY
12-10-20 11:54,11:54,6698700,8772900,2074200,BUY
12-10-20 11:55,11:55,6807800,8790625,1982825,BUY
12-10-20 11:56,11:56,6808375,8753325,1944950,BUY
12-10-20 11:57,11:57,6826325,8836450,2010125,BUY
12-10-20 11:58,11:58,6837100,8610025,1772925,BUY
12-10-20 11:59,11:59,6832500,8849975,2017475,BUY
12-10-20 12:00,12:00,6812000,8507000,1695000,BUY
12-10-20 12:01,12:01,6839175,8860450,2021275,BUY
12-10-20 12:02,12:02,6868125,8890225,2022100,BUY
12-10-20 12:03,12:03,6887100,8820450,1933350,BUY
12-10-20 12:04,12:04,6950775,8914425,1963650,BUY
12-10-20 12:05,12:05,6950225,8751875,1801650,BUY
12-10-20 12:06,12:06,6900100,8704500,1804400,BUY
12-10-20 12:07,12:07,6932825,8697375,1764550,BUY
12-10-20 12:08,12:08,6768050,8696275,1928225,BUY
12-10-20 12:09,12:09,6970175,8716750,1746575,BUY
12-10-20 12:10,12:10,6929175,8696325,1767150,BUY
12-10-20 12:11,12:11,6811250,8803400,1992150,BUY
12-10-20 12:12,12:12,6991475,8745900,1754425,BUY
12-10-20 12:13,12:13,7064550,8800675,1736125,BUY
12-10-20 12:14,12:14,7007125,8689900,1682775,BUY
12-10-20 12:15,12:15,6993350,8666650,1673300,BUY
12-10-20 12:16,12:16,7020975,8666275,1645300,BUY
12-10-20 12:17,12:17,6980250,8694225,1713975,BUY
12-10-20 12:18,12:18,7007775,8638100,1630325,BUY
12-10-20 12:19,12:19,6980850,8584500,1603650,BUY
12-10-20 12:20,12:20,6952025,8555500,1603475,BUY
12-10-20 12:21,12:21,7029900,8629950,1600050,BUY
12-10-20 12:22,12:22,6974750,8455000,1480250,BUY
12-10-20 12:23,12:23,6971175,8588950,1617775,BUY
12-10-20 12:24,12:24,6910475,8607300,1696825,BUY
12-10-20 12:25,12:25,6957025,8580100,1623075,BUY
12-10-20 12:26,12:26,6905625,8575125,1669500,BUY
12-10-20 12:27,12:27,7001300,8596150,1594850,BUY
12-10-20 12:28,12:28,6981850,8630950,1649100,BUY
12-10-20 12:29,12:29,7069575,8582200,1512625,BUY
12-10-20 12:30,12:30,7023625,8542000,1518375,BUY
12-10-20 12:31,12:31,7015600,8633700,1618100,BUY
12-10-20 12:32,12:32,7023275,8597200,1573925,BUY
12-10-20 12:33,12:33,7028925,8620275,1591350,BUY
12-10-20 12:34,12:34,7035675,8547625,1511950,BUY
12-10-20 12:35,12:35,7046575,8599625,1553050,BUY
12-10-20 12:36,12:36,7046375,8610850,1564475,BUY
12-10-20 12:37,12:37,7083125,8625575,1542450,BUY
12-10-20 12:38,12:38,6844475,8622275,1777800,BUY
12-10-20 12:39,12:39,7158575,8701050,1542475,BUY
12-10-20 12:40,12:40,7087950,8700350,1612400,BUY
12-10-20 12:41,12:41,6980950,8714775,1733825,BUY
12-10-20 12:42,12:42,7014825,8711350,1696525,BUY
12-10-20 12:43,12:43,7028575,8470100,1441525,BUY
12-10-20 12:44,12:44,7058300,8720700,1662400,BUY
12-10-20 12:45,12:45,7121775,8725225,1603450,BUY
12-10-20 12:46,12:46,7130975,8773250,1642275,BUY
12-10-20 12:47,12:47,7067150,8718500,1651350,BUY
12-10-20 12:48,12:48,6978275,8712475,1734200,BUY
12-10-20 12:49,12:49,7132100,8693025,1560925,BUY
12-10-20 12:50,12:50,7086575,8714300,1627725,BUY
12-10-20 12:51,12:51,7108975,8722000,1613025,BUY
12-10-20 12:52,12:52,7098200,8708350,1610150,BUY
12-10-20 12:53,12:53,7174275,8716150,1541875,BUY
12-10-20 12:54,12:54,7079825,8734900,1655075,BUY
12-10-20 12:55,12:55,7049175,8759875,1710700,BUY
12-10-20 12:56,12:56,7260900,8764975,1504075,BUY
12-10-20 12:57,12:57,7084600,8457450,1372850,BUY
12-10-20 12:58,12:58,7242700,8723075,1480375,BUY
12-10-20 12:59,12:59,7236375,8770550,1534175,BUY
12-10-20 13:00,13:00,7281325,8596750,1315425,BUY
12-10-20 13:01,13:01,7328275,8826325,1498050,BUY
12-10-20 13:02,13:02,7313600,8802525,1488925,BUY
12-10-20 13:03,13:03,7273175,8834200,1561025,BUY
12-10-20 13:04,13:04,7249850,8375725,1125875,BUY
12-10-20 13:05,13:05,7366175,8609975,1243800,BUY
12-10-20 13:06,13:06,7348100,8861350,1513250,BUY
12-10-20 13:07,13:07,7331100,8892025,1560925,BUY
12-10-20 13:08,13:08,7389600,8858525,1468925,BUY
12-10-20 13:09,13:09,7358650,8805125,1446475,BUY
12-10-20 13:10,13:10,7400625,8856625,1456000,BUY
12-10-20 13:11,13:11,7357325,8880700,1523375,BUY
12-10-20 13:12,13:12,7460825,8553200,1092375,BUY
12-10-20 13:13,13:13,7424250,8878350,1454100,BUY
12-10-20 13:14,13:14,7343725,8660175,1316450,BUY
12-10-20 13:15,13:15,7443825,8744200,1300375,BUY
12-10-20 13:16,13:16,7443825,8870600,1426775,BUY
12-10-20 13:17,13:17,7487625,8854100,1366475,BUY
12-10-20 13:18,13:18,7537200,8921225,1384025,BUY
12-10-20 13:19,13:19,7605075,8950900,1345825,BUY
12-10-20 13:20,13:20,7577800,8944175,1366375,BUY
12-10-20 13:21,13:21,7457825,8792300,1334475,BUY
12-10-20 13:22,13:22,7497275,8768250,1270975,BUY
12-10-20 13:23,13:23,7466525,8787625,1321100,BUY
12-10-20 13:24,13:24,7544375,8639050,1094675,BUY
12-10-20 13:25,13:25,7587075,8839875,1252800,BUY
12-10-20 13:26,13:26,7620450,8887725,1267275,BUY
12-10-20 13:27,13:27,7644400,8868775,1224375,BUY
12-10-20 13:28,13:28,7631250,8856525,1225275,BUY
12-10-20 13:29,13:29,7631250,8795950,1164700,BUY
12-10-20 13:30,13:30,7703725,8793400,1089675,BUY
12-10-20 13:31,13:31,7674175,8818975,1144800,BUY
12-10-20 13:32,13:32,7685800,8770050,1084250,BUY
12-10-20 13:33,13:33,7753800,8890150,1136350,BUY
12-10-20 13:34,13:34,7457350,7548375,91025,BUY
12-10-20 13:40,13:40,7721675,8919850,1198175,BUY
12-10-20 13:41,13:41,7723175,8943875,1220700,BUY
12-10-20 13:42,13:42,7804425,9003275,1198850,BUY
12-10-20 13:43,13:43,7804425,8982725,1178300,BUY
12-10-20 13:44,13:44,7763600,9002775,1239175,BUY
12-10-20 13:45,13:45,7851150,8959400,1108250,BUY
12-10-20 13:46,13:46,7830700,8958075,1127375,BUY
12-10-20 13:47,13:47,7781100,8936675,1155575,BUY
12-10-20 13:48,13:48,7835875,8977000,1141125,BUY
12-10-20 13:49,13:49,7787500,8948875,1161375,BUY
12-10-20 13:50,13:50,7765225,8934675,1169450,BUY
12-10-20 13:51,13:51,7822450,8952800,1130350,BUY
12-10-20 13:52,13:52,7886175,8974175,1088000,BUY
12-10-20 13:53,13:53,7885300,9016625,1131325,BUY
12-10-20 13:54,13:54,7877925,8921625,1043700,BUY
12-10-20 13:55,13:55,7838550,8991575,1153025,BUY
12-10-20 13:56,13:56,7877150,8973875,1096725,BUY
12-10-20 13:57,13:57,7813700,9058400,1244700,BUY
12-10-20 13:58,13:58,7863500,9051125,1187625,BUY
12-10-20 13:59,13:59,7824925,9052625,1227700,BUY
12-10-20 14:00,14:00,7829300,8992525,1163225,BUY
12-10-20 14:01,14:01,7772400,9032650,1260250,BUY
12-10-20 14:02,14:02,7776550,8955625,1179075,BUY
12-10-20 14:03,14:03,7927200,9097825,1170625,BUY
12-10-20 14:04,14:04,7900250,9081150,1180900,BUY
12-10-20 14:05,14:05,7872875,9090950,1218075,BUY
12-10-20 14:06,14:06,7936850,9095025,1158175,BUY
12-10-20 14:07,14:07,7911175,9137600,1226425,BUY
12-10-20 14:08,14:08,7928300,9111125,1182825,BUY
12-10-20 14:09,14:09,7835550,9100750,1265200,BUY
12-10-20 14:10,14:10,7899950,9109675,1209725,BUY
12-10-20 14:11,14:11,7895675,9086750,1191075,BUY
12-10-20 14:12,14:12,7979350,9076275,1096925,BUY
12-10-20 14:13,14:13,7951475,9090750,1139275,BUY
12-10-20 14:14,14:14,7983575,9082225,1098650,BUY
12-10-20 14:15,14:15,8039300,9035100,995800,BUY
12-10-20 14:16,14:16,8005175,9038900,1033725,BUY
12-10-20 14:17,14:17,7996225,9027100,1030875,BUY
12-10-20 14:18,14:18,8000725,9034550,1033825,BUY
12-10-20 14:19,14:19,7977100,9028100,1051000,BUY
12-10-20 14:20,14:20,7998975,9070625,1071650,BUY
12-10-20 14:21,14:21,7990475,8873625,883150,BUY
12-10-20 14:22,14:22,8043150,8895475,852325,BUY
12-10-20 14:23,14:23,8017200,8909825,892625,BUY
12-10-20 14:24,14:24,8040275,8851925,811650,BUY
12-10-20 14:25,14:25,8006250,8892775,886525,BUY
12-10-20 14:26,14:26,8057475,8885250,827775,BUY
12-10-20 14:27,14:27,8039450,8825750,786300,BUY
12-10-20 14:28,14:28,8039000,8852725,813725,BUY
12-10-20 14:29,14:29,8043125,8780925,737800,BUY
12-10-20 14:30,14:30,8110925,8836525,725600,BUY
12-10-20 14:31,14:31,8042925,8882825,839900,BUY
12-10-20 14:32,14:32,8058200,8859750,801550,BUY
12-10-20 14:33,14:33,8025975,8828850,802875,BUY
12-10-20 14:34,14:34,8054800,8765125,710325,BUY
12-10-20 14:35,14:35,8056425,8765600,709175,BUY
12-10-20 14:36,14:36,8002825,8780550,777725,BUY
12-10-20 14:37,14:37,7968525,8757750,789225,BUY
12-10-20 14:38,14:38,8001875,8778625,776750,BUY
12-10-20 14:39,14:39,8113450,8811050,697600,BUY
12-10-20 14:40,14:40,8010575,8785350,774775,BUY
12-10-20 14:41,14:41,8076925,8816925,740000,BUY
12-10-20 14:42,14:42,7983625,8458600,474975,BUY
12-10-20 14:43,14:43,8053600,8872425,818825,BUY
12-10-20 14:44,14:44,8054500,8823550,769050,BUY
12-10-20 14:45,14:45,7967500,8800950,833450,BUY
12-10-20 14:46,14:46,8052425,8811550,759125,BUY
12-10-20 14:47,14:47,7960250,8866350,906100,BUY
12-10-20 14:48,14:48,7953550,8786275,832725,BUY
12-10-20 14:49,14:49,7993000,8789425,796425,BUY
12-10-20 14:50,14:50,7957850,8791650,833800,BUY
12-10-20 14:51,14:51,7925425,8756700,831275,BUY
12-10-20 14:52,14:52,7967575,8719450,751875,BUY
12-10-20 14:53,14:53,7928350,8768550,840200,BUY
12-10-20 14:54,14:54,7926675,8724900,798225,BUY
12-10-20 14:55,14:55,7926675,8753700,827025,BUY
12-10-20 14:56,14:56,7910000,8695100,785100,BUY
12-10-20 14:57,14:57,7901125,8545625,644500,BUY
12-10-20 14:58,14:58,7891025,8707075,816050,BUY
12-10-20 14:59,14:59,7952150,8745200,793050,BUY
12-10-20 15:00,15:00,7863450,8803775,940325,BUY
12-10-20 15:01,15:01,7851075,8752875,901800,BUY
12-10-20 15:02,15:02,7801000,8777475,976475,BUY
12-10-20 15:03,15:03,7709700,8706775,997075,BUY
12-10-20 15:04,15:04,7702025,8736125,1034100,BUY
12-10-20 15:05,15:05,7710325,8680000,969675,BUY
12-10-20 15:06,15:06,7697700,8708325,1010625,BUY
12-10-20 15:07,15:07,7659400,8712600,1053200,BUY
12-10-20 15:08,15:08,7718375,8718775,1000400,BUY
12-10-20 15:09,15:09,7711725,8676625,964900,BUY
12-10-20 15:10,15:10,7720000,8677200,957200,BUY
12-10-20 15:11,15:11,7707475,8634075,926600,BUY
12-10-20 15:12,15:12,7697625,8619000,921375,BUY
12-10-20 15:13,15:13,7572900,8630875,1057975,BUY
12-10-20 15:14,15:14,7612525,8588150,975625,BUY
12-10-20 15:15,15:15,7611950,8569250,957300,BUY
12-10-20 15:16,15:16,7625775,8590175,964400,BUY
12-10-20 15:17,15:17,7588475,8609300,1020825,BUY
12-10-20 15:18,15:18,7494700,8531800,1037100,BUY
12-10-20 15:19,15:19,7436600,8519400,1082800,BUY
12-10-20 15:20,15:20,7477500,8526900,1049400,BUY
12-10-20 15:21,15:21,7320425,8375075,1054650,BUY
12-10-20 15:22,15:22,7283200,8356200,1073000,BUY
12-10-20 15:23,15:23,7237425,8331575,1094150,BUY
12-10-20 15:24,15:24,7216250,8286675,1070425,BUY
12-10-20 15:25,15:25,7270675,8332725,1062050,BUY
12-10-20 15:26,15:26,7172550,8310325,1137775,BUY
12-10-20 15:27,15:27,7065525,8146400,1080875,BUY
12-10-20 15:28,15:28,7079225,8160900,1081675,BUY
12-10-20 15:29,15:29,7087250,8149450,1062200,BUY
13-10-20 9:15,9:15,6902675,7868500,965825,BUY
13-10-20 9:16,9:16,6882700,7851775,969075,BUY
13-10-20 9:17,9:17,7113925,8089600,975675,BUY
13-10-20 9:18,9:18,7103450,8124775,1021325,BUY
13-10-20 9:19,9:19,7110850,8109950,999100,BUY
13-10-20 9:20,9:20,7432125,8636350,1204225,BUY
13-10-20 9:21,9:21,7424900,8569850,1144950,BUY
13-10-20 9:22,9:22,7371750,8635325,1263575,BUY
13-10-20 9:23,9:23,7667025,8946575,1279550,BUY
13-10-20 9:24,9:24,7721900,8950900,1229000,BUY
13-10-20 9:25,9:25,7709350,8924550,1215200,BUY
13-10-20 9:26,9:26,7890900,9015075,1124175,BUY
13-10-20 9:27,9:27,7878800,8988475,1109675,BUY
13-10-20 9:28,9:28,7884025,8988700,1104675,BUY
13-10-20 9:29,9:29,7943400,8955425,1012025,BUY
13-10-20 9:30,9:30,7970650,9002850,1032200,BUY
13-10-20 9:31,9:31,7951675,9024500,1072825,BUY
13-10-20 9:32,9:32,8017925,9077850,1059925,BUY
13-10-20 9:33,9:33,8032575,9046625,1014050,BUY
13-10-20 9:34,9:34,7992025,9038825,1046800,BUY
13-10-20 9:35,9:35,8048775,9259450,1210675,BUY
13-10-20 9:36,9:36,8002375,9256300,1253925,BUY
13-10-20 9:37,9:37,8021725,9231925,1210200,BUY
13-10-20 9:38,9:38,8086350,9217075,1130725,BUY
13-10-20 9:39,9:39,8086275,9202900,1116625,BUY
13-10-20 9:40,9:40,8095425,9271925,1176500,BUY
13-10-20 9:41,9:41,8145400,9136025,990625,BUY
13-10-20 9:42,9:42,8144825,9070350,925525,BUY
13-10-20 9:43,9:43,8183150,9152525,969375,BUY
13-10-20 9:44,9:44,8225700,9104525,878825,BUY
13-10-20 9:45,9:45,8238100,9112450,874350,BUY
13-10-20 9:46,9:46,8156350,9102350,946000,BUY
13-10-20 9:47,9:47,8137175,9084100,946925,BUY
13-10-20 9:48,9:48,8143700,9106225,962525,BUY
13-10-20 9:49,9:49,8134400,9051350,916950,BUY
13-10-20 9:50,9:50,8211000,9125325,914325,BUY
13-10-20 9:51,9:51,8228325,9200475,972150,BUY
13-10-20 9:52,9:52,8180775,9135400,954625,BUY
13-10-20 9:53,9:53,8283050,9180850,897800,BUY
13-10-20 9:54,9:54,8200450,9133250,932800,BUY
13-10-20 9:55,9:55,8296725,8761400,464675,BUY
13-10-20 9:56,9:56,8317850,9161875,844025,BUY
13-10-20 9:57,9:57,8318825,9170125,851300,BUY
13-10-20 9:58,9:58,8247500,9145875,898375,BUY
13-10-20 9:59,9:59,8345825,9163975,818150,BUY
13-10-20 10:00,10:00,8384175,9221725,837550,BUY
13-10-20 10:01,10:01,8387975,9246650,858675,BUY
13-10-20 10:02,10:02,8464000,9343875,879875,BUY
13-10-20 10:03,10:03,8470375,9270350,799975,BUY
13-10-20 10:04,10:04,8408525,9293050,884525,BUY
13-10-20 10:05,10:05,8533125,9346975,813850,BUY
13-10-20 10:06,10:06,8574475,9348700,774225,BUY
13-10-20 10:07,10:07,8502000,9401950,899950,BUY
13-10-20 10:08,10:08,8612225,9389375,777150,BUY
13-10-20 10:09,10:09,8564600,9384175,819575,BUY
13-10-20 10:10,10:10,8597650,9354250,756600,BUY
13-10-20 10:11,10:11,8560925,9319950,759025,BUY
13-10-20 10:12,10:12,8577825,9331475,753650,BUY
13-10-20 10:13,10:13,8589450,9287075,697625,BUY
13-10-20 10:14,10:14,8615575,9363075,747500,BUY
13-10-20 10:15,10:15,8633525,9390700,757175,BUY
13-10-20 10:16,10:16,8585900,9312325,726425,BUY
13-10-20 10:17,10:17,8611250,9326625,715375,BUY
13-10-20 10:18,10:18,8603100,9312825,709725,BUY
13-10-20 10:19,10:19,8555900,9382375,826475,BUY
13-10-20 10:20,10:20,8619550,9439600,820050,BUY
13-10-20 10:21,10:21,8626250,9377675,751425,BUY
13-10-20 10:22,10:22,8653925,9505725,851800,BUY
13-10-20 10:23,10:23,8620850,9533550,912700,BUY
13-10-20 10:24,10:24,8598075,9475175,877100,BUY
13-10-20 10:25,10:25,8534425,9491900,957475,BUY
13-10-20 10:26,10:26,8544950,9440325,895375,BUY
13-10-20 10:27,10:27,8507350,9405700,898350,BUY
13-10-20 10:28,10:28,8542475,9459825,917350,BUY
13-10-20 10:29,10:29,8581925,9452775,870850,BUY
13-10-20 10:30,10:30,8554100,9427450,873350,BUY
13-10-20 10:31,10:31,8590500,9467100,876600,BUY
13-10-20 10:32,10:32,8536300,9434300,898000,BUY
13-10-20 10:33,10:33,8545325,9468675,923350,BUY
13-10-20 10:34,10:34,8551575,9504125,952550,BUY
13-10-20 10:35,10:35,8617175,9064875,447700,BUY
13-10-20 10:36,10:36,8579375,9530275,950900,BUY
13-10-20 10:37,10:37,8596700,9532150,935450,BUY
13-10-20 10:38,10:38,8567800,9283125,715325,BUY
13-10-20 10:39,10:39,8662025,9595625,933600,BUY
13-10-20 10:40,10:40,8657950,9572775,914825,BUY
13-10-20 10:41,10:41,8297450,9545950,1248500,BUY
13-10-20 10:42,10:42,8228625,8977250,748625,BUY
13-10-20 10:43,10:43,8228975,9526775,1297800,BUY
13-10-20 10:44,10:44,8321600,9560450,1238850,BUY
13-10-20 10:45,10:45,8419725,9589025,1169300,BUY
13-10-20 10:46,10:46,8382775,9614050,1231275,BUY
13-10-20 10:47,10:47,8220300,9581425,1361125,BUY
13-10-20 10:48,10:48,8123925,9601300,1477375,BUY
13-10-20 10:49,10:49,8245550,9602625,1357075,BUY
13-10-20 10:50,10:50,8269700,9656325,1386625,BUY
13-10-20 10:51,10:51,8269700,9644875,1375175,BUY
13-10-20 10:52,10:52,8301250,9651450,1350200,BUY
13-10-20 10:53,10:53,8270800,9668825,1398025,BUY
13-10-20 10:54,10:54,8300425,9712600,1412175,BUY
13-10-20 10:55,10:55,8285800,9718850,1433050,BUY
13-10-20 10:56,10:56,8351050,9627050,1276000,BUY
13-10-20 10:57,10:57,8399150,9648825,1249675,BUY
13-10-20 10:58,10:58,8358850,9650475,1291625,BUY
13-10-20 10:59,10:59,8495675,9527450,1031775,BUY
13-10-20 11:00,11:00,8524375,9724700,1200325,BUY
13-10-20 11:01,11:01,8468600,9407650,939050,BUY
13-10-20 11:02,11:02,8632775,9496200,863425,BUY
13-10-20 11:03,11:03,8632775,9706925,1074150,BUY
13-10-20 11:04,11:04,8683450,9743125,1059675,BUY
13-10-20 11:05,11:05,8693375,9778700,1085325,BUY
13-10-20 11:06,11:06,8638300,9475925,837625,BUY
13-10-20 11:07,11:07,8696925,9514450,817525,BUY
13-10-20 11:08,11:08,8721175,9559575,838400,BUY
13-10-20 11:09,11:09,8780975,9603375,822400,BUY
13-10-20 11:10,11:10,8781800,9842475,1060675,BUY
13-10-20 11:11,11:11,8854675,9803775,949100,BUY
13-10-20 11:12,11:12,8845650,9636400,790750,BUY
13-10-20 11:13,11:13,8798700,9668125,869425,BUY
13-10-20 11:14,11:14,8800325,9625900,825575,BUY
13-10-20 11:15,11:15,8873675,9583800,710125,BUY
13-10-20 11:16,11:16,8865775,9562125,696350,BUY
13-10-20 11:17,11:17,8965500,9771825,806325,BUY
13-10-20 11:18,11:18,8846250,9748925,902675,BUY
13-10-20 11:19,11:19,8861700,9818475,956775,BUY
13-10-20 11:20,11:20,8653350,9778225,1124875,BUY
13-10-20 11:21,11:21,8911800,9473775,561975,BUY
13-10-20 11:22,11:22,8923250,9816025,892775,BUY
13-10-20 11:23,11:23,8907375,9796150,888775,BUY
13-10-20 11:24,11:24,8846700,9814375,967675,BUY
13-10-20 11:25,11:25,8925875,9869575,943700,BUY
13-10-20 11:26,11:26,8928525,9672725,744200,BUY
13-10-20 11:27,11:27,8984750,9920125,935375,BUY
13-10-20 11:28,11:28,8974675,9890175,915500,BUY
13-10-20 11:29,11:29,8989100,9883175,894075,BUY
13-10-20 11:30,11:30,8932675,9674750,742075,BUY
13-10-20 11:31,11:31,8925125,9787375,862250,BUY
13-10-20 11:32,11:32,8904400,9596725,692325,BUY
13-10-20 11:33,11:33,8926700,9529225,602525,BUY
13-10-20 11:34,11:34,8952875,9648775,695900,BUY
13-10-20 11:35,11:35,8931275,9756000,824725,BUY
13-10-20 11:36,11:36,9010275,9725975,715700,BUY
13-10-20 11:37,11:37,8959500,9415850,456350,BUY
13-10-20 11:38,11:38,8931700,9092875,161175,BUY
13-10-20 11:39,11:39,9002550,9529725,527175,BUY
13-10-20 11:40,11:40,8940475,9582175,641700,BUY
13-10-20 11:41,11:41,8974825,9469825,495000,BUY
13-10-20 11:42,11:42,8955200,9814925,859725,BUY
13-10-20 11:43,11:43,8976550,9513675,537125,BUY
13-10-20 11:44,11:44,8911325,9848850,937525,BUY
13-10-20 11:45,11:45,8975325,9788700,813375,BUY
13-10-20 11:46,11:46,8930425,9825850,895425,BUY
13-10-20 11:47,11:47,9020525,9843800,823275,BUY
13-10-20 11:48,11:48,8980225,9746475,766250,BUY
13-10-20 11:49,11:49,8909200,9757175,847975,BUY
13-10-20 11:50,11:50,8984025,9708325,724300,BUY
13-10-20 11:51,11:51,8887725,9740575,852850,BUY
13-10-20 11:52,11:52,8974250,9754425,780175,BUY
13-10-20 11:53,11:53,8990550,9798000,807450,BUY
13-10-20 11:54,11:54,8981925,9771800,789875,BUY
13-10-20 11:55,11:55,8981550,9832575,851025,BUY
13-10-20 11:56,11:56,9021175,9824325,803150,BUY
13-10-20 11:57,11:57,8938325,9822575,884250,BUY
13-10-20 11:58,11:58,8994300,9587775,593475,BUY
13-10-20 11:59,11:59,8968725,9527300,558575,BUY
13-10-20 12:00,12:00,8972225,9878350,906125,BUY
13-10-20 12:01,12:01,8987700,9898175,910475,BUY
13-10-20 12:02,12:02,8889325,9807175,917850,BUY
13-10-20 12:03,12:03,8906525,9823275,916750,BUY
13-10-20 12:04,12:04,8825025,9774150,949125,BUY
13-10-20 12:05,12:05,9031800,9899875,868075,BUY
13-10-20 12:06,12:06,8992825,9872425,879600,BUY
13-10-20 12:07,12:07,8966400,9798350,831950,BUY
13-10-20 12:08,12:08,8942500,9840775,898275,BUY
13-10-20 12:09,12:09,8885400,9810900,925500,BUY
13-10-20 12:10,12:10,8907175,9801275,894100,BUY
13-10-20 12:11,12:11,8912925,9833450,920525,BUY
13-10-20 12:12,12:12,8913075,9810300,897225,BUY
13-10-20 12:13,12:13,8927925,9863400,935475,BUY
13-10-20 12:14,12:14,8941100,9912500,971400,BUY
13-10-20 12:15,12:15,9007875,9921575,913700,BUY
13-10-20 12:16,12:16,8996400,9919725,923325,BUY
13-10-20 12:17,12:17,8952575,9765450,812875,BUY
13-10-20 12:18,12:18,8937200,9741250,804050,BUY
13-10-20 12:19,12:19,8976250,9759425,783175,BUY
13-10-20 12:20,12:20,9033000,9829500,796500,BUY
13-10-20 12:21,12:21,9015325,9795975,780650,BUY
13-10-20 12:22,12:22,9006575,9735425,728850,BUY
13-10-20 12:23,12:23,8974225,9788300,814075,BUY
13-10-20 12:24,12:24,9026950,9781125,754175,BUY
13-10-20 12:25,12:25,9013175,9751950,738775,BUY
13-10-20 12:26,12:26,9004200,9504525,500325,BUY
13-10-20 12:27,12:27,9031800,9823700,791900,BUY
13-10-20 12:28,12:28,9069825,9857075,787250,BUY
13-10-20 12:29,12:29,9001225,9823425,822200,BUY
13-10-20 12:30,12:30,9022200,9821675,799475,BUY
13-10-20 12:31,12:31,8951525,9759700,808175,BUY
13-10-20 12:32,12:32,9081050,9811400,730350,BUY
13-10-20 12:33,12:33,9025350,9816850,791500,BUY
13-10-20 12:34,12:34,9026200,9414925,388725,BUY
13-10-20 12:35,12:35,9118025,9836025,718000,BUY
13-10-20 12:36,12:36,9110175,9841175,731000,BUY
13-10-20 12:37,12:37,9108950,9824800,715850,BUY
13-10-20 12:38,12:38,9042700,9806950,764250,BUY
13-10-20 12:39,12:39,9102650,9653950,551300,BUY
13-10-20 12:40,12:40,9027800,9828975,801175,BUY
13-10-20 12:41,12:41,9072950,9504925,431975,BUY
13-10-20 12:42,12:42,9098125,9870725,772600,BUY
13-10-20 12:43,12:43,9069375,9578400,509025,BUY
13-10-20 12:44,12:44,9137850,9484875,347025,BUY
13-10-20 12:45,12:45,9124125,9864600,740475,BUY
13-10-20 12:46,12:46,9198675,9842725,644050,BUY
13-10-20 12:47,12:47,9189975,9686000,496025,BUY
13-10-20 12:48,12:48,9108675,9698125,589450,BUY
13-10-20 12:49,12:49,9159475,9656975,497500,BUY
13-10-20 12:50,12:50,9235050,9719375,484325,BUY
13-10-20 12:51,12:51,9223175,9739950,516775,BUY
13-10-20 12:52,12:52,9226000,9726725,500725,BUY
13-10-20 12:53,12:53,9187650,9679700,492050,BUY
13-10-20 12:54,12:54,9249650,9686100,436450,BUY
13-10-20 12:55,12:55,9187525,9713375,525850,BUY
13-10-20 12:56,12:56,9229150,9701300,472150,BUY
13-10-20 12:57,12:57,9305425,9701925,396500,BUY
13-10-20 12:58,12:58,9253775,9341750,87975,BUY
13-10-20 12:59,12:59,9313725,9703600,389875,BUY
13-10-20 13:00,13:00,9261925,9616175,354250,BUY
13-10-20 13:01,13:01,9284550,9642575,358025,BUY
13-10-20 13:02,13:02,9254875,9318225,63350,BUY
13-10-20 13:03,13:03,9362550,9666100,303550,BUY
13-10-20 13:04,13:04,9319900,9610850,290950,BUY
13-10-20 13:05,13:05,9378025,9628450,250425,BUY
13-10-20 13:06,13:06,9411300,9755300,344000,BUY
13-10-20 13:07,13:07,9467350,9760575,293225,BUY
13-10-20 13:08,13:08,9425300,9408475,-16825,SELL
13-10-20 13:09,13:09,9382550,9743525,360975,BUY
13-10-20 13:10,13:10,9387000,9671350,284350,BUY
13-10-20 13:11,13:11,9406225,9770625,364400,BUY
13-10-20 13:12,13:12,9386875,9654325,267450,BUY
13-10-20 13:13,13:13,9316925,9662450,345525,BUY
13-10-20 13:14,13:14,9358900,9614675,255775,BUY
13-10-20 13:15,13:15,9422800,9349300,-73500,SELL
13-10-20 13:16,13:16,9371125,9471100,99975,BUY
13-10-20 13:17,13:17,9399600,9670875,271275,BUY
13-10-20 13:18,13:18,9305450,9557425,251975,BUY
13-10-20 13:19,13:19,9436000,9694050,258050,BUY
13-10-20 13:20,13:20,9388025,9030675,-357350,SELL
13-10-20 13:21,13:21,9360225,9524300,164075,BUY
13-10-20 13:22,13:22,9286850,9555975,269125,BUY
13-10-20 13:23,13:23,9385125,9396425,11300,BUY
13-10-20 13:24,13:24,9437075,9595200,158125,BUY
13-10-20 13:25,13:25,9362575,9635475,272900,BUY
13-10-20 13:26,13:26,9338850,9586125,247275,BUY
13-10-20 13:27,13:27,9330725,9354100,23375,BUY
13-10-20 13:28,13:28,9331775,9061575,-270200,SELL
13-10-20 13:29,13:29,9363725,9266450,-97275,SELL
13-10-20 13:30,13:30,9350500,9611075,260575,BUY
13-10-20 13:31,13:31,9395200,9336525,-58675,SELL
13-10-20 13:32,13:32,9420025,9658850,238825,BUY
13-10-20 13:33,13:33,9391100,9083000,-308100,SELL
13-10-20 13:34,13:34,9346400,9630950,284550,BUY
13-10-20 13:35,13:35,9283950,9543025,259075,BUY
13-10-20 13:36,13:36,9379175,9643375,264200,BUY
13-10-20 13:37,13:37,9396200,9586800,190600,BUY
13-10-20 13:38,13:38,9480875,9604800,123925,BUY
13-10-20 13:39,13:39,9391575,9561750,170175,BUY
13-10-20 13:40,13:40,9357000,9035200,-321800,SELL
13-10-20 13:41,13:41,9320000,9371675,51675,BUY
13-10-20 13:42,13:42,9443625,9652275,208650,BUY
13-10-20 13:43,13:43,9374200,9635125,260925,BUY
13-10-20 13:44,13:44,9407400,9648575,241175,BUY
13-10-20 13:45,13:45,9529375,9686150,156775,BUY
13-10-20 13:46,13:46,9484925,9208300,-276625,SELL
13-10-20 13:47,13:47,9491650,9458350,-33300,SELL
13-10-20 13:48,13:48,9557375,9788250,230875,BUY
13-10-20 13:49,13:49,9505000,9719000,214000,BUY
13-10-20 13:50,13:50,9538850,9515450,-23400,SELL
13-10-20 13:51,13:51,9587150,9761750,174600,BUY
13-10-20 13:52,13:52,9570475,9425000,-145475,SELL
13-10-20 13:53,13:53,9483475,9665175,181700,BUY
13-10-20 13:54,13:54,9500150,9648275,148125,BUY
13-10-20 13:55,13:55,9546900,9692350,145450,BUY
13-10-20 13:56,13:56,9569825,9670200,100375,BUY
13-10-20 13:57,13:57,9575100,9192200,-382900,SELL
13-10-20 13:58,13:58,9556475,9749750,193275,BUY
13-10-20 13:59,13:59,9548575,9654050,105475,BUY
13-10-20 14:00,14:00,9627650,9781800,154150,BUY
13-10-20 14:01,14:01,9628400,9708100,79700,BUY
13-10-20 14:02,14:02,9636500,9781275,144775,BUY
13-10-20 14:03,14:03,9601325,9654200,52875,BUY
13-10-20 14:04,14:04,9559425,9680125,120700,BUY
13-10-20 14:05,14:05,9611900,9652975,41075,BUY
13-10-20 14:06,14:06,9573125,9738525,165400,BUY
13-10-20 14:07,14:07,9627625,9430125,-197500,SELL
13-10-20 14:08,14:08,9597525,9741300,143775,BUY
13-10-20 14:09,14:09,9665350,9474475,-190875,SELL
13-10-20 14:10,14:10,9627400,9751725,124325,BUY
13-10-20 14:11,14:11,9643450,9709000,65550,BUY
13-10-20 14:12,14:12,9625750,9749000,123250,BUY
13-10-20 14:13,14:13,9621475,9584200,-37275,SELL
13-10-20 14:14,14:14,9642375,9744950,102575,BUY
13-10-20 14:15,14:15,9710175,9813250,103075,BUY
13-10-20 14:16,14:16,9677175,9782350,105175,BUY
13-10-20 14:17,14:17,9638100,9721650,83550,BUY
13-10-20 14:18,14:18,9596050,9664300,68250,BUY
13-10-20 14:19,14:19,9640725,9664575,23850,BUY
13-10-20 14:20,14:20,9677625,9694300,16675,BUY
13-10-20 14:21,14:21,9623850,9594300,-29550,SELL
13-10-20 14:22,14:22,9600225,9601175,950,BUY
13-10-20 14:23,14:23,9605200,9307850,-297350,SELL
13-10-20 14:24,14:24,9667500,9633975,-33525,SELL
13-10-20 14:25,14:25,9684800,9611475,-73325,SELL
13-10-20 14:26,14:26,9668300,9645500,-22800,SELL
13-10-20 14:27,14:27,9694800,9568700,-126100,SELL
13-10-20 14:28,14:28,9677550,9550950,-126600,SELL
13-10-20 14:29,14:29,9698650,9332725,-365925,SELL
13-10-20 14:30,14:30,9739350,9613225,-126125,SELL
13-10-20 14:31,14:31,9696600,9573025,-123575,SELL
13-10-20 14:32,14:32,9719275,9625975,-93300,SELL
13-10-20 14:33,14:33,9669875,9556450,-113425,SELL
13-10-20 14:34,14:34,9653325,9578875,-74450,SELL
13-10-20 14:35,14:35,9697875,9602750,-95125,SELL
13-10-20 14:36,14:36,9713500,9382325,-331175,SELL
13-10-20 14:37,14:37,9709550,9556950,-152600,SELL
13-10-20 14:38,14:38,9733325,9401050,-332275,SELL
13-10-20 14:39,14:39,9746075,9606300,-139775,SELL
13-10-20 14:40,14:40,9683075,9571825,-111250,SELL
13-10-20 14:41,14:41,9670625,9542675,-127950,SELL
13-10-20 14:42,14:42,9606775,9515850,-90925,SELL
13-10-20 14:43,14:43,9678750,9542900,-135850,SELL
13-10-20 14:44,14:44,9653975,9566575,-87400,SELL
13-10-20 14:45,14:45,9624400,9517275,-107125,SELL
13-10-20 14:46,14:46,9641075,9491275,-149800,SELL
13-10-20 14:47,14:47,9566775,9435375,-131400,SELL
13-10-20 14:48,14:48,9687000,9514850,-172150,SELL
13-10-20 14:49,14:49,9631300,9508825,-122475,SELL
13-10-20 14:50,14:50,9593550,9456425,-137125,SELL
13-10-20 14:51,14:51,9485075,9368400,-116675,SELL
13-10-20 14:52,14:52,9493150,9338175,-154975,SELL
13-10-20 14:53,14:53,9491075,9355600,-135475,SELL
13-10-20 14:54,14:54,9487075,9357575,-129500,SELL
13-10-20 14:55,14:55,9504050,9411650,-92400,SELL
13-10-20 14:56,14:56,9492750,9168450,-324300,SELL
13-10-20 14:57,14:57,9403000,9305325,-97675,SELL
13-10-20 14:58,14:58,9419350,9305925,-113425,SELL
13-10-20 14:59,14:59,9435425,9126900,-308525,SELL
13-10-20 15:00,15:00,9385725,9207775,-177950,SELL
13-10-20 15:01,15:01,9392200,9290850,-101350,SELL
13-10-20 15:02,15:02,9350275,9306550,-43725,SELL
13-10-20 15:03,15:03,9375825,9217075,-158750,SELL
13-10-20 15:04,15:04,9359225,9222175,-137050,SELL
13-10-20 15:05,15:05,9319025,9185425,-133600,SELL
13-10-20 15:06,15:06,9179850,9042525,-137325,SELL
13-10-20 15:07,15:07,9229875,9044275,-185600,SELL
13-10-20 15:08,15:08,9227600,9090050,-137550,SELL
13-10-20 15:09,15:09,9216425,9039550,-176875,SELL
13-10-20 15:10,15:10,9206200,9045850,-160350,SELL
13-10-20 15:11,15:11,9231225,9043425,-187800,SELL
13-10-20 15:12,15:12,9181400,8982125,-199275,SELL
13-10-20 15:13,15:13,9172225,8962325,-209900,SELL
13-10-20 15:14,15:14,9179050,8688725,-490325,SELL
13-10-20 15:15,15:15,9139175,8841700,-297475,SELL
13-10-20 15:16,15:16,9084700,8851650,-233050,SELL
13-10-20 15:17,15:17,9117350,8852900,-264450,SELL
13-10-20 15:18,15:18,9035150,8750700,-284450,SELL
13-10-20 15:19,15:19,8976550,8692075,-284475,SELL
13-10-20 15:20,15:20,9050850,8778250,-272600,SELL
13-10-20 15:21,15:21,8823975,8533650,-290325,SELL
13-10-20 15:22,15:22,8829175,8535575,-293600,SELL
13-10-20 15:23,15:23,8811025,8515400,-295625,SELL
13-10-20 15:24,15:24,8681125,8357425,-323700,SELL
13-10-20 15:25,15:25,8700900,8441650,-259250,SELL
13-10-20 15:26,15:26,8649550,8352575,-296975,SELL
13-10-20 15:27,15:27,8600650,8170775,-429875,SELL
13-10-20 15:28,15:28,8576175,8212900,-363275,SELL
13-10-20 15:29,15:29,8565775,8227400,-338375,SELL
14-10-20 9:15,9:15,8373100,7913300,-459800,SELL
14-10-20 9:16,9:16,8362875,7887750,-475125,SELL
14-10-20 9:17,9:17,8772875,8324025,-448850,SELL
14-10-20 9:18,9:18,8770625,8316600,-454025,SELL
14-10-20 9:19,9:19,8759050,8340325,-418725,SELL
14-10-20 9:20,9:20,9160600,8691025,-469575,SELL
14-10-20 9:21,9:21,9152625,8587775,-564850,SELL
14-10-20 9:22,9:22,9129775,8650200,-479575,SELL
14-10-20 9:23,9:23,9383325,8856700,-526625,SELL
14-10-20 9:24,9:24,9396125,8876000,-520125,SELL
14-10-20 9:25,9:25,9388550,8831325,-557225,SELL
14-10-20 9:26,9:26,9459475,9012200,-447275,SELL
14-10-20 9:27,9:27,9449150,8981800,-467350,SELL
14-10-20 9:28,9:28,9444050,8969325,-474725,SELL
14-10-20 9:29,9:29,9647325,9051850,-595475,SELL
14-10-20 9:30,9:30,9644300,9012125,-632175,SELL
14-10-20 9:31,9:31,9614100,9067950,-546150,SELL
14-10-20 9:32,9:32,9818300,9223875,-594425,SELL
14-10-20 9:33,9:33,9783050,9181650,-601400,SELL
14-10-20 9:34,9:34,9795525,9170650,-624875,SELL
14-10-20 9:35,9:35,9867525,9215300,-652225,SELL
14-10-20 9:36,9:36,9891900,9197275,-694625,SELL
14-10-20 9:37,9:37,9866625,9141425,-725200,SELL
14-10-20 9:38,9:38,10029925,9296725,-733200,SELL
14-10-20 9:39,9:39,10026975,9284925,-742050,SELL
14-10-20 9:40,9:40,10048925,9284575,-764350,SELL
14-10-20 9:41,9:41,10154075,9421350,-732725,SELL
14-10-20 9:42,9:42,10145000,9473750,-671250,SELL
14-10-20 9:43,9:43,10131475,9412550,-718925,SELL
14-10-20 9:44,9:44,10360150,9531025,-829125,SELL
14-10-20 9:45,9:45,10358900,9500300,-858600,SELL
14-10-20 9:46,9:46,10337475,9505525,-831950,SELL
14-10-20 9:47,9:47,10509175,9364600,-1144575,SELL
14-10-20 9:48,9:48,10493475,9380800,-1112675,SELL
14-10-20 9:49,9:49,10501375,9325950,-1175425,SELL
14-10-20 9:50,9:50,10603075,9536200,-1066875,SELL
14-10-20 9:51,9:51,10598050,9467875,-1130175,SELL
14-10-20 9:52,9:52,10588700,9496425,-1092275,SELL
14-10-20 9:53,9:53,10668275,9577600,-1090675,SELL
14-10-20 9:54,9:54,10689650,9603800,-1085850,SELL
14-10-20 9:55,9:55,10690875,9574175,-1116700,SELL
14-10-20 9:56,9:56,10702125,9621700,-1080425,SELL
14-10-20 9:57,9:57,10689150,9613575,-1075575,SELL
14-10-20 9:58,9:58,10683875,9606800,-1077075,SELL
14-10-20 9:59,9:59,10678850,9394225,-1284625,SELL
14-10-20 10:00,10:00,10671825,9657625,-1014200,SELL
14-10-20 10:01,10:01,10675625,9656625,-1019000,SELL
14-10-20 10:02,10:02,10699425,9643450,-1055975,SELL
14-10-20 10:03,10:03,10687350,9605750,-1081600,SELL
14-10-20 10:04,10:04,10704450,9610525,-1093925,SELL
14-10-20 10:05,10:05,10778200,9539025,-1239175,SELL
14-10-20 10:06,10:06,10737800,9500700,-1237100,SELL
14-10-20 10:07,10:07,10789150,9722325,-1066825,SELL
14-10-20 10:08,10:08,10839100,9711475,-1127625,SELL
14-10-20 10:09,10:09,10855350,9785350,-1070000,SELL
14-10-20 10:10,10:10,10803300,9781150,-1022150,SELL
14-10-20 10:11,10:11,10879175,9588500,-1290675,SELL
14-10-20 10:12,10:12,10879350,9828500,-1050850,SELL
14-10-20 10:13,10:13,10840325,9469675,-1370650,SELL
14-10-20 10:14,10:14,10958700,9749275,-1209425,SELL
14-10-20 10:15,10:15,10989100,9521750,-1467350,SELL
14-10-20 10:16,10:16,10934475,9714975,-1219500,SELL
14-10-20 10:17,10:17,11090800,9871050,-1219750,SELL
14-10-20 10:18,10:18,11060500,9854225,-1206275,SELL
14-10-20 10:19,10:19,11105850,9956150,-1149700,SELL
14-10-20 10:20,10:20,11044025,9584375,-1459650,SELL
14-10-20 10:21,10:21,11045425,9596450,-1448975,SELL
14-10-20 10:22,10:22,10985475,9230100,-1755375,SELL
14-10-20 10:23,10:23,11125075,9429400,-1695675,SELL
14-10-20 10:24,10:24,11124775,9912450,-1212325,SELL
14-10-20 10:25,10:25,11118975,9805725,-1313250,SELL
14-10-20 10:26,10:26,11216700,9747125,-1469575,SELL
14-10-20 10:27,10:27,11218000,9689425,-1528575,SELL
14-10-20 10:28,10:28,11172400,9689825,-1482575,SELL
14-10-20 10:29,10:29,11291450,9916525,-1374925,SELL
14-10-20 10:30,10:30,11296225,9748500,-1547725,SELL
14-10-20 10:31,10:31,11294050,9390375,-1903675,SELL
14-10-20 10:32,10:32,11358150,9572750,-1785400,SELL
14-10-20 10:33,10:33,11371100,9460350,-1910750,SELL
14-10-20 10:34,10:34,11368325,9862625,-1505700,SELL
14-10-20 10:35,10:35,11397025,9739600,-1657425,SELL
14-10-20 10:36,10:36,11398475,9951375,-1447100,SELL
14-10-20 10:37,10:37,11392325,9638250,-1754075,SELL
14-10-20 10:38,10:38,11448100,9913550,-1534550,SELL
14-10-20 10:39,10:39,11387375,9623075,-1764300,SELL
14-10-20 10:40,10:40,11356925,9837450,-1519475,SELL
14-10-20 10:41,10:41,11465775,9880550,-1585225,SELL
14-10-20 10:42,10:42,11471100,9793925,-1677175,SELL
14-10-20 10:43,10:43,11420925,9940400,-1480525,SELL
14-10-20 10:44,10:44,11437625,9889050,-1548575,SELL
14-10-20 10:45,10:45,11475000,9153575,-2321425,SELL
14-10-20 10:46,10:46,11457625,9917725,-1539900,SELL
14-10-20 10:47,10:47,11499000,9991550,-1507450,SELL
14-10-20 10:48,10:48,11503500,9990175,-1513325,SELL
14-10-20 10:49,10:49,11484250,9946800,-1537450,SELL
14-10-20 10:50,10:50,11546325,10001000,-1545325,SELL
14-10-20 10:51,10:51,11535300,9750325,-1784975,SELL
14-10-20 10:52,10:52,11527975,9993975,-1534000,SELL
14-10-20 10:53,10:53,11620775,9973550,-1647225,SELL
14-10-20 10:54,10:54,11546400,9745450,-1800950,SELL
14-10-20 10:55,10:55,11565950,8921925,-2644025,SELL
14-10-20 10:56,10:56,11637450,9944925,-1692525,SELL
14-10-20 10:57,10:57,11580750,9859025,-1721725,SELL
14-10-20 10:58,10:58,11635950,9791900,-1844050,SELL
14-10-20 10:59,10:59,11654650,9074350,-2580300,SELL
14-10-20 11:00,11:00,11680125,9925850,-1754275,SELL
14-10-20 11:01,11:01,11691600,9949325,-1742275,SELL
14-10-20 11:02,11:02,11748300,8944175,-2804125,SELL
14-10-20 11:03,11:03,11703175,9816275,-1886900,SELL
14-10-20 11:04,11:04,11728850,9934175,-1794675,SELL
14-10-20 11:05,11:05,11802800,9577800,-2225000,SELL
14-10-20 11:06,11:06,11837125,10081225,-1755900,SELL
14-10-20 11:07,11:07,11798425,10089750,-1708675,SELL
14-10-20 11:08,11:08,11732675,9869050,-1863625,SELL
14-10-20 11:09,11:09,11716125,9958775,-1757350,SELL
14-10-20 11:10,11:10,11713050,9885275,-1827775,SELL
14-10-20 11:11,11:11,11761000,9708125,-2052875,SELL
14-10-20 11:12,11:12,11755450,9929600,-1825850,SELL
14-10-20 11:13,11:13,11738900,9258625,-2480275,SELL
14-10-20 11:14,11:14,11821575,9603500,-2218075,SELL
14-10-20 11:15,11:15,11774350,9593600,-2180750,SELL
14-10-20 11:16,11:16,11761250,9699600,-2061650,SELL
14-10-20 11:17,11:17,11898650,9755725,-2142925,SELL
14-10-20 11:18,11:18,11916500,10029525,-1886975,SELL
14-10-20 11:19,11:19,11897650,9927900,-1969750,SELL
14-10-20 11:20,11:20,11878550,9866875,-2011675,SELL
14-10-20 11:21,11:21,11890900,9889875,-2001025,SELL
14-10-20 11:22,11:22,11877250,9880000,-1997250,SELL
14-10-20 11:23,11:23,11907475,9881100,-2026375,SELL
14-10-20 11:24,11:24,11913125,9636700,-2276425,SELL
14-10-20 11:25,11:25,11853175,9649550,-2203625,SELL
14-10-20 11:26,11:26,11954775,9268925,-2685850,SELL
14-10-20 11:27,11:27,11995925,9895900,-2100025,SELL
14-10-20 11:28,11:28,11910650,9484900,-2425750,SELL
14-10-20 11:29,11:29,12099025,9663075,-2435950,SELL
14-10-20 11:30,11:30,12105925,9979175,-2126750,SELL
14-10-20 11:31,11:31,12098800,9733925,-2364875,SELL
14-10-20 11:32,11:32,12047650,9600400,-2447250,SELL
14-10-20 11:33,11:33,12035700,9720600,-2315100,SELL
14-10-20 11:34,11:34,12052550,9799575,-2252975,SELL
14-10-20 11:35,11:35,12106475,9838700,-2267775,SELL
14-10-20 11:36,11:36,12095275,9281250,-2814025,SELL
14-10-20 11:37,11:37,12009150,9617425,-2391725,SELL
14-10-20 11:38,11:38,12076300,9725875,-2350425,SELL
14-10-20 11:39,11:39,12047975,9269950,-2778025,SELL
14-10-20 11:40,11:40,12087500,9782625,-2304875,SELL
14-10-20 11:41,11:41,12030450,9408675,-2621775,SELL
14-10-20 11:42,11:42,12079225,9216275,-2862950,SELL
14-10-20 11:43,11:43,12092425,9321725,-2770700,SELL
14-10-20 11:44,11:44,12112350,9748000,-2364350,SELL
14-10-20 11:45,11:45,12100625,9748025,-2352600,SELL
14-10-20 11:46,11:46,12111675,9543850,-2567825,SELL
14-10-20 11:47,11:47,11864600,9744775,-2119825,SELL
14-10-20 11:48,11:48,12131650,9498775,-2632875,SELL
14-10-20 11:49,11:49,12104300,9565675,-2538625,SELL
14-10-20 11:50,11:50,12138375,9211450,-2926925,SELL
14-10-20 11:51,11:51,12115050,9470200,-2644850,SELL
14-10-20 11:52,11:52,12128850,9681375,-2447475,SELL
14-10-20 11:53,11:53,12205275,9812325,-2392950,SELL
14-10-20 11:54,11:54,12206450,9746675,-2459775,SELL
14-10-20 11:55,11:55,12235150,9852550,-2382600,SELL
14-10-20 11:56,11:56,12189400,9757225,-2432175,SELL
14-10-20 11:57,11:57,12195725,9037450,-3158275,SELL
14-10-20 11:58,11:58,12174600,9186875,-2987725,SELL
14-10-20 11:59,11:59,12236275,9877250,-2359025,SELL
14-10-20 12:00,12:00,12256925,9590000,-2666925,SELL
14-10-20 12:01,12:01,12240350,9626050,-2614300,SELL
14-10-20 12:02,12:02,12305075,9821150,-2483925,SELL
14-10-20 12:03,12:03,12304225,9869825,-2434400,SELL
14-10-20 12:04,12:04,12286525,9575050,-2711475,SELL
14-10-20 12:05,12:05,12401000,9842900,-2558100,SELL
14-10-20 12:06,12:06,12375350,9761925,-2613425,SELL
14-10-20 12:07,12:07,12366500,9886825,-2479675,SELL
14-10-20 12:08,12:08,12365300,9815625,-2549675,SELL
14-10-20 12:09,12:09,12320500,9648950,-2671550,SELL
14-10-20 12:10,12:10,12320500,9833950,-2486550,SELL
14-10-20 12:11,12:11,12387675,9856625,-2531050,SELL
14-10-20 12:12,12:12,12401900,9817200,-2584700,SELL
14-10-20 12:13,12:13,12442375,9197775,-3244600,SELL
14-10-20 12:14,12:14,12460200,9726050,-2734150,SELL
14-10-20 12:15,12:15,12471025,9860125,-2610900,SELL
14-10-20 12:16,12:16,12441100,9967150,-2473950,SELL
14-10-20 12:17,12:17,12450125,9764200,-2685925,SELL
14-10-20 12:18,12:18,12483975,9867625,-2616350,SELL
14-10-20 12:19,12:19,12458900,9560000,-2898900,SELL
14-10-20 12:20,12:20,12456725,9739225,-2717500,SELL
14-10-20 12:21,12:21,12433075,9880175,-2552900,SELL
14-10-20 12:22,12:22,12450725,9518200,-2932525,SELL
14-10-20 12:23,12:23,12426125,9678300,-2747825,SELL
14-10-20 12:24,12:24,12545675,10052300,-2493375,SELL
14-10-20 12:25,12:25,12534600,10051800,-2482800,SELL
14-10-20 12:26,12:26,12006450,9910525,-2095925,SELL
14-10-20 12:27,12:27,11992575,9833350,-2159225,SELL
14-10-20 12:28,12:28,11991350,9828950,-2162400,SELL
14-10-20 12:29,12:29,12058625,9925850,-2132775,SELL
14-10-20 12:30,12:30,12067100,9804000,-2263100,SELL
14-10-20 12:31,12:31,12024850,9912200,-2112650,SELL
14-10-20 12:32,12:32,12090650,9946225,-2144425,SELL
14-10-20 12:33,12:33,12105950,10027075,-2078875,SELL
14-10-20 12:34,12:34,12090700,9799550,-2291150,SELL
14-10-20 12:35,12:35,12064200,9974650,-2089550,SELL
14-10-20 12:36,12:36,12046950,9960925,-2086025,SELL
14-10-20 12:37,12:37,12008925,9973550,-2035375,SELL
14-10-20 12:38,12:38,12048975,9948600,-2100375,SELL
14-10-20 12:39,12:39,12057200,9976625,-2080575,SELL
14-10-20 12:40,12:40,12049825,10026275,-2023550,SELL
14-10-20 12:41,12:41,12101075,10171325,-1929750,SELL
14-10-20 12:42,12:42,12063825,9965475,-2098350,SELL
14-10-20 12:43,12:43,12033525,10082425,-1951100,SELL
14-10-20 12:44,12:44,12012350,10044075,-1968275,SELL
14-10-20 12:45,12:45,12038525,9680025,-2358500,SELL
14-10-20 12:46,12:46,12082650,10012450,-2070200,SELL
14-10-20 12:47,12:47,12065100,9979450,-2085650,SELL
14-10-20 12:48,12:48,12025625,9961800,-2063825,SELL
14-10-20 12:49,12:49,12056950,9771850,-2285100,SELL
14-10-20 12:50,12:50,12104225,9923100,-2181125,SELL
14-10-20 12:51,12:51,12067225,10024500,-2042725,SELL
14-10-20 12:52,12:52,12056225,9669825,-2386400,SELL
14-10-20 12:53,12:53,12051100,9635675,-2415425,SELL
14-10-20 12:54,12:54,12066275,9832000,-2234275,SELL
14-10-20 12:55,12:55,12068925,10093450,-1975475,SELL
14-10-20 12:56,12:56,12059050,9980375,-2078675,SELL
14-10-20 12:57,12:57,12076850,9922950,-2153900,SELL
14-10-20 12:58,12:58,12017000,10026625,-1990375,SELL
14-10-20 12:59,12:59,12039150,10100825,-1938325,SELL
14-10-20 13:00,13:00,12078100,10054425,-2023675,SELL
14-10-20 13:01,13:01,12024425,10047800,-1976625,SELL
14-10-20 13:02,13:02,12115575,10091200,-2024375,SELL
14-10-20 13:03,13:03,12099250,10031400,-2067850,SELL
14-10-20 13:04,13:04,12106075,10026250,-2079825,SELL
14-10-20 13:05,13:05,12080325,9782100,-2298225,SELL
14-10-20 13:06,13:06,11993925,9832400,-2161525,SELL
14-10-20 13:07,13:07,12006125,9588750,-2417375,SELL
14-10-20 13:08,13:08,12021050,9073175,-2947875,SELL
14-10-20 13:09,13:09,12016375,9487525,-2528850,SELL
14-10-20 13:10,13:10,11994500,9553700,-2440800,SELL
14-10-20 13:11,13:11,12026950,9627875,-2399075,SELL
14-10-20 13:12,13:12,12042775,9662750,-2380025,SELL
14-10-20 13:13,13:13,12074550,9932550,-2142000,SELL
14-10-20 13:14,13:14,12060150,9779700,-2280450,SELL
14-10-20 13:15,13:15,12042950,9903650,-2139300,SELL
14-10-20 13:16,13:16,12055775,9872900,-2182875,SELL
14-10-20 13:17,13:17,12066425,9398100,-2668325,SELL
14-10-20 13:18,13:18,12101800,9711875,-2389925,SELL
14-10-20 13:19,13:19,12101800,9688875,-2412925,SELL
14-10-20 13:20,13:20,12047375,9457525,-2589850,SELL
14-10-20 13:21,13:21,12130050,9632175,-2497875,SELL
14-10-20 13:22,13:22,12123650,9862850,-2260800,SELL
14-10-20 13:23,13:23,12158725,9729925,-2428800,SELL
14-10-20 13:24,13:24,12200000,9713525,-2486475,SELL
14-10-20 13:25,13:25,12223325,9446950,-2776375,SELL
14-10-20 13:26,13:26,12159400,9506500,-2652900,SELL
14-10-20 13:27,13:27,12175825,9710800,-2465025,SELL
14-10-20 13:28,13:28,12187650,9196200,-2991450,SELL
14-10-20 13:29,13:29,12216050,9652300,-2563750,SELL
14-10-20 13:30,13:30,12257325,9889775,-2367550,SELL
14-10-20 13:31,13:31,12234125,9896350,-2337775,SELL
14-10-20 13:32,13:32,12192600,9962975,-2229625,SELL
14-10-20 13:33,13:33,12243775,9666850,-2576925,SELL
14-10-20 13:34,13:34,12225125,9426600,-2798525,SELL
14-10-20 13:35,13:35,12262725,9964525,-2298200,SELL
14-10-20 13:36,13:36,12166925,9735275,-2431650,SELL
14-10-20 13:37,13:37,12207850,9446575,-2761275,SELL
14-10-20 13:38,13:38,12207850,9636100,-2571750,SELL
14-10-20 13:39,13:39,12246275,9771950,-2474325,SELL
14-10-20 13:40,13:40,12263300,10053400,-2209900,SELL
14-10-20 13:41,13:41,12233500,9580575,-2652925,SELL
14-10-20 13:42,13:42,12245400,9629050,-2616350,SELL
14-10-20 13:43,13:43,12234800,9772600,-2462200,SELL
14-10-20 13:44,13:44,12248175,9950100,-2298075,SELL
14-10-20 13:45,13:45,12279575,9766900,-2512675,SELL
14-10-20 13:46,13:46,12268050,9947575,-2320475,SELL
14-10-20 13:47,13:47,12282500,9906650,-2375850,SELL
14-10-20 13:48,13:48,12218875,9619175,-2599700,SELL
14-10-20 13:49,13:49,12274250,9959825,-2314425,SELL
14-10-20 13:50,13:50,12229975,10019900,-2210075,SELL
14-10-20 13:51,13:51,12279725,9678950,-2600775,SELL
14-10-20 13:52,13:52,12256075,9488400,-2767675,SELL
14-10-20 13:53,13:53,12256075,9163075,-3093000,SELL
14-10-20 13:54,13:54,12284125,9980625,-2303500,SELL
14-10-20 13:55,13:55,12268275,9733975,-2534300,SELL
14-10-20 13:56,13:56,12294175,10063200,-2230975,SELL
14-10-20 13:57,13:57,12229625,9524300,-2705325,SELL
14-10-20 13:58,13:58,12240050,9800825,-2439225,SELL
14-10-20 13:59,13:59,12257350,10033375,-2223975,SELL
14-10-20 14:00,14:00,12245550,10097225,-2148325,SELL
14-10-20 14:01,14:01,12210200,9842875,-2367325,SELL
14-10-20 14:02,14:02,12213100,9806825,-2406275,SELL
14-10-20 14:03,14:03,12031525,9977075,-2054450,SELL
14-10-20 14:04,14:04,12075350,9885400,-2189950,SELL
14-10-20 14:05,14:05,12091250,9773750,-2317500,SELL
14-10-20 14:06,14:06,12049100,9538000,-2511100,SELL
14-10-20 14:07,14:07,12064825,9730650,-2334175,SELL
14-10-20 14:08,14:08,12078500,9804450,-2274050,SELL
14-10-20 14:09,14:09,12047675,9773850,-2273825,SELL
14-10-20 14:10,14:10,12056725,9872625,-2184100,SELL
14-10-20 14:11,14:11,12027475,9782375,-2245100,SELL
14-10-20 14:12,14:12,12028325,9685050,-2343275,SELL
14-10-20 14:13,14:13,12019600,9548075,-2471525,SELL
14-10-20 14:14,14:14,12023375,9677250,-2346125,SELL
14-10-20 14:15,14:15,12011550,9871675,-2139875,SELL
14-10-20 14:16,14:16,12006975,9671175,-2335800,SELL
14-10-20 14:17,14:17,12011575,9830700,-2180875,SELL
14-10-20 14:18,14:18,11957400,9807425,-2149975,SELL
14-10-20 14:19,14:19,12011725,9934075,-2077650,SELL
14-10-20 14:20,14:20,12015350,9994175,-2021175,SELL
14-10-20 14:21,14:21,11163525,9693200,-1470325,SELL
14-10-20 14:22,14:22,11175650,9877125,-1298525,SELL
14-10-20 14:23,14:23,11151450,9900375,-1251075,SELL
14-10-20 14:24,14:24,10689675,9813975,-875700,SELL
14-10-20 14:25,14:25,10689675,9811125,-878550,SELL
14-10-20 14:26,14:26,10687425,9632200,-1055225,SELL
14-10-20 14:27,14:27,10592625,9916000,-676625,SELL
14-10-20 14:28,14:28,10590150,9892750,-697400,SELL
14-10-20 14:29,14:29,10562100,9906375,-655725,SELL
14-10-20 14:30,14:30,10379925,9938950,-440975,SELL
14-10-20 14:31,14:31,10379275,9886900,-492375,SELL
14-10-20 14:32,14:32,10378100,9927075,-451025,SELL
14-10-20 14:33,14:33,10124775,9996075,-128700,SELL
14-10-20 14:34,14:34,10146950,10002850,-144100,SELL
14-10-20 14:35,14:35,10134325,10023175,-111150,SELL
14-10-20 14:36,14:36,10211250,9880250,-331000,SELL
14-10-20 14:37,14:37,10188725,9997475,-191250,SELL
14-10-20 14:38,14:38,10161925,10045175,-116750,SELL
14-10-20 14:39,14:39,10045275,10019275,-26000,SELL
14-10-20 14:40,14:40,10015650,9940275,-75375,SELL
14-10-20 14:41,14:41,10015650,9795475,-220175,SELL
14-10-20 14:42,14:42,10134775,9877250,-257525,SELL
14-10-20 14:43,14:43,10164325,10124950,-39375,SELL
14-10-20 14:44,14:44,10164325,10141225,-23100,SELL
14-10-20 14:45,14:45,9970000,10229200,259200,BUY
14-10-20 14:46,14:46,9928750,10148225,219475,BUY
14-10-20 14:47,14:47,9932750,10173175,240425,BUY
14-10-20 14:48,14:48,9994750,10028200,33450,BUY
14-10-20 14:49,14:49,9951850,10089925,138075,BUY
14-10-20 14:50,14:50,9994750,9905075,-89675,SELL
14-10-20 14:51,14:51,9988100,10087025,98925,BUY
14-10-20 14:52,14:52,9963250,9613600,-349650,SELL
14-10-20 14:53,14:53,9996225,10089375,93150,BUY
14-10-20 14:54,14:54,9993200,10079950,86750,BUY
14-10-20 14:55,14:55,10040325,10152800,112475,BUY
14-10-20 14:56,14:56,10043900,10159175,115275,BUY
14-10-20 14:57,14:57,9560125,9997225,437100,BUY
14-10-20 14:58,14:58,9584875,9994950,410075,BUY
14-10-20 14:59,14:59,9584875,10000625,415750,BUY
14-10-20 15:00,15:00,9316500,9886600,570100,BUY
14-10-20 15:01,15:01,9320450,9878750,558300,BUY
14-10-20 15:02,15:02,9317125,9862450,545325,BUY
14-10-20 15:03,15:03,9156225,9869325,713100,BUY
14-10-20 15:04,15:04,9163625,9908450,744825,BUY
14-10-20 15:05,15:05,9163625,9921775,758150,BUY
14-10-20 15:06,15:06,9108950,9942275,833325,BUY
14-10-20 15:07,15:07,9115175,9974175,859000,BUY
14-10-20 15:08,15:08,9071650,9971425,899775,BUY
14-10-20 15:09,15:09,9082350,10077350,995000,BUY
14-10-20 15:10,15:10,9102225,10102425,1000200,BUY
14-10-20 15:11,15:11,9074175,10053100,978925,BUY
14-10-20 15:12,15:12,8856075,10083650,1227575,BUY
14-10-20 15:13,15:13,8848675,10043275,1194600,BUY
14-10-20 15:14,15:14,8831300,10026725,1195425,BUY
14-10-20 15:15,15:15,8798675,9952575,1153900,BUY
14-10-20 15:16,15:16,8784675,9927325,1142650,BUY
14-10-20 15:17,15:17,8789100,9978150,1189050,BUY
14-10-20 15:18,15:18,8358325,9803050,1444725,BUY
14-10-20 15:19,15:19,8350250,9789825,1439575,BUY
14-10-20 15:20,15:20,8371700,9788600,1416900,BUY
14-10-20 15:21,15:21,8011000,9575325,1564325,BUY
14-10-20 15:22,15:22,7999975,9576500,1576525,BUY
14-10-20 15:23,15:23,8008300,9588625,1580325,BUY
14-10-20 15:24,15:24,7865100,9450150,1585050,BUY
14-10-20 15:25,15:25,7905500,9457325,1551825,BUY
14-10-20 15:26,15:26,7850675,9476400,1625725,BUY
14-10-20 15:27,15:27,7920525,9476450,1555925,BUY
14-10-20 15:28,15:28,7900825,9482725,1581900,BUY
14-10-20 15:29,15:29,7915800,9482925,1567125,BUY
15-10-20 9:15,9:15,7379350,8246825,867475,BUY
15-10-20 9:16,9:16,7434750,8288650,853900,BUY
15-10-20 9:17,9:17,8512250,10081150,1568900,BUY
15-10-20 9:18,9:18,8536625,10086725,1550100,BUY
15-10-20 9:19,9:19,8531625,10067825,1536200,BUY
15-10-20 9:20,9:20,10104450,11077375,972925,BUY
15-10-20 9:21,9:21,10066775,11059275,992500,BUY
15-10-20 9:22,9:22,10089500,11058475,968975,BUY
15-10-20 9:23,9:23,11160650,11541350,380700,BUY
15-10-20 9:24,9:24,11174325,11686225,511900,BUY
15-10-20 9:25,9:25,11153375,11704200,550825,BUY
15-10-20 9:26,9:26,11882925,12377950,495025,BUY
15-10-20 9:27,9:27,11896125,12416275,520150,BUY
15-10-20 9:28,9:28,11867975,12276425,408450,BUY
15-10-20 9:29,9:29,12424400,12787375,362975,BUY
15-10-20 9:30,9:30,12442000,12709950,267950,BUY
15-10-20 9:31,9:31,12427000,12770025,343025,BUY
15-10-20 9:32,9:32,13016200,13104775,88575,BUY
15-10-20 9:33,9:33,13037975,12760725,-277250,SELL
15-10-20 9:34,9:34,13008075,13120300,112225,BUY
15-10-20 9:35,9:35,13227775,13572000,344225,BUY
15-10-20 9:36,9:36,13278100,13578600,300500,BUY
15-10-20 9:37,9:37,13286750,13510200,223450,BUY
15-10-20 9:38,9:38,13114175,14047700,933525,BUY
15-10-20 9:39,9:39,13112600,14039975,927375,BUY
15-10-20 9:40,9:40,13093300,14036825,943525,BUY
15-10-20 9:41,9:41,13008975,14453725,1444750,BUY
15-10-20 9:42,9:42,12997875,14448575,1450700,BUY
15-10-20 9:43,9:43,12970600,14265425,1294825,BUY
15-10-20 9:44,9:44,13411025,14571225,1160200,BUY
15-10-20 9:45,9:45,13425775,14571600,1145825,BUY
15-10-20 9:46,9:46,13417250,14355100,937850,BUY
15-10-20 9:47,9:47,13690250,14885825,1195575,BUY
15-10-20 9:48,9:48,13690775,14739750,1048975,BUY
15-10-20 9:49,9:49,13688075,14526150,838075,BUY
15-10-20 9:50,9:50,12485025,15446175,2961150,BUY
15-10-20 9:51,9:51,12502875,15256725,2753850,BUY
15-10-20 9:52,9:52,12484425,15393775,2909350,BUY
15-10-20 9:53,9:53,12161650,16009000,3847350,BUY
15-10-20 9:54,9:54,12189825,15834175,3644350,BUY
15-10-20 9:55,9:55,12163600,15758350,3594750,BUY
15-10-20 9:56,9:56,12183575,16304425,4120850,BUY
15-10-20 9:57,9:57,12180625,16253975,4073350,BUY
15-10-20 9:58,9:58,12180625,16087150,3906525,BUY
15-10-20 9:59,9:59,12513725,16367125,3853400,BUY
15-10-20 10:00,10:00,12578375,16330150,3751775,BUY
15-10-20 10:01,10:01,12547675,16392850,3845175,BUY
15-10-20 10:02,10:02,13136500,16537225,3400725,BUY
15-10-20 10:03,10:03,13106125,16812000,3705875,BUY
15-10-20 10:04,10:04,13112275,16600375,3488100,BUY
15-10-20 10:05,10:05,13578200,17106575,3528375,BUY
15-10-20 10:06,10:06,13546250,16507725,2961475,BUY
15-10-20 10:07,10:07,13508350,17236425,3728075,BUY
15-10-20 10:08,10:08,13926475,17412400,3485925,BUY
15-10-20 10:09,10:09,13919225,17400700,3481475,BUY
15-10-20 10:10,10:10,13922700,17415275,3492575,BUY
15-10-20 10:11,10:11,14295550,17405400,3109850,BUY
15-10-20 10:12,10:12,14255250,17764050,3508800,BUY
15-10-20 10:13,10:13,14278975,17735925,3456950,BUY
15-10-20 10:14,10:14,14498075,17631225,3133150,BUY
15-10-20 10:15,10:15,14511775,16988075,2476300,BUY
15-10-20 10:16,10:16,14523475,17641850,3118375,BUY
15-10-20 10:17,10:17,14781250,18076775,3295525,BUY
15-10-20 10:18,10:18,14747925,17864150,3116225,BUY
15-10-20 10:19,10:19,14740000,18187775,3447775,BUY
15-10-20 10:20,10:20,15033425,18334750,3301325,BUY
15-10-20 10:21,10:21,15032175,18340850,3308675,BUY
15-10-20 10:22,10:22,15045475,17876100,2830625,BUY
15-10-20 10:23,10:23,15300125,18627925,3327800,BUY
15-10-20 10:24,10:24,15262025,18308825,3046800,BUY
15-10-20 10:25,10:25,15248275,18479600,3231325,BUY
15-10-20 10:26,10:26,15286075,17858100,2572025,BUY
15-10-20 10:27,10:27,15261775,17716025,2454250,BUY
15-10-20 10:28,10:28,15240750,18018200,2777450,BUY
15-10-20 10:29,10:29,15523875,17819900,2296025,BUY
15-10-20 10:30,10:30,15550475,17930150,2379675,BUY
15-10-20 10:31,10:31,15464425,17896775,2432350,BUY
15-10-20 10:32,10:32,15619850,17327800,1707950,BUY
15-10-20 10:33,10:33,15720550,17686475,1965925,BUY
15-10-20 10:34,10:34,15692200,17353650,1661450,BUY
15-10-20 10:35,10:35,15777200,17909925,2132725,BUY
15-10-20 10:36,10:36,15794300,17902125,2107825,BUY
15-10-20 10:37,10:37,15809175,17365875,1556700,BUY
15-10-20 10:38,10:38,16000750,17897925,1897175,BUY
15-10-20 10:39,10:39,16021550,18128000,2106450,BUY
15-10-20 10:40,10:40,16014975,18116550,2101575,BUY
15-10-20 10:41,10:41,16177175,18270275,2093100,BUY
15-10-20 10:42,10:42,16159325,18261175,2101850,BUY
15-10-20 10:43,10:43,16190475,18101125,1910650,BUY
15-10-20 10:44,10:44,16431475,18159600,1728125,BUY
15-10-20 10:45,10:45,16441175,17327250,886075,BUY
15-10-20 10:46,10:46,16430800,18215375,1784575,BUY
15-10-20 10:47,10:47,16509975,18331850,1821875,BUY
15-10-20 10:48,10:48,16469150,18341725,1872575,BUY
15-10-20 10:49,10:49,16539675,18568675,2029000,BUY
15-10-20 10:50,10:50,16758625,18563675,1805050,BUY
15-10-20 10:51,10:51,16737100,18393525,1656425,BUY
15-10-20 10:52,10:52,16686400,18722300,2035900,BUY
15-10-20 10:53,10:53,16844625,18567400,1722775,BUY
15-10-20 10:54,10:54,16734275,18602700,1868425,BUY
15-10-20 10:55,10:55,16857150,18771850,1914700,BUY
15-10-20 10:56,10:56,16643975,18489250,1845275,BUY
15-10-20 10:57,10:57,16649250,18818650,2169400,BUY
15-10-20 10:58,10:58,16615700,18026625,1410925,BUY
15-10-20 10:59,10:59,16775300,18408750,1633450,BUY
15-10-20 11:00,11:00,16776000,18796825,2020825,BUY
15-10-20 11:01,11:01,16751150,18397725,1646575,BUY
15-10-20 11:02,11:02,16814225,18238075,1423850,BUY
15-10-20 11:03,11:03,16916700,18636875,1720175,BUY
15-10-20 11:04,11:04,16770150,18899675,2129525,BUY
15-10-20 11:05,11:05,16903750,18811450,1907700,BUY
15-10-20 11:06,11:06,16925600,19258475,2332875,BUY
15-10-20 11:07,11:07,16939250,19085925,2146675,BUY
15-10-20 11:08,11:08,16978950,19251375,2272425,BUY
15-10-20 11:09,11:09,16941150,19173475,2232325,BUY
15-10-20 11:10,11:10,16952200,18318525,1366325,BUY
15-10-20 11:11,11:11,17014325,19461650,2447325,BUY
15-10-20 11:12,11:12,17045175,19092450,2047275,BUY
15-10-20 11:13,11:13,17053375,18227275,1173900,BUY
15-10-20 11:14,11:14,17043225,19449525,2406300,BUY
15-10-20 11:15,11:15,17132350,19110750,1978400,BUY
15-10-20 11:16,11:16,17103450,19062150,1958700,BUY
15-10-20 11:17,11:17,17185875,18726950,1541075,BUY
15-10-20 11:18,11:18,17187125,19401550,2214425,BUY
15-10-20 11:19,11:19,17204975,18202325,997350,BUY
15-10-20 11:20,11:20,17284000,18739725,1455725,BUY
15-10-20 11:21,11:21,17134825,18912575,1777750,BUY
15-10-20 11:22,11:22,17287250,19720350,2433100,BUY
15-10-20 11:23,11:23,17434900,19433075,1998175,BUY
15-10-20 11:24,11:24,17381475,19166075,1784600,BUY
15-10-20 11:25,11:25,17449250,19394050,1944800,BUY
15-10-20 11:26,11:26,17514600,18749825,1235225,BUY
15-10-20 11:27,11:27,17499700,19541075,2041375,BUY
15-10-20 11:28,11:28,17447825,19264575,1816750,BUY
15-10-20 11:29,11:29,17561850,18815175,1253325,BUY
15-10-20 11:30,11:30,17681975,19084975,1403000,BUY
15-10-20 11:31,11:31,17619850,18924350,1304500,BUY
15-10-20 11:32,11:32,17823625,19564225,1740600,BUY
15-10-20 11:33,11:33,17795600,19565950,1770350,BUY
15-10-20 11:34,11:34,17762800,19438750,1675950,BUY
15-10-20 11:35,11:35,17821450,18860250,1038800,BUY
15-10-20 11:36,11:36,17805200,18870650,1065450,BUY
15-10-20 11:37,11:37,17833600,19059425,1225825,BUY
15-10-20 11:38,11:38,17986000,18961825,975825,BUY
15-10-20 11:39,11:39,17953650,18687075,733425,BUY
15-10-20 11:40,11:40,17951850,18741150,789300,BUY
15-10-20 11:41,11:41,17999675,18395525,395850,BUY
15-10-20 11:42,11:42,18002300,18955550,953250,BUY
15-10-20 11:43,11:43,17999325,17634825,-364500,SELL
15-10-20 11:44,11:44,17989400,18388150,398750,BUY
15-10-20 11:45,11:45,18016925,19011450,994525,BUY
15-10-20 11:46,11:46,17971275,18695975,724700,BUY
15-10-20 11:47,11:47,18093725,18226950,133225,BUY
15-10-20 11:48,11:48,18143875,18917250,773375,BUY
15-10-20 11:49,11:49,18120250,18204050,83800,BUY
15-10-20 11:50,11:50,18037775,19238475,1200700,BUY
15-10-20 11:51,11:51,18006750,17996150,-10600,SELL
15-10-20 11:52,11:52,18115925,18642675,526750,BUY
15-10-20 11:53,11:53,18197000,19490950,1293950,BUY
15-10-20 11:54,11:54,18168975,18361250,192275,BUY
15-10-20 11:55,11:55,18165075,18174100,9025,BUY
15-10-20 11:56,11:56,18187050,18159600,-27450,SELL
15-10-20 11:57,11:57,18191550,19408800,1217250,BUY
15-10-20 11:58,11:58,18152825,19157700,1004875,BUY
15-10-20 11:59,11:59,18103800,18255375,151575,BUY
15-10-20 12:00,12:00,18186925,19233475,1046550,BUY
15-10-20 12:01,12:01,18145550,18902200,756650,BUY
15-10-20 12:02,12:02,18263650,19302900,1039250,BUY
15-10-20 12:03,12:03,18295650,18319900,24250,BUY
15-10-20 12:04,12:04,18276700,18895625,618925,BUY
15-10-20 12:05,12:05,18387025,19433375,1046350,BUY
15-10-20 12:06,12:06,18339500,19156675,817175,BUY
15-10-20 12:07,12:07,18212275,19400050,1187775,BUY
15-10-20 12:08,12:08,18487275,18983275,496000,BUY
15-10-20 12:09,12:09,18487050,19078700,591650,BUY
15-10-20 12:10,12:10,18406250,18835575,429325,BUY
15-10-20 12:11,12:11,18468600,19803725,1335125,BUY
15-10-20 12:12,12:12,18407850,19743025,1335175,BUY
15-10-20 12:13,12:13,18407850,19169625,761775,BUY
15-10-20 12:14,12:14,18568200,17823850,-744350,SELL
15-10-20 12:15,12:15,18622175,19676350,1054175,BUY
15-10-20 12:16,12:16,18585550,19635675,1050125,BUY
15-10-20 12:17,12:17,18678875,19423350,744475,BUY
15-10-20 12:18,12:18,18695675,19564050,868375,BUY
15-10-20 12:19,12:19,18732700,19422275,689575,BUY
15-10-20 12:20,12:20,18733325,18842700,109375,BUY
15-10-20 12:21,12:21,18753350,19180175,426825,BUY
15-10-20 12:22,12:22,18569850,18762525,192675,BUY
15-10-20 12:23,12:23,18724950,19231900,506950,BUY
15-10-20 12:24,12:24,18654925,18852125,197200,BUY
15-10-20 12:25,12:25,18764900,18914825,149925,BUY
15-10-20 12:26,12:26,18761375,18665950,-95425,SELL
15-10-20 12:27,12:27,18718525,19883825,1165300,BUY
15-10-20 12:28,12:28,18737175,19766725,1029550,BUY
15-10-20 12:29,12:29,18692250,19791775,1099525,BUY
15-10-20 12:30,12:30,18726500,19671475,944975,BUY
15-10-20 12:31,12:31,18715400,19455975,740575,BUY
15-10-20 12:32,12:32,18772950,20009550,1236600,BUY
15-10-20 12:33,12:33,18696025,19571450,875425,BUY
15-10-20 12:34,12:34,18821125,19342425,521300,BUY
15-10-20 12:35,12:35,18867150,19517425,650275,BUY
15-10-20 12:36,12:36,18887975,19801450,913475,BUY
15-10-20 12:37,12:37,18913200,19988250,1075050,BUY
15-10-20 12:38,12:38,18956725,19951125,994400,BUY
15-10-20 12:39,12:39,19005075,19674225,669150,BUY
15-10-20 12:40,12:40,18898100,19509025,610925,BUY
15-10-20 12:41,12:41,19016400,19852050,835650,BUY
15-10-20 12:42,12:42,19004100,18858050,-146050,SELL
15-10-20 12:43,12:43,18995900,19030875,34975,BUY
15-10-20 12:44,12:44,18931450,19712175,780725,BUY
15-10-20 12:45,12:45,18873225,20151575,1278350,BUY
15-10-20 12:46,12:46,18931725,19085975,154250,BUY
15-10-20 12:47,12:47,18887700,19567575,679875,BUY
15-10-20 12:48,12:48,19041550,19557925,516375,BUY
15-10-20 12:49,12:49,19016325,19172775,156450,BUY
15-10-20 12:50,12:50,18948775,19585275,636500,BUY
15-10-20 12:51,12:51,18914550,20112125,1197575,BUY
15-10-20 12:52,12:52,18906125,20455000,1548875,BUY
15-10-20 12:53,12:53,19128750,20093975,965225,BUY
15-10-20 12:54,12:54,19039250,20081450,1042200,BUY
15-10-20 12:55,12:55,19116400,19752125,635725,BUY
15-10-20 12:56,12:56,18979925,20143300,1163375,BUY
15-10-20 12:57,12:57,19077450,20071575,994125,BUY
15-10-20 12:58,12:58,19071425,19242725,171300,BUY
15-10-20 12:59,12:59,19172600,20202575,1029975,BUY
15-10-20 13:00,13:00,19070675,19724900,654225,BUY
15-10-20 13:01,13:01,19110175,19926625,816450,BUY
15-10-20 13:02,13:02,19417250,20118450,701200,BUY
15-10-20 13:03,13:03,19471675,20509975,1038300,BUY
15-10-20 13:04,13:04,19407575,20365975,958400,BUY
15-10-20 13:05,13:05,19445725,17991950,-1453775,SELL
15-10-20 13:06,13:06,19419200,18380100,-1039100,SELL
15-10-20 13:07,13:07,19413775,18331850,-1081925,SELL
15-10-20 13:08,13:08,19832400,17540475,-2291925,SELL
15-10-20 13:09,13:09,19806400,17963450,-1842950,SELL
15-10-20 13:10,13:10,19793575,17796700,-1996875,SELL
15-10-20 13:11,13:11,19763900,18119925,-1643975,SELL
15-10-20 13:12,13:12,20173400,17821325,-2352075,SELL
15-10-20 13:13,13:13,20129500,17746350,-2383150,SELL
15-10-20 13:14,13:14,20160550,17317950,-2842600,SELL
15-10-20 13:15,13:15,20673525,17399575,-3273950,SELL
15-10-20 13:16,13:16,20631100,17756500,-2874600,SELL
15-10-20 13:17,13:17,20674725,16813450,-3861275,SELL
15-10-20 13:18,13:18,20795225,17612725,-3182500,SELL
15-10-20 13:19,13:19,20817525,17730500,-3087025,SELL
15-10-20 13:20,13:20,20807900,17565050,-3242850,SELL
15-10-20 13:21,13:21,20840325,17264325,-3576000,SELL
15-10-20 13:22,13:22,20833850,17460175,-3373675,SELL
15-10-20 13:23,13:23,20885500,17141925,-3743575,SELL
15-10-20 13:24,13:24,20829200,17492525,-3336675,SELL
15-10-20 13:25,13:25,20869150,17462050,-3407100,SELL
15-10-20 13:26,13:26,20885825,17250675,-3635150,SELL
15-10-20 13:27,13:27,21048500,16836800,-4211700,SELL
15-10-20 13:28,13:28,21000400,17530850,-3469550,SELL
15-10-20 13:29,13:29,21004725,17091825,-3912900,SELL
15-10-20 13:30,13:30,21235350,17208325,-4027025,SELL
15-10-20 13:31,13:31,21213625,17063225,-4150400,SELL
15-10-20 13:32,13:32,21215375,16876375,-4339000,SELL
15-10-20 13:33,13:33,21334325,17034450,-4299875,SELL
15-10-20 13:34,13:34,21430975,16933425,-4497550,SELL
15-10-20 13:35,13:35,21381600,17145475,-4236125,SELL
15-10-20 13:36,13:36,21613750,16764525,-4849225,SELL
15-10-20 13:37,13:37,21621550,16755000,-4866550,SELL
15-10-20 13:38,13:38,21630325,16687225,-4943100,SELL
15-10-20 13:39,13:39,21412250,16827350,-4584900,SELL
15-10-20 13:40,13:40,21431725,16552925,-4878800,SELL
15-10-20 13:41,13:41,21424575,16594700,-4829875,SELL
15-10-20 13:42,13:42,21470525,16878725,-4591800,SELL
15-10-20 13:43,13:43,21498025,16622175,-4875850,SELL
15-10-20 13:44,13:44,21531975,16636900,-4895075,SELL
15-10-20 13:45,13:45,21797950,16810600,-4987350,SELL
15-10-20 13:46,13:46,21795150,16809425,-4985725,SELL
15-10-20 13:47,13:47,21790275,16487475,-5302800,SELL
15-10-20 13:48,13:48,21655275,15667150,-5988125,SELL
15-10-20 13:49,13:49,21639475,15683400,-5956075,SELL
15-10-20 13:50,13:50,21681075,15511425,-6169650,SELL
15-10-20 13:51,13:51,21554525,14662950,-6891575,SELL
15-10-20 13:52,13:52,21528125,15136700,-6391425,SELL
15-10-20 13:53,13:53,21584775,14998525,-6586250,SELL
15-10-20 13:54,13:54,21392900,13759300,-7633600,SELL
15-10-20 13:55,13:55,21410725,14126875,-7283850,SELL
15-10-20 13:56,13:56,21399225,14051275,-7347950,SELL
15-10-20 13:57,13:57,21501425,13603925,-7897500,SELL
15-10-20 13:58,13:58,21524100,13822050,-7702050,SELL
15-10-20 13:59,13:59,21520425,13830825,-7689600,SELL
15-10-20 14:00,14:00,21543325,13878375,-7664950,SELL
15-10-20 14:01,14:01,21564250,14231425,-7332825,SELL
15-10-20 14:02,14:02,21562550,14192050,-7370500,SELL
15-10-20 14:03,14:03,21643150,13611550,-8031600,SELL
15-10-20 14:04,14:04,21677700,14327250,-7350450,SELL
15-10-20 14:05,14:05,21662175,14394800,-7267375,SELL
15-10-20 14:06,14:06,21910575,14129525,-7781050,SELL
15-10-20 14:07,14:07,21925125,14423550,-7501575,SELL
15-10-20 14:08,14:08,21909775,14249375,-7660400,SELL
15-10-20 14:09,14:09,21798200,13317400,-8480800,SELL
15-10-20 14:10,14:10,21806075,13515400,-8290675,SELL
15-10-20 14:11,14:11,21784200,13465350,-8318850,SELL
15-10-20 14:12,14:12,21603075,12250550,-9352525,SELL
15-10-20 14:13,14:13,21650625,12182375,-9468250,SELL
15-10-20 14:14,14:14,21645225,12296525,-9348700,SELL
15-10-20 14:15,14:15,21255475,11925600,-9329875,SELL
15-10-20 14:16,14:16,21257850,11824325,-9433525,SELL
15-10-20 14:17,14:17,21257850,11937275,-9320575,SELL
15-10-20 14:18,14:18,20844550,11371975,-9472575,SELL
15-10-20 14:19,14:19,20849900,10653175,-10196725,SELL
15-10-20 14:20,14:20,20854850,10501300,-10353550,SELL
15-10-20 14:21,14:21,20984200,11518275,-9465925,SELL
15-10-20 14:22,14:22,20962525,11668200,-9294325,SELL
15-10-20 14:23,14:23,20964725,11595750,-9368975,SELL
15-10-20 14:24,14:24,21237075,11858975,-9378100,SELL
15-10-20 14:25,14:25,21206400,11713125,-9493275,SELL
15-10-20 14:26,14:26,21219775,11569575,-9650200,SELL
15-10-20 14:27,14:27,21385075,11934075,-9451000,SELL
15-10-20 14:28,14:28,21401575,11565950,-9835625,SELL
15-10-20 14:29,14:29,21382225,11951000,-9431225,SELL
15-10-20 14:30,14:30,21341275,11960925,-9380350,SELL
15-10-20 14:31,14:31,21365100,12129950,-9235150,SELL
15-10-20 14:32,14:32,21346075,11888950,-9457125,SELL
15-10-20 14:33,14:33,21631925,12356725,-9275200,SELL
15-10-20 14:34,14:34,21632350,12511550,-9120800,SELL
15-10-20 14:35,14:35,21637125,12093425,-9543700,SELL
15-10-20 14:36,14:36,21762250,12502875,-9259375,SELL
15-10-20 14:37,14:37,21764850,12544875,-9219975,SELL
15-10-20 14:38,14:38,21738850,12385625,-9353225,SELL
15-10-20 14:39,14:39,21659350,11941775,-9717575,SELL
15-10-20 14:40,14:40,21617875,11977500,-9640375,SELL
15-10-20 14:41,14:41,21654875,11869400,-9785475,SELL
15-10-20 14:42,14:42,21454250,11627425,-9826825,SELL
15-10-20 14:43,14:43,21431675,11123675,-10308000,SELL
15-10-20 14:44,14:44,21455550,11709700,-9745850,SELL
15-10-20 14:45,14:45,21400025,11654300,-9745725,SELL
15-10-20 14:46,14:46,21396100,11753725,-9642375,SELL
15-10-20 14:47,14:47,21412725,11824050,-9588675,SELL
15-10-20 14:48,14:48,21250925,11916250,-9334675,SELL
15-10-20 14:49,14:49,21263125,11698850,-9564275,SELL
15-10-20 14:50,14:50,21248275,11784425,-9463850,SELL
15-10-20 14:51,14:51,21197500,11583350,-9614150,SELL
15-10-20 14:52,14:52,21205850,11959650,-9246200,SELL
15-10-20 14:53,14:53,21183075,12138450,-9044625,SELL
15-10-20 14:54,14:54,20937350,11933675,-9003675,SELL
15-10-20 14:55,14:55,20944625,11965175,-8979450,SELL
15-10-20 14:56,14:56,20948275,11040600,-9907675,SELL
15-10-20 14:57,14:57,20340200,11556325,-8783875,SELL
15-10-20 14:58,14:58,20345375,11797950,-8547425,SELL
15-10-20 14:59,14:59,20347050,11720475,-8626575,SELL
15-10-20 15:00,15:00,19695050,11516000,-8179050,SELL
15-10-20 15:01,15:01,19692700,11609450,-8083250,SELL
15-10-20 15:02,15:02,19686925,11867225,-7819700,SELL
15-10-20 15:03,15:03,19771500,11478175,-8293325,SELL
15-10-20 15:04,15:04,19773250,11482025,-8291225,SELL
15-10-20 15:05,15:05,19790225,11685600,-8104625,SELL
15-10-20 15:06,15:06,19485750,10824325,-8661425,SELL
15-10-20 15:07,15:07,19479950,10958950,-8521000,SELL
15-10-20 15:08,15:08,19483275,11114950,-8368325,SELL
15-10-20 15:09,15:09,18819175,10388025,-8431150,SELL
15-10-20 15:10,15:10,18813200,10358050,-8455150,SELL
15-10-20 15:11,15:11,18829325,10433475,-8395850,SELL
15-10-20 15:12,15:12,17941350,10057775,-7883575,SELL
15-10-20 15:13,15:13,17954800,9920225,-8034575,SELL
15-10-20 15:14,15:14,17937325,9744075,-8193250,SELL
15-10-20 15:15,15:15,17333000,9525000,-7808000,SELL
15-10-20 15:16,15:16,17328425,9333400,-7995025,SELL
15-10-20 15:17,15:17,17325775,8311750,-9014025,SELL
15-10-20 15:18,15:18,16471800,9101700,-7370100,SELL
15-10-20 15:19,15:19,16461450,8768850,-7692600,SELL
15-10-20 15:20,15:20,16477500,8808050,-7669450,SELL
15-10-20 15:21,15:21,15610550,8482400,-7128150,SELL
15-10-20 15:22,15:22,15607500,8683325,-6924175,SELL
15-10-20 15:23,15:23,15596600,8535000,-7061600,SELL
15-10-20 15:24,15:24,14720300,7634300,-7086000,SELL
15-10-20 15:25,15:25,14733000,8730725,-6002275,SELL
15-10-20 15:26,15:26,14704950,8604475,-6100475,SELL
15-10-20 15:27,15:27,12731600,7094700,-5636900,SELL
15-10-20 15:28,15:28,12734450,6536050,-6198400,SELL
15-10-20 15:29,15:29,0,91175,91175,BUY
16-10-20 9:15,9:15,3615075,2252250,-1362825,SELL
16-10-20 9:16,9:16,3614175,2271500,-1342675,SELL
16-10-20 9:17,9:17,3856400,2400000,-1456400,SELL
16-10-20 9:18,9:18,3857475,2433375,-1424100,SELL
16-10-20 9:19,9:19,3857475,2431825,-1425650,SELL
16-10-20 9:20,9:20,4337300,2928950,-1408350,SELL
16-10-20 9:21,9:21,4336225,2922100,-1414125,SELL
16-10-20 9:22,9:22,4336925,2912825,-1424100,SELL
16-10-20 9:23,9:23,4563975,3135275,-1428700,SELL
16-10-20 9:24,9:24,4562400,3132875,-1429525,SELL
16-10-20 9:25,9:25,4548850,3144350,-1404500,SELL
16-10-20 9:26,9:26,4739025,3214775,-1524250,SELL
16-10-20 9:27,9:27,4743300,3233275,-1510025,SELL
16-10-20 9:28,9:28,4736825,3230725,-1506100,SELL
16-10-20 9:29,9:29,4915000,3390775,-1524225,SELL
16-10-20 9:30,9:30,4915325,3420825,-1494500,SELL
16-10-20 9:31,9:31,4897900,3414075,-1483825,SELL
16-10-20 9:32,9:32,4991650,3552375,-1439275,SELL
16-10-20 9:33,9:33,4989825,3549400,-1440425,SELL
16-10-20 9:34,9:34,4973650,3526700,-1446950,SELL
16-10-20 9:35,9:35,5109125,3657475,-1451650,SELL
16-10-20 9:36,9:36,5110775,3693325,-1417450,SELL
16-10-20 9:37,9:37,5104875,3673950,-1430925,SELL
16-10-20 9:38,9:38,5190900,3782825,-1408075,SELL
16-10-20 9:39,9:39,5212325,3801025,-1411300,SELL
16-10-20 9:40,9:40,5204750,3762400,-1442350,SELL
16-10-20 9:41,9:41,5272425,3788950,-1483475,SELL
16-10-20 9:42,9:42,5273650,3803175,-1470475,SELL
16-10-20 9:43,9:43,5256700,3788950,-1467750,SELL
16-10-20 9:44,9:44,5306975,3896250,-1410725,SELL
16-10-20 9:45,9:45,5329900,3923075,-1406825,SELL
16-10-20 9:46,9:46,5353800,3930100,-1423700,SELL
16-10-20 9:47,9:47,5407400,3951475,-1455925,SELL
16-10-20 9:48,9:48,5430525,3985375,-1445150,SELL
16-10-20 9:49,9:49,5424775,3958600,-1466175,SELL
16-10-20 9:50,9:50,5462700,3903150,-1559550,SELL
16-10-20 9:51,9:51,5443850,3895675,-1548175,SELL
16-10-20 9:52,9:52,5440900,3869875,-1571025,SELL
16-10-20 9:53,9:53,5511600,3901525,-1610075,SELL
16-10-20 9:54,9:54,5529875,3893575,-1636300,SELL
16-10-20 9:55,9:55,5529875,3905875,-1624000,SELL
16-10-20 9:56,9:56,5609825,3953125,-1656700,SELL
16-10-20 9:57,9:57,5608150,3953125,-1655025,SELL
16-10-20 9:58,9:58,5629825,3949750,-1680075,SELL
16-10-20 9:59,9:59,5724800,4035175,-1689625,SELL
16-10-20 10:00,10:00,5725800,4036050,-1689750,SELL
16-10-20 10:01,10:01,5726075,4027175,-1698900,SELL
16-10-20 10:02,10:02,5880625,4144725,-1735900,SELL
16-10-20 10:03,10:03,5887525,4171825,-1715700,SELL
16-10-20 10:04,10:04,5881650,4152525,-1729125,SELL
16-10-20 10:05,10:05,5987350,4213425,-1773925,SELL
16-10-20 10:06,10:06,5972400,4213425,-1758975,SELL
16-10-20 10:07,10:07,5972400,4249350,-1723050,SELL
16-10-20 10:08,10:08,5970550,4219300,-1751250,SELL
16-10-20 10:09,10:09,5991500,4214325,-1777175,SELL
16-10-20 10:10,10:10,5970550,4196725,-1773825,SELL
16-10-20 10:11,10:11,6015900,4218650,-1797250,SELL
16-10-20 10:12,10:12,6016575,4227425,-1789150,SELL
16-10-20 10:13,10:13,5979350,4213875,-1765475,SELL
16-10-20 10:14,10:14,6083125,4220350,-1862775,SELL
16-10-20 10:15,10:15,6089000,4246600,-1842400,SELL
16-10-20 10:16,10:16,6089000,4246600,-1842400,SELL
16-10-20 10:17,10:17,6051450,4207650,-1843800,SELL
16-10-20 10:18,10:18,6070575,4193125,-1877450,SELL
16-10-20 10:19,10:19,6054700,4243300,-1811400,SELL
16-10-20 10:20,10:20,6064625,4248725,-1815900,SELL
16-10-20 10:21,10:21,6081250,4285700,-1795550,SELL
16-10-20 10:22,10:22,6081550,4316050,-1765500,SELL
16-10-20 10:23,10:23,6133275,4292825,-1840450,SELL
16-10-20 10:24,10:24,6113200,4283875,-1829325,SELL
16-10-20 10:25,10:25,6113200,4292825,-1820375,SELL
16-10-20 10:26,10:26,6134700,4309175,-1825525,SELL
16-10-20 10:27,10:27,6129725,4272000,-1857725,SELL
16-10-20 10:28,10:28,6136200,4272000,-1864200,SELL
16-10-20 10:29,10:29,6167400,4308275,-1859125,SELL
16-10-20 10:30,10:30,6193550,4317250,-1876300,SELL
16-10-20 10:31,10:31,6173175,4313450,-1859725,SELL
16-10-20 10:32,10:32,6214225,4332825,-1881400,SELL
16-10-20 10:33,10:33,6180950,4279875,-1901075,SELL
16-10-20 10:34,10:34,6212850,4325675,-1887175,SELL
16-10-20 10:35,10:35,6164875,4388775,-1776100,SELL
16-10-20 10:36,10:36,6218725,4359850,-1858875,SELL
16-10-20 10:37,10:37,6197550,4342500,-1855050,SELL
16-10-20 10:38,10:38,6229975,4353825,-1876150,SELL
16-10-20 10:39,10:39,6226825,4329750,-1897075,SELL
16-10-20 10:40,10:40,6223500,4364075,-1859425,SELL
16-10-20 10:41,10:41,6220550,4382800,-1837750,SELL
16-10-20 10:42,10:42,6236025,4369925,-1866100,SELL
16-10-20 10:43,10:43,6278000,4383925,-1894075,SELL
16-10-20 10:44,10:44,6256675,4380425,-1876250,SELL
16-10-20 10:45,10:45,6268025,4424150,-1843875,SELL
16-10-20 10:46,10:46,6284225,4413725,-1870500,SELL
16-10-20 10:47,10:47,6277225,4417750,-1859475,SELL
16-10-20 10:48,10:48,6309750,4428925,-1880825,SELL
16-10-20 10:49,10:49,6306875,4398225,-1908650,SELL
16-10-20 10:50,10:50,6210150,4397075,-1813075,SELL
16-10-20 10:51,10:51,6229200,4400150,-1829050,SELL
16-10-20 10:52,10:52,6204325,4409150,-1795175,SELL
16-10-20 10:53,10:53,6260100,4439650,-1820450,SELL
16-10-20 10:54,10:54,6228100,4461800,-1766300,SELL
16-10-20 10:55,10:55,6240725,4468925,-1771800,SELL
16-10-20 10:56,10:56,6212050,4436950,-1775100,SELL
16-10-20 10:57,10:57,6226650,4434225,-1792425,SELL
16-10-20 10:58,10:58,6204900,4456225,-1748675,SELL
16-10-20 10:59,10:59,6216300,4480375,-1735925,SELL
16-10-20 11:00,11:00,6224525,4488625,-1735900,SELL
16-10-20 11:01,11:01,6215350,4457975,-1757375,SELL
16-10-20 11:02,11:02,6238125,4486600,-1751525,SELL
16-10-20 11:03,11:03,6244675,4464025,-1780650,SELL
16-10-20 11:04,11:04,6246200,4481850,-1764350,SELL
16-10-20 11:05,11:05,6246525,4452100,-1794425,SELL
16-10-20 11:06,11:06,6108725,4438000,-1670725,SELL
16-10-20 11:07,11:07,6230100,4438800,-1791300,SELL
16-10-20 11:08,11:08,6224025,4457175,-1766850,SELL
16-10-20 11:09,11:09,6212075,4449275,-1762800,SELL
16-10-20 11:10,11:10,6238900,4458300,-1780600,SELL
16-10-20 11:11,11:11,6244250,4439075,-1805175,SELL
16-10-20 11:12,11:12,6247750,4445950,-1801800,SELL
16-10-20 11:13,11:13,6273650,4426525,-1847125,SELL
16-10-20 11:14,11:14,6286775,4448425,-1838350,SELL
16-10-20 11:15,11:15,6273850,4476000,-1797850,SELL
16-10-20 11:16,11:16,6265025,4452950,-1812075,SELL
16-10-20 11:17,11:17,6295250,4453350,-1841900,SELL
16-10-20 11:18,11:18,6273750,4452475,-1821275,SELL
16-10-20 11:19,11:19,6184850,4453275,-1731575,SELL
16-10-20 11:20,11:20,6296925,4485125,-1811800,SELL
16-10-20 11:21,11:21,6195750,4494225,-1701525,SELL
16-10-20 11:22,11:22,6304925,4507400,-1797525,SELL
16-10-20 11:23,11:23,6343550,4513200,-1830350,SELL
16-10-20 11:24,11:24,6322250,4490200,-1832050,SELL
16-10-20 11:25,11:25,6304450,4512675,-1791775,SELL
16-10-20 11:26,11:26,6317675,4508125,-1809550,SELL
16-10-20 11:27,11:27,6327100,4508475,-1818625,SELL
16-10-20 11:28,11:28,6333000,4494900,-1838100,SELL
16-10-20 11:29,11:29,6353750,4516250,-1837500,SELL
16-10-20 11:30,11:30,6295500,4519000,-1776500,SELL
16-10-20 11:31,11:31,6289375,4516075,-1773300,SELL
16-10-20 11:32,11:32,6329550,4544325,-1785225,SELL
16-10-20 11:33,11:33,6178275,4555525,-1622750,SELL
16-10-20 11:34,11:34,6338125,4566925,-1771200,SELL
16-10-20 11:35,11:35,6268950,4575325,-1693625,SELL
16-10-20 11:36,11:36,6322225,4578200,-1744025,SELL
16-10-20 11:37,11:37,6307125,4575300,-1731825,SELL
16-10-20 11:38,11:38,6315400,4570850,-1744550,SELL
16-10-20 11:39,11:39,6300350,4623500,-1676850,SELL
16-10-20 11:40,11:40,6305425,4635950,-1669475,SELL
16-10-20 11:41,11:41,6292025,4555000,-1737025,SELL
16-10-20 11:42,11:42,6317950,4574425,-1743525,SELL
16-10-20 11:43,11:43,6285325,4540125,-1745200,SELL
16-10-20 11:44,11:44,6261025,4568025,-1693000,SELL
16-10-20 11:45,11:45,6287875,4568050,-1719825,SELL
16-10-20 11:46,11:46,6314775,4598550,-1716225,SELL
16-10-20 11:47,11:47,6262375,4582975,-1679400,SELL
16-10-20 11:48,11:48,6289675,4605275,-1684400,SELL
16-10-20 11:49,11:49,6317950,4596450,-1721500,SELL
16-10-20 11:50,11:50,6313300,4580400,-1732900,SELL
16-10-20 11:51,11:51,6294875,4569000,-1725875,SELL
16-10-20 11:52,11:52,6315850,4574700,-1741150,SELL
16-10-20 11:53,11:53,6203975,4575450,-1628525,SELL
16-10-20 11:54,11:54,6222800,4587850,-1634950,SELL
16-10-20 11:55,11:55,6307975,4632625,-1675350,SELL
16-10-20 11:56,11:56,6277225,4653725,-1623500,SELL
16-10-20 11:57,11:57,6292375,4623175,-1669200,SELL
16-10-20 11:58,11:58,6215425,4645300,-1570125,SELL
16-10-20 11:59,11:59,6255475,4653675,-1601800,SELL
16-10-20 12:00,12:00,6333950,4688600,-1645350,SELL
16-10-20 12:01,12:01,6331875,4683450,-1648425,SELL
16-10-20 12:02,12:02,6109375,4735475,-1373900,SELL
16-10-20 12:03,12:03,6111750,4695500,-1416250,SELL
16-10-20 12:04,12:04,6081450,4709650,-1371800,SELL
16-10-20 12:05,12:05,6051175,4773725,-1277450,SELL
16-10-20 12:06,12:06,6026800,4787325,-1239475,SELL
16-10-20 12:07,12:07,6043075,4764725,-1278350,SELL
16-10-20 12:08,12:08,6092825,4834650,-1258175,SELL
16-10-20 12:09,12:09,6111650,4862500,-1249150,SELL
16-10-20 12:10,12:10,6090675,4835600,-1255075,SELL
16-10-20 12:11,12:11,6120925,4919700,-1201225,SELL
16-10-20 12:12,12:12,6120825,4919700,-1201125,SELL
16-10-20 12:13,12:13,6107400,4933575,-1173825,SELL
16-10-20 12:14,12:14,6133275,4948300,-1184975,SELL
16-10-20 12:15,12:15,6097725,4920325,-1177400,SELL
16-10-20 12:16,12:16,6109475,4927425,-1182050,SELL
16-10-20 12:17,12:17,6118150,4943025,-1175125,SELL
16-10-20 12:18,12:18,6137750,4958825,-1178925,SELL
16-10-20 12:19,12:19,6107775,4934275,-1173500,SELL
16-10-20 12:20,12:20,6123225,4996225,-1127000,SELL
16-10-20 12:21,12:21,6136050,4995950,-1140100,SELL
16-10-20 12:22,12:22,6161850,4982225,-1179625,SELL
16-10-20 12:23,12:23,6190175,5023950,-1166225,SELL
16-10-20 12:24,12:24,6190125,5055300,-1134825,SELL
16-10-20 12:25,12:25,6194925,5024225,-1170700,SELL
16-10-20 12:26,12:26,6183875,4998525,-1185350,SELL
16-10-20 12:27,12:27,6194775,5012300,-1182475,SELL
16-10-20 12:28,12:28,6169975,5007100,-1162875,SELL
16-10-20 12:29,12:29,6162100,5023675,-1138425,SELL
16-10-20 12:30,12:30,6197775,5033900,-1163875,SELL
16-10-20 12:31,12:31,6222575,5054575,-1168000,SELL
16-10-20 12:32,12:32,6122000,5052350,-1069650,SELL
16-10-20 12:33,12:33,6084150,5047500,-1036650,SELL
16-10-20 12:34,12:34,6122150,5032725,-1089425,SELL
16-10-20 12:35,12:35,6189300,5165250,-1024050,SELL
16-10-20 12:36,12:36,6186625,5134650,-1051975,SELL
16-10-20 12:37,12:37,6183850,5173000,-1010850,SELL
16-10-20 12:38,12:38,6228675,5186450,-1042225,SELL
16-10-20 12:39,12:39,6185675,5171350,-1014325,SELL
16-10-20 12:40,12:40,6242300,5177750,-1064550,SELL
16-10-20 12:41,12:41,6259125,5197800,-1061325,SELL
16-10-20 12:42,12:42,6289800,5218525,-1071275,SELL
16-10-20 12:43,12:43,6269425,5215675,-1053750,SELL
16-10-20 12:44,12:44,6194775,5248700,-946075,SELL
16-10-20 12:45,12:45,6219300,5254475,-964825,SELL
16-10-20 12:46,12:46,6215975,5249500,-966475,SELL
16-10-20 12:47,12:47,6206025,5239525,-966500,SELL
16-10-20 12:48,12:48,6201450,5264975,-936475,SELL
16-10-20 12:49,12:49,6187300,5251725,-935575,SELL
16-10-20 12:50,12:50,6283150,5291100,-992050,SELL
16-10-20 12:51,12:51,6284325,5291200,-993125,SELL
16-10-20 12:52,12:52,6267425,5275800,-991625,SELL
16-10-20 12:53,12:53,6190800,5291525,-899275,SELL
16-10-20 12:54,12:54,6193175,5300000,-893175,SELL
16-10-20 12:55,12:55,6192325,5282975,-909350,SELL
16-10-20 12:56,12:56,6231225,5336700,-894525,SELL
16-10-20 12:57,12:57,6229950,5336750,-893200,SELL
16-10-20 12:58,12:58,6237475,5333900,-903575,SELL
16-10-20 12:59,12:59,6272000,5321750,-950250,SELL
16-10-20 13:00,13:00,6233050,5295450,-937600,SELL
16-10-20 13:01,13:01,6232825,5319050,-913775,SELL
16-10-20 13:02,13:02,6278000,5304575,-973425,SELL
16-10-20 13:03,13:03,6269650,5338300,-931350,SELL
16-10-20 13:04,13:04,6280075,5313975,-966100,SELL
16-10-20 13:05,13:05,6299900,5351000,-948900,SELL
16-10-20 13:06,13:06,6266175,5344675,-921500,SELL
16-10-20 13:07,13:07,6335500,5323650,-1011850,SELL
16-10-20 13:08,13:08,6315225,5369425,-945800,SELL
16-10-20 13:09,13:09,6306875,5383025,-923850,SELL
16-10-20 13:10,13:10,6325100,5373400,-951700,SELL
16-10-20 13:11,13:11,6310900,5349600,-961300,SELL
16-10-20 13:12,13:12,6314075,5365650,-948425,SELL
16-10-20 13:13,13:13,6289375,5374975,-914400,SELL
16-10-20 13:14,13:14,6304175,5365675,-938500,SELL
16-10-20 13:15,13:15,6359375,5388800,-970575,SELL
16-10-20 13:16,13:16,6331725,5361575,-970150,SELL
16-10-20 13:17,13:17,6322650,5379150,-943500,SELL
16-10-20 13:18,13:18,6216300,5385325,-830975,SELL
16-10-20 13:19,13:19,6169100,5362375,-806725,SELL
16-10-20 13:20,13:20,6222425,5383650,-838775,SELL
16-10-20 13:21,13:21,6219775,5368500,-851275,SELL
16-10-20 13:22,13:22,6210775,5397275,-813500,SELL
16-10-20 13:23,13:23,6208125,5368500,-839625,SELL
16-10-20 13:24,13:24,6238925,5363575,-875350,SELL
16-10-20 13:25,13:25,6236625,5353800,-882825,SELL
16-10-20 13:26,13:26,6234025,5378975,-855050,SELL
16-10-20 13:27,13:27,6219000,5366100,-852900,SELL
16-10-20 13:28,13:28,6190600,5371925,-818675,SELL
16-10-20 13:29,13:29,6234900,5366100,-868800,SELL
16-10-20 13:30,13:30,6263700,5373375,-890325,SELL
16-10-20 13:31,13:31,6292500,5392725,-899775,SELL
16-10-20 13:32,13:32,6278500,5405925,-872575,SELL
16-10-20 13:33,13:33,6161825,5366250,-795575,SELL
16-10-20 13:34,13:34,6177950,5379125,-798825,SELL
16-10-20 13:35,13:35,6149150,5375575,-773575,SELL
16-10-20 13:36,13:36,6182675,5413350,-769325,SELL
16-10-20 13:37,13:37,6198975,5399600,-799375,SELL
16-10-20 13:38,13:38,6227125,5419550,-807575,SELL
16-10-20 13:39,13:39,6256300,5418100,-838200,SELL
16-10-20 13:40,13:40,6262950,5420750,-842200,SELL
16-10-20 13:41,13:41,6250625,5446850,-803775,SELL
16-10-20 13:42,13:42,6263375,5429625,-833750,SELL
16-10-20 13:43,13:43,6238550,5446900,-791650,SELL
16-10-20 13:44,13:44,6300175,5439925,-860250,SELL
16-10-20 13:45,13:45,6293875,5446175,-847700,SELL
16-10-20 13:46,13:46,6283575,5413500,-870075,SELL
16-10-20 13:47,13:47,6283575,5428900,-854675,SELL
16-10-20 13:48,13:48,6318400,5378800,-939600,SELL
16-10-20 13:49,13:49,6349925,5378800,-971125,SELL
16-10-20 13:50,13:50,6351200,5365025,-986175,SELL
16-10-20 13:51,13:51,6455100,5412850,-1042250,SELL
16-10-20 13:52,13:52,6439325,5403300,-1036025,SELL
16-10-20 13:53,13:53,6467225,5402600,-1064625,SELL
16-10-20 13:54,13:54,6442100,5374675,-1067425,SELL
16-10-20 13:55,13:55,6431675,5345850,-1085825,SELL
16-10-20 13:56,13:56,6432300,5345750,-1086550,SELL
16-10-20 13:57,13:57,6455725,5339725,-1116000,SELL
16-10-20 13:58,13:58,6471000,5368575,-1102425,SELL
16-10-20 13:59,13:59,6467175,5378700,-1088475,SELL
16-10-20 14:00,14:00,6487150,5404525,-1082625,SELL
16-10-20 14:01,14:01,6478050,5389375,-1088675,SELL
16-10-20 14:02,14:02,6492725,5371325,-1121400,SELL
16-10-20 14:03,14:03,6522450,5403175,-1119275,SELL
16-10-20 14:04,14:04,6517700,5403175,-1114525,SELL
16-10-20 14:05,14:05,6497775,5373600,-1124175,SELL
16-10-20 14:06,14:06,6562950,5403150,-1159800,SELL
16-10-20 14:07,14:07,6540750,5393925,-1146825,SELL
16-10-20 14:08,14:08,6577725,5393925,-1183800,SELL
16-10-20 14:09,14:09,6552850,5385300,-1167550,SELL
16-10-20 14:10,14:10,6582575,5419450,-1163125,SELL
16-10-20 14:11,14:11,6591025,5432125,-1158900,SELL
16-10-20 14:12,14:12,6618425,5387900,-1230525,SELL
16-10-20 14:13,14:13,6628925,5401525,-1227400,SELL
16-10-20 14:14,14:14,6652450,5401525,-1250925,SELL
16-10-20 14:15,14:15,6677850,5398525,-1279325,SELL
16-10-20 14:16,14:16,6613550,5388350,-1225200,SELL
16-10-20 14:17,14:17,6611625,5388225,-1223400,SELL
16-10-20 14:18,14:18,6670650,5416400,-1254250,SELL
16-10-20 14:19,14:19,6653800,5432525,-1221275,SELL
16-10-20 14:20,14:20,6707800,5429950,-1277850,SELL
16-10-20 14:21,14:21,6717050,5395975,-1321075,SELL
16-10-20 14:22,14:22,6720650,5428900,-1291750,SELL
16-10-20 14:23,14:23,6686225,5399325,-1286900,SELL
16-10-20 14:24,14:24,6680975,5389300,-1291675,SELL
16-10-20 14:25,14:25,6671925,5389650,-1282275,SELL
16-10-20 14:26,14:26,6654275,5392175,-1262100,SELL
16-10-20 14:27,14:27,6667075,5356450,-1310625,SELL
16-10-20 14:28,14:28,6704700,5370325,-1334375,SELL
16-10-20 14:29,14:29,6708675,5366675,-1342000,SELL
16-10-20 14:30,14:30,6722075,5437525,-1284550,SELL
16-10-20 14:31,14:31,6720725,5411125,-1309600,SELL
16-10-20 14:32,14:32,6667475,5443375,-1224100,SELL
16-10-20 14:33,14:33,6725650,5333875,-1391775,SELL
16-10-20 14:34,14:34,6696800,5362925,-1333875,SELL
16-10-20 14:35,14:35,6728800,5357300,-1371500,SELL
16-10-20 14:36,14:36,6689475,5340425,-1349050,SELL
16-10-20 14:37,14:37,6689675,5367300,-1322375,SELL
16-10-20 14:38,14:38,6653150,5354900,-1298250,SELL
16-10-20 14:39,14:39,6646950,5339725,-1307225,SELL
16-10-20 14:40,14:40,6687950,5359150,-1328800,SELL
16-10-20 14:41,14:41,6659600,5325900,-1333700,SELL
16-10-20 14:42,14:42,6676975,5357875,-1319100,SELL
16-10-20 14:43,14:43,6687050,5334325,-1352725,SELL
16-10-20 14:44,14:44,6712325,5353825,-1358500,SELL
16-10-20 14:45,14:45,6692300,5375800,-1316500,SELL
16-10-20 14:46,14:46,6694775,5378075,-1316700,SELL
16-10-20 14:47,14:47,6686650,5338000,-1348650,SELL
16-10-20 14:48,14:48,6697100,5366350,-1330750,SELL
16-10-20 14:49,14:49,6621200,5332575,-1288625,SELL
16-10-20 14:50,14:50,6645700,5323175,-1322525,SELL
16-10-20 14:51,14:51,6694950,5341325,-1353625,SELL
16-10-20 14:52,14:52,6669025,5321300,-1347725,SELL
16-10-20 14:53,14:53,6669025,5311175,-1357850,SELL
16-10-20 14:54,14:54,6670300,5317600,-1352700,SELL
16-10-20 14:55,14:55,6717200,5298400,-1418800,SELL
16-10-20 14:56,14:56,6694125,5308250,-1385875,SELL
16-10-20 14:57,14:57,6692875,5317700,-1375175,SELL
16-10-20 14:58,14:58,6692875,5314000,-1378875,SELL
16-10-20 14:59,14:59,6702175,5353750,-1348425,SELL
16-10-20 15:00,15:00,6747900,5337175,-1410725,SELL
16-10-20 15:01,15:01,6734925,5313450,-1421475,SELL
16-10-20 15:02,15:02,6739150,5316375,-1422775,SELL
16-10-20 15:03,15:03,6698150,5291775,-1406375,SELL
16-10-20 15:04,15:04,6690125,5284800,-1405325,SELL
16-10-20 15:05,15:05,6635625,5251700,-1383925,SELL
16-10-20 15:06,15:06,6680700,5250575,-1430125,SELL
16-10-20 15:07,15:07,6630500,5226900,-1403600,SELL
16-10-20 15:08,15:08,6671275,5217350,-1453925,SELL
16-10-20 15:09,15:09,6638725,5221100,-1417625,SELL
16-10-20 15:10,15:10,6655750,5245025,-1410725,SELL
16-10-20 15:11,15:11,6666975,5237675,-1429300,SELL
16-10-20 15:12,15:12,6571150,5105475,-1465675,SELL
16-10-20 15:13,15:13,6564400,5102825,-1461575,SELL
16-10-20 15:14,15:14,6593825,5081550,-1512275,SELL
16-10-20 15:15,15:15,6507850,5025850,-1482000,SELL
16-10-20 15:16,15:16,6495525,4992825,-1502700,SELL
16-10-20 15:17,15:17,6524575,5009800,-1514775,SELL
16-10-20 15:18,15:18,6417675,4943750,-1473925,SELL
16-10-20 15:19,15:19,6430550,4951175,-1479375,SELL
16-10-20 15:20,15:20,6442000,4969100,-1472900,SELL
16-10-20 15:21,15:21,6281275,4861450,-1419825,SELL
16-10-20 15:22,15:22,6277125,4855800,-1421325,SELL
16-10-20 15:23,15:23,6263900,4830375,-1433525,SELL
16-10-20 15:24,15:24,6154025,4690750,-1463275,SELL
16-10-20 15:25,15:25,6182250,4695750,-1486500,SELL
16-10-20 15:26,15:26,6160750,4690675,-1470075,SELL
16-10-20 15:27,15:27,6064450,4542675,-1521775,SELL
16-10-20 15:28,15:28,6051125,4564250,-1486875,SELL
16-10-20 15:29,15:29,6080150,4557575,-1522575,SELL
19-10-20 9:15,9:15,5858000,4415400,-1442600,SELL
19-10-20 9:16,9:16,5850400,4414975,-1435425,SELL
19-10-20 9:17,9:17,6129325,4787825,-1341500,SELL
19-10-20 9:18,9:18,6104625,4785500,-1319125,SELL
19-10-20 9:19,9:19,6122625,4799200,-1323425,SELL
19-10-20 9:20,9:20,6355850,5147425,-1208425,SELL
19-10-20 9:21,9:21,6336925,5147675,-1189250,SELL
19-10-20 9:22,9:22,6380800,5146525,-1234275,SELL
19-10-20 9:23,9:23,6609700,5408200,-1201500,SELL
19-10-20 9:24,9:24,6614075,5408400,-1205675,SELL
19-10-20 9:25,9:25,6612325,5408575,-1203750,SELL
19-10-20 9:26,9:26,6791800,5542500,-1249300,SELL
19-10-20 9:27,9:27,6803500,5536175,-1267325,SELL
19-10-20 9:28,9:28,6816900,5535000,-1281900,SELL
19-10-20 9:29,9:29,6884725,5696875,-1187850,SELL
19-10-20 9:30,9:30,6856075,5682275,-1173800,SELL
19-10-20 9:31,9:31,6905850,5689550,-1216300,SELL
19-10-20 9:32,9:32,6875075,5913950,-961125,SELL
19-10-20 9:33,9:33,6875500,5915025,-960475,SELL
19-10-20 9:34,9:34,6854250,5898725,-955525,SELL
19-10-20 9:35,9:35,6902375,6066975,-835400,SELL
19-10-20 9:36,9:36,6878925,6068125,-810800,SELL
19-10-20 9:37,9:37,6889850,6075850,-814000,SELL
19-10-20 9:38,9:38,6921150,6121575,-799575,SELL
19-10-20 9:39,9:39,6938525,6121425,-817100,SELL
19-10-20 9:40,9:40,6960000,6122700,-837300,SELL
19-10-20 9:41,9:41,6750000,6257375,-492625,SELL
19-10-20 9:42,9:42,6776700,6267150,-509550,SELL
19-10-20 9:43,9:43,6787400,6266275,-521125,SELL
19-10-20 9:44,9:44,6674650,6375925,-298725,SELL
19-10-20 9:45,9:45,6641750,6386050,-255700,SELL
19-10-20 9:46,9:46,6674750,6374825,-299925,SELL
19-10-20 9:47,9:47,6744225,6545025,-199200,SELL
19-10-20 9:48,9:48,6744225,6538750,-205475,SELL
19-10-20 9:49,9:49,6759025,6544925,-214100,SELL
19-10-20 9:50,9:50,6851000,6625300,-225700,SELL
19-10-20 9:51,9:51,6834500,6616275,-218225,SELL
19-10-20 9:52,9:52,6790675,6626300,-164375,SELL
19-10-20 9:53,9:53,6631475,6732975,101500,BUY
19-10-20 9:54,9:54,6664275,6743250,78975,BUY
19-10-20 9:55,9:55,6634350,6740800,106450,BUY
19-10-20 9:56,9:56,6682975,6879600,196625,BUY
19-10-20 9:57,9:57,6652350,6881525,229175,BUY
19-10-20 9:58,9:58,6649100,6871925,222825,BUY
19-10-20 9:59,9:59,6743025,7063300,320275,BUY
19-10-20 10:00,10:00,6725350,7062100,336750,BUY
19-10-20 10:01,10:01,6734975,7064200,329225,BUY
19-10-20 10:02,10:02,6703700,7141075,437375,BUY
19-10-20 10:03,10:03,6741725,7142175,400450,BUY
19-10-20 10:04,10:04,6703700,7141075,437375,BUY
19-10-20 10:05,10:05,6493375,7323200,829825,BUY
19-10-20 10:06,10:06,6474175,7321450,847275,BUY
19-10-20 10:07,10:07,6479675,7320200,840525,BUY
19-10-20 10:08,10:08,6529200,7418750,889550,BUY
19-10-20 10:09,10:09,6533600,7423450,889850,BUY
19-10-20 10:10,10:10,6576725,7427825,851100,BUY
19-10-20 10:11,10:11,6559025,7526600,967575,BUY
19-10-20 10:12,10:12,6539750,7526550,986800,BUY
19-10-20 10:13,10:13,6492275,7517475,1025200,BUY
19-10-20 10:14,10:14,6689500,7605325,915825,BUY
19-10-20 10:15,10:15,6657200,7599700,942500,BUY
19-10-20 10:16,10:16,6703850,7608925,905075,BUY
19-10-20 10:17,10:17,6658350,7751650,1093300,BUY
19-10-20 10:18,10:18,6625175,7744250,1119075,BUY
19-10-20 10:19,10:19,6640300,7747475,1107175,BUY
19-10-20 10:20,10:20,6765325,7836300,1070975,BUY
19-10-20 10:21,10:21,6781650,7839375,1057725,BUY
19-10-20 10:22,10:22,6757625,7833250,1075625,BUY
19-10-20 10:23,10:23,6826275,7905200,1078925,BUY
19-10-20 10:24,10:24,6845725,7808800,963075,BUY
19-10-20 10:25,10:25,6856625,7902425,1045800,BUY
19-10-20 10:26,10:26,6933475,7978875,1045400,BUY
19-10-20 10:27,10:27,6919400,7981775,1062375,BUY
19-10-20 10:28,10:28,6929000,7965225,1036225,BUY
19-10-20 10:29,10:29,6936125,8069750,1133625,BUY
19-10-20 10:30,10:30,6964900,8066025,1101125,BUY
19-10-20 10:31,10:31,6942650,8063150,1120500,BUY
19-10-20 10:32,10:32,7001950,8111250,1109300,BUY
19-10-20 10:33,10:33,6958175,8115300,1157125,BUY
19-10-20 10:34,10:34,6983275,8117700,1134425,BUY
19-10-20 10:35,10:35,7000875,8191800,1190925,BUY
19-10-20 10:36,10:36,6996425,8185475,1189050,BUY
19-10-20 10:37,10:37,6976575,8184275,1207700,BUY
19-10-20 10:38,10:38,7045675,8230000,1184325,BUY
19-10-20 10:39,10:39,7086650,8243275,1156625,BUY
19-10-20 10:40,10:40,7032925,8239950,1207025,BUY
19-10-20 10:41,10:41,7046125,8326925,1280800,BUY
19-10-20 10:42,10:42,7021800,8318025,1296225,BUY
19-10-20 10:43,10:43,7018275,8309025,1290750,BUY
19-10-20 10:44,10:44,7042050,8324950,1282900,BUY
19-10-20 10:45,10:45,7055700,8314725,1259025,BUY
19-10-20 10:46,10:46,7060925,8320875,1259950,BUY
19-10-20 10:47,10:47,7095400,8329350,1233950,BUY
19-10-20 10:48,10:48,7113625,8332675,1219050,BUY
19-10-20 10:49,10:49,7063050,8325300,1262250,BUY
19-10-20 10:50,10:50,7137175,8326950,1189775,BUY
19-10-20 10:51,10:51,7151475,8330675,1179200,BUY
19-10-20 10:52,10:52,7057625,8313350,1255725,BUY
19-10-20 10:53,10:53,7181325,8364175,1182850,BUY
19-10-20 10:54,10:54,7151500,8376150,1224650,BUY
19-10-20 10:55,10:55,7187075,8380500,1193425,BUY
19-10-20 10:56,10:56,7137825,8293625,1155800,BUY
19-10-20 10:57,10:57,7137775,8298900,1161125,BUY
19-10-20 10:58,10:58,7084275,8294450,1210175,BUY
19-10-20 10:59,10:59,7145625,8361100,1215475,BUY
19-10-20 11:00,11:00,7065125,8363800,1298675,BUY
19-10-20 11:01,11:01,7188225,8361650,1173425,BUY
19-10-20 11:02,11:02,7210375,8411825,1201450,BUY
19-10-20 11:03,11:03,7159200,8412700,1253500,BUY
19-10-20 11:04,11:04,7191750,8416050,1224300,BUY
19-10-20 11:05,11:05,7218100,8407625,1189525,BUY
19-10-20 11:06,11:06,7197475,8402400,1204925,BUY
19-10-20 11:07,11:07,7261575,8402400,1140825,BUY
19-10-20 11:08,11:08,7259450,8432850,1173400,BUY
19-10-20 11:09,11:09,7269225,8416425,1147200,BUY
19-10-20 11:10,11:10,7288950,8426200,1137250,BUY
19-10-20 11:11,11:11,7193575,8396200,1202625,BUY
19-10-20 11:12,11:12,7244950,8416825,1171875,BUY
19-10-20 11:13,11:13,7281225,8400000,1118775,BUY
19-10-20 11:14,11:14,7244725,8380750,1136025,BUY
19-10-20 11:15,11:15,7255075,8432200,1177125,BUY
19-10-20 11:16,11:16,7238775,8431525,1192750,BUY
19-10-20 11:17,11:17,7222825,8452325,1229500,BUY
19-10-20 11:18,11:18,7243875,8452650,1208775,BUY
19-10-20 11:19,11:19,7262925,8439350,1176425,BUY
19-10-20 11:20,11:20,7286850,8436375,1149525,BUY
19-10-20 11:21,11:21,7307425,8439650,1132225,BUY
19-10-20 11:22,11:22,7257225,8433375,1176150,BUY
19-10-20 11:23,11:23,7315275,8392775,1077500,BUY
19-10-20 11:24,11:24,7335875,8390575,1054700,BUY
19-10-20 11:25,11:25,7302175,8396400,1094225,BUY
19-10-20 11:26,11:26,7368900,8469650,1100750,BUY
19-10-20 11:27,11:27,7402575,8466375,1063800,BUY
19-10-20 11:28,11:28,7408275,8466375,1058100,BUY
19-10-20 11:29,11:29,7487800,8482850,995050,BUY
19-10-20 11:30,11:30,7487025,8488250,1001225,BUY
19-10-20 11:31,11:31,7438150,8498250,1060100,BUY
19-10-20 11:32,11:32,7492075,8494025,1001950,BUY
19-10-20 11:33,11:33,7354150,8494275,1140125,BUY
19-10-20 11:34,11:34,7491950,8489350,997400,BUY
19-10-20 11:35,11:35,7491500,8525675,1034175,BUY
19-10-20 11:36,11:36,7503425,8533850,1030425,BUY
19-10-20 11:37,11:37,7464875,8527650,1062775,BUY
19-10-20 11:38,11:38,7474200,8568775,1094575,BUY
19-10-20 11:39,11:39,7454650,8570325,1115675,BUY
19-10-20 11:40,11:40,7396200,8573225,1177025,BUY
19-10-20 11:41,11:41,7497725,8582025,1084300,BUY
19-10-20 11:42,11:42,7592300,8582950,990650,BUY
19-10-20 11:43,11:43,7570700,8577750,1007050,BUY
19-10-20 11:44,11:44,7391075,8580400,1189325,BUY
19-10-20 11:45,11:45,7478250,8579200,1100950,BUY
19-10-20 11:46,11:46,7446000,8576250,1130250,BUY
19-10-20 11:47,11:47,7429050,8594825,1165775,BUY
19-10-20 11:48,11:48,7543775,8611875,1068100,BUY
19-10-20 11:49,11:49,7340475,8602250,1261775,BUY
19-10-20 11:50,11:50,7368350,8610725,1242375,BUY
19-10-20 11:51,11:51,7545850,8622475,1076625,BUY
19-10-20 11:52,11:52,7535850,8609450,1073600,BUY
19-10-20 11:53,11:53,7596550,8596925,1000375,BUY
19-10-20 11:54,11:54,7605850,8613425,1007575,BUY
19-10-20 11:55,11:55,7549525,8606675,1057150,BUY
19-10-20 11:56,11:56,7449600,8508375,1058775,BUY
19-10-20 11:57,11:57,7446300,8512000,1065700,BUY
19-10-20 11:58,11:58,7511150,8512000,1000850,BUY
19-10-20 11:59,11:59,7515625,8518200,1002575,BUY
19-10-20 12:00,12:00,7374125,8530825,1156700,BUY
19-10-20 12:01,12:01,7236525,8520525,1284000,BUY
19-10-20 12:02,12:02,7582950,8578825,995875,BUY
19-10-20 12:03,12:03,7596475,8579100,982625,BUY
19-10-20 12:04,12:04,7582375,8569525,987150,BUY
19-10-20 12:05,12:05,7450575,8595975,1145400,BUY
19-10-20 12:06,12:06,7503275,8589675,1086400,BUY
19-10-20 12:07,12:07,7406050,8599225,1193175,BUY
19-10-20 12:08,12:08,7529400,8710325,1180925,BUY
19-10-20 12:09,12:09,7521450,8713925,1192475,BUY
19-10-20 12:10,12:10,7528225,8706825,1178600,BUY
19-10-20 12:11,12:11,7517050,8761250,1244200,BUY
19-10-20 12:12,12:12,7387100,8766775,1379675,BUY
19-10-20 12:13,12:13,7391675,8759325,1367650,BUY
19-10-20 12:14,12:14,7518575,8866375,1347800,BUY
19-10-20 12:15,12:15,7543825,8866825,1323000,BUY
19-10-20 12:16,12:16,7524950,8863450,1338500,BUY
19-10-20 12:17,12:17,7586975,8936750,1349775,BUY
19-10-20 12:18,12:18,7555350,8924975,1369625,BUY
19-10-20 12:19,12:19,7420675,8923275,1502600,BUY
19-10-20 12:20,12:20,7631200,8959500,1328300,BUY
19-10-20 12:21,12:21,7513875,8967550,1453675,BUY
19-10-20 12:22,12:22,7548000,8978350,1430350,BUY
19-10-20 12:23,12:23,7628325,8993525,1365200,BUY
19-10-20 12:24,12:24,7632350,8998550,1366200,BUY
19-10-20 12:25,12:25,7518425,8998875,1480450,BUY
19-10-20 12:26,12:26,7629550,9003100,1373550,BUY
19-10-20 12:27,12:27,7527150,8991050,1463900,BUY
19-10-20 12:28,12:28,7551250,9001350,1450100,BUY
19-10-20 12:29,12:29,7638925,9003650,1364725,BUY
19-10-20 12:30,12:30,7665850,9016900,1351050,BUY
19-10-20 12:31,12:31,7620275,9003775,1383500,BUY
19-10-20 12:32,12:32,7583575,9086425,1502850,BUY
19-10-20 12:33,12:33,7614375,9089600,1475225,BUY
19-10-20 12:34,12:34,7561350,9079975,1518625,BUY
19-10-20 12:35,12:35,7534775,9046625,1511850,BUY
19-10-20 12:36,12:36,7513050,9086450,1573400,BUY
19-10-20 12:37,12:37,7536925,9084700,1547775,BUY
19-10-20 12:38,12:38,7486000,9124650,1638650,BUY
19-10-20 12:39,12:39,7507025,9137175,1630150,BUY
19-10-20 12:40,12:40,7452575,9133400,1680825,BUY
19-10-20 12:41,12:41,7455250,9089250,1634000,BUY
19-10-20 12:42,12:42,7533250,9090750,1557500,BUY
19-10-20 12:43,12:43,7413100,9086650,1673550,BUY
19-10-20 12:44,12:44,7519375,9123800,1604425,BUY
19-10-20 12:45,12:45,7522575,9112325,1589750,BUY
19-10-20 12:46,12:46,7505125,9112325,1607200,BUY
19-10-20 12:47,12:47,7408400,9117225,1708825,BUY
19-10-20 12:48,12:48,7371200,9138225,1767025,BUY
19-10-20 12:49,12:49,7388675,9130400,1741725,BUY
19-10-20 12:50,12:50,7428000,9180875,1752875,BUY
19-10-20 12:51,12:51,7417200,9201000,1783800,BUY
19-10-20 12:52,12:52,7413575,9190375,1776800,BUY
19-10-20 12:53,12:53,7458325,9202250,1743925,BUY
19-10-20 12:54,12:54,7336475,9195975,1859500,BUY
19-10-20 12:55,12:55,7353850,9134975,1781125,BUY
19-10-20 12:56,12:56,7382800,9193875,1811075,BUY
19-10-20 12:57,12:57,7374475,9189625,1815150,BUY
19-10-20 12:58,12:58,7374475,9186050,1811575,BUY
19-10-20 12:59,12:59,7359700,9197200,1837500,BUY
19-10-20 13:00,13:00,7361600,9215325,1853725,BUY
19-10-20 13:01,13:01,7188225,9223050,2034825,BUY
19-10-20 13:02,13:02,7350200,9161775,1811575,BUY
19-10-20 13:03,13:03,7342625,9240525,1897900,BUY
19-10-20 13:04,13:04,7378050,9244150,1866100,BUY
19-10-20 13:05,13:05,7417500,9243700,1826200,BUY
19-10-20 13:06,13:06,7322050,9234100,1912050,BUY
19-10-20 13:07,13:07,7404725,9236800,1832075,BUY
19-10-20 13:08,13:08,7327250,9236750,1909500,BUY
19-10-20 13:09,13:09,7312400,9224000,1911600,BUY
19-10-20 13:10,13:10,7380150,9281550,1901400,BUY
19-10-20 13:11,13:11,7183525,9284225,2100700,BUY
19-10-20 13:12,13:12,7350900,9269000,1918100,BUY
19-10-20 13:13,13:13,7396600,9279775,1883175,BUY
19-10-20 13:14,13:14,7386300,9275950,1889650,BUY
19-10-20 13:15,13:15,7502725,9337400,1834675,BUY
19-10-20 13:16,13:16,7499950,9335300,1835350,BUY
19-10-20 13:17,13:17,7447825,9335575,1887750,BUY
19-10-20 13:18,13:18,7206525,9265025,2058500,BUY
19-10-20 13:19,13:19,7200150,9266550,2066400,BUY
19-10-20 13:20,13:20,7152850,9270625,2117775,BUY
19-10-20 13:21,13:21,7207600,9337175,2129575,BUY
19-10-20 13:22,13:22,7215575,9335125,2119550,BUY
19-10-20 13:23,13:23,7213575,9331325,2117750,BUY
19-10-20 13:24,13:24,7247500,9383225,2135725,BUY
19-10-20 13:25,13:25,7248350,9366000,2117650,BUY
19-10-20 13:26,13:26,7265775,9379125,2113350,BUY
19-10-20 13:27,13:27,7228700,9371575,2142875,BUY
19-10-20 13:28,13:28,7098950,9369250,2270300,BUY
19-10-20 13:29,13:29,7239825,9376700,2136875,BUY
19-10-20 13:30,13:30,7240575,9334500,2093925,BUY
19-10-20 13:31,13:31,7191225,9325925,2134700,BUY
19-10-20 13:32,13:32,7188625,9333325,2144700,BUY
19-10-20 13:33,13:33,7086375,9310475,2224100,BUY
19-10-20 13:34,13:34,7100500,9327225,2226725,BUY
19-10-20 13:35,13:35,7232800,9320250,2087450,BUY
19-10-20 13:36,13:36,7267275,9319000,2051725,BUY
19-10-20 13:37,13:37,7297575,9337500,2039925,BUY
19-10-20 13:38,13:38,7297575,9328025,2030450,BUY
19-10-20 13:39,13:39,7194925,9352500,2157575,BUY
19-10-20 13:40,13:40,7200925,9349050,2148125,BUY
19-10-20 13:41,13:41,7251275,9361275,2110000,BUY
19-10-20 13:42,13:42,7254200,9274950,2020750,BUY
19-10-20 13:43,13:43,7177300,9337625,2160325,BUY
19-10-20 13:44,13:44,7146725,9340625,2193900,BUY
19-10-20 13:45,13:45,7198725,9358200,2159475,BUY
19-10-20 13:46,13:46,7312550,9362400,2049850,BUY
19-10-20 13:47,13:47,7217775,9358650,2140875,BUY
19-10-20 13:48,13:48,7302700,9391725,2089025,BUY
19-10-20 13:49,13:49,7227450,9376950,2149500,BUY
19-10-20 13:50,13:50,7175825,9395350,2219525,BUY
19-10-20 13:51,13:51,7299950,9400050,2100100,BUY
19-10-20 13:52,13:52,7281350,9387325,2105975,BUY
19-10-20 13:53,13:53,7246825,9401150,2154325,BUY
19-10-20 13:54,13:54,7223750,9399050,2175300,BUY
19-10-20 13:55,13:55,7296925,9402550,2105625,BUY
19-10-20 13:56,13:56,7292150,9412200,2120050,BUY
19-10-20 13:57,13:57,7283275,9446525,2163250,BUY
19-10-20 13:58,13:58,7351550,9438175,2086625,BUY
19-10-20 13:59,13:59,7359875,9446550,2086675,BUY
19-10-20 14:00,14:00,7347925,9521725,2173800,BUY
19-10-20 14:01,14:01,7250600,9510550,2259950,BUY
19-10-20 14:02,14:02,7301425,9500000,2198575,BUY
19-10-20 14:03,14:03,7455850,9532825,2076975,BUY
19-10-20 14:04,14:04,7510875,9547875,2037000,BUY
19-10-20 14:05,14:05,7492250,9552525,2060275,BUY
19-10-20 14:06,14:06,7419225,9577850,2158625,BUY
19-10-20 14:07,14:07,7389500,9572400,2182900,BUY
19-10-20 14:08,14:08,7349425,9576750,2227325,BUY
19-10-20 14:09,14:09,7411750,9628675,2216925,BUY
19-10-20 14:10,14:10,7463200,9626825,2163625,BUY
19-10-20 14:11,14:11,7472825,9604050,2131225,BUY
19-10-20 14:12,14:12,7341375,9625200,2283825,BUY
19-10-20 14:13,14:13,7466950,9627550,2160600,BUY
19-10-20 14:14,14:14,7477950,9614925,2136975,BUY
19-10-20 14:15,14:15,7493425,9666825,2173400,BUY
19-10-20 14:16,14:16,7483225,9656425,2173200,BUY
19-10-20 14:17,14:17,7493425,9656450,2163025,BUY
19-10-20 14:18,14:18,7537725,9640750,2103025,BUY
19-10-20 14:19,14:19,7527875,9640950,2113075,BUY
19-10-20 14:20,14:20,7472875,9630350,2157475,BUY
19-10-20 14:21,14:21,7462925,9605525,2142600,BUY
19-10-20 14:22,14:22,7431175,9606075,2174900,BUY
19-10-20 14:23,14:23,7452750,9611425,2158675,BUY
19-10-20 14:24,14:24,7472025,9591475,2119450,BUY
19-10-20 14:25,14:25,7472850,9608625,2135775,BUY
19-10-20 14:26,14:26,7438800,9598600,2159800,BUY
19-10-20 14:27,14:27,7489175,9612300,2123125,BUY
19-10-20 14:28,14:28,7455175,9612300,2157125,BUY
19-10-20 14:29,14:29,7431600,9614125,2182525,BUY
19-10-20 14:30,14:30,7494850,9650825,2155975,BUY
19-10-20 14:31,14:31,7512475,9656550,2144075,BUY
19-10-20 14:32,14:32,7512450,9650925,2138475,BUY
19-10-20 14:33,14:33,7534775,9646275,2111500,BUY
19-10-20 14:34,14:34,7556175,9653725,2097550,BUY
19-10-20 14:35,14:35,7560675,9655075,2094400,BUY
19-10-20 14:36,14:36,7331275,9582875,2251600,BUY
19-10-20 14:37,14:37,7281175,9583625,2302450,BUY
19-10-20 14:38,14:38,7262400,9573800,2311400,BUY
19-10-20 14:39,14:39,7343250,9649900,2306650,BUY
19-10-20 14:40,14:40,7261800,9651725,2389925,BUY
19-10-20 14:41,14:41,7314475,9651725,2337250,BUY
19-10-20 14:42,14:42,7332925,9662000,2329075,BUY
19-10-20 14:43,14:43,7323350,9662000,2338650,BUY
19-10-20 14:44,14:44,7256550,9656650,2400100,BUY
19-10-20 14:45,14:45,7361700,9695825,2334125,BUY
19-10-20 14:46,14:46,7328675,9695650,2366975,BUY
19-10-20 14:47,14:47,7361700,9701375,2339675,BUY
19-10-20 14:48,14:48,7294175,9708900,2414725,BUY
19-10-20 14:49,14:49,7284325,9710850,2426525,BUY
19-10-20 14:50,14:50,7341500,9712850,2371350,BUY
19-10-20 14:51,14:51,7321600,9725125,2403525,BUY
19-10-20 14:52,14:52,7352250,9718975,2366725,BUY
19-10-20 14:53,14:53,7383850,9723700,2339850,BUY
19-10-20 14:54,14:54,7286475,9644300,2357825,BUY
19-10-20 14:55,14:55,7317800,9634300,2316500,BUY
19-10-20 14:56,14:56,7309225,9640400,2331175,BUY
19-10-20 14:57,14:57,7268850,9616525,2347675,BUY
19-10-20 14:58,14:58,7253050,9622050,2369000,BUY
19-10-20 14:59,14:59,7251575,9617025,2365450,BUY
19-10-20 15:00,15:00,7256625,9570675,2314050,BUY
19-10-20 15:01,15:01,7150425,9570675,2420250,BUY
19-10-20 15:02,15:02,7262875,9571325,2308450,BUY
19-10-20 15:03,15:03,7224050,9501650,2277600,BUY
19-10-20 15:04,15:04,7259275,9496050,2236775,BUY
19-10-20 15:05,15:05,7211250,9500775,2289525,BUY
19-10-20 15:06,15:06,7143725,9437950,2294225,BUY
19-10-20 15:07,15:07,7143750,9439350,2295600,BUY
19-10-20 15:08,15:08,7153850,9438775,2284925,BUY
19-10-20 15:09,15:09,7146000,9423000,2277000,BUY
19-10-20 15:10,15:10,7151775,9418150,2266375,BUY
19-10-20 15:11,15:11,7103075,9416600,2313525,BUY
19-10-20 15:12,15:12,7035850,9349250,2313400,BUY
19-10-20 15:13,15:13,7111150,9359025,2247875,BUY
19-10-20 15:14,15:14,7125300,9359150,2233850,BUY
19-10-20 15:15,15:15,7082375,9283775,2201400,BUY
19-10-20 15:16,15:16,7052975,9281275,2228300,BUY
19-10-20 15:17,15:17,7060375,9280225,2219850,BUY
19-10-20 15:18,15:18,6952500,9145500,2193000,BUY
19-10-20 15:19,15:19,6925175,9149225,2224050,BUY
19-10-20 15:20,15:20,6925800,9154150,2228350,BUY
19-10-20 15:21,15:21,6716375,8940200,2223825,BUY
19-10-20 15:22,15:22,6709150,8934850,2225700,BUY
19-10-20 15:23,15:23,6681650,8936900,2255250,BUY
19-10-20 15:24,15:24,6613125,8778675,2165550,BUY
19-10-20 15:25,15:25,6626475,8781925,2155450,BUY
19-10-20 15:26,15:26,6577650,8778600,2200950,BUY
19-10-20 15:27,15:27,6437425,8574025,2136600,BUY
19-10-20 15:28,15:28,6460775,8571850,2111075,BUY
19-10-20 15:29,15:29,6462325,8574575,2112250,BUY
20-10-20 9:15,9:15,6208750,8331400,2122650,BUY
20-10-20 9:16,9:16,6211475,8326300,2114825,BUY
20-10-20 9:17,9:17,6640525,8868250,2227725,BUY
20-10-20 9:18,9:18,6607350,8870925,2263575,BUY
20-10-20 9:19,9:19,6623100,8848700,2225600,BUY
20-10-20 9:20,9:20,7071525,9379275,2307750,BUY
20-10-20 9:21,9:21,7100625,9381800,2281175,BUY
20-10-20 9:22,9:22,7116350,9385100,2268750,BUY
20-10-20 9:23,9:23,7458025,9602525,2144500,BUY
20-10-20 9:24,9:24,7492250,9612325,2120075,BUY
20-10-20 9:25,9:25,7475225,9609025,2133800,BUY
20-10-20 9:26,9:26,7629050,9663825,2034775,BUY
20-10-20 9:27,9:27,7641850,9614425,1972575,BUY
20-10-20 9:28,9:28,7590500,9660500,2070000,BUY
20-10-20 9:29,9:29,7930600,9857300,1926700,BUY
20-10-20 9:30,9:30,7937425,9868475,1931050,BUY
20-10-20 9:31,9:31,7897825,9863975,1966150,BUY
20-10-20 9:32,9:32,8097300,9935825,1838525,BUY
20-10-20 9:33,9:33,8139275,9937725,1798450,BUY
20-10-20 9:34,9:34,8141475,9941650,1800175,BUY
20-10-20 9:35,9:35,8153750,10091025,1937275,BUY
20-10-20 9:36,9:36,8168825,10013850,1845025,BUY
20-10-20 9:37,9:37,8201975,10094625,1892650,BUY
20-10-20 9:38,9:38,8234200,10110025,1875825,BUY
20-10-20 9:39,9:39,8351425,10146175,1794750,BUY
20-10-20 9:40,9:40,8333825,10152775,1818950,BUY
20-10-20 9:41,9:41,8438075,10239375,1801300,BUY
20-10-20 9:42,9:42,8385175,10232500,1847325,BUY
20-10-20 9:43,9:43,8447650,10231350,1783700,BUY
20-10-20 9:44,9:44,8463975,10301300,1837325,BUY
20-10-20 9:45,9:45,8472025,10323200,1851175,BUY
20-10-20 9:46,9:46,8500250,10315425,1815175,BUY
20-10-20 9:47,9:47,8602575,10364250,1761675,BUY
20-10-20 9:48,9:48,8643675,10379150,1735475,BUY
20-10-20 9:49,9:49,8602575,10356000,1753425,BUY
20-10-20 9:50,9:50,8700975,10492450,1791475,BUY
20-10-20 9:51,9:51,8654825,10478025,1823200,BUY
20-10-20 9:52,9:52,8698700,10485750,1787050,BUY
20-10-20 9:53,9:53,8621250,10504900,1883650,BUY
20-10-20 9:54,9:54,8557750,10495200,1937450,BUY
20-10-20 9:55,9:55,8645575,10526050,1880475,BUY
20-10-20 9:56,9:56,8677725,10440350,1762625,BUY
20-10-20 9:57,9:57,8772525,10433125,1660600,BUY
20-10-20 9:58,9:58,8698375,10388800,1690425,BUY
20-10-20 9:59,9:59,8808775,10512275,1703500,BUY
20-10-20 10:00,10:00,8838950,10517550,1678600,BUY
20-10-20 10:01,10:01,8793825,10512275,1718450,BUY
20-10-20 10:02,10:02,8884875,10535050,1650175,BUY
20-10-20 10:03,10:03,8913025,10522050,1609025,BUY
20-10-20 10:04,10:04,8832500,10534450,1701950,BUY
20-10-20 10:05,10:05,8936950,10606600,1669650,BUY
20-10-20 10:06,10:06,8939550,10606000,1666450,BUY
20-10-20 10:07,10:07,8946375,10613950,1667575,BUY
20-10-20 10:08,10:08,8935000,10616375,1681375,BUY
20-10-20 10:09,10:09,9015050,10642175,1627125,BUY
20-10-20 10:10,10:10,9029875,10641475,1611600,BUY
20-10-20 10:11,10:11,9028200,10642850,1614650,BUY
20-10-20 10:12,10:12,8835625,10654050,1818425,BUY
20-10-20 10:13,10:13,8885225,10617175,1731950,BUY
20-10-20 10:14,10:14,9054675,10740825,1686150,BUY
20-10-20 10:15,10:15,9019475,10746200,1726725,BUY
20-10-20 10:16,10:16,8946275,10748875,1802600,BUY
20-10-20 10:17,10:17,8995550,10777400,1781850,BUY
20-10-20 10:18,10:18,9034525,10747225,1712700,BUY
20-10-20 10:19,10:19,9103950,10747225,1643275,BUY
20-10-20 10:20,10:20,9142150,10828700,1686550,BUY
20-10-20 10:21,10:21,8921300,10820575,1899275,BUY
20-10-20 10:22,10:22,9023350,10820575,1797225,BUY
20-10-20 10:23,10:23,8951300,10866975,1915675,BUY
20-10-20 10:24,10:24,8951300,10686950,1735650,BUY
20-10-20 10:25,10:25,8924425,10832900,1908475,BUY
20-10-20 10:26,10:26,9125375,10887875,1762500,BUY
20-10-20 10:27,10:27,9138050,10880975,1742925,BUY
20-10-20 10:28,10:28,9153350,10773900,1620550,BUY
20-10-20 10:29,10:29,9191125,10948625,1757500,BUY
20-10-20 10:30,10:30,9004275,10931300,1927025,BUY
20-10-20 10:31,10:31,9059625,10774200,1714575,BUY
20-10-20 10:32,10:32,9157875,11001150,1843275,BUY
20-10-20 10:33,10:33,9081275,11001750,1920475,BUY
20-10-20 10:34,10:34,9029650,11001750,1972100,BUY
20-10-20 10:35,10:35,9157025,11077825,1920800,BUY
20-10-20 10:36,10:36,9157200,11076225,1919025,BUY
20-10-20 10:37,10:37,9205100,11062900,1857800,BUY
20-10-20 10:38,10:38,9095700,11138550,2042850,BUY
20-10-20 10:39,10:39,9169325,11148700,1979375,BUY
20-10-20 10:40,10:40,9119950,11150275,2030325,BUY
20-10-20 10:41,10:41,9199075,11113300,1914225,BUY
20-10-20 10:42,10:42,9123000,11048575,1925575,BUY
20-10-20 10:43,10:43,9217075,11149450,1932375,BUY
20-10-20 10:44,10:44,9184350,11114875,1930525,BUY
20-10-20 10:45,10:45,9185425,11108550,1923125,BUY
20-10-20 10:46,10:46,9100150,11098800,1998650,BUY
20-10-20 10:47,10:47,8846025,11012125,2166100,BUY
20-10-20 10:48,10:48,8821950,11017750,2195800,BUY
20-10-20 10:49,10:49,8890725,11017750,2127025,BUY
20-10-20 10:50,10:50,8862325,11077050,2214725,BUY
20-10-20 10:51,10:51,8789450,11077050,2287600,BUY
20-10-20 10:52,10:52,8867000,11066650,2199650,BUY
20-10-20 10:53,10:53,8798450,11093425,2294975,BUY
20-10-20 10:54,10:54,8844475,11101725,2257250,BUY
20-10-20 10:55,10:55,8739900,11101725,2361825,BUY
20-10-20 10:56,10:56,8822650,11113575,2290925,BUY
20-10-20 10:57,10:57,8688625,11115575,2426950,BUY
20-10-20 10:58,10:58,8859000,11094375,2235375,BUY
20-10-20 10:59,10:59,8864275,11165300,2301025,BUY
20-10-20 11:00,11:00,8852600,11124300,2271700,BUY
20-10-20 11:01,11:01,8843850,11164575,2320725,BUY
20-10-20 11:02,11:02,8787650,11232825,2445175,BUY
20-10-20 11:03,11:03,8806550,11225100,2418550,BUY
20-10-20 11:04,11:04,8857900,11196275,2338375,BUY
20-10-20 11:05,11:05,8731950,11251800,2519850,BUY
20-10-20 11:06,11:06,8904800,11170125,2265325,BUY
20-10-20 11:07,11:07,8738300,11092750,2354450,BUY
20-10-20 11:08,11:08,8823475,11217250,2393775,BUY
20-10-20 11:09,11:09,8920950,11309600,2388650,BUY
20-10-20 11:10,11:10,8980150,11317100,2336950,BUY
20-10-20 11:11,11:11,8714700,11326100,2611400,BUY
20-10-20 11:12,11:12,8701625,11330175,2628550,BUY
20-10-20 11:13,11:13,8724100,11330175,2606075,BUY
20-10-20 11:14,11:14,8493375,11241825,2748450,BUY
20-10-20 11:15,11:15,8419350,11240900,2821550,BUY
20-10-20 11:16,11:16,8386850,11240075,2853225,BUY
20-10-20 11:17,11:17,8455725,11286775,2831050,BUY
20-10-20 11:18,11:18,8451925,11294000,2842075,BUY
20-10-20 11:19,11:19,8497925,11297400,2799475,BUY
20-10-20 11:20,11:20,8495550,11301500,2805950,BUY
20-10-20 11:21,11:21,8468050,11300700,2832650,BUY
20-10-20 11:22,11:22,8354975,11301800,2946825,BUY
20-10-20 11:23,11:23,8379600,11335875,2956275,BUY
20-10-20 11:24,11:24,8435075,11335825,2900750,BUY
20-10-20 11:25,11:25,8326000,11329175,3003175,BUY
20-10-20 11:26,11:26,8360075,11292325,2932250,BUY
20-10-20 11:27,11:27,8366525,11309150,2942625,BUY
20-10-20 11:28,11:28,8438225,11306450,2868225,BUY
20-10-20 11:29,11:29,8407150,11316400,2909250,BUY
20-10-20 11:30,11:30,8343400,11310375,2966975,BUY
20-10-20 11:31,11:31,8191625,11263850,3072225,BUY
20-10-20 11:32,11:32,8478500,11284400,2805900,BUY
20-10-20 11:33,11:33,8291325,11276350,2985025,BUY
20-10-20 11:34,11:34,8459975,11150250,2690275,BUY
20-10-20 11:35,11:35,8346675,11285050,2938375,BUY
20-10-20 11:36,11:36,8360425,11291725,2931300,BUY
20-10-20 11:37,11:37,8242575,11164725,2922150,BUY
20-10-20 11:38,11:38,8434575,11303225,2868650,BUY
20-10-20 11:39,11:39,8374975,11291800,2916825,BUY
20-10-20 11:40,11:40,8259525,11303900,3044375,BUY
20-10-20 11:41,11:41,8363550,11326625,2963075,BUY
20-10-20 11:42,11:42,8248625,11300350,3051725,BUY
20-10-20 11:43,11:43,8312875,11310700,2997825,BUY
20-10-20 11:44,11:44,8298000,11332125,3034125,BUY
20-10-20 11:45,11:45,8357375,11340875,2983500,BUY
20-10-20 11:46,11:46,8332875,11332125,2999250,BUY
20-10-20 11:47,11:47,8348625,11370675,3022050,BUY
20-10-20 11:48,11:48,8224650,11282725,3058075,BUY
20-10-20 11:49,11:49,8309450,11376600,3067150,BUY
20-10-20 11:50,11:50,8245475,10851975,2606500,BUY
20-10-20 11:51,11:51,8429300,11400325,2971025,BUY
20-10-20 11:52,11:52,8414275,11392850,2978575,BUY
20-10-20 11:53,11:53,8359975,11415125,3055150,BUY
20-10-20 11:54,11:54,8333700,11411875,3078175,BUY
20-10-20 11:55,11:55,8333700,11413825,3080125,BUY
20-10-20 11:56,11:56,8197425,11471950,3274525,BUY
20-10-20 11:57,11:57,8214750,11471175,3256425,BUY
20-10-20 11:58,11:58,8124425,11424400,3299975,BUY
20-10-20 11:59,11:59,8093350,11500600,3407250,BUY
20-10-20 12:00,12:00,8184100,11483700,3299600,BUY
20-10-20 12:01,12:01,8131200,11507125,3375925,BUY
20-10-20 12:02,12:02,8192375,11537250,3344875,BUY
20-10-20 12:03,12:03,8242150,11464425,3222275,BUY
20-10-20 12:04,12:04,8156850,11548700,3391850,BUY
20-10-20 12:05,12:05,8219000,11557100,3338100,BUY
20-10-20 12:06,12:06,8199125,11559175,3360050,BUY
20-10-20 12:07,12:07,8207950,11563600,3355650,BUY
20-10-20 12:08,12:08,8289200,11497250,3208050,BUY
20-10-20 12:09,12:09,8194650,11547025,3352375,BUY
20-10-20 12:10,12:10,8262525,11500600,3238075,BUY
20-10-20 12:11,12:11,8144575,11507000,3362425,BUY
20-10-20 12:12,12:12,8232875,11558475,3325600,BUY
20-10-20 12:13,12:13,8025850,11510475,3484625,BUY
20-10-20 12:14,12:14,8114525,11558450,3443925,BUY
20-10-20 12:15,12:15,8213100,11548900,3335800,BUY
20-10-20 12:16,12:16,8230625,11528550,3297925,BUY
20-10-20 12:17,12:17,8293400,11586375,3292975,BUY
20-10-20 12:18,12:18,8178200,11589325,3411125,BUY
20-10-20 12:19,12:19,8159900,11095025,2935125,BUY
20-10-20 12:20,12:20,8368350,11545825,3177475,BUY
20-10-20 12:21,12:21,8178625,11477050,3298425,BUY
20-10-20 12:22,12:22,8108900,11490800,3381900,BUY
20-10-20 12:23,12:23,8384125,11578725,3194600,BUY
20-10-20 12:24,12:24,8400900,11583000,3182100,BUY
20-10-20 12:25,12:25,8394250,11581425,3187175,BUY
20-10-20 12:26,12:26,8115225,11487650,3372425,BUY
20-10-20 12:27,12:27,8241000,11518475,3277475,BUY
20-10-20 12:28,12:28,8151875,11557050,3405175,BUY
20-10-20 12:29,12:29,8203225,11586450,3383225,BUY
20-10-20 12:30,12:30,8288250,11592275,3304025,BUY
20-10-20 12:31,12:31,8199500,11588400,3388900,BUY
20-10-20 12:32,12:32,8205700,11589350,3383650,BUY
20-10-20 12:33,12:33,8205825,11586975,3381150,BUY
20-10-20 12:34,12:34,8251375,11459000,3207625,BUY
20-10-20 12:35,12:35,8055400,11623600,3568200,BUY
20-10-20 12:36,12:36,8286600,11549125,3262525,BUY
20-10-20 12:37,12:37,8151900,11617325,3465425,BUY
20-10-20 12:38,12:38,8126600,11637325,3510725,BUY
20-10-20 12:39,12:39,8233325,11636075,3402750,BUY
20-10-20 12:40,12:40,8266450,11633175,3366725,BUY
20-10-20 12:41,12:41,8206525,11647750,3441225,BUY
20-10-20 12:42,12:42,8222250,11641500,3419250,BUY
20-10-20 12:43,12:43,8321475,11642525,3321050,BUY
20-10-20 12:44,12:44,8295875,11655250,3359375,BUY
20-10-20 12:45,12:45,8192850,11655000,3462150,BUY
20-10-20 12:46,12:46,8228025,11656075,3428050,BUY
20-10-20 12:47,12:47,8248000,11105800,2857800,BUY
20-10-20 12:48,12:48,8073350,11652475,3579125,BUY
20-10-20 12:49,12:49,8073350,11592225,3518875,BUY
20-10-20 12:50,12:50,8152925,11669750,3516825,BUY
20-10-20 12:51,12:51,8339925,11665725,3325800,BUY
20-10-20 12:52,12:52,8092000,11665725,3573725,BUY
20-10-20 12:53,12:53,8260000,11682325,3422325,BUY
20-10-20 12:54,12:54,8207725,11619175,3411450,BUY
20-10-20 12:55,12:55,8182100,11620700,3438600,BUY
20-10-20 12:56,12:56,8334250,11703350,3369100,BUY
20-10-20 12:57,12:57,8420100,11709850,3289750,BUY
20-10-20 12:58,12:58,8391275,11702225,3310950,BUY
20-10-20 12:59,12:59,8245225,11695250,3450025,BUY
20-10-20 13:00,13:00,8502700,11748625,3245925,BUY
20-10-20 13:01,13:01,8483200,11740550,3257350,BUY
20-10-20 13:02,13:02,8407925,11761475,3353550,BUY
20-10-20 13:03,13:03,8426675,11759800,3333125,BUY
20-10-20 13:04,13:04,8453000,11749375,3296375,BUY
20-10-20 13:05,13:05,8453000,11719825,3266825,BUY
20-10-20 13:06,13:06,8378800,11720225,3341425,BUY
20-10-20 13:07,13:07,8224100,11714575,3490475,BUY
20-10-20 13:08,13:08,8343600,11715250,3371650,BUY
20-10-20 13:09,13:09,8233425,11671800,3438375,BUY
20-10-20 13:10,13:10,8282000,11660925,3378925,BUY
20-10-20 13:11,13:11,8329175,11672000,3342825,BUY
20-10-20 13:12,13:12,8356600,11630350,3273750,BUY
20-10-20 13:13,13:13,8239750,11613325,3373575,BUY
20-10-20 13:14,13:14,8262700,11624225,3361525,BUY
20-10-20 13:15,13:15,8209900,11574900,3365000,BUY
20-10-20 13:16,13:16,8340600,11582750,3242150,BUY
20-10-20 13:17,13:17,8373925,11570725,3196800,BUY
20-10-20 13:18,13:18,8173050,11532000,3358950,BUY
20-10-20 13:19,13:19,8170000,11530875,3360875,BUY
20-10-20 13:20,13:20,8366975,11544425,3177450,BUY
20-10-20 13:21,13:21,8359125,11554675,3195550,BUY
20-10-20 13:22,13:22,8356375,11549925,3193550,BUY
20-10-20 13:23,13:23,8366700,11547675,3180975,BUY
20-10-20 13:24,13:24,8262375,11505425,3243050,BUY
20-10-20 13:25,13:25,8217225,11542275,3325050,BUY
20-10-20 13:26,13:26,8328750,11549925,3221175,BUY
20-10-20 13:27,13:27,8374225,11549325,3175100,BUY
20-10-20 13:28,13:28,8216550,11543350,3326800,BUY
20-10-20 13:29,13:29,8214025,11532200,3318175,BUY
20-10-20 13:30,13:30,8272400,11457575,3185175,BUY
20-10-20 13:31,13:31,8245025,11586700,3341675,BUY
20-10-20 13:32,13:32,8189850,11419675,3229825,BUY
20-10-20 13:33,13:33,8319050,11592075,3273025,BUY
20-10-20 13:34,13:34,8128475,11596725,3468250,BUY
20-10-20 13:35,13:35,8258800,11592075,3333275,BUY
20-10-20 13:36,13:36,8196050,11572650,3376600,BUY
20-10-20 13:37,13:37,8148575,11573750,3425175,BUY
20-10-20 13:38,13:38,8287550,11580100,3292550,BUY
20-10-20 13:39,13:39,8063250,11523850,3460600,BUY
20-10-20 13:40,13:40,8147400,11516775,3369375,BUY
20-10-20 13:41,13:41,8081875,11485450,3403575,BUY
20-10-20 13:42,13:42,8114825,11473100,3358275,BUY
20-10-20 13:43,13:43,8076000,11471500,3395500,BUY
20-10-20 13:44,13:44,8221350,11514675,3293325,BUY
20-10-20 13:45,13:45,8164600,11477925,3313325,BUY
20-10-20 13:46,13:46,8154125,11368450,3214325,BUY
20-10-20 13:47,13:47,8154125,11441575,3287450,BUY
20-10-20 13:48,13:48,8026025,11441150,3415125,BUY
20-10-20 13:49,13:49,8068875,11484050,3415175,BUY
20-10-20 13:50,13:50,8184775,11487050,3302275,BUY
20-10-20 13:51,13:51,7875500,11433125,3557625,BUY
20-10-20 13:52,13:52,7940075,11409625,3469550,BUY
20-10-20 13:53,13:53,8031725,11265375,3233650,BUY
20-10-20 13:54,13:54,8113000,11451325,3338325,BUY
20-10-20 13:55,13:55,7992425,11451325,3458900,BUY
20-10-20 13:56,13:56,8044775,11451325,3406550,BUY
20-10-20 13:57,13:57,8176750,11431375,3254625,BUY
20-10-20 13:58,13:58,8129100,11403550,3274450,BUY
20-10-20 13:59,13:59,8030975,11416975,3386000,BUY
20-10-20 14:00,14:00,8149175,11414225,3265050,BUY
20-10-20 14:01,14:01,8155150,11420150,3265000,BUY
20-10-20 14:02,14:02,8042075,11409400,3367325,BUY
20-10-20 14:03,14:03,8128250,11343875,3215625,BUY
20-10-20 14:04,14:04,7975500,11303500,3328000,BUY
20-10-20 14:05,14:05,8138275,11341750,3203475,BUY
20-10-20 14:06,14:06,8095375,11287475,3192100,BUY
20-10-20 14:07,14:07,7959200,11257950,3298750,BUY
20-10-20 14:08,14:08,7924500,11221900,3297400,BUY
20-10-20 14:09,14:09,8075175,11314625,3239450,BUY
20-10-20 14:10,14:10,8095550,11318325,3222775,BUY
20-10-20 14:11,14:11,8221000,11317250,3096250,BUY
20-10-20 14:12,14:12,8073400,11225675,3152275,BUY
20-10-20 14:13,14:13,7958975,11261000,3302025,BUY
20-10-20 14:14,14:14,8037925,11227375,3189450,BUY
20-10-20 14:15,14:15,8096150,11183775,3087625,BUY
20-10-20 14:16,14:16,8003025,11182675,3179650,BUY
20-10-20 14:17,14:17,8018200,11173375,3155175,BUY
20-10-20 14:18,14:18,7909150,11092900,3183750,BUY
20-10-20 14:19,14:19,7913800,11091000,3177200,BUY
20-10-20 14:20,14:20,7930450,11066000,3135550,BUY
20-10-20 14:21,14:21,7727375,11047125,3319750,BUY
20-10-20 14:22,14:22,7908150,11056450,3148300,BUY
20-10-20 14:23,14:23,7791900,11052250,3260350,BUY
20-10-20 14:24,14:24,7877775,11018650,3140875,BUY
20-10-20 14:25,14:25,7869350,10941025,3071675,BUY
20-10-20 14:26,14:26,7725725,10989300,3263575,BUY
20-10-20 14:27,14:27,7656575,10949450,3292875,BUY
20-10-20 14:28,14:28,7728400,10962075,3233675,BUY
20-10-20 14:29,14:29,7800150,10804250,3004100,BUY
20-10-20 14:30,14:30,7757400,10978350,3220950,BUY
20-10-20 14:31,14:31,7658200,10940825,3282625,BUY
20-10-20 14:32,14:32,7889350,10968025,3078675,BUY
20-10-20 14:33,14:33,7831650,10914700,3083050,BUY
20-10-20 14:34,14:34,7751925,10934025,3182100,BUY
20-10-20 14:35,14:35,7699850,10934300,3234450,BUY
20-10-20 14:36,14:36,7814650,10960775,3146125,BUY
20-10-20 14:37,14:37,7905025,10968350,3063325,BUY
20-10-20 14:38,14:38,7797550,10967325,3169775,BUY
20-10-20 14:39,14:39,7824975,10860425,3035450,BUY
20-10-20 14:40,14:40,7781800,10859275,3077475,BUY
20-10-20 14:41,14:41,7578025,10780125,3202100,BUY
20-10-20 14:42,14:42,7811450,10793225,2981775,BUY
20-10-20 14:43,14:43,7715900,10792175,3076275,BUY
20-10-20 14:44,14:44,7718150,10827975,3109825,BUY
20-10-20 14:45,14:45,7764950,10787725,3022775,BUY
20-10-20 14:46,14:46,7752325,10822475,3070150,BUY
20-10-20 14:47,14:47,7845575,10824450,2978875,BUY
20-10-20 14:48,14:48,7634675,10814700,3180025,BUY
20-10-20 14:49,14:49,7696550,10813450,3116900,BUY
20-10-20 14:50,14:50,7675050,10814650,3139600,BUY
20-10-20 14:51,14:51,7716425,10805050,3088625,BUY
20-10-20 14:52,14:52,7717850,10803025,3085175,BUY
20-10-20 14:53,14:53,7670975,10803025,3132050,BUY
20-10-20 14:54,14:54,7606125,10735575,3129450,BUY
20-10-20 14:55,14:55,7810525,10747250,2936725,BUY
20-10-20 14:56,14:56,7698800,10736625,3037825,BUY
20-10-20 14:57,14:57,7493300,10692225,3198925,BUY
20-10-20 14:58,14:58,7672050,10582500,2910450,BUY
20-10-20 14:59,14:59,7729000,10647550,2918550,BUY
20-10-20 15:00,15:00,7542275,10624175,3081900,BUY
20-10-20 15:01,15:01,7560600,10626325,3065725,BUY
20-10-20 15:02,15:02,7693525,10626600,2933075,BUY
20-10-20 15:03,15:03,7585325,10525950,2940625,BUY
20-10-20 15:04,15:04,7504975,10517275,3012300,BUY
20-10-20 15:05,15:05,7514425,10517275,3002850,BUY
20-10-20 15:06,15:06,7345000,10398925,3053925,BUY
20-10-20 15:07,15:07,7403200,10413625,3010425,BUY
20-10-20 15:08,15:08,7496225,10428750,2932525,BUY
20-10-20 15:09,15:09,7429350,10354650,2925300,BUY
20-10-20 15:10,15:10,7502725,10352400,2849675,BUY
20-10-20 15:11,15:11,7433300,10350075,2916775,BUY
20-10-20 15:12,15:12,7179775,10190325,3010550,BUY
20-10-20 15:13,15:13,7335950,10188300,2852350,BUY
20-10-20 15:14,15:14,7358075,10185850,2827775,BUY
20-10-20 15:15,15:15,7231000,9987900,2756900,BUY
20-10-20 15:16,15:16,7230875,9986925,2756050,BUY
20-10-20 15:17,15:17,7277100,9986925,2709825,BUY
20-10-20 15:18,15:18,7072850,9731875,2659025,BUY
20-10-20 15:19,15:19,7074550,9733250,2658700,BUY
20-10-20 15:20,15:20,7074950,9742275,2667325,BUY
20-10-20 15:21,15:21,6790725,9520400,2729675,BUY
20-10-20 15:22,15:22,6863950,9522600,2658650,BUY
20-10-20 15:23,15:23,6715275,9515875,2800600,BUY
20-10-20 15:24,15:24,6679150,9328400,2649250,BUY
20-10-20 15:25,15:25,6735500,9330625,2595125,BUY
20-10-20 15:26,15:26,6706150,9330625,2624475,BUY
20-10-20 15:27,15:27,6507175,9109225,2602050,BUY
20-10-20 15:28,15:28,6396550,9097650,2701100,BUY
20-10-20 15:29,15:29,6516250,9109300,2593050,BUY
21-10-20 9:15,9:15,5403650,8735400,3331750,BUY
21-10-20 9:16,9:16,5384500,8765825,3381325,BUY
21-10-20 9:17,9:17,6727000,9423900,2696900,BUY
21-10-20 9:18,9:18,6621825,9390425,2768600,BUY
21-10-20 9:19,9:19,6753350,9392775,2639425,BUY
21-10-20 9:20,9:20,7217250,10049275,2832025,BUY
21-10-20 9:21,9:21,7201425,10079725,2878300,BUY
21-10-20 9:22,9:22,7184300,10079725,2895425,BUY
21-10-20 9:23,9:23,7422175,10468875,3046700,BUY
21-10-20 9:24,9:24,7420850,10469475,3048625,BUY
21-10-20 9:25,9:25,7359775,10469475,3109700,BUY
21-10-20 9:26,9:26,7461250,10846550,3385300,BUY
21-10-20 9:27,9:27,7487225,10848100,3360875,BUY
21-10-20 9:28,9:28,7487225,10845825,3358600,BUY
21-10-20 9:29,9:29,7655275,11192550,3537275,BUY
21-10-20 9:30,9:30,7625975,11198675,3572700,BUY
21-10-20 9:31,9:31,7588825,11198675,3609850,BUY
21-10-20 9:32,9:32,7814025,11518600,3704575,BUY
21-10-20 9:33,9:33,7734975,11552125,3817150,BUY
21-10-20 9:34,9:34,7809100,11547950,3738850,BUY
21-10-20 9:35,9:35,7890550,11732300,3841750,BUY
21-10-20 9:36,9:36,7896600,11725275,3828675,BUY
21-10-20 9:37,9:37,7921000,11732300,3811300,BUY
21-10-20 9:38,9:38,8035550,11900000,3864450,BUY
21-10-20 9:39,9:39,7924400,11785050,3860650,BUY
21-10-20 9:40,9:40,8082200,11866875,3784675,BUY
21-10-20 9:41,9:41,8205550,11915725,3710175,BUY
21-10-20 9:42,9:42,8151225,11943075,3791850,BUY
21-10-20 9:43,9:43,8205525,11881525,3676000,BUY
21-10-20 9:44,9:44,8170950,12109125,3938175,BUY
21-10-20 9:45,9:45,8188200,12069125,3880925,BUY
21-10-20 9:46,9:46,8133325,12042625,3909300,BUY
21-10-20 9:47,9:47,8111775,12071200,3959425,BUY
21-10-20 9:48,9:48,8038300,12104525,4066225,BUY
21-10-20 9:49,9:49,8120250,12075725,3955475,BUY
21-10-20 9:50,9:50,8293925,12179600,3885675,BUY
21-10-20 9:51,9:51,8080650,12111150,4030500,BUY
21-10-20 9:52,9:52,8155725,12143275,3987550,BUY
21-10-20 9:53,9:53,8205275,12206775,4001500,BUY
21-10-20 9:54,9:54,8205200,12228350,4023150,BUY
21-10-20 9:55,9:55,8306400,12263300,3956900,BUY
21-10-20 9:56,9:56,8223325,12333300,4109975,BUY
21-10-20 9:57,9:57,8347650,12368575,4020925,BUY
21-10-20 9:58,9:58,8289200,12303525,4014325,BUY
21-10-20 9:59,9:59,8247475,12495150,4247675,BUY
21-10-20 10:00,10:00,8265950,12406075,4140125,BUY
21-10-20 10:01,10:01,8198000,12428475,4230475,BUY
21-10-20 10:02,10:02,8436450,12582150,4145700,BUY
21-10-20 10:03,10:03,8281700,12554875,4273175,BUY
21-10-20 10:04,10:04,8372800,12515200,4142400,BUY
21-10-20 10:05,10:05,8451500,12626475,4174975,BUY
21-10-20 10:06,10:06,8595100,12658150,4063050,BUY
21-10-20 10:07,10:07,8335450,12583525,4248075,BUY
21-10-20 10:08,10:08,8451550,12767525,4315975,BUY
21-10-20 10:09,10:09,8573300,12846000,4272700,BUY
21-10-20 10:10,10:10,8516975,12814850,4297875,BUY
21-10-20 10:11,10:11,8281625,12851100,4569475,BUY
21-10-20 10:12,10:12,8416850,12958625,4541775,BUY
21-10-20 10:13,10:13,8383350,12913825,4530475,BUY
21-10-20 10:14,10:14,8526575,13120975,4594400,BUY
21-10-20 10:15,10:15,8532850,13090575,4557725,BUY
21-10-20 10:16,10:16,8468675,13088125,4619450,BUY
21-10-20 10:17,10:17,8432125,13203025,4770900,BUY
21-10-20 10:18,10:18,8431700,13203000,4771300,BUY
21-10-20 10:19,10:19,8409125,13172575,4763450,BUY
21-10-20 10:20,10:20,8435625,13113150,4677525,BUY
21-10-20 10:21,10:21,8393850,13164825,4770975,BUY
21-10-20 10:22,10:22,8441125,13221725,4780600,BUY
21-10-20 10:23,10:23,8374325,13138200,4763875,BUY
21-10-20 10:24,10:24,8391125,13174500,4783375,BUY
21-10-20 10:25,10:25,8288925,13104125,4815200,BUY
21-10-20 10:26,10:26,8179225,13218500,5039275,BUY
21-10-20 10:27,10:27,8329375,13080450,4751075,BUY
21-10-20 10:28,10:28,7955600,13100550,5144950,BUY
21-10-20 10:29,10:29,8230225,13110000,4879775,BUY
21-10-20 10:30,10:30,8108025,13056500,4948475,BUY
21-10-20 10:31,10:31,8229750,13007075,4777325,BUY
21-10-20 10:32,10:32,8201075,13166550,4965475,BUY
21-10-20 10:33,10:33,8153125,13234700,5081575,BUY
21-10-20 10:34,10:34,8383700,13138450,4754750,BUY
21-10-20 10:35,10:35,8262225,13099300,4837075,BUY
21-10-20 10:36,10:36,8310675,13133800,4823125,BUY
21-10-20 10:37,10:37,8201375,13137000,4935625,BUY
21-10-20 10:38,10:38,8385200,12986550,4601350,BUY
21-10-20 10:39,10:39,8318300,13242150,4923850,BUY
21-10-20 10:40,10:40,8296375,13284475,4988100,BUY
21-10-20 10:41,10:41,8408125,13220350,4812225,BUY
21-10-20 10:42,10:42,8181000,12938150,4757150,BUY
21-10-20 10:43,10:43,8266550,13252400,4985850,BUY
21-10-20 10:44,10:44,8370850,13067800,4696950,BUY
21-10-20 10:45,10:45,8248075,13286575,5038500,BUY
21-10-20 10:46,10:46,8102700,12967250,4864550,BUY
21-10-20 10:47,10:47,8235025,13409800,5174775,BUY
21-10-20 10:48,10:48,8151325,13394600,5243275,BUY
21-10-20 10:49,10:49,8361475,13394550,5033075,BUY
21-10-20 10:50,10:50,8411000,13439325,5028325,BUY
21-10-20 10:51,10:51,8356650,13421400,5064750,BUY
21-10-20 10:52,10:52,8358575,13425600,5067025,BUY
21-10-20 10:53,10:53,7994375,12981550,4987175,BUY
21-10-20 10:54,10:54,8373375,13360450,4987075,BUY
21-10-20 10:55,10:55,8314900,13215500,4900600,BUY
21-10-20 10:56,10:56,7993250,13409250,5416000,BUY
21-10-20 10:57,10:57,7935000,13366275,5431275,BUY
21-10-20 10:58,10:58,8268975,13414550,5145575,BUY
21-10-20 10:59,10:59,7997650,13097250,5099600,BUY
21-10-20 11:00,11:00,8161175,13381500,5220325,BUY
21-10-20 11:01,11:01,8393475,13452050,5058575,BUY
21-10-20 11:02,11:02,8387650,13501875,5114225,BUY
21-10-20 11:03,11:03,8527850,13577225,5049375,BUY
21-10-20 11:04,11:04,8327675,13216875,4889200,BUY
21-10-20 11:05,11:05,8192075,13641500,5449425,BUY
21-10-20 11:06,11:06,8179225,13531225,5352000,BUY
21-10-20 11:07,11:07,8334925,13525150,5190225,BUY
21-10-20 11:08,11:08,8110700,13643375,5532675,BUY
21-10-20 11:09,11:09,8097675,13543525,5445850,BUY
21-10-20 11:10,11:10,8196225,13655400,5459175,BUY
21-10-20 11:11,11:11,8235225,13793650,5558425,BUY
21-10-20 11:12,11:12,8091050,13720275,5629225,BUY
21-10-20 11:13,11:13,8346925,13588100,5241175,BUY
21-10-20 11:14,11:14,8096800,13641475,5544675,BUY
21-10-20 11:15,11:15,8352750,13751075,5398325,BUY
21-10-20 11:16,11:16,8084350,13703800,5619450,BUY
21-10-20 11:17,11:17,8182950,13735975,5553025,BUY
21-10-20 11:18,11:18,8456325,13768150,5311825,BUY
21-10-20 11:19,11:19,8316925,13721675,5404750,BUY
21-10-20 11:20,11:20,8203200,13568650,5365450,BUY
21-10-20 11:21,11:21,8224150,13628950,5404800,BUY
21-10-20 11:22,11:22,8047775,13599325,5551550,BUY
21-10-20 11:23,11:23,8125500,13531475,5405975,BUY
21-10-20 11:24,11:24,8245625,13568375,5322750,BUY
21-10-20 11:25,11:25,8045675,13348275,5302600,BUY
21-10-20 11:26,11:26,8544300,13538175,4993875,BUY
21-10-20 11:27,11:27,8443925,13358500,4914575,BUY
21-10-20 11:28,11:28,8522075,13442275,4920200,BUY
21-10-20 11:29,11:29,8522075,13679600,5157525,BUY
21-10-20 11:30,11:30,8389625,13564175,5174550,BUY
21-10-20 11:31,11:31,8276125,13526300,5250175,BUY
21-10-20 11:32,11:32,8532450,13741550,5209100,BUY
21-10-20 11:33,11:33,8081700,13685625,5603925,BUY
21-10-20 11:34,11:34,8112275,13359650,5247375,BUY
21-10-20 11:35,11:35,8407150,13392525,4985375,BUY
21-10-20 11:36,11:36,8215625,13772650,5557025,BUY
21-10-20 11:37,11:37,8417700,13863025,5445325,BUY
21-10-20 11:38,11:38,8704750,13692900,4988150,BUY
21-10-20 11:39,11:39,8558500,13719400,5160900,BUY
21-10-20 11:40,11:40,8699725,13836500,5136775,BUY
21-10-20 11:41,11:41,8761950,13847050,5085100,BUY
21-10-20 11:42,11:42,8592625,13742825,5150200,BUY
21-10-20 11:43,11:43,8583550,13858725,5275175,BUY
21-10-20 11:44,11:44,8525850,13829600,5303750,BUY
21-10-20 11:45,11:45,8722975,13790475,5067500,BUY
21-10-20 11:46,11:46,8644150,13826600,5182450,BUY
21-10-20 11:47,11:47,8429500,13844225,5414725,BUY
21-10-20 11:48,11:48,8500575,13886200,5385625,BUY
21-10-20 11:49,11:49,8095400,13785400,5690000,BUY
21-10-20 11:50,11:50,8608100,13967050,5358950,BUY
21-10-20 11:51,11:51,8560150,13960975,5400825,BUY
21-10-20 11:52,11:52,8480250,13924550,5444300,BUY
21-10-20 11:53,11:53,8429300,13984125,5554825,BUY
21-10-20 11:54,11:54,8438250,13950875,5512625,BUY
21-10-20 11:55,11:55,8581325,13773375,5192050,BUY
21-10-20 11:56,11:56,8513700,14022150,5508450,BUY
21-10-20 11:57,11:57,8389475,13986650,5597175,BUY
21-10-20 11:58,11:58,8404775,13928200,5523425,BUY
21-10-20 11:59,11:59,8606750,13749800,5143050,BUY
21-10-20 12:00,12:00,8600975,13628575,5027600,BUY
21-10-20 12:01,12:01,8537550,13639900,5102350,BUY
21-10-20 12:02,12:02,8144200,13559025,5414825,BUY
21-10-20 12:03,12:03,8503550,14056475,5552925,BUY
21-10-20 12:04,12:04,8354400,14012775,5658375,BUY
21-10-20 12:05,12:05,8301050,13526450,5225400,BUY
21-10-20 12:06,12:06,8325375,12805525,4480150,BUY
21-10-20 12:07,12:07,8118975,13777300,5658325,BUY
21-10-20 12:08,12:08,8710900,14067325,5356425,BUY
21-10-20 12:09,12:09,8422425,14054850,5632425,BUY
21-10-20 12:10,12:10,8381050,14036575,5655525,BUY
21-10-20 12:11,12:11,8343150,14050250,5707100,BUY
21-10-20 12:12,12:12,8471800,14052200,5580400,BUY
21-10-20 12:13,12:13,8483375,14049400,5566025,BUY
21-10-20 12:14,12:14,8418125,13899575,5481450,BUY
21-10-20 12:15,12:15,8426200,14184550,5758350,BUY
21-10-20 12:16,12:16,8409725,14133525,5723800,BUY
21-10-20 12:17,12:17,8091925,13807725,5715800,BUY
21-10-20 12:18,12:18,8174525,14028350,5853825,BUY
21-10-20 12:19,12:19,8348575,14021300,5672725,BUY
21-10-20 12:20,12:20,8332225,14075025,5742800,BUY
21-10-20 12:21,12:21,8260775,13852400,5591625,BUY
21-10-20 12:22,12:22,8102350,14057750,5955400,BUY
21-10-20 12:23,12:23,8494500,14189075,5694575,BUY
21-10-20 12:24,12:24,8705725,14215200,5509475,BUY
21-10-20 12:25,12:25,8617675,14248025,5630350,BUY
21-10-20 12:26,12:26,8330850,14178675,5847825,BUY
21-10-20 12:27,12:27,8119350,14095825,5976475,BUY
21-10-20 12:28,12:28,8505775,14288550,5782775,BUY
21-10-20 12:29,12:29,8346750,14255575,5908825,BUY
21-10-20 12:30,12:30,8222525,14227675,6005150,BUY
21-10-20 12:31,12:31,8118000,14201800,6083800,BUY
21-10-20 12:32,12:32,8269325,14331925,6062600,BUY
21-10-20 12:33,12:33,8388000,14250625,5862625,BUY
21-10-20 12:34,12:34,8386975,13707100,5320125,BUY
21-10-20 12:35,12:35,8228600,14286475,6057875,BUY
21-10-20 12:36,12:36,8319250,14271025,5951775,BUY
21-10-20 12:37,12:37,8352575,14259100,5906525,BUY
21-10-20 12:38,12:38,8255875,14249525,5993650,BUY
21-10-20 12:39,12:39,8073625,13733050,5659425,BUY
21-10-20 12:40,12:40,8452475,14242175,5789700,BUY
21-10-20 12:41,12:41,8495450,14022925,5527475,BUY
21-10-20 12:42,12:42,8533850,14254950,5721100,BUY
21-10-20 12:43,12:43,8484200,14264150,5779950,BUY
21-10-20 12:44,12:44,8595275,14013850,5418575,BUY
21-10-20 12:45,12:45,8779825,14318625,5538800,BUY
21-10-20 12:46,12:46,8620300,14233650,5613350,BUY
21-10-20 12:47,12:47,8647650,13968375,5320725,BUY
21-10-20 12:48,12:48,8534125,14197975,5663850,BUY
21-10-20 12:49,12:49,8586475,14207700,5621225,BUY
21-10-20 12:50,12:50,8734375,14211175,5476800,BUY
21-10-20 12:51,12:51,8631475,13980200,5348725,BUY
21-10-20 12:52,12:52,8630825,13975550,5344725,BUY
21-10-20 12:53,12:53,8554300,13858125,5303825,BUY
21-10-20 12:54,12:54,8591125,14119825,5528700,BUY
21-10-20 12:55,12:55,8606475,14241250,5634775,BUY
21-10-20 12:56,12:56,8591125,13585800,4994675,BUY
21-10-20 12:57,12:57,8408550,14391125,5982575,BUY
21-10-20 12:58,12:58,8572000,14029175,5457175,BUY
21-10-20 12:59,12:59,8736000,13904175,5168175,BUY
21-10-20 13:00,13:00,8753300,14267975,5514675,BUY
21-10-20 13:01,13:01,8645125,14267975,5622850,BUY
21-10-20 13:02,13:02,8753300,14254050,5500750,BUY
21-10-20 13:03,13:03,8673650,14081700,5408050,BUY
21-10-20 13:04,13:04,8652950,14353800,5700850,BUY
21-10-20 13:05,13:05,8739325,14253650,5514325,BUY
21-10-20 13:06,13:06,8521450,14111250,5589800,BUY
21-10-20 13:07,13:07,8319250,13950650,5631400,BUY
21-10-20 13:08,13:08,8397725,14039400,5641675,BUY
21-10-20 13:09,13:09,8483650,13784800,5301150,BUY
21-10-20 13:10,13:10,8342825,13965375,5622550,BUY
21-10-20 13:11,13:11,8626875,13986000,5359125,BUY
21-10-20 13:12,13:12,8467975,14419900,5951925,BUY
21-10-20 13:13,13:13,8632750,14444350,5811600,BUY
21-10-20 13:14,13:14,8683125,13784925,5101800,BUY
21-10-20 13:15,13:15,8944150,14464600,5520450,BUY
21-10-20 13:16,13:16,8919500,14464600,5545100,BUY
21-10-20 13:17,13:17,8876575,14460775,5584200,BUY
21-10-20 13:18,13:18,8608225,13774700,5166475,BUY
21-10-20 13:19,13:19,8667725,13739000,5071275,BUY
21-10-20 13:20,13:20,8711650,13779225,5067575,BUY
21-10-20 13:21,13:21,8682250,13514500,4832250,BUY
21-10-20 13:22,13:22,8578750,13535525,4956775,BUY
21-10-20 13:23,13:23,8685350,13539200,4853850,BUY
21-10-20 13:24,13:24,8754525,12888675,4134150,BUY
21-10-20 13:25,13:25,8785725,12920975,4135250,BUY
21-10-20 13:26,13:26,8681150,12917375,4236225,BUY
21-10-20 13:27,13:27,8617425,12633700,4016275,BUY
21-10-20 13:28,13:28,8601025,12596800,3995775,BUY
21-10-20 13:29,13:29,8622900,12612925,3990025,BUY
21-10-20 13:30,13:30,8657700,12222075,3564375,BUY
21-10-20 13:31,13:31,8668350,12195225,3526875,BUY
21-10-20 13:32,13:32,8591900,12195225,3603325,BUY
21-10-20 13:33,13:33,8650275,12178575,3528300,BUY
21-10-20 13:34,13:34,8597150,12182100,3584950,BUY
21-10-20 13:35,13:35,8662850,12137750,3474900,BUY
21-10-20 13:36,13:36,8729800,12113050,3383250,BUY
21-10-20 13:37,13:37,8761525,12113050,3351525,BUY
21-10-20 13:38,13:38,8749600,12113050,3363450,BUY
21-10-20 13:39,13:39,8688800,11897600,3208800,BUY
21-10-20 13:40,13:40,8774250,11897600,3123350,BUY
21-10-20 13:41,13:41,8702150,11897600,3195450,BUY
21-10-20 13:42,13:42,8881075,11954150,3073075,BUY
21-10-20 13:43,13:43,8820350,11922450,3102100,BUY
21-10-20 13:44,13:44,8783550,11922450,3138900,BUY
21-10-20 13:45,13:45,8932775,11557675,2624900,BUY
21-10-20 13:46,13:46,8770925,11531675,2760750,BUY
21-10-20 13:47,13:47,8865375,11537325,2671950,BUY
21-10-20 13:48,13:48,8932250,11489375,2557125,BUY
21-10-20 13:49,13:49,8847725,11483950,2636225,BUY
21-10-20 13:50,13:50,8786875,11489375,2702500,BUY
21-10-20 13:51,13:51,8982300,11499300,2517000,BUY
21-10-20 13:52,13:52,8890850,11491050,2600200,BUY
21-10-20 13:53,13:53,8854375,11468525,2614150,BUY
21-10-20 13:54,13:54,8904650,11337125,2432475,BUY
21-10-20 13:55,13:55,8868025,11250675,2382650,BUY
21-10-20 13:56,13:56,8761950,11337125,2575175,BUY
21-10-20 13:57,13:57,8867675,11331750,2464075,BUY
21-10-20 13:58,13:58,8870225,11357650,2487425,BUY
21-10-20 13:59,13:59,9012650,11336925,2324275,BUY
21-10-20 14:00,14:00,8880075,11393475,2513400,BUY
21-10-20 14:01,14:01,8962700,11401800,2439100,BUY
21-10-20 14:02,14:02,9022825,11401800,2378975,BUY
21-10-20 14:03,14:03,9185075,11376850,2191775,BUY
21-10-20 14:04,14:04,9157950,11376850,2218900,BUY
21-10-20 14:05,14:05,9147250,11376850,2229600,BUY
21-10-20 14:06,14:06,9232575,11383825,2151250,BUY
21-10-20 14:07,14:07,9278775,11387750,2108975,BUY
21-10-20 14:08,14:08,9267125,11331925,2064800,BUY
21-10-20 14:09,14:09,9337100,11416050,2078950,BUY
21-10-20 14:10,14:10,9285200,11424450,2139250,BUY
21-10-20 14:11,14:11,9337125,11390950,2053825,BUY
21-10-20 14:12,14:12,9156650,10858900,1702250,BUY
21-10-20 14:13,14:13,9285075,10834075,1549000,BUY
21-10-20 14:14,14:14,9188800,10859450,1670650,BUY
21-10-20 14:15,14:15,9386650,10757225,1370575,BUY
21-10-20 14:16,14:16,9394550,10773450,1378900,BUY
21-10-20 14:17,14:17,9352175,10764850,1412675,BUY
21-10-20 14:18,14:18,9338500,10845475,1506975,BUY
21-10-20 14:19,14:19,9428800,10807750,1378950,BUY
21-10-20 14:20,14:20,9413975,10812150,1398175,BUY
21-10-20 14:21,14:21,9427125,10788625,1361500,BUY
21-10-20 14:22,14:22,9370225,10830625,1460400,BUY
21-10-20 14:23,14:23,9345750,10834725,1488975,BUY
21-10-20 14:24,14:24,9413100,10710825,1297725,BUY
21-10-20 14:25,14:25,9559500,10732850,1173350,BUY
21-10-20 14:26,14:26,9467350,10753200,1285850,BUY
21-10-20 14:27,14:27,9454875,10491800,1036925,BUY
21-10-20 14:28,14:28,9448725,10477650,1028925,BUY
21-10-20 14:29,14:29,9332475,10462825,1130350,BUY
21-10-20 14:30,14:30,9424100,10492275,1068175,BUY
21-10-20 14:31,14:31,9418100,10495950,1077850,BUY
21-10-20 14:32,14:32,9420475,10483750,1063275,BUY
21-10-20 14:33,14:33,9467400,10665400,1198000,BUY
21-10-20 14:34,14:34,9427150,10641100,1213950,BUY
21-10-20 14:35,14:35,9452425,10656900,1204475,BUY
21-10-20 14:36,14:36,9490500,10636125,1145625,BUY
21-10-20 14:37,14:37,9409225,10652050,1242825,BUY
21-10-20 14:38,14:38,9409425,10712800,1303375,BUY
21-10-20 14:39,14:39,9548275,10806500,1258225,BUY
21-10-20 14:40,14:40,9524950,10806500,1281550,BUY
21-10-20 14:41,14:41,9519025,10767300,1248275,BUY
21-10-20 14:42,14:42,9188850,10786425,1597575,BUY
21-10-20 14:43,14:43,8976025,10778100,1802075,BUY
21-10-20 14:44,14:44,9098800,10727425,1628625,BUY
21-10-20 14:45,14:45,9196050,10864700,1668650,BUY
21-10-20 14:46,14:46,9198300,10870875,1672575,BUY
21-10-20 14:47,14:47,9179200,10809800,1630600,BUY
21-10-20 14:48,14:48,9202000,10963050,1761050,BUY
21-10-20 14:49,14:49,9183800,10978250,1794450,BUY
21-10-20 14:50,14:50,9198725,10975200,1776475,BUY
21-10-20 14:51,14:51,9179875,11062450,1882575,BUY
21-10-20 14:52,14:52,9158275,11065500,1907225,BUY
21-10-20 14:53,14:53,9181900,11065500,1883600,BUY
21-10-20 14:54,14:54,9239475,11156350,1916875,BUY
21-10-20 14:55,14:55,9230800,11114775,1883975,BUY
21-10-20 14:56,14:56,9124300,11077025,1952725,BUY
21-10-20 14:57,14:57,9199200,11073600,1874400,BUY
21-10-20 14:58,14:58,9069000,11131275,2062275,BUY
21-10-20 14:59,14:59,9058650,11077800,2019150,BUY
21-10-20 15:00,15:00,8334650,10879525,2544875,BUY
21-10-20 15:01,15:01,8279625,10898875,2619250,BUY
21-10-20 15:02,15:02,8304875,10843675,2538800,BUY
21-10-20 15:03,15:03,7939000,10544575,2605575,BUY
21-10-20 15:04,15:04,8014575,10585975,2571400,BUY
21-10-20 15:05,15:05,7912925,10585975,2673050,BUY
21-10-20 15:06,15:06,8027125,10675650,2648525,BUY
21-10-20 15:07,15:07,8025900,10626575,2600675,BUY
21-10-20 15:08,15:08,8022175,10626575,2604400,BUY
21-10-20 15:09,15:09,7922150,10642025,2719875,BUY
21-10-20 15:10,15:10,8019475,10682075,2662600,BUY
21-10-20 15:11,15:11,8018300,10712350,2694050,BUY
21-10-20 15:12,15:12,7710575,10738800,3028225,BUY
21-10-20 15:13,15:13,7725250,10728450,3003200,BUY
21-10-20 15:14,15:14,7659675,10681550,3021875,BUY
21-10-20 15:15,15:15,7377775,10746650,3368875,BUY
21-10-20 15:16,15:16,7428425,10746400,3317975,BUY
21-10-20 15:17,15:17,7261875,10746400,3484525,BUY
21-10-20 15:18,15:18,6993825,10743275,3749450,BUY
21-10-20 15:19,15:19,6930500,10748500,3818000,BUY
21-10-20 15:20,15:20,7008100,10754775,3746675,BUY
21-10-20 15:21,15:21,6704100,10639400,3935300,BUY
21-10-20 15:22,15:22,6708200,10600250,3892050,BUY
21-10-20 15:23,15:23,6638750,10636425,3997675,BUY
21-10-20 15:24,15:24,6406000,10546625,4140625,BUY
21-10-20 15:25,15:25,6434875,10550500,4115625,BUY
21-10-20 15:26,15:26,6364375,10487100,4122725,BUY
21-10-20 15:27,15:27,6297125,10365400,4068275,BUY
21-10-20 15:28,15:28,6270400,10365175,4094775,BUY
21-10-20 15:29,15:29,6334500,10365175,4030675,BUY
22-10-20 9:15,9:15,6062300,8362100,2299800,BUY
22-10-20 9:16,9:16,6071525,10020100,3948575,BUY
22-10-20 9:17,9:17,6270700,10383000,4112300,BUY
22-10-20 9:18,9:18,6279425,10360975,4081550,BUY
22-10-20 9:19,9:19,6185600,10381000,4195400,BUY
22-10-20 9:20,9:20,7033775,11167775,4134000,BUY
22-10-20 9:21,9:21,7108650,11144100,4035450,BUY
22-10-20 9:22,9:22,7128975,11167350,4038375,BUY
22-10-20 9:23,9:23,8540175,12749225,4209050,BUY
22-10-20 9:24,9:24,8485250,12753825,4268575,BUY
22-10-20 9:25,9:25,8519750,12751775,4232025,BUY
22-10-20 9:26,9:26,9554225,13581800,4027575,BUY
22-10-20 9:27,9:27,9464675,13556800,4092125,BUY
22-10-20 9:28,9:28,9544725,13569900,4025175,BUY
22-10-20 9:29,9:29,10250275,14010050,3759775,BUY
22-10-20 9:30,9:30,10257100,13963775,3706675,BUY
22-10-20 9:31,9:31,10216225,14014575,3798350,BUY
22-10-20 9:32,9:32,10720750,14171025,3450275,BUY
22-10-20 9:33,9:33,10600875,14174100,3573225,BUY
22-10-20 9:34,9:34,10768375,14174100,3405725,BUY
22-10-20 9:35,9:35,11047025,14354850,3307825,BUY
22-10-20 9:36,9:36,11044750,14354850,3310100,BUY
22-10-20 9:37,9:37,10942750,14348725,3405975,BUY
22-10-20 9:38,9:38,11405750,14571550,3165800,BUY
22-10-20 9:39,9:39,11379825,14575250,3195425,BUY
22-10-20 9:40,9:40,11226150,14502550,3276400,BUY
22-10-20 9:41,9:41,11798925,14774625,2975700,BUY
22-10-20 9:42,9:42,11800175,14719100,2918925,BUY
22-10-20 9:43,9:43,11678100,14698775,3020675,BUY
22-10-20 9:44,9:44,11889400,14895825,3006425,BUY
22-10-20 9:45,9:45,11994200,14938150,2943950,BUY
22-10-20 9:46,9:46,12001050,14932100,2931050,BUY
22-10-20 9:47,9:47,11974900,15037200,3062300,BUY
22-10-20 9:48,9:48,11964000,15011900,3047900,BUY
22-10-20 9:49,9:49,11934600,15023525,3088925,BUY
22-10-20 9:50,9:50,12275850,15141525,2865675,BUY
22-10-20 9:51,9:51,12255075,15196725,2941650,BUY
22-10-20 9:52,9:52,12194900,15212875,3017975,BUY
22-10-20 9:53,9:53,12336750,15353700,3016950,BUY
22-10-20 9:54,9:54,12297200,15370600,3073400,BUY
22-10-20 9:55,9:55,12323900,15344125,3020225,BUY
22-10-20 9:56,9:56,12119400,15511175,3391775,BUY
22-10-20 9:57,9:57,12055625,15497050,3441425,BUY
22-10-20 9:58,9:58,12063250,15497050,3433800,BUY
22-10-20 9:59,9:59,12345675,15792700,3447025,BUY
22-10-20 10:00,10:00,12303550,15838775,3535225,BUY
22-10-20 10:01,10:01,12266650,15823100,3556450,BUY
22-10-20 10:02,10:02,12553575,15840425,3286850,BUY
22-10-20 10:03,10:03,12579250,16083050,3503800,BUY
22-10-20 10:04,10:04,12429025,16154875,3725850,BUY
22-10-20 10:05,10:05,12894225,16387875,3493650,BUY
22-10-20 10:06,10:06,12692950,16145000,3452050,BUY
22-10-20 10:07,10:07,12816800,16365275,3548475,BUY
22-10-20 10:08,10:08,13068400,16740900,3672500,BUY
22-10-20 10:09,10:09,13056450,16723425,3666975,BUY
22-10-20 10:10,10:10,13174325,16754475,3580150,BUY
22-10-20 10:11,10:11,13145675,16930450,3784775,BUY
22-10-20 10:12,10:12,13182300,16850550,3668250,BUY
22-10-20 10:13,10:13,13160575,16918000,3757425,BUY
22-10-20 10:14,10:14,13188550,16802900,3614350,BUY
22-10-20 10:15,10:15,13307450,16620250,3312800,BUY
22-10-20 10:16,10:16,13243650,16956600,3712950,BUY
22-10-20 10:17,10:17,13427875,17027600,3599725,BUY
22-10-20 10:18,10:18,13312000,16648475,3336475,BUY
22-10-20 10:19,10:19,13330425,16999825,3669400,BUY
22-10-20 10:20,10:20,13731300,17218650,3487350,BUY
22-10-20 10:21,10:21,13867575,17283400,3415825,BUY
22-10-20 10:22,10:22,13790925,17269400,3478475,BUY
22-10-20 10:23,10:23,14054250,17370350,3316100,BUY
22-10-20 10:24,10:24,13825350,17266300,3440950,BUY
22-10-20 10:25,10:25,13940725,17063250,3122525,BUY
22-10-20 10:26,10:26,13830575,17323900,3493325,BUY
22-10-20 10:27,10:27,14046750,17329450,3282700,BUY
22-10-20 10:28,10:28,14090900,17310900,3220000,BUY
22-10-20 10:29,10:29,14031725,17405300,3373575,BUY
22-10-20 10:30,10:30,14175300,17376125,3200825,BUY
22-10-20 10:31,10:31,14086150,17322950,3236800,BUY
22-10-20 10:32,10:32,14109325,17330200,3220875,BUY
22-10-20 10:33,10:33,14085325,16993800,2908475,BUY
22-10-20 10:34,10:34,14141150,17361825,3220675,BUY
22-10-20 10:35,10:35,14212475,17454525,3242050,BUY
22-10-20 10:36,10:36,14212525,17423675,3211150,BUY
22-10-20 10:37,10:37,14062375,17354350,3291975,BUY
22-10-20 10:38,10:38,14402725,17554825,3152100,BUY
22-10-20 10:39,10:39,14200150,17574150,3374000,BUY
22-10-20 10:40,10:40,14297250,17421425,3124175,BUY
22-10-20 10:41,10:41,14325875,17435850,3109975,BUY
22-10-20 10:42,10:42,14380275,17261725,2881450,BUY
22-10-20 10:43,10:43,14278525,17585600,3307075,BUY
22-10-20 10:44,10:44,14351150,17638775,3287625,BUY
22-10-20 10:45,10:45,14329400,17720350,3390950,BUY
22-10-20 10:46,10:46,14282550,17666050,3383500,BUY
22-10-20 10:47,10:47,14374300,17829475,3455175,BUY
22-10-20 10:48,10:48,14503325,17768200,3264875,BUY
22-10-20 10:49,10:49,14492750,17879725,3386975,BUY
22-10-20 10:50,10:50,14502575,17834050,3331475,BUY
22-10-20 10:51,10:51,14428150,17813150,3385000,BUY
22-10-20 10:52,10:52,14340050,17226125,2886075,BUY
22-10-20 10:53,10:53,14502225,17483500,2981275,BUY
22-10-20 10:54,10:54,14518600,17807275,3288675,BUY
22-10-20 10:55,10:55,14684625,17914575,3229950,BUY
22-10-20 10:56,10:56,14578100,18159600,3581500,BUY
22-10-20 10:57,10:57,14646500,18117300,3470800,BUY
22-10-20 10:58,10:58,14694750,18144375,3449625,BUY
22-10-20 10:59,10:59,14812525,18299750,3487225,BUY
22-10-20 11:00,11:00,14818875,18299950,3481075,BUY
22-10-20 11:01,11:01,14679925,18317100,3637175,BUY
22-10-20 11:02,11:02,14069175,18597275,4528100,BUY
22-10-20 11:03,11:03,14082300,18612475,4530175,BUY
22-10-20 11:04,11:04,13958000,18522975,4564975,BUY
22-10-20 11:05,11:05,13852150,18757100,4904950,BUY
22-10-20 11:06,11:06,13900625,18694375,4793750,BUY
22-10-20 11:07,11:07,13785600,18685100,4899500,BUY
22-10-20 11:08,11:08,13964375,18906150,4941775,BUY
22-10-20 11:09,11:09,13793900,18445625,4651725,BUY
22-10-20 11:10,11:10,13801550,18802425,5000875,BUY
22-10-20 11:11,11:11,13852725,18662525,4809800,BUY
22-10-20 11:12,11:12,13852775,18913150,5060375,BUY
22-10-20 11:13,11:13,14003400,18960675,4957275,BUY
22-10-20 11:14,11:14,13984900,19007225,5022325,BUY
22-10-20 11:15,11:15,13798025,18750975,4952950,BUY
22-10-20 11:16,11:16,13991975,19048375,5056400,BUY
22-10-20 11:17,11:17,13954575,18589700,4635125,BUY
22-10-20 11:18,11:18,14015125,18948425,4933300,BUY
22-10-20 11:19,11:19,14065800,18579150,4513350,BUY
22-10-20 11:20,11:20,14158725,19087950,4929225,BUY
22-10-20 11:21,11:21,13876250,19077150,5200900,BUY
22-10-20 11:22,11:22,14116925,19047925,4931000,BUY
22-10-20 11:23,11:23,14055750,18876000,4820250,BUY
22-10-20 11:24,11:24,14040250,18828350,4788100,BUY
22-10-20 11:25,11:25,14218925,19061875,4842950,BUY
22-10-20 11:26,11:26,14244300,18478200,4233900,BUY
22-10-20 11:27,11:27,14459100,19120875,4661775,BUY
22-10-20 11:28,11:28,14432875,19197200,4764325,BUY
22-10-20 11:29,11:29,14323025,18789175,4466150,BUY
22-10-20 11:30,11:30,14329200,18815275,4486075,BUY
22-10-20 11:31,11:31,14338950,18484675,4145725,BUY
22-10-20 11:32,11:32,14254375,18491125,4236750,BUY
22-10-20 11:33,11:33,14217200,18507525,4290325,BUY
22-10-20 11:34,11:34,14229075,18472950,4243875,BUY
22-10-20 11:35,11:35,14568475,18676200,4107725,BUY
22-10-20 11:36,11:36,14672100,18386025,3713925,BUY
22-10-20 11:37,11:37,14629850,18499425,3869575,BUY
22-10-20 11:38,11:38,14419700,18702300,4282600,BUY
22-10-20 11:39,11:39,14443200,18772100,4328900,BUY
22-10-20 11:40,11:40,14618250,18505325,3887075,BUY
22-10-20 11:41,11:41,14672500,18988250,4315750,BUY
22-10-20 11:42,11:42,14466025,18892650,4426625,BUY
22-10-20 11:43,11:43,14765550,18917200,4151650,BUY
22-10-20 11:44,11:44,14740050,19056625,4316575,BUY
22-10-20 11:45,11:45,14779450,19172000,4392550,BUY
22-10-20 11:46,11:46,14789250,18858500,4069250,BUY
22-10-20 11:47,11:47,14829525,18815350,3985825,BUY
22-10-20 11:48,11:48,14828750,19228000,4399250,BUY
22-10-20 11:49,11:49,14767575,18414000,3646425,BUY
22-10-20 11:50,11:50,14710700,19019675,4308975,BUY
22-10-20 11:51,11:51,14719000,19051725,4332725,BUY
22-10-20 11:52,11:52,14774250,19282175,4507925,BUY
22-10-20 11:53,11:53,14963475,19109975,4146500,BUY
22-10-20 11:54,11:54,15050425,19374075,4323650,BUY
22-10-20 11:55,11:55,15039125,19382950,4343825,BUY
22-10-20 11:56,11:56,14724225,19109350,4385125,BUY
22-10-20 11:57,11:57,14858275,18418850,3560575,BUY
22-10-20 11:58,11:58,14981075,18937300,3956225,BUY
22-10-20 11:59,11:59,15098450,19059400,3960950,BUY
22-10-20 12:00,12:00,15027650,19432275,4404625,BUY
22-10-20 12:01,12:01,15177000,19470525,4293525,BUY
22-10-20 12:02,12:02,15092150,19569900,4477750,BUY
22-10-20 12:03,12:03,15032625,18992850,3960225,BUY
22-10-20 12:04,12:04,14957450,18450425,3492975,BUY
22-10-20 12:05,12:05,15213650,19529025,4315375,BUY
22-10-20 12:06,12:06,15135375,19597000,4461625,BUY
22-10-20 12:07,12:07,15175350,19349025,4173675,BUY
22-10-20 12:08,12:08,15667100,19326375,3659275,BUY
22-10-20 12:09,12:09,15488625,19620075,4131450,BUY
22-10-20 12:10,12:10,15546975,19565525,4018550,BUY
22-10-20 12:11,12:11,15466575,19096925,3630350,BUY
22-10-20 12:12,12:12,15522475,19467375,3944900,BUY
22-10-20 12:13,12:13,15563100,18205750,2642650,BUY
22-10-20 12:14,12:14,15458475,19709200,4250725,BUY
22-10-20 12:15,12:15,15562075,19734625,4172550,BUY
22-10-20 12:16,12:16,15506075,19213825,3707750,BUY
22-10-20 12:17,12:17,15317925,19714225,4396300,BUY
22-10-20 12:18,12:18,15697625,19757000,4059375,BUY
22-10-20 12:19,12:19,15607725,19736900,4129175,BUY
22-10-20 12:20,12:20,15626975,19508150,3881175,BUY
22-10-20 12:21,12:21,15638875,19857825,4218950,BUY
22-10-20 12:22,12:22,15600000,19420125,3820125,BUY
22-10-20 12:23,12:23,15709675,19751325,4041650,BUY
22-10-20 12:24,12:24,15932950,19738200,3805250,BUY
22-10-20 12:25,12:25,16022725,19813825,3791100,BUY
22-10-20 12:26,12:26,15880825,19580200,3699375,BUY
22-10-20 12:27,12:27,15858925,18967700,3108775,BUY
22-10-20 12:28,12:28,15834300,19002050,3167750,BUY
22-10-20 12:29,12:29,15747575,19257200,3509625,BUY
22-10-20 12:30,12:30,15854575,19246600,3392025,BUY
22-10-20 12:31,12:31,15923000,19139300,3216300,BUY
22-10-20 12:32,12:32,16007800,19025700,3017900,BUY
22-10-20 12:33,12:33,16091375,18955950,2864575,BUY
22-10-20 12:34,12:34,16128375,19242325,3113950,BUY
22-10-20 12:35,12:35,16180525,19321125,3140600,BUY
22-10-20 12:36,12:36,16357825,19461775,3103950,BUY
22-10-20 12:37,12:37,16088425,19370675,3282250,BUY
22-10-20 12:38,12:38,16306750,19267900,2961150,BUY
22-10-20 12:39,12:39,16640650,19485725,2845075,BUY
22-10-20 12:40,12:40,16603225,19387625,2784400,BUY
22-10-20 12:41,12:41,16629225,19456750,2827525,BUY
22-10-20 12:42,12:42,16516025,19216650,2700625,BUY
22-10-20 12:43,12:43,16542325,19284675,2742350,BUY
22-10-20 12:44,12:44,16598425,19297125,2698700,BUY
22-10-20 12:45,12:45,16699900,19422700,2722800,BUY
22-10-20 12:46,12:46,16688250,19141000,2452750,BUY
22-10-20 12:47,12:47,16633875,19295975,2662100,BUY
22-10-20 12:48,12:48,16668250,19377575,2709325,BUY
22-10-20 12:49,12:49,16660625,19355550,2694925,BUY
22-10-20 12:50,12:50,16784725,19137750,2353025,BUY
22-10-20 12:51,12:51,17022325,19341425,2319100,BUY
22-10-20 12:52,12:52,16967100,19122950,2155850,BUY
22-10-20 12:53,12:53,16857700,19457900,2600200,BUY
22-10-20 12:54,12:54,16813450,19220575,2407125,BUY
22-10-20 12:55,12:55,16974900,19468525,2493625,BUY
22-10-20 12:56,12:56,16801400,19493500,2692100,BUY
22-10-20 12:57,12:57,17246475,19539750,2293275,BUY
22-10-20 12:58,12:58,17189000,19474500,2285500,BUY
22-10-20 12:59,12:59,17014700,19538050,2523350,BUY
22-10-20 13:00,13:00,16828225,19233350,2405125,BUY
22-10-20 13:01,13:01,16786075,19505800,2719725,BUY
22-10-20 13:02,13:02,16731650,19274150,2542500,BUY
22-10-20 13:03,13:03,16876000,19759675,2883675,BUY
22-10-20 13:04,13:04,16851650,19479450,2627800,BUY
22-10-20 13:05,13:05,16742275,19185200,2442925,BUY
22-10-20 13:06,13:06,17001050,19596350,2595300,BUY
22-10-20 13:07,13:07,17127850,19638175,2510325,BUY
22-10-20 13:08,13:08,17020975,19849300,2828325,BUY
22-10-20 13:09,13:09,16738575,20131225,3392650,BUY
22-10-20 13:10,13:10,16852300,20054100,3201800,BUY
22-10-20 13:11,13:11,16993950,20029825,3035875,BUY
22-10-20 13:12,13:12,16821725,19964700,3142975,BUY
22-10-20 13:13,13:13,16648350,20128700,3480350,BUY
22-10-20 13:14,13:14,16699825,20102150,3402325,BUY
22-10-20 13:15,13:15,16850250,20113925,3263675,BUY
22-10-20 13:16,13:16,16895700,19920600,3024900,BUY
22-10-20 13:17,13:17,16990125,20104775,3114650,BUY
22-10-20 13:18,13:18,17105750,19997775,2892025,BUY
22-10-20 13:19,13:19,17003050,19786975,2783925,BUY
22-10-20 13:20,13:20,17111775,20034900,2923125,BUY
22-10-20 13:21,13:21,17108300,19596775,2488475,BUY
22-10-20 13:22,13:22,17053775,19674975,2621200,BUY
22-10-20 13:23,13:23,16916450,20075900,3159450,BUY
22-10-20 13:24,13:24,17219900,20073100,2853200,BUY
22-10-20 13:25,13:25,17287125,20076975,2789850,BUY
22-10-20 13:26,13:26,17156400,20121975,2965575,BUY
22-10-20 13:27,13:27,17131725,19961700,2829975,BUY
22-10-20 13:28,13:28,17243975,19776475,2532500,BUY
22-10-20 13:29,13:29,17010700,20116125,3105425,BUY
22-10-20 13:30,13:30,16987850,20136800,3148950,BUY
22-10-20 13:31,13:31,17138200,20094250,2956050,BUY
22-10-20 13:32,13:32,16940200,20132050,3191850,BUY
22-10-20 13:33,13:33,17163950,20183475,3019525,BUY
22-10-20 13:34,13:34,16970775,20175225,3204450,BUY
22-10-20 13:35,13:35,17086925,20168275,3081350,BUY
22-10-20 13:36,13:36,17083100,19778325,2695225,BUY
22-10-20 13:37,13:37,17025925,20036150,3010225,BUY
22-10-20 13:38,13:38,16908325,19727625,2819300,BUY
22-10-20 13:39,13:39,17130900,19924950,2794050,BUY
22-10-20 13:40,13:40,17284725,19681800,2397075,BUY
22-10-20 13:41,13:41,17217700,19652050,2434350,BUY
22-10-20 13:42,13:42,17580550,19973875,2393325,BUY
22-10-20 13:43,13:43,17586350,19987450,2401100,BUY
22-10-20 13:44,13:44,17679525,20039225,2359700,BUY
22-10-20 13:45,13:45,17858925,19867800,2008875,BUY
22-10-20 13:46,13:46,17731025,19778400,2047375,BUY
22-10-20 13:47,13:47,17788700,19757700,1969000,BUY
22-10-20 13:48,13:48,17538400,19416700,1878300,BUY
22-10-20 13:49,13:49,17451500,19451200,1999700,BUY
22-10-20 13:50,13:50,17663950,19485575,1821625,BUY
22-10-20 13:51,13:51,17913075,19308100,1395025,BUY
22-10-20 13:52,13:52,17834700,19600650,1765950,BUY
22-10-20 13:53,13:53,17812200,19609550,1797350,BUY
22-10-20 13:54,13:54,17854400,19360675,1506275,BUY
22-10-20 13:55,13:55,17840050,19722475,1882425,BUY
22-10-20 13:56,13:56,17926700,19421625,1494925,BUY
22-10-20 13:57,13:57,17830450,19447750,1617300,BUY
22-10-20 13:58,13:58,17661475,19818450,2156975,BUY
22-10-20 13:59,13:59,17838200,19475150,1636950,BUY
22-10-20 14:00,14:00,17542900,19921725,2378825,BUY
22-10-20 14:01,14:01,17523600,19843650,2320050,BUY
22-10-20 14:02,14:02,17367175,19624800,2257625,BUY
22-10-20 14:03,14:03,17241050,19938800,2697750,BUY
22-10-20 14:04,14:04,17336675,19563925,2227250,BUY
22-10-20 14:05,14:05,17355325,19737250,2381925,BUY
22-10-20 14:06,14:06,17188175,19795050,2606875,BUY
22-10-20 14:07,14:07,17080350,19886550,2806200,BUY
22-10-20 14:08,14:08,17037050,19824250,2787200,BUY
22-10-20 14:09,14:09,17317950,19900750,2582800,BUY
22-10-20 14:10,14:10,17177550,19866975,2689425,BUY
22-10-20 14:11,14:11,17271725,19814675,2542950,BUY
22-10-20 14:12,14:12,17064200,19665575,2601375,BUY
22-10-20 14:13,14:13,17134200,19938325,2804125,BUY
22-10-20 14:14,14:14,17120800,19995525,2874725,BUY
22-10-20 14:15,14:15,17324600,19674825,2350225,BUY
22-10-20 14:16,14:16,17182825,19906275,2723450,BUY
22-10-20 14:17,14:17,17238725,19671775,2433050,BUY
22-10-20 14:18,14:18,17091250,19656775,2565525,BUY
22-10-20 14:19,14:19,17200700,19955925,2755225,BUY
22-10-20 14:20,14:20,17120550,19478350,2357800,BUY
22-10-20 14:21,14:21,17136275,19796900,2660625,BUY
22-10-20 14:22,14:22,17099075,19801900,2702825,BUY
22-10-20 14:23,14:23,17284975,19589425,2304450,BUY
22-10-20 14:24,14:24,17432725,19676025,2243300,BUY
22-10-20 14:25,14:25,17438125,19672000,2233875,BUY
22-10-20 14:26,14:26,17420150,19073925,1653775,BUY
22-10-20 14:27,14:27,17161650,19837525,2675875,BUY
22-10-20 14:28,14:28,17062875,19630275,2567400,BUY
22-10-20 14:29,14:29,16960300,19716550,2756250,BUY
22-10-20 14:30,14:30,17219050,19694100,2475050,BUY
22-10-20 14:31,14:31,17103175,19333900,2230725,BUY
22-10-20 14:32,14:32,17130625,19407700,2277075,BUY
22-10-20 14:33,14:33,17270425,19534575,2264150,BUY
22-10-20 14:34,14:34,17312700,19551550,2238850,BUY
22-10-20 14:35,14:35,17207425,19551550,2344125,BUY
22-10-20 14:36,14:36,17298050,19227250,1929200,BUY
22-10-20 14:37,14:37,17289450,19144150,1854700,BUY
22-10-20 14:38,14:38,17284175,19132125,1847950,BUY
22-10-20 14:39,14:39,17298025,18518125,1220100,BUY
22-10-20 14:40,14:40,17297325,18587950,1290625,BUY
22-10-20 14:41,14:41,17265575,18561800,1296225,BUY
22-10-20 14:42,14:42,17076375,18054900,978525,BUY
22-10-20 14:43,14:43,17064850,18013450,948600,BUY
22-10-20 14:44,14:44,16997700,18262650,1264950,BUY
22-10-20 14:45,14:45,16845575,17649725,804150,BUY
22-10-20 14:46,14:46,16775400,17960750,1185350,BUY
22-10-20 14:47,14:47,16865075,17851125,986050,BUY
22-10-20 14:48,14:48,16597300,17431300,834000,BUY
22-10-20 14:49,14:49,16653925,17602475,948550,BUY
22-10-20 14:50,14:50,16684925,17690800,1005875,BUY
22-10-20 14:51,14:51,16601525,17975475,1373950,BUY
22-10-20 14:52,14:52,16636050,17911850,1275800,BUY
22-10-20 14:53,14:53,16634675,17921425,1286750,BUY
22-10-20 14:54,14:54,16605850,18017625,1411775,BUY
22-10-20 14:55,14:55,16473475,18192700,1719225,BUY
22-10-20 14:56,14:56,16616325,18164125,1547800,BUY
22-10-20 14:57,14:57,15409450,18074325,2664875,BUY
22-10-20 14:58,14:58,15451875,17780450,2328575,BUY
22-10-20 14:59,14:59,15468850,18045075,2576225,BUY
22-10-20 15:00,15:00,15661450,18029975,2368525,BUY
22-10-20 15:01,15:01,15634225,17920950,2286725,BUY
22-10-20 15:02,15:02,15679875,17791850,2111975,BUY
22-10-20 15:03,15:03,15605500,17775750,2170250,BUY
22-10-20 15:04,15:04,15622050,17967425,2345375,BUY
22-10-20 15:05,15:05,15680050,18020425,2340375,BUY
22-10-20 15:06,15:06,15630900,17667475,2036575,BUY
22-10-20 15:07,15:07,15671875,17463875,1792000,BUY
22-10-20 15:08,15:08,15575825,17634800,2058975,BUY
22-10-20 15:09,15:09,15560825,17440325,1879500,BUY
22-10-20 15:10,15:10,15607725,17461525,1853800,BUY
22-10-20 15:11,15:11,15579175,17227975,1648800,BUY
22-10-20 15:12,15:12,15059800,17205075,2145275,BUY
22-10-20 15:13,15:13,14997150,17207500,2210350,BUY
22-10-20 15:14,15:14,15093875,17034275,1940400,BUY
22-10-20 15:15,15:15,14335625,16015350,1679725,BUY
22-10-20 15:16,15:16,14286750,16413450,2126700,BUY
22-10-20 15:17,15:17,14269500,16192475,1922975,BUY
22-10-20 15:18,15:18,13346250,14980600,1634350,BUY
22-10-20 15:19,15:19,13296675,15053050,1756375,BUY
22-10-20 15:20,15:20,13344350,14599125,1254775,BUY
22-10-20 15:21,15:21,12434675,14251875,1817200,BUY
22-10-20 15:22,15:22,12432875,13658800,1225925,BUY
22-10-20 15:23,15:23,12412950,13900500,1487550,BUY
22-10-20 15:24,15:24,11750500,12499925,749425,BUY
22-10-20 15:25,15:25,11826175,12676850,850675,BUY
22-10-20 15:26,15:26,11764525,12624525,860000,BUY
22-10-20 15:27,15:27,10300475,11475875,1175400,BUY
22-10-20 15:28,15:28,10311275,11874325,1563050,BUY
22-10-20 15:29,15:29,10279575,9542150,-737425,SELL
23-10-20 9:15,9:15,4932700,5312850,380150,BUY
23-10-20 9:16,9:16,5517975,5200000,-317975,SELL
23-10-20 9:17,9:17,5706725,5635700,-71025,SELL
23-10-20 9:18,9:18,5462825,5641350,178525,BUY
23-10-20 9:19,9:19,5481550,5503850,22300,BUY
23-10-20 9:20,9:20,6052900,6174450,121550,BUY
23-10-20 9:21,9:21,5713250,6043825,330575,BUY
23-10-20 9:22,9:22,6221900,6173625,-48275,SELL
23-10-20 9:23,9:23,6389875,6340350,-49525,SELL
23-10-20 9:24,9:24,6339325,6266425,-72900,SELL
23-10-20 9:25,9:25,6297275,6377025,79750,BUY
23-10-20 9:26,9:26,6398175,6474725,76550,BUY
23-10-20 9:27,9:27,6053700,6456075,402375,BUY
23-10-20 9:28,9:28,6265125,6438775,173650,BUY
23-10-20 9:29,9:29,6678125,6574675,-103450,SELL
23-10-20 9:30,9:30,6545375,6598575,53200,BUY
23-10-20 9:31,9:31,6586500,6395275,-191225,SELL
23-10-20 9:32,9:32,6685850,6716975,31125,BUY
23-10-20 9:33,9:33,6648625,6597100,-51525,SELL
23-10-20 9:34,9:34,6782175,6450450,-331725,SELL
23-10-20 9:35,9:35,7238050,6476150,-761900,SELL
23-10-20 9:36,9:36,6821700,6790100,-31600,SELL
23-10-20 9:37,9:37,6444050,6666300,222250,BUY
23-10-20 9:38,9:38,6851225,6797200,-54025,SELL
23-10-20 9:39,9:39,6806850,6882250,75400,BUY
23-10-20 9:40,9:40,6882975,6906600,23625,BUY
23-10-20 9:41,9:41,7073700,6722750,-350950,SELL
23-10-20 9:42,9:42,6725200,6630225,-94975,SELL
23-10-20 9:43,9:43,6782075,6995325,213250,BUY
23-10-20 9:44,9:44,7035475,6718350,-317125,SELL
23-10-20 9:45,9:45,7017550,6907175,-110375,SELL
23-10-20 9:46,9:46,7021225,6875000,-146225,SELL
23-10-20 9:47,9:47,7080075,6987225,-92850,SELL
23-10-20 9:48,9:48,7084750,7060000,-24750,SELL
23-10-20 9:49,9:49,7666725,7082775,-583950,SELL
23-10-20 9:50,9:50,6960375,7118700,158325,BUY
23-10-20 9:51,9:51,6994600,7153125,158525,BUY
23-10-20 9:52,9:52,7261600,6924775,-336825,SELL
23-10-20 9:53,9:53,7073075,7138950,65875,BUY
23-10-20 9:54,9:54,7348000,7176600,-171400,SELL
23-10-20 9:55,9:55,7128575,7139925,11350,BUY
23-10-20 9:56,9:56,7149450,7138975,-10475,SELL
23-10-20 9:57,9:57,7507925,7040425,-467500,SELL
23-10-20 9:58,9:58,7334775,6892850,-441925,SELL
23-10-20 9:59,9:59,7603175,7267025,-336150,SELL
23-10-20 10:00,10:00,7472475,7135675,-336800,SELL
23-10-20 10:01,10:01,7433350,7087200,-346150,SELL
23-10-20 10:02,10:02,7362200,7326500,-35700,SELL
23-10-20 10:03,10:03,7597150,7378900,-218250,SELL
23-10-20 10:04,10:04,7579000,6827875,-751125,SELL
23-10-20 10:05,10:05,7908925,7419400,-489525,SELL
23-10-20 10:06,10:06,7481500,7192675,-288825,SELL
23-10-20 10:07,10:07,7812250,7463000,-349250,SELL
23-10-20 10:08,10:08,7719825,6944150,-775675,SELL
23-10-20 10:09,10:09,7887575,7500025,-387550,SELL
23-10-20 10:10,10:10,8146300,7470875,-675425,SELL
23-10-20 10:11,10:11,7652700,7155800,-496900,SELL
23-10-20 10:12,10:12,7641575,7127825,-513750,SELL
23-10-20 10:13,10:13,7732475,7325825,-406650,SELL
23-10-20 10:14,10:14,7699900,7139900,-560000,SELL
23-10-20 10:15,10:15,7814100,7375125,-438975,SELL
23-10-20 10:16,10:16,7995900,7072325,-923575,SELL
23-10-20 10:17,10:17,7699450,7083550,-615900,SELL
23-10-20 10:18,10:18,7835975,7536650,-299325,SELL
23-10-20 10:19,10:19,7863025,7437150,-425875,SELL
23-10-20 10:20,10:20,7592875,7501825,-91050,SELL
23-10-20 10:21,10:21,7792425,7517175,-275250,SELL
23-10-20 10:22,10:22,7924225,7466675,-457550,SELL
23-10-20 10:23,10:23,8056350,7313825,-742525,SELL
23-10-20 10:24,10:24,7570625,7405550,-165075,SELL
23-10-20 10:25,10:25,7814125,7424775,-389350,SELL
23-10-20 10:26,10:26,7795075,7352325,-442750,SELL
23-10-20 10:27,10:27,7803775,7447550,-356225,SELL
23-10-20 10:28,10:28,8003200,7552550,-450650,SELL
23-10-20 10:29,10:29,7657875,7474825,-183050,SELL
23-10-20 10:30,10:30,7836675,7413900,-422775,SELL
23-10-20 10:31,10:31,7929850,7627450,-302400,SELL
23-10-20 10:32,10:32,8051150,7507250,-543900,SELL
23-10-20 10:33,10:33,7758275,7368675,-389600,SELL
23-10-20 10:34,10:34,8550175,7441550,-1108625,SELL
23-10-20 10:35,10:35,8507125,7284825,-1222300,SELL
23-10-20 10:36,10:36,8141725,7428175,-713550,SELL
23-10-20 10:37,10:37,7988125,7437950,-550175,SELL
23-10-20 10:38,10:38,7875250,7300725,-574525,SELL
23-10-20 10:39,10:39,8222975,7373725,-849250,SELL
23-10-20 10:40,10:40,8411075,7336175,-1074900,SELL
23-10-20 10:41,10:41,7850975,7450550,-400425,SELL
23-10-20 10:42,10:42,7976350,7341325,-635025,SELL
23-10-20 10:43,10:43,8209650,7360100,-849550,SELL
23-10-20 10:44,10:44,8019550,7236950,-782600,SELL
23-10-20 10:45,10:45,8306325,7508425,-797900,SELL
23-10-20 10:46,10:46,8068175,7427025,-641150,SELL
23-10-20 10:47,10:47,8348150,7475075,-873075,SELL
23-10-20 10:48,10:48,8152950,7400925,-752025,SELL
23-10-20 10:49,10:49,8530800,7660375,-870425,SELL
23-10-20 10:50,10:50,8417400,7667725,-749675,SELL
23-10-20 10:51,10:51,8411625,7625400,-786225,SELL
23-10-20 10:52,10:52,8205275,7732075,-473200,SELL
23-10-20 10:53,10:53,8599025,7639175,-959850,SELL
23-10-20 10:54,10:54,8131600,7631050,-500550,SELL
23-10-20 10:55,10:55,8813525,7617625,-1195900,SELL
23-10-20 10:56,10:56,8455925,7648000,-807925,SELL
23-10-20 10:57,10:57,8632700,7454450,-1178250,SELL
23-10-20 10:58,10:58,8766400,7572825,-1193575,SELL
23-10-20 10:59,10:59,8286025,7602000,-684025,SELL
23-10-20 11:00,11:00,8469725,7352875,-1116850,SELL
23-10-20 11:01,11:01,8488950,7566500,-922450,SELL
23-10-20 11:02,11:02,8406850,7450975,-955875,SELL
23-10-20 11:03,11:03,8539650,7647950,-891700,SELL
23-10-20 11:04,11:04,8602725,7564050,-1038675,SELL
23-10-20 11:05,11:05,8582100,7550400,-1031700,SELL
23-10-20 11:06,11:06,8439100,7709800,-729300,SELL
23-10-20 11:07,11:07,8423975,7546075,-877900,SELL
23-10-20 11:08,11:08,8374375,7369450,-1004925,SELL
23-10-20 11:09,11:09,8458025,7830600,-627425,SELL
23-10-20 11:10,11:10,8603325,7628050,-975275,SELL
23-10-20 11:11,11:11,8466900,7929300,-537600,SELL
23-10-20 11:12,11:12,8360200,7701925,-658275,SELL
23-10-20 11:13,11:13,8682075,7641425,-1040650,SELL
23-10-20 11:14,11:14,8464250,7653750,-810500,SELL
23-10-20 11:15,11:15,8600950,7950100,-650850,SELL
23-10-20 11:16,11:16,8464575,7524550,-940025,SELL
23-10-20 11:17,11:17,8662175,7664000,-998175,SELL
23-10-20 11:18,11:18,8405000,7674000,-731000,SELL
23-10-20 11:19,11:19,8416475,7791700,-624775,SELL
23-10-20 11:20,11:20,8669000,7635725,-1033275,SELL
23-10-20 11:21,11:21,8690850,7881475,-809375,SELL
23-10-20 11:22,11:22,8896600,7647775,-1248825,SELL
23-10-20 11:23,11:23,9098400,7671825,-1426575,SELL
23-10-20 11:24,11:24,8599725,7298000,-1301725,SELL
23-10-20 11:25,11:25,8628225,7538950,-1089275,SELL
23-10-20 11:26,11:26,8573625,7569800,-1003825,SELL
23-10-20 11:27,11:27,8538600,7827050,-711550,SELL
23-10-20 11:28,11:28,8932400,7665800,-1266600,SELL
23-10-20 11:29,11:29,8774375,7874075,-900300,SELL
23-10-20 11:30,11:30,8468200,7808700,-659500,SELL
23-10-20 11:31,11:31,9114450,8004800,-1109650,SELL
23-10-20 11:32,11:32,8649675,7783475,-866200,SELL
23-10-20 11:33,11:33,8851875,7805400,-1046475,SELL
23-10-20 11:34,11:34,8545250,7576450,-968800,SELL
23-10-20 11:35,11:35,8821425,7803350,-1018075,SELL
23-10-20 11:36,11:36,8482950,7821600,-661350,SELL
23-10-20 11:37,11:37,8507475,7719825,-787650,SELL
23-10-20 11:38,11:38,8524750,7732175,-792575,SELL
23-10-20 11:39,11:39,8812675,7700800,-1111875,SELL
23-10-20 11:40,11:40,8661825,7704300,-957525,SELL
23-10-20 11:41,11:41,9054850,7845150,-1209700,SELL
23-10-20 11:42,11:42,8761600,7872075,-889525,SELL
23-10-20 11:43,11:43,9258175,7625875,-1632300,SELL
23-10-20 11:44,11:44,8741200,7638550,-1102650,SELL
23-10-20 11:45,11:45,8757925,7741900,-1016025,SELL
23-10-20 11:46,11:46,9619100,7977025,-1642075,SELL
23-10-20 11:47,11:47,8795225,7658125,-1137100,SELL
23-10-20 11:48,11:48,9101225,7663725,-1437500,SELL
23-10-20 11:49,11:49,9183025,7580275,-1602750,SELL
23-10-20 11:50,11:50,8813500,7780800,-1032700,SELL
23-10-20 11:51,11:51,8832775,7731925,-1100850,SELL
23-10-20 11:52,11:52,8823975,7791925,-1032050,SELL
23-10-20 11:53,11:53,8772750,7675825,-1096925,SELL
23-10-20 11:54,11:54,8724350,7711450,-1012900,SELL
23-10-20 11:55,11:55,8808100,7876225,-931875,SELL
23-10-20 11:56,11:56,8858350,7615775,-1242575,SELL
23-10-20 11:57,11:57,8722000,7682175,-1039825,SELL
23-10-20 11:58,11:58,8741875,7625325,-1116550,SELL
23-10-20 11:59,11:59,8597925,7592850,-1005075,SELL
23-10-20 12:00,12:00,9343650,7967975,-1375675,SELL
23-10-20 12:01,12:01,9076600,7641900,-1434700,SELL
23-10-20 12:02,12:02,9086625,7579725,-1506900,SELL
23-10-20 12:03,12:03,8852400,7858475,-993925,SELL
23-10-20 12:04,12:04,8653800,7302150,-1351650,SELL
23-10-20 12:05,12:05,8973775,7680950,-1292825,SELL
23-10-20 12:06,12:06,8799850,7331075,-1468775,SELL
23-10-20 12:07,12:07,9208375,7705450,-1502925,SELL
23-10-20 12:08,12:08,9061125,7848250,-1212875,SELL
23-10-20 12:09,12:09,9281475,7422825,-1858650,SELL
23-10-20 12:10,12:10,8822100,8023975,-798125,SELL
23-10-20 12:11,12:11,9334450,7726925,-1607525,SELL
23-10-20 12:12,12:12,9156075,7734450,-1421625,SELL
23-10-20 12:13,12:13,8970400,7966200,-1004200,SELL
23-10-20 12:14,12:14,8997975,7741275,-1256700,SELL
23-10-20 12:15,12:15,9063075,7874750,-1188325,SELL
23-10-20 12:16,12:16,8867100,7598625,-1268475,SELL
23-10-20 12:17,12:17,8978975,7945025,-1033950,SELL
23-10-20 12:18,12:18,8905075,7800450,-1104625,SELL
23-10-20 12:19,12:19,8844425,7803450,-1040975,SELL
23-10-20 12:20,12:20,8884100,7756075,-1128025,SELL
23-10-20 12:21,12:21,8973475,7433625,-1539850,SELL
23-10-20 12:22,12:22,9308100,7919825,-1388275,SELL
23-10-20 12:23,12:23,9140150,7976900,-1163250,SELL
23-10-20 12:24,12:24,9118850,7966300,-1152550,SELL
23-10-20 12:25,12:25,8698400,7960575,-737825,SELL
23-10-20 12:26,12:26,8969900,8042300,-927600,SELL
23-10-20 12:27,12:27,9373925,7834400,-1539525,SELL
23-10-20 12:28,12:28,8924175,7850125,-1074050,SELL
23-10-20 12:29,12:29,8564050,7746475,-817575,SELL
23-10-20 12:30,12:30,9310225,7965200,-1345025,SELL
23-10-20 12:31,12:31,9192325,8095300,-1097025,SELL
23-10-20 12:32,12:32,9185850,7927675,-1258175,SELL
23-10-20 12:33,12:33,8948550,7780175,-1168375,SELL
23-10-20 12:34,12:34,9194275,7805375,-1388900,SELL
23-10-20 12:35,12:35,9232775,7601225,-1631550,SELL
23-10-20 12:36,12:36,9067425,7896075,-1171350,SELL
23-10-20 12:37,12:37,9238750,7545000,-1693750,SELL
23-10-20 12:38,12:38,8844575,7875025,-969550,SELL
23-10-20 12:39,12:39,9422300,7974650,-1447650,SELL
23-10-20 12:40,12:40,9066875,8012275,-1054600,SELL
23-10-20 12:41,12:41,9173275,7837650,-1335625,SELL
23-10-20 12:42,12:42,9091450,7779325,-1312125,SELL
23-10-20 12:43,12:43,8963525,7523300,-1440225,SELL
23-10-20 12:44,12:44,9007550,7595425,-1412125,SELL
23-10-20 12:45,12:45,9061100,7744650,-1316450,SELL
23-10-20 12:46,12:46,9139250,7963575,-1175675,SELL
23-10-20 12:47,12:47,8872800,7480525,-1392275,SELL
23-10-20 12:48,12:48,8987825,7666025,-1321800,SELL
23-10-20 12:49,12:49,9561200,7912250,-1648950,SELL
23-10-20 12:50,12:50,9550900,7798650,-1752250,SELL
23-10-20 12:51,12:51,9312175,7573200,-1738975,SELL
23-10-20 12:52,12:52,8958525,8093675,-864850,SELL
23-10-20 12:53,12:53,9375425,7774875,-1600550,SELL
23-10-20 12:54,12:54,9138725,7948775,-1189950,SELL
23-10-20 12:55,12:55,9108675,7588050,-1520625,SELL
23-10-20 12:56,12:56,9491600,7707600,-1784000,SELL
23-10-20 12:57,12:57,9076375,7840100,-1236275,SELL
23-10-20 12:58,12:58,9176475,7674350,-1502125,SELL
23-10-20 12:59,12:59,8943775,7483300,-1460475,SELL
23-10-20 13:00,13:00,9398075,8070025,-1328050,SELL
23-10-20 13:01,13:01,9427300,8133500,-1293800,SELL
23-10-20 13:02,13:02,9328850,7878275,-1450575,SELL
23-10-20 13:03,13:03,9956925,8123675,-1833250,SELL
23-10-20 13:04,13:04,9160425,7606925,-1553500,SELL
23-10-20 13:05,13:05,9076875,7893275,-1183600,SELL
23-10-20 13:06,13:06,8994275,7916025,-1078250,SELL
23-10-20 13:07,13:07,9148225,8050350,-1097875,SELL
23-10-20 13:08,13:08,9399125,7773575,-1625550,SELL
23-10-20 13:09,13:09,9341950,7772875,-1569075,SELL
23-10-20 13:10,13:10,9037200,7900050,-1137150,SELL
23-10-20 13:11,13:11,9156900,7431400,-1725500,SELL
23-10-20 13:12,13:12,9347450,7688300,-1659150,SELL
23-10-20 13:13,13:13,9126450,7636600,-1489850,SELL
23-10-20 13:14,13:14,9168275,7949225,-1219050,SELL
23-10-20 13:15,13:15,9393700,7878325,-1515375,SELL
23-10-20 13:16,13:16,9216050,7699675,-1516375,SELL
23-10-20 13:17,13:17,9297675,8263150,-1034525,SELL
23-10-20 13:18,13:18,9526250,8244650,-1281600,SELL
23-10-20 13:19,13:19,9106700,8253625,-853075,SELL
23-10-20 13:20,13:20,9677175,8315225,-1361950,SELL
23-10-20 13:21,13:21,9681700,7984075,-1697625,SELL
23-10-20 13:22,13:22,9464775,8111450,-1353325,SELL
23-10-20 13:23,13:23,9242925,8175975,-1066950,SELL
23-10-20 13:24,13:24,8993800,8077400,-916400,SELL
23-10-20 13:25,13:25,9255400,8310525,-944875,SELL
23-10-20 13:26,13:26,9259400,8303200,-956200,SELL
23-10-20 13:27,13:27,9557250,8036100,-1521150,SELL
23-10-20 13:28,13:28,9323300,7878525,-1444775,SELL
23-10-20 13:29,13:29,9557250,7659200,-1898050,SELL
23-10-20 13:30,13:30,9112275,7607350,-1504925,SELL
23-10-20 13:31,13:31,9226725,8037125,-1189600,SELL
23-10-20 13:32,13:32,9120250,8092000,-1028250,SELL
23-10-20 13:33,13:33,8997675,8281825,-715850,SELL
23-10-20 13:34,13:34,9239750,8269875,-969875,SELL
23-10-20 13:35,13:35,9084875,8332550,-752325,SELL
23-10-20 13:36,13:36,9140825,8090100,-1050725,SELL
23-10-20 13:37,13:37,9047525,8155725,-891800,SELL
23-10-20 13:38,13:38,9207000,7962975,-1244025,SELL
23-10-20 13:39,13:39,9442400,7853225,-1589175,SELL
23-10-20 13:40,13:40,9217725,8064100,-1153625,SELL
23-10-20 13:41,13:41,9155650,8082275,-1073375,SELL
23-10-20 13:42,13:42,9241975,8222525,-1019450,SELL
23-10-20 13:43,13:43,9046600,8206550,-840050,SELL
23-10-20 13:44,13:44,9193775,8142475,-1051300,SELL
23-10-20 13:45,13:45,9609575,8286975,-1322600,SELL
23-10-20 13:46,13:46,9222025,7998675,-1223350,SELL
23-10-20 13:47,13:47,9203800,8214200,-989600,SELL
23-10-20 13:48,13:48,9287175,8261150,-1026025,SELL
23-10-20 13:49,13:49,9173275,8161975,-1011300,SELL
23-10-20 13:50,13:50,9261275,8143500,-1117775,SELL
23-10-20 13:51,13:51,9461800,8222650,-1239150,SELL
23-10-20 13:52,13:52,9686825,8300425,-1386400,SELL
23-10-20 13:53,13:53,9614725,8102175,-1512550,SELL
23-10-20 13:54,13:54,9070850,8241100,-829750,SELL
23-10-20 13:55,13:55,9431525,8158525,-1273000,SELL
23-10-20 13:56,13:56,9001825,7661800,-1340025,SELL
23-10-20 13:57,13:57,9100550,7848225,-1252325,SELL
23-10-20 13:58,13:58,9091050,7951925,-1139125,SELL
23-10-20 13:59,13:59,9377075,8073750,-1303325,SELL
23-10-20 14:00,14:00,9227975,8070350,-1157625,SELL
23-10-20 14:01,14:01,9047525,7986650,-1060875,SELL
23-10-20 14:02,14:02,9186550,7519150,-1667400,SELL
23-10-20 14:03,14:03,9602475,8260725,-1341750,SELL
23-10-20 14:04,14:04,9249900,8081525,-1168375,SELL
23-10-20 14:05,14:05,9427975,8253150,-1174825,SELL
23-10-20 14:06,14:06,9459075,8236250,-1222825,SELL
23-10-20 14:07,14:07,9473725,7918075,-1555650,SELL
23-10-20 14:08,14:08,9279425,8100975,-1178450,SELL
23-10-20 14:09,14:09,9212800,8248975,-963825,SELL
23-10-20 14:10,14:10,9291900,8157575,-1134325,SELL
23-10-20 14:11,14:11,9267550,8048475,-1219075,SELL
23-10-20 14:12,14:12,9773450,8131525,-1641925,SELL
23-10-20 14:13,14:13,9094950,7876025,-1218925,SELL
23-10-20 14:14,14:14,9114350,8179900,-934450,SELL
23-10-20 14:15,14:15,9506575,8172125,-1334450,SELL
23-10-20 14:16,14:16,9185150,8050550,-1134600,SELL
23-10-20 14:17,14:17,9525625,7986875,-1538750,SELL
23-10-20 14:18,14:18,9462575,8290675,-1171900,SELL
23-10-20 14:19,14:19,9629675,8250450,-1379225,SELL
23-10-20 14:20,14:20,9528600,8264825,-1263775,SELL
23-10-20 14:21,14:21,9517550,8287350,-1230200,SELL
23-10-20 14:22,14:22,9491525,7705675,-1785850,SELL
23-10-20 14:23,14:23,9716725,8065850,-1650875,SELL
23-10-20 14:24,14:24,9222425,7854700,-1367725,SELL
23-10-20 14:25,14:25,9256875,7961575,-1295300,SELL
23-10-20 14:26,14:26,9245850,8279450,-966400,SELL
23-10-20 14:27,14:27,9383900,8228525,-1155375,SELL
23-10-20 14:28,14:28,9966950,8276450,-1690500,SELL
23-10-20 14:29,14:29,9622225,8245150,-1377075,SELL
23-10-20 14:30,14:30,9409225,8192375,-1216850,SELL
23-10-20 14:31,14:31,9366050,8175925,-1190125,SELL
23-10-20 14:32,14:32,9414325,8144350,-1269975,SELL
23-10-20 14:33,14:33,9636050,8247800,-1388250,SELL
23-10-20 14:34,14:34,9650450,8206375,-1444075,SELL
23-10-20 14:35,14:35,9506900,8139400,-1367500,SELL
23-10-20 14:36,14:36,9169975,8034125,-1135850,SELL
23-10-20 14:37,14:37,9614900,7770450,-1844450,SELL
23-10-20 14:38,14:38,9529175,7843650,-1685525,SELL
23-10-20 14:39,14:39,9401100,8389175,-1011925,SELL
23-10-20 14:40,14:40,10067800,8421800,-1646000,SELL
23-10-20 14:41,14:41,9333400,8188550,-1144850,SELL
23-10-20 14:42,14:42,9375625,8254875,-1120750,SELL
23-10-20 14:43,14:43,9535025,8194325,-1340700,SELL
23-10-20 14:44,14:44,10171400,8426500,-1744900,SELL
23-10-20 14:45,14:45,9795950,8407925,-1388025,SELL
23-10-20 14:46,14:46,9440800,8337025,-1103775,SELL
23-10-20 14:47,14:47,9249625,8274725,-974900,SELL
23-10-20 14:48,14:48,9176175,8266050,-910125,SELL
23-10-20 14:49,14:49,9435025,8303000,-1132025,SELL
23-10-20 14:50,14:50,9529200,8391700,-1137500,SELL
23-10-20 14:51,14:51,9392250,8063125,-1329125,SELL
23-10-20 14:52,14:52,9383800,8280400,-1103400,SELL
23-10-20 14:53,14:53,9236775,8048500,-1188275,SELL
23-10-20 14:54,14:54,9365875,8199375,-1166500,SELL
23-10-20 14:55,14:55,8985975,7773875,-1212100,SELL
23-10-20 14:56,14:56,9157425,8312925,-844500,SELL
23-10-20 14:57,14:57,9690525,8300925,-1389600,SELL
23-10-20 14:58,14:58,9453700,8078325,-1375375,SELL
23-10-20 14:59,14:59,9275300,8134875,-1140425,SELL
23-10-20 15:00,15:00,8995725,8151950,-843775,SELL
23-10-20 15:01,15:01,8970125,7693425,-1276700,SELL
23-10-20 15:02,15:02,9078775,8100200,-978575,SELL
23-10-20 15:03,15:03,9031400,8133425,-897975,SELL
23-10-20 15:04,15:04,9087350,8101375,-985975,SELL
23-10-20 15:05,15:05,9333675,8149425,-1184250,SELL
23-10-20 15:06,15:06,8721650,8136200,-585450,SELL
23-10-20 15:07,15:07,8944025,8114275,-829750,SELL
23-10-20 15:08,15:08,9246650,7675425,-1571225,SELL
23-10-20 15:09,15:09,9281175,7913100,-1368075,SELL
23-10-20 15:10,15:10,9261450,8185500,-1075950,SELL
23-10-20 15:11,15:11,9265025,7985975,-1279050,SELL
23-10-20 15:12,15:12,8978600,8218325,-760275,SELL
23-10-20 15:13,15:13,8986125,8232125,-754000,SELL
23-10-20 15:14,15:14,8997650,8151750,-845900,SELL
23-10-20 15:15,15:15,9144675,8064750,-1079925,SELL
23-10-20 15:16,15:16,8667925,8043675,-624250,SELL
23-10-20 15:17,15:17,8946500,8086375,-860125,SELL
23-10-20 15:18,15:18,9053150,8077125,-976025,SELL
23-10-20 15:19,15:19,8627475,8035275,-592200,SELL
23-10-20 15:20,15:20,8844875,7917950,-926925,SELL
23-10-20 15:21,15:21,8454475,7860800,-593675,SELL
23-10-20 15:22,15:22,8658475,7813100,-845375,SELL
23-10-20 15:23,15:23,8413350,7955900,-457450,SELL
23-10-20 15:24,15:24,8875725,7666100,-1209625,SELL
23-10-20 15:25,15:25,8615425,7918250,-697175,SELL
23-10-20 15:26,15:26,8545150,7889075,-656075,SELL
23-10-20 15:27,15:27,8469700,7758700,-711000,SELL
23-10-20 15:28,15:28,8726875,7603675,-1123200,SELL
23-10-20 15:29,15:29,8565400,7802800,-762600,SELL
26-10-20 9:15,9:15,8425675,7534675,-891000,SELL
26-10-20 9:16,9:16,8032650,7497550,-535100,SELL
26-10-20 9:17,9:17,8564900,7299925,-1264975,SELL
26-10-20 9:18,9:18,8479100,7597775,-881325,SELL
26-10-20 9:19,9:19,8268100,7589900,-678200,SELL
26-10-20 9:20,9:20,8824450,8082850,-741600,SELL
26-10-20 9:21,9:21,8684650,7959175,-725475,SELL
26-10-20 9:22,9:22,8701125,7997700,-703425,SELL
26-10-20 9:23,9:23,9058175,8227750,-830425,SELL
26-10-20 9:24,9:24,8781000,8427900,-353100,SELL
26-10-20 9:25,9:25,8932050,8265175,-666875,SELL
26-10-20 9:26,9:26,9269050,8652300,-616750,SELL
26-10-20 9:27,9:27,9421175,8471700,-949475,SELL
26-10-20 9:28,9:28,9360050,8580275,-779775,SELL
26-10-20 9:29,9:29,9428150,8607100,-821050,SELL
26-10-20 9:30,9:30,9446075,8769450,-676625,SELL
26-10-20 9:31,9:31,9445725,8556400,-889325,SELL
26-10-20 9:32,9:32,9599175,8805900,-793275,SELL
26-10-20 9:33,9:33,9553975,8685700,-868275,SELL
26-10-20 9:34,9:34,9644850,8918325,-726525,SELL
26-10-20 9:35,9:35,9489200,9014975,-474225,SELL
26-10-20 9:36,9:36,9445325,8791625,-653700,SELL
26-10-20 9:37,9:37,9540125,8743700,-796425,SELL
26-10-20 9:38,9:38,9471525,8751525,-720000,SELL
26-10-20 9:39,9:39,9462975,8447150,-1015825,SELL
26-10-20 9:40,9:40,9536575,8344875,-1191700,SELL
26-10-20 9:41,9:41,9477350,9075750,-401600,SELL
26-10-20 9:42,9:42,9468675,8922950,-545725,SELL
26-10-20 9:43,9:43,9558900,9038375,-520525,SELL
26-10-20 9:44,9:44,9352400,9112575,-239825,SELL
26-10-20 9:45,9:45,9361050,9176025,-185025,SELL
26-10-20 9:46,9:46,9537650,8984450,-553200,SELL
26-10-20 9:47,9:47,9635600,9275625,-359975,SELL
26-10-20 9:48,9:48,9630775,9174375,-456400,SELL
26-10-20 9:49,9:49,9748150,9288150,-460000,SELL
26-10-20 9:50,9:50,9625475,9272125,-353350,SELL
26-10-20 9:51,9:51,9435675,9283025,-152650,SELL
26-10-20 9:52,9:52,9580900,9322675,-258225,SELL
26-10-20 9:53,9:53,9417950,9271475,-146475,SELL
26-10-20 9:54,9:54,9479625,9224200,-255425,SELL
26-10-20 9:55,9:55,9663475,9333825,-329650,SELL
26-10-20 9:56,9:56,9404350,9246200,-158150,SELL
26-10-20 9:57,9:57,9679850,9176425,-503425,SELL
26-10-20 9:58,9:58,9478500,9176175,-302325,SELL
26-10-20 9:59,9:59,9240100,9201675,-38425,SELL
26-10-20 10:00,10:00,9794875,9330475,-464400,SELL
26-10-20 10:01,10:01,9454125,9286025,-168100,SELL
26-10-20 10:02,10:02,9483525,9106950,-376575,SELL
26-10-20 10:03,10:03,9856650,9375625,-481025,SELL
26-10-20 10:04,10:04,9680600,9344275,-336325,SELL
26-10-20 10:05,10:05,9649875,9443300,-206575,SELL
26-10-20 10:06,10:06,9871200,9499375,-371825,SELL
26-10-20 10:07,10:07,9757275,9506875,-250400,SELL
26-10-20 10:08,10:08,9865050,9514475,-350575,SELL
26-10-20 10:09,10:09,9757850,9330475,-427375,SELL
26-10-20 10:10,10:10,9980300,9342850,-637450,SELL
26-10-20 10:11,10:11,10251200,9741350,-509850,SELL
26-10-20 10:12,10:12,9913275,9635850,-277425,SELL
26-10-20 10:13,10:13,9522825,9516900,-5925,SELL
26-10-20 10:14,10:14,9575025,9581825,6800,BUY
26-10-20 10:15,10:15,10056600,9698825,-357775,SELL
26-10-20 10:16,10:16,9802050,9474100,-327950,SELL
26-10-20 10:17,10:17,9845625,9623375,-222250,SELL
26-10-20 10:18,10:18,10069050,9553350,-515700,SELL
26-10-20 10:19,10:19,10013125,9490550,-522575,SELL
26-10-20 10:20,10:20,9934900,9605650,-329250,SELL
26-10-20 10:21,10:21,9920475,9690700,-229775,SELL
26-10-20 10:22,10:22,9887475,9594650,-292825,SELL
26-10-20 10:23,10:23,10113825,9508600,-605225,SELL
26-10-20 10:24,10:24,9794300,9655350,-138950,SELL
26-10-20 10:25,10:25,10043575,9528350,-515225,SELL
26-10-20 10:26,10:26,9989425,9514525,-474900,SELL
26-10-20 10:27,10:27,9970875,9610575,-360300,SELL
26-10-20 10:28,10:28,9957100,9528225,-428875,SELL
26-10-20 10:29,10:29,9623000,9426900,-196100,SELL
26-10-20 10:30,10:30,9861125,9262225,-598900,SELL
26-10-20 10:31,10:31,10028400,9639425,-388975,SELL
26-10-20 10:32,10:32,9928575,9283800,-644775,SELL
26-10-20 10:33,10:33,10179025,9432800,-746225,SELL
26-10-20 10:34,10:34,9964625,9646300,-318325,SELL
26-10-20 10:35,10:35,9867850,9682350,-185500,SELL
26-10-20 10:36,10:36,9950600,9610825,-339775,SELL
26-10-20 10:37,10:37,9730725,9709300,-21425,SELL
26-10-20 10:38,10:38,9817600,9488675,-328925,SELL
26-10-20 10:39,10:39,9855050,9359425,-495625,SELL
26-10-20 10:40,10:40,9855050,9644650,-210400,SELL
26-10-20 10:41,10:41,9747750,9646925,-100825,SELL
26-10-20 10:42,10:42,9934900,9752625,-182275,SELL
26-10-20 10:43,10:43,10275075,9930275,-344800,SELL
26-10-20 10:44,10:44,10010550,9665325,-345225,SELL
26-10-20 10:45,10:45,10107375,9924175,-183200,SELL
26-10-20 10:46,10:46,10018600,9747375,-271225,SELL
26-10-20 10:47,10:47,9858575,9839025,-19550,SELL
26-10-20 10:48,10:48,10625850,9883375,-742475,SELL
26-10-20 10:49,10:49,9924850,9753700,-171150,SELL
26-10-20 10:50,10:50,9945175,9551150,-394025,SELL
26-10-20 10:51,10:51,9987625,9542950,-444675,SELL
26-10-20 10:52,10:52,10006300,9749500,-256800,SELL
26-10-20 10:53,10:53,9826825,9653000,-173825,SELL
26-10-20 10:54,10:54,9752575,9791625,39050,BUY
26-10-20 10:55,10:55,10153250,9650425,-502825,SELL
26-10-20 10:56,10:56,10013950,9679750,-334200,SELL
26-10-20 10:57,10:57,10343250,9555825,-787425,SELL
26-10-20 10:58,10:58,10347675,9807400,-540275,SELL
26-10-20 10:59,10:59,10124500,9737575,-386925,SELL
26-10-20 11:00,11:00,9833175,9362600,-470575,SELL
26-10-20 11:01,11:01,9891875,9901925,10050,BUY
26-10-20 11:02,11:02,10130250,9548525,-581725,SELL
26-10-20 11:03,11:03,10278400,9706600,-571800,SELL
26-10-20 11:04,11:04,9738375,9881850,143475,BUY
26-10-20 11:05,11:05,10050375,9944700,-105675,SELL
26-10-20 11:06,11:06,10172375,9926650,-245725,SELL
26-10-20 11:07,11:07,10195575,10065800,-129775,SELL
26-10-20 11:08,11:08,9846650,9807175,-39475,SELL
26-10-20 11:09,11:09,10204125,9851100,-353025,SELL
26-10-20 11:10,11:10,10118375,9831300,-287075,SELL
26-10-20 11:11,11:11,10020575,9881900,-138675,SELL
26-10-20 11:12,11:12,10084625,9933475,-151150,SELL
26-10-20 11:13,11:13,10170025,9857500,-312525,SELL
26-10-20 11:14,11:14,10212225,10030400,-181825,SELL
26-10-20 11:15,11:15,10728100,10112525,-615575,SELL
26-10-20 11:16,11:16,10224725,10128300,-96425,SELL
26-10-20 11:17,11:17,10345125,9810800,-534325,SELL
26-10-20 11:18,11:18,10246100,9814500,-431600,SELL
26-10-20 11:19,11:19,10341825,9978075,-363750,SELL
26-10-20 11:20,11:20,9976000,9871850,-104150,SELL
26-10-20 11:21,11:21,9962925,9601300,-361625,SELL
26-10-20 11:22,11:22,9936275,9955425,19150,BUY
26-10-20 11:23,11:23,10151925,9767675,-384250,SELL
26-10-20 11:24,11:24,10202175,9957650,-244525,SELL
26-10-20 11:25,11:25,10177700,9866850,-310850,SELL
26-10-20 11:26,11:26,10225600,9902525,-323075,SELL
26-10-20 11:27,11:27,10168625,9784525,-384100,SELL
26-10-20 11:28,11:28,10218275,9774375,-443900,SELL
26-10-20 11:29,11:29,10001050,9455650,-545400,SELL
26-10-20 11:30,11:30,10377150,9801750,-575400,SELL
26-10-20 11:31,11:31,10327300,9467075,-860225,SELL
26-10-20 11:32,11:32,10016175,9581950,-434225,SELL
26-10-20 11:33,11:33,10007975,9522475,-485500,SELL
26-10-20 11:34,11:34,10073625,9855425,-218200,SELL
26-10-20 11:35,11:35,10788125,9676150,-1111975,SELL
26-10-20 11:36,11:36,10301775,9742800,-558975,SELL
26-10-20 11:37,11:37,10301775,9429725,-872050,SELL
26-10-20 11:38,11:38,10633675,9614300,-1019375,SELL
26-10-20 11:39,11:39,10654425,9590075,-1064350,SELL
26-10-20 11:40,11:40,10630975,9730200,-900775,SELL
26-10-20 11:41,11:41,10337550,9357200,-980350,SELL
26-10-20 11:42,11:42,10549000,9271875,-1277125,SELL
26-10-20 11:43,11:43,10611075,9408200,-1202875,SELL
26-10-20 11:44,11:44,10658050,9453075,-1204975,SELL
26-10-20 11:45,11:45,10910700,9365075,-1545625,SELL
26-10-20 11:46,11:46,10321875,9363550,-958325,SELL
26-10-20 11:47,11:47,10640975,9353325,-1287650,SELL
26-10-20 11:48,11:48,10462700,9335375,-1127325,SELL
26-10-20 11:49,11:49,10748700,9111800,-1636900,SELL
26-10-20 11:50,11:50,10705325,9507425,-1197900,SELL
26-10-20 11:51,11:51,10728775,9288325,-1440450,SELL
26-10-20 11:52,11:52,10802225,9241900,-1560325,SELL
26-10-20 11:53,11:53,10695400,9437175,-1258225,SELL
26-10-20 11:54,11:54,10546625,9252150,-1294475,SELL
26-10-20 11:55,11:55,10642250,8948350,-1693900,SELL
26-10-20 11:56,11:56,10810900,9123575,-1687325,SELL
26-10-20 11:57,11:57,10974975,9353375,-1621600,SELL
26-10-20 11:58,11:58,10845175,9185125,-1660050,SELL
26-10-20 11:59,11:59,10607725,9633775,-973950,SELL
26-10-20 12:00,12:00,10636925,9521800,-1115125,SELL
26-10-20 12:01,12:01,10815825,9343000,-1472825,SELL
26-10-20 12:02,12:02,10943025,9380250,-1562775,SELL
26-10-20 12:03,12:03,11184725,9037300,-2147425,SELL
26-10-20 12:04,12:04,10679375,8954750,-1724625,SELL
26-10-20 12:05,12:05,10929025,9316075,-1612950,SELL
26-10-20 12:06,12:06,10748300,9020750,-1727550,SELL
26-10-20 12:07,12:07,10752525,9361800,-1390725,SELL
26-10-20 12:08,12:08,11144575,9449725,-1694850,SELL
26-10-20 12:09,12:09,11470600,9608350,-1862250,SELL
26-10-20 12:10,12:10,11384100,9588825,-1795275,SELL
26-10-20 12:11,12:11,11080300,9053925,-2026375,SELL
26-10-20 12:12,12:12,10998200,9420650,-1577550,SELL
26-10-20 12:13,12:13,11206875,9153100,-2053775,SELL
26-10-20 12:14,12:14,11174525,9334675,-1839850,SELL
26-10-20 12:15,12:15,11581975,9495575,-2086400,SELL
26-10-20 12:16,12:16,11474850,9272050,-2202800,SELL
26-10-20 12:17,12:17,11336350,9251100,-2085250,SELL
26-10-20 12:18,12:18,11474550,9411775,-2062775,SELL
26-10-20 12:19,12:19,11371325,9399275,-1972050,SELL
26-10-20 12:20,12:20,11353000,9439650,-1913350,SELL
26-10-20 12:21,12:21,11463350,9574250,-1889100,SELL
26-10-20 12:22,12:22,11351800,9350500,-2001300,SELL
26-10-20 12:23,12:23,11150075,9515800,-1634275,SELL
26-10-20 12:24,12:24,11146075,9626775,-1519300,SELL
26-10-20 12:25,12:25,11343600,9560775,-1782825,SELL
26-10-20 12:26,12:26,11447525,9530925,-1916600,SELL
26-10-20 12:27,12:27,11816725,9483975,-2332750,SELL
26-10-20 12:28,12:28,11020900,9022275,-1998625,SELL
26-10-20 12:29,12:29,11181775,9177050,-2004725,SELL
26-10-20 12:30,12:30,11563600,9443125,-2120475,SELL
26-10-20 12:31,12:31,11405700,9405150,-2000550,SELL
26-10-20 12:32,12:32,11562450,9467025,-2095425,SELL
26-10-20 12:33,12:33,11141000,9339600,-1801400,SELL
26-10-20 12:34,12:34,11464450,9397625,-2066825,SELL
26-10-20 12:35,12:35,11540900,9302975,-2237925,SELL
26-10-20 12:36,12:36,11406175,9188050,-2218125,SELL
26-10-20 12:37,12:37,11801125,9300500,-2500625,SELL
26-10-20 12:38,12:38,11566100,9376575,-2189525,SELL
26-10-20 12:39,12:39,12020075,9431875,-2588200,SELL
26-10-20 12:40,12:40,11767450,9398625,-2368825,SELL
26-10-20 12:41,12:41,11992500,9199400,-2793100,SELL
26-10-20 12:42,12:42,11501525,9153925,-2347600,SELL
26-10-20 12:43,12:43,11678925,9296900,-2382025,SELL
26-10-20 12:44,12:44,11924725,9152175,-2772550,SELL
26-10-20 12:45,12:45,12087800,8882800,-3205000,SELL
26-10-20 12:46,12:46,11768975,9156150,-2612825,SELL
26-10-20 12:47,12:47,11559575,8875150,-2684425,SELL
26-10-20 12:48,12:48,11520700,9081575,-2439125,SELL
26-10-20 12:49,12:49,11705800,8975075,-2730725,SELL
26-10-20 12:50,12:50,12138125,9163050,-2975075,SELL
26-10-20 12:51,12:51,11834600,9150350,-2684250,SELL
26-10-20 12:52,12:52,11847150,9164800,-2682350,SELL
26-10-20 12:53,12:53,11753300,9175775,-2577525,SELL
26-10-20 12:54,12:54,11765725,8628100,-3137625,SELL
26-10-20 12:55,12:55,12168850,9107975,-3060875,SELL
26-10-20 12:56,12:56,11947500,8983325,-2964175,SELL
26-10-20 12:57,12:57,11836500,9089725,-2746775,SELL
26-10-20 12:58,12:58,12409350,9184225,-3225125,SELL
26-10-20 12:59,12:59,11970200,9148150,-2822050,SELL
26-10-20 13:00,13:00,12031550,8962575,-3068975,SELL
26-10-20 13:01,13:01,12355750,9031700,-3324050,SELL
26-10-20 13:02,13:02,11867275,9107875,-2759400,SELL
26-10-20 13:03,13:03,12152125,9065325,-3086800,SELL
26-10-20 13:04,13:04,11986000,9061575,-2924425,SELL
26-10-20 13:05,13:05,12180375,8876575,-3303800,SELL
26-10-20 13:06,13:06,12378975,8997350,-3381625,SELL
26-10-20 13:07,13:07,12377700,8860600,-3517100,SELL
26-10-20 13:08,13:08,12134750,8907050,-3227700,SELL
26-10-20 13:09,13:09,12189800,8828500,-3361300,SELL
26-10-20 13:10,13:10,12222400,9148275,-3074125,SELL
26-10-20 13:11,13:11,12211850,8989100,-3222750,SELL
26-10-20 13:12,13:12,12326750,8974325,-3352425,SELL
26-10-20 13:13,13:13,12511100,9147650,-3363450,SELL
26-10-20 13:14,13:14,12180500,9028950,-3151550,SELL
26-10-20 13:15,13:15,12183325,8963700,-3219625,SELL
26-10-20 13:16,13:16,12281250,9065675,-3215575,SELL
26-10-20 13:17,13:17,12359025,9111950,-3247075,SELL
26-10-20 13:18,13:18,12351350,9027150,-3324200,SELL
26-10-20 13:19,13:19,12190350,9281750,-2908600,SELL
26-10-20 13:20,13:20,12179950,9243175,-2936775,SELL
26-10-20 13:21,13:21,12251500,9153475,-3098025,SELL
26-10-20 13:22,13:22,12378700,9180050,-3198650,SELL
26-10-20 13:23,13:23,12429250,9206575,-3222675,SELL
26-10-20 13:24,13:24,12371425,9232950,-3138475,SELL
26-10-20 13:25,13:25,12680600,9223650,-3456950,SELL
26-10-20 13:26,13:26,12442450,9192700,-3249750,SELL
26-10-20 13:27,13:27,11795675,9240000,-2555675,SELL
26-10-20 13:28,13:28,12152675,9251475,-2901200,SELL
26-10-20 13:29,13:29,12669200,9149925,-3519275,SELL
26-10-20 13:30,13:30,12592300,9185725,-3406575,SELL
26-10-20 13:31,13:31,12207275,9260550,-2946725,SELL
26-10-20 13:32,13:32,12732950,9123775,-3609175,SELL
26-10-20 13:33,13:33,12639700,9290550,-3349150,SELL
26-10-20 13:34,13:34,12703775,9208325,-3495450,SELL
26-10-20 13:35,13:35,12519950,9312900,-3207050,SELL
26-10-20 13:36,13:36,12508575,9219950,-3288625,SELL
26-10-20 13:37,13:37,12318850,9345825,-2973025,SELL
26-10-20 13:38,13:38,12554350,9105625,-3448725,SELL
26-10-20 13:39,13:39,12502975,9280800,-3222175,SELL
26-10-20 13:40,13:40,12576875,9325550,-3251325,SELL
26-10-20 13:41,13:41,12489475,9137400,-3352075,SELL
26-10-20 13:42,13:42,12567300,9184575,-3382725,SELL
26-10-20 13:43,13:43,12365300,9166825,-3198475,SELL
26-10-20 13:44,13:44,12574575,9114800,-3459775,SELL
26-10-20 13:45,13:45,12616850,9333700,-3283150,SELL
26-10-20 13:46,13:46,12770125,9410325,-3359800,SELL
26-10-20 13:47,13:47,12423575,9448850,-2974725,SELL
26-10-20 13:48,13:48,12688575,9371650,-3316925,SELL
26-10-20 13:49,13:49,12680125,9284500,-3395625,SELL
26-10-20 13:50,13:50,12750425,9249000,-3501425,SELL
26-10-20 13:51,13:51,12627800,9341525,-3286275,SELL
26-10-20 13:52,13:52,12975450,9502425,-3473025,SELL
26-10-20 13:53,13:53,12627800,9441950,-3185850,SELL
26-10-20 13:54,13:54,12620375,9396100,-3224275,SELL
26-10-20 13:55,13:55,12806950,9365850,-3441100,SELL
26-10-20 13:56,13:56,12814150,9340225,-3473925,SELL
26-10-20 13:57,13:57,12951000,9333825,-3617175,SELL
26-10-20 13:58,13:58,12949275,9413250,-3536025,SELL
26-10-20 13:59,13:59,12824050,9332800,-3491250,SELL
26-10-20 14:00,14:00,12904450,9312925,-3591525,SELL
26-10-20 14:01,14:01,12554850,9382975,-3171875,SELL
26-10-20 14:02,14:02,13156650,9481900,-3674750,SELL
26-10-20 14:03,14:03,13098925,9278050,-3820875,SELL
26-10-20 14:04,14:04,12824225,9253300,-3570925,SELL
26-10-20 14:05,14:05,12804125,9233775,-3570350,SELL
26-10-20 14:06,14:06,12990200,9229500,-3760700,SELL
26-10-20 14:07,14:07,12683425,9187150,-3496275,SELL
26-10-20 14:08,14:08,12855350,9056850,-3798500,SELL
26-10-20 14:09,14:09,12931575,9121400,-3810175,SELL
26-10-20 14:10,14:10,13209825,9277725,-3932100,SELL
26-10-20 14:11,14:11,12892600,9175775,-3716825,SELL
26-10-20 14:12,14:12,13177175,9145025,-4032150,SELL
26-10-20 14:13,14:13,13274800,9074650,-4200150,SELL
26-10-20 14:14,14:14,13131600,9137900,-3993700,SELL
26-10-20 14:15,14:15,13192200,9154350,-4037850,SELL
26-10-20 14:16,14:16,13311950,9430825,-3881125,SELL
26-10-20 14:17,14:17,12961875,9418125,-3543750,SELL
26-10-20 14:18,14:18,13209975,9317750,-3892225,SELL
26-10-20 14:19,14:19,13084400,9237325,-3847075,SELL
26-10-20 14:20,14:20,13065700,9170175,-3895525,SELL
26-10-20 14:21,14:21,13074525,9247125,-3827400,SELL
26-10-20 14:22,14:22,13235125,9262850,-3972275,SELL
26-10-20 14:23,14:23,12999750,9184875,-3814875,SELL
26-10-20 14:24,14:24,13123975,9315275,-3808700,SELL
26-10-20 14:25,14:25,12987625,9194525,-3793100,SELL
26-10-20 14:26,14:26,12757450,9353000,-3404450,SELL
26-10-20 14:27,14:27,13001275,9096875,-3904400,SELL
26-10-20 14:28,14:28,12956375,9082475,-3873900,SELL
26-10-20 14:29,14:29,12759100,9250750,-3508350,SELL
26-10-20 14:30,14:30,12997050,9121625,-3875425,SELL
26-10-20 14:31,14:31,13012725,9084925,-3927800,SELL
26-10-20 14:32,14:32,12984850,9064750,-3920100,SELL
26-10-20 14:33,14:33,13373500,9252950,-4120550,SELL
26-10-20 14:34,14:34,13163725,9327300,-3836425,SELL
26-10-20 14:35,14:35,13110250,9337900,-3772350,SELL
26-10-20 14:36,14:36,12973875,9339900,-3633975,SELL
26-10-20 14:37,14:37,13112825,9315475,-3797350,SELL
26-10-20 14:38,14:38,13319525,9274925,-4044600,SELL
26-10-20 14:39,14:39,12787100,9098325,-3688775,SELL
26-10-20 14:40,14:40,12981650,9287325,-3694325,SELL
26-10-20 14:41,14:41,12993125,9268275,-3724850,SELL
26-10-20 14:42,14:42,13153700,9356450,-3797250,SELL
26-10-20 14:43,14:43,13164600,9337375,-3827225,SELL
26-10-20 14:44,14:44,12781050,9349425,-3431625,SELL
26-10-20 14:45,14:45,13333950,9255700,-4078250,SELL
26-10-20 14:46,14:46,12995900,9163500,-3832400,SELL
26-10-20 14:47,14:47,13012250,9397050,-3615200,SELL
26-10-20 14:48,14:48,12838300,9136000,-3702300,SELL
26-10-20 14:49,14:49,12836975,9050475,-3786500,SELL
26-10-20 14:50,14:50,12850625,9218575,-3632050,SELL
26-10-20 14:51,14:51,12839200,9050875,-3788325,SELL
26-10-20 14:52,14:52,12897350,9223950,-3673400,SELL
26-10-20 14:53,14:53,12957725,9180150,-3777575,SELL
26-10-20 14:54,14:54,12902125,9200775,-3701350,SELL
26-10-20 14:55,14:55,12884375,9047375,-3837000,SELL
26-10-20 14:56,14:56,12875800,9053100,-3822700,SELL
26-10-20 14:57,14:57,12918675,9148325,-3770350,SELL
26-10-20 14:58,14:58,13035750,8727100,-4308650,SELL
26-10-20 14:59,14:59,13218775,8915475,-4303300,SELL
26-10-20 15:00,15:00,12892800,8919200,-3973600,SELL
26-10-20 15:01,15:01,12979675,9078600,-3901075,SELL
26-10-20 15:02,15:02,13003650,9126375,-3877275,SELL
26-10-20 15:03,15:03,12868425,8923950,-3944475,SELL
26-10-20 15:04,15:04,12862225,9035125,-3827100,SELL
26-10-20 15:05,15:05,12868425,8894475,-3973950,SELL
26-10-20 15:06,15:06,12929150,9022775,-3906375,SELL
26-10-20 15:07,15:07,12762650,9042450,-3720200,SELL
26-10-20 15:08,15:08,12807450,8933400,-3874050,SELL
26-10-20 15:09,15:09,12915150,8924575,-3990575,SELL
26-10-20 15:10,15:10,12833125,8965150,-3867975,SELL
26-10-20 15:11,15:11,13018125,8983100,-4035025,SELL
26-10-20 15:12,15:12,12819575,8921050,-3898525,SELL
26-10-20 15:13,15:13,13002275,8817500,-4184775,SELL
26-10-20 15:14,15:14,12514725,8777000,-3737725,SELL
26-10-20 15:15,15:15,12713775,8841725,-3872050,SELL
26-10-20 15:16,15:16,12821400,8860875,-3960525,SELL
26-10-20 15:17,15:17,12693275,8660050,-4033225,SELL
26-10-20 15:18,15:18,12686400,8662900,-4023500,SELL
26-10-20 15:19,15:19,12737100,8635625,-4101475,SELL
26-10-20 15:20,15:20,12699875,8778250,-3921625,SELL
26-10-20 15:21,15:21,12455125,8547925,-3907200,SELL
26-10-20 15:22,15:22,12126650,8469725,-3656925,SELL
26-10-20 15:23,15:23,12248625,8500900,-3747725,SELL
26-10-20 15:24,15:24,12013075,8307050,-3706025,SELL
26-10-20 15:25,15:25,11925350,8446350,-3479000,SELL
26-10-20 15:26,15:26,12023425,8396225,-3627200,SELL
26-10-20 15:27,15:27,12031000,8309825,-3721175,SELL
26-10-20 15:28,15:28,12128375,8201775,-3926600,SELL
26-10-20 15:29,15:29,12082425,8328575,-3753850,SELL
27-10-20 9:15,9:15,12048825,8130000,-3918825,SELL
27-10-20 9:16,9:16,11888950,8032775,-3856175,SELL
27-10-20 9:17,9:17,11642975,8091675,-3551300,SELL
27-10-20 9:18,9:18,11628550,8150850,-3477700,SELL
27-10-20 9:19,9:19,11768075,8035900,-3732175,SELL
27-10-20 9:20,9:20,11864675,8503975,-3360700,SELL
27-10-20 9:21,9:21,11943650,8243900,-3699750,SELL
27-10-20 9:22,9:22,11824875,8585150,-3239725,SELL
27-10-20 9:23,9:23,12223075,9039600,-3183475,SELL
27-10-20 9:24,9:24,12263100,9091900,-3171200,SELL
27-10-20 9:25,9:25,12222575,9074600,-3147975,SELL
27-10-20 9:26,9:26,12239125,9350375,-2888750,SELL
27-10-20 9:27,9:27,12137650,9345350,-2792300,SELL
27-10-20 9:28,9:28,12505625,9320875,-3184750,SELL
27-10-20 9:29,9:29,12280550,9521250,-2759300,SELL
27-10-20 9:30,9:30,12391625,9563425,-2828200,SELL
27-10-20 9:31,9:31,12101625,9530900,-2570725,SELL
27-10-20 9:32,9:32,12405150,9839550,-2565600,SELL
27-10-20 9:33,9:33,12450025,9858850,-2591175,SELL
27-10-20 9:34,9:34,12272250,9904725,-2367525,SELL
27-10-20 9:35,9:35,12583325,10067400,-2515925,SELL
27-10-20 9:36,9:36,12410750,10077350,-2333400,SELL
27-10-20 9:37,9:37,12721475,10065375,-2656100,SELL
27-10-20 9:38,9:38,12692000,10141325,-2550675,SELL
27-10-20 9:39,9:39,12650800,10147125,-2503675,SELL
27-10-20 9:40,9:40,12789300,10134575,-2654725,SELL
27-10-20 9:41,9:41,12360500,10149850,-2210650,SELL
27-10-20 9:42,9:42,12723825,10144025,-2579800,SELL
27-10-20 9:43,9:43,12517475,10178900,-2338575,SELL
27-10-20 9:44,9:44,12631475,10268625,-2362850,SELL
27-10-20 9:45,9:45,12702100,10331300,-2370800,SELL
27-10-20 9:46,9:46,12575600,10173400,-2402200,SELL
27-10-20 9:47,9:47,12069750,10301500,-1768250,SELL
27-10-20 9:48,9:48,12083550,10261250,-1822300,SELL
27-10-20 9:49,9:49,12141250,10330075,-1811175,SELL
27-10-20 9:50,9:50,11931175,10320750,-1610425,SELL
27-10-20 9:51,9:51,11769975,10412075,-1357900,SELL
27-10-20 9:52,9:52,12040350,10419750,-1620600,SELL
27-10-20 9:53,9:53,11784775,10480300,-1304475,SELL
27-10-20 9:54,9:54,12071925,10584900,-1487025,SELL
27-10-20 9:55,9:55,11606575,10429025,-1177550,SELL
27-10-20 9:56,9:56,12278850,10549475,-1729375,SELL
27-10-20 9:57,9:57,12181075,10660175,-1520900,SELL
27-10-20 9:58,9:58,12197250,10621875,-1575375,SELL
27-10-20 9:59,9:59,11716950,10621100,-1095850,SELL
27-10-20 10:00,10:00,11835175,10560500,-1274675,SELL
27-10-20 10:01,10:01,12031350,10449775,-1581575,SELL
27-10-20 10:02,10:02,11942400,10796325,-1146075,SELL
27-10-20 10:03,10:03,11954525,10518475,-1436050,SELL
27-10-20 10:04,10:04,11960875,10758500,-1202375,SELL
27-10-20 10:05,10:05,11836975,10735550,-1101425,SELL
27-10-20 10:06,10:06,11783000,10892825,-890175,SELL
27-10-20 10:07,10:07,11751200,10835600,-915600,SELL
27-10-20 10:08,10:08,12236175,10777650,-1458525,SELL
27-10-20 10:09,10:09,12015550,10978250,-1037300,SELL
27-10-20 10:10,10:10,11818225,10933150,-885075,SELL
27-10-20 10:11,10:11,11795350,11081825,-713525,SELL
27-10-20 10:12,10:12,11836700,10899250,-937450,SELL
27-10-20 10:13,10:13,11799125,10920675,-878450,SELL
27-10-20 10:14,10:14,12308850,11016100,-1292750,SELL
27-10-20 10:15,10:15,12222000,11203300,-1018700,SELL
27-10-20 10:16,10:16,11983500,11214650,-768850,SELL
27-10-20 10:17,10:17,12244600,11098350,-1146250,SELL
27-10-20 10:18,10:18,12204500,11292700,-911800,SELL
27-10-20 10:19,10:19,12117100,11135525,-981575,SELL
27-10-20 10:20,10:20,12035375,11196450,-838925,SELL
27-10-20 10:21,10:21,12151125,11055525,-1095600,SELL
27-10-20 10:22,10:22,11818750,10822650,-996100,SELL
27-10-20 10:23,10:23,11945825,11268150,-677675,SELL
27-10-20 10:24,10:24,12025550,11244750,-780800,SELL
27-10-20 10:25,10:25,12002150,11102575,-899575,SELL
27-10-20 10:26,10:26,11811750,11167275,-644475,SELL
27-10-20 10:27,10:27,11835150,11128125,-707025,SELL
27-10-20 10:28,10:28,12226775,11131725,-1095050,SELL
27-10-20 10:29,10:29,12253125,11430650,-822475,SELL
27-10-20 10:30,10:30,11959125,11460525,-498600,SELL
27-10-20 10:31,10:31,11952825,11188800,-764025,SELL
27-10-20 10:32,10:32,12007075,11359450,-647625,SELL
27-10-20 10:33,10:33,12164250,11032650,-1131600,SELL
27-10-20 10:34,10:34,11820275,11296000,-524275,SELL
27-10-20 10:35,10:35,12328850,11178850,-1150000,SELL
27-10-20 10:36,10:36,12046500,11446775,-599725,SELL
27-10-20 10:37,10:37,12117475,11316850,-800625,SELL
27-10-20 10:38,10:38,12004425,11258475,-745950,SELL
27-10-20 10:39,10:39,12082250,11308875,-773375,SELL
27-10-20 10:40,10:40,12073975,11013475,-1060500,SELL
27-10-20 10:41,10:41,11973825,11422300,-551525,SELL
27-10-20 10:42,10:42,12024750,11251925,-772825,SELL
27-10-20 10:43,10:43,12197350,11479475,-717875,SELL
27-10-20 10:44,10:44,11796875,11541300,-255575,SELL
27-10-20 10:45,10:45,12001225,11699575,-301650,SELL
27-10-20 10:46,10:46,11973725,11431975,-541750,SELL
27-10-20 10:47,10:47,11798825,11637025,-161800,SELL
27-10-20 10:48,10:48,12420750,11822775,-597975,SELL
27-10-20 10:49,10:49,11975375,11782875,-192500,SELL
27-10-20 10:50,10:50,11770675,11731075,-39600,SELL
27-10-20 10:51,10:51,11697200,11641225,-55975,SELL
27-10-20 10:52,10:52,11703700,11115800,-587900,SELL
27-10-20 10:53,10:53,11527575,11517900,-9675,SELL
27-10-20 10:54,10:54,11737625,11427500,-310125,SELL
27-10-20 10:55,10:55,11738350,11776875,38525,BUY
27-10-20 10:56,10:56,11747225,11461750,-285475,SELL
27-10-20 10:57,10:57,11685550,10819425,-866125,SELL
27-10-20 10:58,10:58,11692925,11670250,-22675,SELL
27-10-20 10:59,10:59,11741200,11574275,-166925,SELL
27-10-20 11:00,11:00,11940475,11488050,-452425,SELL
27-10-20 11:01,11:01,11944450,11839425,-105025,SELL
27-10-20 11:02,11:02,11749700,11473175,-276525,SELL
27-10-20 11:03,11:03,11909600,11785750,-123850,SELL
27-10-20 11:04,11:04,11734600,11753300,18700,BUY
27-10-20 11:05,11:05,11794525,11657050,-137475,SELL
27-10-20 11:06,11:06,11831750,11878550,46800,BUY
27-10-20 11:07,11:07,11950300,11695650,-254650,SELL
27-10-20 11:08,11:08,11488325,11909400,421075,BUY
27-10-20 11:09,11:09,12073975,11455675,-618300,SELL
27-10-20 11:10,11:10,11928475,11825550,-102925,SELL
27-10-20 11:11,11:11,11794375,11738950,-55425,SELL
27-10-20 11:12,11:12,11911350,11178375,-732975,SELL
27-10-20 11:13,11:13,11718450,11547975,-170475,SELL
27-10-20 11:14,11:14,11523150,11777325,254175,BUY
27-10-20 11:15,11:15,11840250,11623975,-216275,SELL
27-10-20 11:16,11:16,12051450,11711700,-339750,SELL
27-10-20 11:17,11:17,11734750,11799575,64825,BUY
27-10-20 11:18,11:18,11962350,11632600,-329750,SELL
27-10-20 11:19,11:19,11577100,11173350,-403750,SELL
27-10-20 11:20,11:20,11726950,11709025,-17925,SELL
27-10-20 11:21,11:21,12064850,11858625,-206225,SELL
27-10-20 11:22,11:22,11605925,11903675,297750,BUY
27-10-20 11:23,11:23,11497650,11215625,-282025,SELL
27-10-20 11:24,11:24,11928500,11628150,-300350,SELL
27-10-20 11:25,11:25,11523350,11853600,330250,BUY
27-10-20 11:26,11:26,11543250,11870125,326875,BUY
27-10-20 11:27,11:27,12060175,11891975,-168200,SELL
27-10-20 11:28,11:28,11781450,11804900,23450,BUY
27-10-20 11:29,11:29,11688125,11731750,43625,BUY
27-10-20 11:30,11:30,11684450,11643575,-40875,SELL
27-10-20 11:31,11:31,11687600,11838650,151050,BUY
27-10-20 11:32,11:32,11685975,11623775,-62200,SELL
27-10-20 11:33,11:33,11564650,11799200,234550,BUY
27-10-20 11:34,11:34,11500750,11782975,282225,BUY
27-10-20 11:35,11:35,11480800,11767375,286575,BUY
27-10-20 11:36,11:36,11647225,11347400,-299825,SELL
27-10-20 11:37,11:37,11459175,11651150,191975,BUY
27-10-20 11:38,11:38,11590625,11718300,127675,BUY
27-10-20 11:39,11:39,11783100,11930625,147525,BUY
27-10-20 11:40,11:40,12002625,11978950,-23675,SELL
27-10-20 11:41,11:41,11678475,11705700,27225,BUY
27-10-20 11:42,11:42,11655375,11609675,-45700,SELL
27-10-20 11:43,11:43,11634575,11876800,242225,BUY
27-10-20 11:44,11:44,11359700,11698525,338825,BUY
27-10-20 11:45,11:45,12048000,11820025,-227975,SELL
27-10-20 11:46,11:46,11575050,11856550,281500,BUY
27-10-20 11:47,11:47,11509650,11853425,343775,BUY
27-10-20 11:48,11:48,11194350,11682000,487650,BUY
27-10-20 11:49,11:49,11188675,11720575,531900,BUY
27-10-20 11:50,11:50,11148325,12013050,864725,BUY
27-10-20 11:51,11:51,11286575,11791000,504425,BUY
27-10-20 11:52,11:52,11319775,11771450,451675,BUY
27-10-20 11:53,11:53,11682700,11976150,293450,BUY
27-10-20 11:54,11:54,11548100,12212450,664350,BUY
27-10-20 11:55,11:55,11362200,12009575,647375,BUY
27-10-20 11:56,11:56,11269975,12226400,956425,BUY
27-10-20 11:57,11:57,11343300,12126600,783300,BUY
27-10-20 11:58,11:58,11021300,11993975,972675,BUY
27-10-20 11:59,11:59,11288425,12261750,973325,BUY
27-10-20 12:00,12:00,11495550,12235375,739825,BUY
27-10-20 12:01,12:01,11328475,12235525,907050,BUY
27-10-20 12:02,12:02,11348150,12100400,752250,BUY
27-10-20 12:03,12:03,11304550,12177600,873050,BUY
27-10-20 12:04,12:04,11428500,12045550,617050,BUY
27-10-20 12:05,12:05,11167925,11957175,789250,BUY
27-10-20 12:06,12:06,11538375,12131925,593550,BUY
27-10-20 12:07,12:07,11205400,12078450,873050,BUY
27-10-20 12:08,12:08,11349175,12176700,827525,BUY
27-10-20 12:09,12:09,11154400,12247425,1093025,BUY
27-10-20 12:10,12:10,11171375,12130050,958675,BUY
27-10-20 12:11,12:11,10971950,11944850,972900,BUY
27-10-20 12:12,12:12,10796100,11979750,1183650,BUY
27-10-20 12:13,12:13,10955325,12142500,1187175,BUY
27-10-20 12:14,12:14,10977875,12149950,1172075,BUY
27-10-20 12:15,12:15,11183550,12198575,1015025,BUY
27-10-20 12:16,12:16,10999850,11861675,861825,BUY
27-10-20 12:17,12:17,10828950,11914675,1085725,BUY
27-10-20 12:18,12:18,10764450,12188175,1423725,BUY
27-10-20 12:19,12:19,10661325,12184200,1522875,BUY
27-10-20 12:20,12:20,10952200,11984225,1032025,BUY
27-10-20 12:21,12:21,11016425,11901275,884850,BUY
27-10-20 12:22,12:22,10957575,12098525,1140950,BUY
27-10-20 12:23,12:23,10839025,12014950,1175925,BUY
27-10-20 12:24,12:24,10943825,12135700,1191875,BUY
27-10-20 12:25,12:25,10948875,12084425,1135550,BUY
27-10-20 12:26,12:26,10873850,12237425,1363575,BUY
27-10-20 12:27,12:27,10929300,11990775,1061475,BUY
27-10-20 12:28,12:28,11077900,12071075,993175,BUY
27-10-20 12:29,12:29,10930025,11982425,1052400,BUY
27-10-20 12:30,12:30,10957275,12371625,1414350,BUY
27-10-20 12:31,12:31,10946075,12232600,1286525,BUY
27-10-20 12:32,12:32,10992100,12125675,1133575,BUY
27-10-20 12:33,12:33,11055525,12278200,1222675,BUY
27-10-20 12:34,12:34,10881125,12294250,1413125,BUY
27-10-20 12:35,12:35,10807325,12181700,1374375,BUY
27-10-20 12:36,12:36,10998525,11990075,991550,BUY
27-10-20 12:37,12:37,10833300,12273875,1440575,BUY
27-10-20 12:38,12:38,11109400,12393850,1284450,BUY
27-10-20 12:39,12:39,11371300,12074875,703575,BUY
27-10-20 12:40,12:40,11210075,12223400,1013325,BUY
27-10-20 12:41,12:41,11199050,12405900,1206850,BUY
27-10-20 12:42,12:42,11237975,12386500,1148525,BUY
27-10-20 12:43,12:43,10875150,12343175,1468025,BUY
27-10-20 12:44,12:44,11130400,12247375,1116975,BUY
27-10-20 12:45,12:45,10914725,12530800,1616075,BUY
27-10-20 12:46,12:46,11046050,12195750,1149700,BUY
27-10-20 12:47,12:47,11308650,12539275,1230625,BUY
27-10-20 12:48,12:48,10945950,12462675,1516725,BUY
27-10-20 12:49,12:49,11113725,12493925,1380200,BUY
27-10-20 12:50,12:50,10797875,12354900,1557025,BUY
27-10-20 12:51,12:51,11065725,12562675,1496950,BUY
27-10-20 12:52,12:52,11139400,12093575,954175,BUY
27-10-20 12:53,12:53,10963850,11980700,1016850,BUY
27-10-20 12:54,12:54,11198300,12358525,1160225,BUY
27-10-20 12:55,12:55,10989025,12645025,1656000,BUY
27-10-20 12:56,12:56,10379475,12441825,2062350,BUY
27-10-20 12:57,12:57,11336050,12643700,1307650,BUY
27-10-20 12:58,12:58,10959325,12443475,1484150,BUY
27-10-20 12:59,12:59,11180650,12105100,924450,BUY
27-10-20 13:00,13:00,11278925,12406500,1127575,BUY
27-10-20 13:01,13:01,11728675,12673750,945075,BUY
27-10-20 13:02,13:02,11188550,12667750,1479200,BUY
27-10-20 13:03,13:03,11168575,12568225,1399650,BUY
27-10-20 13:04,13:04,11344700,12234575,889875,BUY
27-10-20 13:05,13:05,11041250,12527625,1486375,BUY
27-10-20 13:06,13:06,11194350,12313175,1118825,BUY
27-10-20 13:07,13:07,11183000,12743350,1560350,BUY
27-10-20 13:08,13:08,11274925,12690550,1415625,BUY
27-10-20 13:09,13:09,11334475,12826350,1491875,BUY
27-10-20 13:10,13:10,11539200,12792050,1252850,BUY
27-10-20 13:11,13:11,11068125,12793675,1725550,BUY
27-10-20 13:12,13:12,10718350,12792850,2074500,BUY
27-10-20 13:13,13:13,10531700,12791375,2259675,BUY
27-10-20 13:14,13:14,10703375,12763100,2059725,BUY
27-10-20 13:15,13:15,10958750,12672275,1713525,BUY
27-10-20 13:16,13:16,10771625,12317450,1545825,BUY
27-10-20 13:17,13:17,11062375,12799150,1736775,BUY
27-10-20 13:18,13:18,10882450,12227975,1345525,BUY
27-10-20 13:19,13:19,10700825,12898150,2197325,BUY
27-10-20 13:20,13:20,10878500,12714825,1836325,BUY
27-10-20 13:21,13:21,10558825,12326100,1767275,BUY
27-10-20 13:22,13:22,10555975,12491800,1935825,BUY
27-10-20 13:23,13:23,10570125,12781875,2211750,BUY
27-10-20 13:24,13:24,10481100,13096975,2615875,BUY
27-10-20 13:25,13:25,10602150,12859475,2257325,BUY
27-10-20 13:26,13:26,10850700,12397950,1547250,BUY
27-10-20 13:27,13:27,10627650,12752700,2125050,BUY
27-10-20 13:28,13:28,10810375,13291175,2480800,BUY
27-10-20 13:29,13:29,10571975,13133700,2561725,BUY
27-10-20 13:30,13:30,10449050,13273225,2824175,BUY
27-10-20 13:31,13:31,10815100,13031150,2216050,BUY
27-10-20 13:32,13:32,10438150,13022600,2584450,BUY
27-10-20 13:33,13:33,10736175,13048500,2312325,BUY
27-10-20 13:34,13:34,10792550,13148975,2356425,BUY
27-10-20 13:35,13:35,10749975,13191700,2441725,BUY
27-10-20 13:36,13:36,10703700,12837900,2134200,BUY
27-10-20 13:37,13:37,10943725,13101775,2158050,BUY
27-10-20 13:38,13:38,10857475,13171250,2313775,BUY
27-10-20 13:39,13:39,10472750,12948875,2476125,BUY
27-10-20 13:40,13:40,10477225,13323650,2846425,BUY
27-10-20 13:41,13:41,10908225,13148625,2240400,BUY
27-10-20 13:42,13:42,10716325,13036725,2320400,BUY
27-10-20 13:43,13:43,10702800,13153350,2450550,BUY
27-10-20 13:44,13:44,10889225,13253225,2364000,BUY
27-10-20 13:45,13:45,10766650,13111500,2344850,BUY
27-10-20 13:46,13:46,10659050,12905675,2246625,BUY
27-10-20 13:47,13:47,10738900,13266775,2527875,BUY
27-10-20 13:48,13:48,10650475,12921450,2270975,BUY
27-10-20 13:49,13:49,10805075,12953075,2148000,BUY
27-10-20 13:50,13:50,10717725,13214375,2496650,BUY
27-10-20 13:51,13:51,10526750,13274150,2747400,BUY
27-10-20 13:52,13:52,10645950,12832650,2186700,BUY
27-10-20 13:53,13:53,10528450,12866300,2337850,BUY
27-10-20 13:54,13:54,10524600,13059100,2534500,BUY
27-10-20 13:55,13:55,10702425,13116650,2414225,BUY
27-10-20 13:56,13:56,11024050,13053100,2029050,BUY
27-10-20 13:57,13:57,11047725,12956950,1909225,BUY
27-10-20 13:58,13:58,10838400,12993725,2155325,BUY
27-10-20 13:59,13:59,10686650,12965200,2278550,BUY
27-10-20 14:00,14:00,10546975,13210825,2663850,BUY
27-10-20 14:01,14:01,10549950,12425225,1875275,BUY
27-10-20 14:02,14:02,10666875,13198425,2531550,BUY
27-10-20 14:03,14:03,11032400,12733700,1701300,BUY
27-10-20 14:04,14:04,10428250,12951275,2523025,BUY
27-10-20 14:05,14:05,10738900,13239525,2500625,BUY
27-10-20 14:06,14:06,10482250,12377350,1895100,BUY
27-10-20 14:07,14:07,10647800,12782750,2134950,BUY
27-10-20 14:08,14:08,10664825,13324525,2659700,BUY
27-10-20 14:09,14:09,10362025,13310375,2948350,BUY
27-10-20 14:10,14:10,10300850,13316450,3015600,BUY
27-10-20 14:11,14:11,10592075,13261050,2668975,BUY
27-10-20 14:12,14:12,10296800,13201550,2904750,BUY
27-10-20 14:13,14:13,10665250,13402150,2736900,BUY
27-10-20 14:14,14:14,10402625,13351375,2948750,BUY
27-10-20 14:15,14:15,10593225,13338775,2745550,BUY
27-10-20 14:16,14:16,10465075,13424150,2959075,BUY
27-10-20 14:17,14:17,10764575,13582850,2818275,BUY
27-10-20 14:18,14:18,10881800,13450875,2569075,BUY
27-10-20 14:19,14:19,11031375,13635750,2604375,BUY
27-10-20 14:20,14:20,10626975,13557425,2930450,BUY
27-10-20 14:21,14:21,10522500,13537800,3015300,BUY
27-10-20 14:22,14:22,10520875,13549775,3028900,BUY
27-10-20 14:23,14:23,10697575,13580075,2882500,BUY
27-10-20 14:24,14:24,10487825,13439025,2951200,BUY
27-10-20 14:25,14:25,10304950,13539450,3234500,BUY
27-10-20 14:26,14:26,10652575,13471400,2818825,BUY
27-10-20 14:27,14:27,10663075,13396200,2733125,BUY
27-10-20 14:28,14:28,10414800,13494000,3079200,BUY
27-10-20 14:29,14:29,10723975,13175050,2451075,BUY
27-10-20 14:30,14:30,10650025,13494600,2844575,BUY
27-10-20 14:31,14:31,10486925,13632300,3145375,BUY
27-10-20 14:32,14:32,10720175,13653900,2933725,BUY
27-10-20 14:33,14:33,10409525,13584100,3174575,BUY
27-10-20 14:34,14:34,10409475,13623075,3213600,BUY
27-10-20 14:35,14:35,10406900,13623675,3216775,BUY
27-10-20 14:36,14:36,10083225,13614200,3530975,BUY
27-10-20 14:37,14:37,10142400,13623625,3481225,BUY
27-10-20 14:38,14:38,10323150,13391825,3068675,BUY
27-10-20 14:39,14:39,10134125,13395200,3261075,BUY
27-10-20 14:40,14:40,10157500,13643500,3486000,BUY
27-10-20 14:41,14:41,9984150,13581750,3597600,BUY
27-10-20 14:42,14:42,10129650,13508200,3378550,BUY
27-10-20 14:43,14:43,10281150,13507675,3226525,BUY
27-10-20 14:44,14:44,10258000,13649600,3391600,BUY
27-10-20 14:45,14:45,10224700,13573575,3348875,BUY
27-10-20 14:46,14:46,9938600,13503200,3564600,BUY
27-10-20 14:47,14:47,10336100,13468200,3132100,BUY
27-10-20 14:48,14:48,10075600,13563025,3487425,BUY
27-10-20 14:49,14:49,10199625,13596925,3397300,BUY
27-10-20 14:50,14:50,9898675,13591650,3692975,BUY
27-10-20 14:51,14:51,10222375,13566650,3344275,BUY
27-10-20 14:52,14:52,10094000,13444300,3350300,BUY
27-10-20 14:53,14:53,10017400,13514500,3497100,BUY
27-10-20 14:54,14:54,10029550,13471250,3441700,BUY
27-10-20 14:55,14:55,10464425,13555725,3091300,BUY
27-10-20 14:56,14:56,10214375,13600750,3386375,BUY
27-10-20 14:57,14:57,10079175,13442150,3362975,BUY
27-10-20 14:58,14:58,9843625,13284275,3440650,BUY
27-10-20 14:59,14:59,9890825,13443275,3552450,BUY
27-10-20 15:00,15:00,9866850,13306500,3439650,BUY
27-10-20 15:01,15:01,9682325,13301100,3618775,BUY
27-10-20 15:02,15:02,9796025,13286175,3490150,BUY
27-10-20 15:03,15:03,9888800,13257900,3369100,BUY
27-10-20 15:04,15:04,9866300,13234425,3368125,BUY
27-10-20 15:05,15:05,10038425,13322175,3283750,BUY
27-10-20 15:06,15:06,9944700,13190925,3246225,BUY
27-10-20 15:07,15:07,9790275,13186650,3396375,BUY
27-10-20 15:08,15:08,10036900,13244975,3208075,BUY
27-10-20 15:09,15:09,9907750,12987200,3079450,BUY
27-10-20 15:10,15:10,9869625,13172500,3302875,BUY
27-10-20 15:11,15:11,9857050,13222325,3365275,BUY
27-10-20 15:12,15:12,9775225,13148100,3372875,BUY
27-10-20 15:13,15:13,10004950,13086100,3081150,BUY
27-10-20 15:14,15:14,9814125,13073200,3259075,BUY
27-10-20 15:15,15:15,9909975,12913200,3003225,BUY
27-10-20 15:16,15:16,9784325,12929700,3145375,BUY
27-10-20 15:17,15:17,9786525,12936225,3149700,BUY
27-10-20 15:18,15:18,9885825,12661150,2775325,BUY
27-10-20 15:19,15:19,9532875,12733875,3201000,BUY
27-10-20 15:20,15:20,9855350,12781500,2926150,BUY
27-10-20 15:21,15:21,9725450,12605975,2880525,BUY
27-10-20 15:22,15:22,9530625,12551375,3020750,BUY
27-10-20 15:23,15:23,9738800,12459500,2720700,BUY
27-10-20 15:24,15:24,9679225,12477400,2798175,BUY
27-10-20 15:25,15:25,9735325,12503975,2768650,BUY
27-10-20 15:26,15:26,9636100,12211050,2574950,BUY
27-10-20 15:27,15:27,9632775,12353575,2720800,BUY
27-10-20 15:28,15:28,9225625,12295775,3070150,BUY
27-10-20 15:29,15:29,9414025,12361325,2947300,BUY
28-10-20 9:15,9:15,9119825,11908600,2788775,BUY
28-10-20 9:16,9:16,9200600,11865500,2664900,BUY
28-10-20 9:17,9:17,9089850,12028375,2938525,BUY
28-10-20 9:18,9:18,9171400,12169300,2997900,BUY
28-10-20 9:19,9:19,9266900,12041675,2774775,BUY
28-10-20 9:20,9:20,9541300,12518100,2976800,BUY
28-10-20 9:21,9:21,9703800,12468975,2765175,BUY
28-10-20 9:22,9:22,9511275,12415225,2903950,BUY
28-10-20 9:23,9:23,10357900,12777600,2419700,BUY
28-10-20 9:24,9:24,10164175,12754200,2590025,BUY
28-10-20 9:25,9:25,10358700,12829600,2470900,BUY
28-10-20 9:26,9:26,10915525,12842125,1926600,BUY
28-10-20 9:27,9:27,10600325,12571550,1971225,BUY
28-10-20 9:28,9:28,10999625,12879625,1880000,BUY
28-10-20 9:29,9:29,10548050,13059200,2511150,BUY
28-10-20 9:30,9:30,10986300,13058350,2072050,BUY
28-10-20 9:31,9:31,11146625,13009150,1862525,BUY
28-10-20 9:32,9:32,11154700,12930875,1776175,BUY
28-10-20 9:33,9:33,11006300,12977175,1970875,BUY
28-10-20 9:34,9:34,10973575,12939775,1966200,BUY
28-10-20 9:35,9:35,11202300,13106750,1904450,BUY
28-10-20 9:36,9:36,11009100,13166600,2157500,BUY
28-10-20 9:37,9:37,11001775,13116550,2114775,BUY
28-10-20 9:38,9:38,11068850,13104900,2036050,BUY
28-10-20 9:39,9:39,11246800,13044950,1798150,BUY
28-10-20 9:40,9:40,11027975,13194300,2166325,BUY
28-10-20 9:41,9:41,10545575,13100150,2554575,BUY
28-10-20 9:42,9:42,11411800,12961350,1549550,BUY
28-10-20 9:43,9:43,11407975,12852275,1444300,BUY
28-10-20 9:44,9:44,10908950,12944950,2036000,BUY
28-10-20 9:45,9:45,10998300,12535425,1537125,BUY
28-10-20 9:46,9:46,11052175,12884325,1832150,BUY
28-10-20 9:47,9:47,11259075,12743450,1484375,BUY
28-10-20 9:48,9:48,11129650,13161875,2032225,BUY
28-10-20 9:49,9:49,11053700,13013750,1960050,BUY
28-10-20 9:50,9:50,11455375,12912325,1456950,BUY
28-10-20 9:51,9:51,11219650,12774550,1554900,BUY
28-10-20 9:52,9:52,11605000,12952200,1347200,BUY
28-10-20 9:53,9:53,11324600,13125950,1801350,BUY
28-10-20 9:54,9:54,11332575,12504150,1171575,BUY
28-10-20 9:55,9:55,11671425,13003400,1331975,BUY
28-10-20 9:56,9:56,12009675,13263325,1253650,BUY
28-10-20 9:57,9:57,11863725,13204200,1340475,BUY
28-10-20 9:58,9:58,11727925,12651825,923900,BUY
28-10-20 9:59,9:59,11510375,12944400,1434025,BUY
28-10-20 10:00,10:00,12118200,13162375,1044175,BUY
28-10-20 10:01,10:01,11963825,13154575,1190750,BUY
28-10-20 10:02,10:02,11837775,12940700,1102925,BUY
28-10-20 10:03,10:03,11929300,12971200,1041900,BUY
28-10-20 10:04,10:04,12005550,13063050,1057500,BUY
28-10-20 10:05,10:05,12055650,12846000,790350,BUY
28-10-20 10:06,10:06,12101275,12947800,846525,BUY
28-10-20 10:07,10:07,12144900,12629375,484475,BUY
28-10-20 10:08,10:08,12173875,12694825,520950,BUY
28-10-20 10:09,10:09,12202900,12484075,281175,BUY
28-10-20 10:10,10:10,12392175,12636775,244600,BUY
28-10-20 10:11,10:11,12025775,12273525,247750,BUY
28-10-20 10:12,10:12,12696500,12948275,251775,BUY
28-10-20 10:13,10:13,12543325,12661875,118550,BUY
28-10-20 10:14,10:14,12392300,12827300,435000,BUY
28-10-20 10:15,10:15,12686725,12841375,154650,BUY
28-10-20 10:16,10:16,12392300,12769675,377375,BUY
28-10-20 10:17,10:17,12529700,12682250,152550,BUY
28-10-20 10:18,10:18,12586475,12576025,-10450,SELL
28-10-20 10:19,10:19,12478500,12633650,155150,BUY
28-10-20 10:20,10:20,12749650,12496025,-253625,SELL
28-10-20 10:21,10:21,12818450,12655975,-162475,SELL
28-10-20 10:22,10:22,12801425,12703300,-98125,SELL
28-10-20 10:23,10:23,12442175,12472125,29950,BUY
28-10-20 10:24,10:24,12699350,12615900,-83450,SELL
28-10-20 10:25,10:25,12498325,12216200,-282125,SELL
28-10-20 10:26,10:26,12665375,12620525,-44850,SELL
28-10-20 10:27,10:27,13011250,12852325,-158925,SELL
28-10-20 10:28,10:28,12403775,12698175,294400,BUY
28-10-20 10:29,10:29,12545325,12524275,-21050,SELL
28-10-20 10:30,10:30,12801050,12283100,-517950,SELL
28-10-20 10:31,10:31,12886225,12917900,31675,BUY
28-10-20 10:32,10:32,12699700,12908975,209275,BUY
28-10-20 10:33,10:33,12853400,12918050,64650,BUY
28-10-20 10:34,10:34,12644325,12391050,-253275,SELL
28-10-20 10:35,10:35,12820400,12545400,-275000,SELL
28-10-20 10:36,10:36,13308250,12612875,-695375,SELL
28-10-20 10:37,10:37,12836225,12818025,-18200,SELL
28-10-20 10:38,10:38,12958550,12397875,-560675,SELL
28-10-20 10:39,10:39,13048025,12605775,-442250,SELL
28-10-20 10:40,10:40,12832100,12682025,-150075,SELL
28-10-20 10:41,10:41,13000800,12439000,-561800,SELL
28-10-20 10:42,10:42,13114800,12386450,-728350,SELL
28-10-20 10:43,10:43,13063400,12654100,-409300,SELL
28-10-20 10:44,10:44,13135600,12879350,-256250,SELL
28-10-20 10:45,10:45,13523500,13077650,-445850,SELL
28-10-20 10:46,10:46,13262975,12933700,-329275,SELL
28-10-20 10:47,10:47,13185700,12735375,-450325,SELL
28-10-20 10:48,10:48,13348675,12529675,-819000,SELL
28-10-20 10:49,10:49,13134950,12498875,-636075,SELL
28-10-20 10:50,10:50,13169250,12249450,-919800,SELL
28-10-20 10:51,10:51,13351025,12307850,-1043175,SELL
28-10-20 10:52,10:52,13304550,12705800,-598750,SELL
28-10-20 10:53,10:53,13055400,12427575,-627825,SELL
28-10-20 10:54,10:54,13324575,12320575,-1004000,SELL
28-10-20 10:55,10:55,13541175,12954750,-586425,SELL
28-10-20 10:56,10:56,13170725,12699250,-471475,SELL
28-10-20 10:57,10:57,13149150,12874150,-275000,SELL
28-10-20 10:58,10:58,13301200,12862025,-439175,SELL
28-10-20 10:59,10:59,13476550,12899325,-577225,SELL
28-10-20 11:00,11:00,13378025,12670050,-707975,SELL
28-10-20 11:01,11:01,13394350,12792125,-602225,SELL
28-10-20 11:02,11:02,13271650,12778775,-492875,SELL
28-10-20 11:03,11:03,13721450,12759150,-962300,SELL
28-10-20 11:04,11:04,13159675,12933975,-225700,SELL
28-10-20 11:05,11:05,12981350,12837250,-144100,SELL
28-10-20 11:06,11:06,13293375,12881375,-412000,SELL
28-10-20 11:07,11:07,13284225,12993400,-290825,SELL
28-10-20 11:08,11:08,13274825,12917875,-356950,SELL
28-10-20 11:09,11:09,13556650,12661125,-895525,SELL
28-10-20 11:10,11:10,13183475,12765650,-417825,SELL
28-10-20 11:11,11:11,13075100,12671875,-403225,SELL
28-10-20 11:12,11:12,13042400,12721900,-320500,SELL
28-10-20 11:13,11:13,13646225,12777800,-868425,SELL
28-10-20 11:14,11:14,13643900,12724975,-918925,SELL
28-10-20 11:15,11:15,13325850,12906925,-418925,SELL
28-10-20 11:16,11:16,13701600,12914825,-786775,SELL
28-10-20 11:17,11:17,13704925,12737350,-967575,SELL
28-10-20 11:18,11:18,13943750,12951000,-992750,SELL
28-10-20 11:19,11:19,13842550,12891750,-950800,SELL
28-10-20 11:20,11:20,13739650,12821275,-918375,SELL
28-10-20 11:21,11:21,13555825,12408650,-1147175,SELL
28-10-20 11:22,11:22,13625725,13000225,-625500,SELL
28-10-20 11:23,11:23,13594775,12658075,-936700,SELL
28-10-20 11:24,11:24,13790200,12959050,-831150,SELL
28-10-20 11:25,11:25,13601125,13073075,-528050,SELL
28-10-20 11:26,11:26,13705625,12823325,-882300,SELL
28-10-20 11:27,11:27,13634700,12344475,-1290225,SELL
28-10-20 11:28,11:28,13497700,12579100,-918600,SELL
28-10-20 11:29,11:29,13935825,12857425,-1078400,SELL
28-10-20 11:30,11:30,13994200,13145150,-849050,SELL
28-10-20 11:31,11:31,13903200,12687025,-1216175,SELL
28-10-20 11:32,11:32,13455625,12550300,-905325,SELL
28-10-20 11:33,11:33,13851775,12826425,-1025350,SELL
28-10-20 11:34,11:34,13839650,12631200,-1208450,SELL
28-10-20 11:35,11:35,13811875,12897325,-914550,SELL
28-10-20 11:36,11:36,13544425,12451450,-1092975,SELL
28-10-20 11:37,11:37,13761875,12749025,-1012850,SELL
28-10-20 11:38,11:38,13580200,12629625,-950575,SELL
28-10-20 11:39,11:39,13440475,12596875,-843600,SELL
28-10-20 11:40,11:40,13862725,12876425,-986300,SELL
28-10-20 11:41,11:41,14177425,12841625,-1335800,SELL
28-10-20 11:42,11:42,13926675,12830475,-1096200,SELL
28-10-20 11:43,11:43,13618525,12819225,-799300,SELL
28-10-20 11:44,11:44,13626325,12390200,-1236125,SELL
28-10-20 11:45,11:45,14011225,12968825,-1042400,SELL
28-10-20 11:46,11:46,13978725,13002225,-976500,SELL
28-10-20 11:47,11:47,13704575,12775575,-929000,SELL
28-10-20 11:48,11:48,13879450,12854100,-1025350,SELL
28-10-20 11:49,11:49,13695825,12763325,-932500,SELL
28-10-20 11:50,11:50,13526650,12547550,-979100,SELL
28-10-20 11:51,11:51,13840425,12445625,-1394800,SELL
28-10-20 11:52,11:52,13525725,12889150,-636575,SELL
28-10-20 11:53,11:53,13630175,12349125,-1281050,SELL
28-10-20 11:54,11:54,13522050,12861600,-660450,SELL
28-10-20 11:55,11:55,13519175,12834450,-684725,SELL
28-10-20 11:56,11:56,13930200,12668025,-1262175,SELL
28-10-20 11:57,11:57,13442000,12548050,-893950,SELL
28-10-20 11:58,11:58,13896400,12924800,-971600,SELL
28-10-20 11:59,11:59,14038575,12868075,-1170500,SELL
28-10-20 12:00,12:00,14124875,13112850,-1012025,SELL
28-10-20 12:01,12:01,13660200,12870475,-789725,SELL
28-10-20 12:02,12:02,14051675,12906925,-1144750,SELL
28-10-20 12:03,12:03,13885225,12525450,-1359775,SELL
28-10-20 12:04,12:04,13467050,12486075,-980975,SELL
28-10-20 12:05,12:05,13727875,12600375,-1127500,SELL
28-10-20 12:06,12:06,13546500,11716050,-1830450,SELL
28-10-20 12:07,12:07,13740675,12723625,-1017050,SELL
28-10-20 12:08,12:08,13545075,12786275,-758800,SELL
28-10-20 12:09,12:09,13470600,12079700,-1390900,SELL
28-10-20 12:10,12:10,13711075,12459025,-1252050,SELL
28-10-20 12:11,12:11,13979150,12751875,-1227275,SELL
28-10-20 12:12,12:12,13746600,12346450,-1400150,SELL
28-10-20 12:13,12:13,13658725,12586675,-1072050,SELL
28-10-20 12:14,12:14,13914225,12167625,-1746600,SELL
28-10-20 12:15,12:15,13802025,12319675,-1482350,SELL
28-10-20 12:16,12:16,13634475,12840275,-794200,SELL
28-10-20 12:17,12:17,14075525,12893125,-1182400,SELL
28-10-20 12:18,12:18,13925125,13200275,-724850,SELL
28-10-20 12:19,12:19,13687175,12696600,-990575,SELL
28-10-20 12:20,12:20,13525950,13167800,-358150,SELL
28-10-20 12:21,12:21,13525150,12534550,-990600,SELL
28-10-20 12:22,12:22,13605675,12843800,-761875,SELL
28-10-20 12:23,12:23,13872925,12723875,-1149050,SELL
28-10-20 12:24,12:24,13571375,12599975,-971400,SELL
28-10-20 12:25,12:25,13591650,11953950,-1637700,SELL
28-10-20 12:26,12:26,14057675,12666375,-1391300,SELL
28-10-20 12:27,12:27,14058575,12994400,-1064175,SELL
28-10-20 12:28,12:28,14012575,12996925,-1015650,SELL
28-10-20 12:29,12:29,13793275,12533150,-1260125,SELL
28-10-20 12:30,12:30,13955425,12771150,-1184275,SELL
28-10-20 12:31,12:31,13729325,12711750,-1017575,SELL
28-10-20 12:32,12:32,13798975,12480100,-1318875,SELL
28-10-20 12:33,12:33,13518950,12326075,-1192875,SELL
28-10-20 12:34,12:34,13497500,12505775,-991725,SELL
28-10-20 12:35,12:35,14100700,12530800,-1569900,SELL
28-10-20 12:36,12:36,13853700,12167875,-1685825,SELL
28-10-20 12:37,12:37,13902975,12211750,-1691225,SELL
28-10-20 12:38,12:38,14223975,12407475,-1816500,SELL
28-10-20 12:39,12:39,14328625,12326175,-2002450,SELL
28-10-20 12:40,12:40,14118550,12283450,-1835100,SELL
28-10-20 12:41,12:41,14120650,11782825,-2337825,SELL
28-10-20 12:42,12:42,14106700,12066075,-2040625,SELL
28-10-20 12:43,12:43,14038925,11906775,-2132150,SELL
28-10-20 12:44,12:44,14303150,11876075,-2427075,SELL
28-10-20 12:45,12:45,14543150,11897475,-2645675,SELL
28-10-20 12:46,12:46,14126825,11874575,-2252250,SELL
28-10-20 12:47,12:47,14374400,11919725,-2454675,SELL
28-10-20 12:48,12:48,14624175,11652525,-2971650,SELL
28-10-20 12:49,12:49,14557150,11769925,-2787225,SELL
28-10-20 12:50,12:50,14629525,11412250,-3217275,SELL
28-10-20 12:51,12:51,14826275,11849775,-2976500,SELL
28-10-20 12:52,12:52,14613075,11864250,-2748825,SELL
28-10-20 12:53,12:53,14744800,11595250,-3149550,SELL
28-10-20 12:54,12:54,14703525,11241050,-3462475,SELL
28-10-20 12:55,12:55,14670700,11188150,-3482550,SELL
28-10-20 12:56,12:56,14679075,11239775,-3439300,SELL
28-10-20 12:57,12:57,14976100,11333650,-3642450,SELL
28-10-20 12:58,12:58,14720125,11298525,-3421600,SELL
28-10-20 12:59,12:59,14515175,11589050,-2926125,SELL
28-10-20 13:00,13:00,14371250,11144150,-3227100,SELL
28-10-20 13:01,13:01,14845650,11468475,-3377175,SELL
28-10-20 13:02,13:02,14924600,11411575,-3513025,SELL
28-10-20 13:03,13:03,14994800,11266900,-3727900,SELL
28-10-20 13:04,13:04,14904300,11310325,-3593975,SELL
28-10-20 13:05,13:05,15085800,10716650,-4369150,SELL
28-10-20 13:06,13:06,14965375,10952525,-4012850,SELL
28-10-20 13:07,13:07,15152300,11038125,-4114175,SELL
28-10-20 13:08,13:08,14946000,11311675,-3634325,SELL
28-10-20 13:09,13:09,14796875,11284800,-3512075,SELL
28-10-20 13:10,13:10,15071350,11195200,-3876150,SELL
28-10-20 13:11,13:11,14620050,11082200,-3537850,SELL
28-10-20 13:12,13:12,14933500,11424275,-3509225,SELL
28-10-20 13:13,13:13,15123550,11374650,-3748900,SELL
28-10-20 13:14,13:14,14982825,11034775,-3948050,SELL
28-10-20 13:15,13:15,14838550,11140500,-3698050,SELL
28-10-20 13:16,13:16,14678075,11085175,-3592900,SELL
28-10-20 13:17,13:17,14718625,11054700,-3663925,SELL
28-10-20 13:18,13:18,15192025,11378200,-3813825,SELL
28-10-20 13:19,13:19,15031375,11318050,-3713325,SELL
28-10-20 13:20,13:20,14870975,11132000,-3738975,SELL
28-10-20 13:21,13:21,14832650,10959550,-3873100,SELL
28-10-20 13:22,13:22,14725375,10857050,-3868325,SELL
28-10-20 13:23,13:23,14854050,10986675,-3867375,SELL
28-10-20 13:24,13:24,14714875,10897900,-3816975,SELL
28-10-20 13:25,13:25,14762100,11031850,-3730250,SELL
28-10-20 13:26,13:26,14834050,11154225,-3679825,SELL
28-10-20 13:27,13:27,14989700,11036150,-3953550,SELL
28-10-20 13:28,13:28,14959725,10996450,-3963275,SELL
28-10-20 13:29,13:29,14935375,10863900,-4071475,SELL
28-10-20 13:30,13:30,14684575,11088950,-3595625,SELL
28-10-20 13:31,13:31,14680150,11240300,-3439850,SELL
28-10-20 13:32,13:32,14611125,11125425,-3485700,SELL
28-10-20 13:33,13:33,14735975,10801700,-3934275,SELL
28-10-20 13:34,13:34,14470200,11067700,-3402500,SELL
28-10-20 13:35,13:35,14669525,10746925,-3922600,SELL
28-10-20 13:36,13:36,14777125,10994825,-3782300,SELL
28-10-20 13:37,13:37,14788400,11195225,-3593175,SELL
28-10-20 13:38,13:38,14857425,10814000,-4043425,SELL
28-10-20 13:39,13:39,14558325,10987350,-3570975,SELL
28-10-20 13:40,13:40,14605950,10547150,-4058800,SELL
28-10-20 13:41,13:41,14881275,10987275,-3894000,SELL
28-10-20 13:42,13:42,14754750,11023100,-3731650,SELL
28-10-20 13:43,13:43,14766525,10781500,-3985025,SELL
28-10-20 13:44,13:44,14593700,10986025,-3607675,SELL
28-10-20 13:45,13:45,14739950,10376050,-4363900,SELL
28-10-20 13:46,13:46,14449125,10604700,-3844425,SELL
28-10-20 13:47,13:47,14448525,10610450,-3838075,SELL
28-10-20 13:48,13:48,14379475,10898350,-3481125,SELL
28-10-20 13:49,13:49,14361900,10403875,-3958025,SELL
28-10-20 13:50,13:50,14673650,10950100,-3723550,SELL
28-10-20 13:51,13:51,14496800,10967350,-3529450,SELL
28-10-20 13:52,13:52,14589675,10587400,-4002275,SELL
28-10-20 13:53,13:53,14509700,10350575,-4159125,SELL
28-10-20 13:54,13:54,14639150,10792950,-3846200,SELL
28-10-20 13:55,13:55,14522350,10832200,-3690150,SELL
28-10-20 13:56,13:56,14495575,10964150,-3531425,SELL
28-10-20 13:57,13:57,14346250,10780550,-3565700,SELL
28-10-20 13:58,13:58,14653700,10762225,-3891475,SELL
28-10-20 13:59,13:59,14516325,10900000,-3616325,SELL
28-10-20 14:00,14:00,14543400,11030950,-3512450,SELL
28-10-20 14:01,14:01,14514975,10723450,-3791525,SELL
28-10-20 14:02,14:02,14429525,10711250,-3718275,SELL
28-10-20 14:03,14:03,14364925,10557475,-3807450,SELL
28-10-20 14:04,14:04,14540275,10375050,-4165225,SELL
28-10-20 14:05,14:05,14553825,10661775,-3892050,SELL
28-10-20 14:06,14:06,14534325,10716400,-3817925,SELL
28-10-20 14:07,14:07,14361650,10506875,-3854775,SELL
28-10-20 14:08,14:08,14379050,10599500,-3779550,SELL
28-10-20 14:09,14:09,14380275,10408650,-3971625,SELL
28-10-20 14:10,14:10,14436550,10399500,-4037050,SELL
28-10-20 14:11,14:11,14359225,10466950,-3892275,SELL
28-10-20 14:12,14:12,14575500,10294500,-4281000,SELL
28-10-20 14:13,14:13,14598550,10850850,-3747700,SELL
28-10-20 14:14,14:14,14589700,10444175,-4145525,SELL
28-10-20 14:15,14:15,14485500,10587375,-3898125,SELL
28-10-20 14:16,14:16,14599825,10564900,-4034925,SELL
28-10-20 14:17,14:17,14362950,10780050,-3582900,SELL
28-10-20 14:18,14:18,14460750,10514275,-3946475,SELL
28-10-20 14:19,14:19,14494125,10587800,-3906325,SELL
28-10-20 14:20,14:20,14441425,10835475,-3605950,SELL
28-10-20 14:21,14:21,14667075,10684225,-3982850,SELL
28-10-20 14:22,14:22,14245725,10592400,-3653325,SELL
28-10-20 14:23,14:23,14255450,10573675,-3681775,SELL
28-10-20 14:24,14:24,14364925,10495075,-3869850,SELL
28-10-20 14:25,14:25,14314125,10529700,-3784425,SELL
28-10-20 14:26,14:26,14272050,10624625,-3647425,SELL
28-10-20 14:27,14:27,14251700,10636225,-3615475,SELL
28-10-20 14:28,14:28,14238050,10256900,-3981150,SELL
28-10-20 14:29,14:29,14251700,10774800,-3476900,SELL
28-10-20 14:30,14:30,14278050,10716475,-3561575,SELL
28-10-20 14:31,14:31,14233775,10594200,-3639575,SELL
28-10-20 14:32,14:32,14600925,10667800,-3933125,SELL
28-10-20 14:33,14:33,14530850,10559150,-3971700,SELL
28-10-20 14:34,14:34,14395875,10728125,-3667750,SELL
28-10-20 14:35,14:35,14600375,10685150,-3915225,SELL
28-10-20 14:36,14:36,14394250,10569875,-3824375,SELL
28-10-20 14:37,14:37,14258175,10462875,-3795300,SELL
28-10-20 14:38,14:38,14272700,10264650,-4008050,SELL
28-10-20 14:39,14:39,14122325,10598825,-3523500,SELL
28-10-20 14:40,14:40,14169750,10196375,-3973375,SELL
28-10-20 14:41,14:41,14251425,10691425,-3560000,SELL
28-10-20 14:42,14:42,14013875,10488900,-3524975,SELL
28-10-20 14:43,14:43,14416225,10531625,-3884600,SELL
28-10-20 14:44,14:44,14335025,10561450,-3773575,SELL
28-10-20 14:45,14:45,14204800,10547025,-3657775,SELL
28-10-20 14:46,14:46,14366025,10687700,-3678325,SELL
28-10-20 14:47,14:47,13928175,10568375,-3359800,SELL
28-10-20 14:48,14:48,14102125,10523800,-3578325,SELL
28-10-20 14:49,14:49,14138775,10640575,-3498200,SELL
28-10-20 14:50,14:50,14225900,10616975,-3608925,SELL
28-10-20 14:51,14:51,14125825,10653750,-3472075,SELL
28-10-20 14:52,14:52,14111975,10579600,-3532375,SELL
28-10-20 14:53,14:53,14322925,10598150,-3724775,SELL
28-10-20 14:54,14:54,14334100,10759325,-3574775,SELL
28-10-20 14:55,14:55,14232000,10681175,-3550825,SELL
28-10-20 14:56,14:56,13888900,10655875,-3233025,SELL
28-10-20 14:57,14:57,13943050,10606950,-3336100,SELL
28-10-20 14:58,14:58,14064100,10523425,-3540675,SELL
28-10-20 14:59,14:59,13936175,10623650,-3312525,SELL
28-10-20 15:00,15:00,13873900,10575100,-3298800,SELL
28-10-20 15:01,15:01,13907200,10591450,-3315750,SELL
28-10-20 15:02,15:02,13926725,10607550,-3319175,SELL
28-10-20 15:03,15:03,13805275,10728200,-3077075,SELL
28-10-20 15:04,15:04,13798675,10522000,-3276675,SELL
28-10-20 15:05,15:05,14071125,10542375,-3528750,SELL
28-10-20 15:06,15:06,13782350,10551175,-3231175,SELL
28-10-20 15:07,15:07,13918100,10555375,-3362725,SELL
28-10-20 15:08,15:08,13736050,10668100,-3067950,SELL
28-10-20 15:09,15:09,13759800,10510400,-3249400,SELL
28-10-20 15:10,15:10,13603100,10147975,-3455125,SELL
28-10-20 15:11,15:11,13726300,10552200,-3174100,SELL
28-10-20 15:12,15:12,13599775,10400475,-3199300,SELL
28-10-20 15:13,15:13,13496025,10448875,-3047150,SELL
28-10-20 15:14,15:14,13561350,10421700,-3139650,SELL
28-10-20 15:15,15:15,13417275,10241650,-3175625,SELL
28-10-20 15:16,15:16,13165425,10259800,-2905625,SELL
28-10-20 15:17,15:17,13483875,10364250,-3119625,SELL
28-10-20 15:18,15:18,13046225,10182275,-2863950,SELL
28-10-20 15:19,15:19,13041325,10089425,-2951900,SELL
28-10-20 15:20,15:20,13228175,10226725,-3001450,SELL
28-10-20 15:21,15:21,12752125,10058500,-2693625,SELL
28-10-20 15:22,15:22,12911750,9911475,-3000275,SELL
28-10-20 15:23,15:23,12776900,9943675,-2833225,SELL
28-10-20 15:24,15:24,12730525,9881850,-2848675,SELL
28-10-20 15:25,15:25,12573525,10043775,-2529750,SELL
28-10-20 15:26,15:26,12731425,9986950,-2744475,SELL
28-10-20 15:27,15:27,12539475,9959425,-2580050,SELL
28-10-20 15:28,15:28,12530075,9807650,-2722425,SELL
28-10-20 15:29,15:29,12659700,9980800,-2678900,SELL
29-10-20 9:15,9:15,12389225,9879525,-2509700,SELL
29-10-20 9:16,9:16,12503550,9727800,-2775750,SELL
29-10-20 9:17,9:17,12831700,10399275,-2432425,SELL
29-10-20 9:18,9:18,12789775,10250700,-2539075,SELL
29-10-20 9:19,9:19,12847325,10224200,-2623125,SELL
29-10-20 9:20,9:20,13750950,11012475,-2738475,SELL
29-10-20 9:21,9:21,13866775,11152850,-2713925,SELL
29-10-20 9:22,9:22,13779875,10897825,-2882050,SELL
29-10-20 9:23,9:23,14688300,11990050,-2698250,SELL
29-10-20 9:24,9:24,14819700,11918225,-2901475,SELL
29-10-20 9:25,9:25,14889125,11981075,-2908050,SELL
29-10-20 9:26,9:26,15287900,12462175,-2825725,SELL
29-10-20 9:27,9:27,15509300,12667125,-2842175,SELL
29-10-20 9:28,9:28,15535125,12585925,-2949200,SELL
29-10-20 9:29,9:29,16028225,13204775,-2823450,SELL
29-10-20 9:30,9:30,16246450,13305825,-2940625,SELL
29-10-20 9:31,9:31,16375500,13204975,-3170525,SELL
29-10-20 9:32,9:32,17112525,13573100,-3539425,SELL
29-10-20 9:33,9:33,17134550,13527500,-3607050,SELL
29-10-20 9:34,9:34,17312975,13739300,-3573675,SELL
29-10-20 9:35,9:35,17735750,14287100,-3448650,SELL
29-10-20 9:36,9:36,17756375,14155225,-3601150,SELL
29-10-20 9:37,9:37,17825675,14311925,-3513750,SELL
29-10-20 9:38,9:38,17546600,14534925,-3011675,SELL
29-10-20 9:39,9:39,17754550,14483850,-3270700,SELL
29-10-20 9:40,9:40,17838025,14171950,-3666075,SELL
29-10-20 9:41,9:41,17907150,14631050,-3276100,SELL
29-10-20 9:42,9:42,18014250,14700875,-3313375,SELL
29-10-20 9:43,9:43,17757825,14789500,-2968325,SELL
29-10-20 9:44,9:44,18170375,15143950,-3026425,SELL
29-10-20 9:45,9:45,18162550,14890650,-3271900,SELL
29-10-20 9:46,9:46,17795850,14916350,-2879500,SELL
29-10-20 9:47,9:47,18020025,15314450,-2705575,SELL
29-10-20 9:48,9:48,18422950,15011200,-3411750,SELL
29-10-20 9:49,9:49,18215050,15077375,-3137675,SELL
29-10-20 9:50,9:50,17965600,15329900,-2635700,SELL
29-10-20 9:51,9:51,17956700,15333875,-2622825,SELL
29-10-20 9:52,9:52,18161425,15346650,-2814775,SELL
29-10-20 9:53,9:53,18278900,15801675,-2477225,SELL
29-10-20 9:54,9:54,18409675,15753925,-2655750,SELL
29-10-20 9:55,9:55,18480200,15596875,-2883325,SELL
29-10-20 9:56,9:56,18270425,16124475,-2145950,SELL
29-10-20 9:57,9:57,18175400,15810150,-2365250,SELL
29-10-20 9:58,9:58,18670625,15923750,-2746875,SELL
29-10-20 9:59,9:59,18192500,15869875,-2322625,SELL
29-10-20 10:00,10:00,18713825,15903950,-2809875,SELL
29-10-20 10:01,10:01,18894025,15848850,-3045175,SELL
29-10-20 10:02,10:02,19083200,15885300,-3197900,SELL
29-10-20 10:03,10:03,19052650,15989050,-3063600,SELL
29-10-20 10:04,10:04,18864875,15890850,-2974025,SELL
29-10-20 10:05,10:05,18819075,15697400,-3121675,SELL
29-10-20 10:06,10:06,18821275,15913950,-2907325,SELL
29-10-20 10:07,10:07,18839300,16010800,-2828500,SELL
29-10-20 10:08,10:08,19360250,15936825,-3423425,SELL
29-10-20 10:09,10:09,19468775,16005075,-3463700,SELL
29-10-20 10:10,10:10,19096400,16113450,-2982950,SELL
29-10-20 10:11,10:11,19679650,16006600,-3673050,SELL
29-10-20 10:12,10:12,19550200,16282025,-3268175,SELL
29-10-20 10:13,10:13,19695475,16250950,-3444525,SELL
29-10-20 10:14,10:14,19609125,16473025,-3136100,SELL
29-10-20 10:15,10:15,19578400,16245325,-3333075,SELL
29-10-20 10:16,10:16,19186625,16567875,-2618750,SELL
29-10-20 10:17,10:17,19475750,16308075,-3167675,SELL
29-10-20 10:18,10:18,19624875,16759550,-2865325,SELL
29-10-20 10:19,10:19,19783925,16800050,-2983875,SELL
29-10-20 10:20,10:20,19865325,16791700,-3073625,SELL
29-10-20 10:21,10:21,20108950,16945825,-3163125,SELL
29-10-20 10:22,10:22,20069750,16842050,-3227700,SELL
29-10-20 10:23,10:23,19905200,16218125,-3687075,SELL
29-10-20 10:24,10:24,19827475,16504300,-3323175,SELL
29-10-20 10:25,10:25,19397675,16502975,-2894700,SELL
29-10-20 10:26,10:26,20022900,16143325,-3879575,SELL
29-10-20 10:27,10:27,19580600,16061550,-3519050,SELL
29-10-20 10:28,10:28,19219925,15803900,-3416025,SELL
29-10-20 10:29,10:29,19945475,16642525,-3302950,SELL
29-10-20 10:30,10:30,20334325,16413525,-3920800,SELL
29-10-20 10:31,10:31,20169225,16392025,-3777200,SELL
29-10-20 10:32,10:32,20239150,16600100,-3639050,SELL
29-10-20 10:33,10:33,20438125,16744200,-3693925,SELL
29-10-20 10:34,10:34,20095100,16578750,-3516350,SELL
29-10-20 10:35,10:35,20888625,16531925,-4356700,SELL
29-10-20 10:36,10:36,20685525,16412700,-4272825,SELL
29-10-20 10:37,10:37,20469325,15747575,-4721750,SELL
29-10-20 10:38,10:38,20441500,16518625,-3922875,SELL
29-10-20 10:39,10:39,20289900,16299100,-3990800,SELL
29-10-20 10:40,10:40,20296375,15978800,-4317575,SELL
29-10-20 10:41,10:41,20705875,16504250,-4201625,SELL
29-10-20 10:42,10:42,20619500,16354650,-4264850,SELL
29-10-20 10:43,10:43,20433975,16005150,-4428825,SELL
29-10-20 10:44,10:44,20746400,16763775,-3982625,SELL
29-10-20 10:45,10:45,20616775,16575025,-4041750,SELL
29-10-20 10:46,10:46,20581975,16761550,-3820425,SELL
29-10-20 10:47,10:47,20964525,16482500,-4482025,SELL
29-10-20 10:48,10:48,20447500,16647375,-3800125,SELL
29-10-20 10:49,10:49,20923400,15850250,-5073150,SELL
29-10-20 10:50,10:50,20587750,16354325,-4233425,SELL
29-10-20 10:51,10:51,20230750,16322525,-3908225,SELL
29-10-20 10:52,10:52,20962350,16421925,-4540425,SELL
29-10-20 10:53,10:53,20652175,16266025,-4386150,SELL
29-10-20 10:54,10:54,21195825,16092975,-5102850,SELL
29-10-20 10:55,10:55,21175200,16682825,-4492375,SELL
29-10-20 10:56,10:56,20909300,15621750,-5287550,SELL
29-10-20 10:57,10:57,21065950,16347125,-4718825,SELL
29-10-20 10:58,10:58,21295275,16354625,-4940650,SELL
29-10-20 10:59,10:59,21048200,16547050,-4501150,SELL
29-10-20 11:00,11:00,21451450,16905625,-4545825,SELL
29-10-20 11:01,11:01,21489575,16959575,-4530000,SELL
29-10-20 11:02,11:02,21675475,17100525,-4574950,SELL
29-10-20 11:03,11:03,21734350,16918600,-4815750,SELL
29-10-20 11:04,11:04,21490800,16500575,-4990225,SELL
29-10-20 11:05,11:05,21293525,16546300,-4747225,SELL
29-10-20 11:06,11:06,21682700,17242950,-4439750,SELL
29-10-20 11:07,11:07,21515300,16447800,-5067500,SELL
29-10-20 11:08,11:08,21548150,16491750,-5056400,SELL
29-10-20 11:09,11:09,21111250,17310525,-3800725,SELL
29-10-20 11:10,11:10,21356975,17365850,-3991125,SELL
29-10-20 11:11,11:11,21525250,17024875,-4500375,SELL
29-10-20 11:12,11:12,21556850,17170975,-4385875,SELL
29-10-20 11:13,11:13,21581675,16997050,-4584625,SELL
29-10-20 11:14,11:14,21645475,17115475,-4530000,SELL
29-10-20 11:15,11:15,21661950,16579075,-5082875,SELL
29-10-20 11:16,11:16,21842625,17263325,-4579300,SELL
29-10-20 11:17,11:17,21552600,17192225,-4360375,SELL
29-10-20 11:18,11:18,21176925,16822925,-4354000,SELL
29-10-20 11:19,11:19,21325700,17480300,-3845400,SELL
29-10-20 11:20,11:20,21553950,17523125,-4030825,SELL
29-10-20 11:21,11:21,21779600,17394325,-4385275,SELL
29-10-20 11:22,11:22,21768300,17331850,-4436450,SELL
29-10-20 11:23,11:23,21708875,17333300,-4375575,SELL
29-10-20 11:24,11:24,21102925,16751950,-4350975,SELL
29-10-20 11:25,11:25,21873675,17682825,-4190850,SELL
29-10-20 11:26,11:26,21866925,17603275,-4263650,SELL
29-10-20 11:27,11:27,21718150,17553975,-4164175,SELL
29-10-20 11:28,11:28,21754125,17145800,-4608325,SELL
29-10-20 11:29,11:29,21635875,17702100,-3933775,SELL
29-10-20 11:30,11:30,21317225,17633500,-3683725,SELL
29-10-20 11:31,11:31,21460500,17830300,-3630200,SELL
29-10-20 11:32,11:32,21884775,17570200,-4314575,SELL
29-10-20 11:33,11:33,21946750,17925900,-4020850,SELL
29-10-20 11:34,11:34,21995600,17626400,-4369200,SELL
29-10-20 11:35,11:35,21849250,17951700,-3897550,SELL
29-10-20 11:36,11:36,21530400,17974400,-3556000,SELL
29-10-20 11:37,11:37,22199300,17982550,-4216750,SELL
29-10-20 11:38,11:38,21912250,18023175,-3889075,SELL
29-10-20 11:39,11:39,21156050,17987950,-3168100,SELL
29-10-20 11:40,11:40,21196250,17875200,-3321050,SELL
29-10-20 11:41,11:41,21236125,17653500,-3582625,SELL
29-10-20 11:42,11:42,21551975,17832850,-3719125,SELL
29-10-20 11:43,11:43,21776775,17935400,-3841375,SELL
29-10-20 11:44,11:44,21867075,17644775,-4222300,SELL
29-10-20 11:45,11:45,21806375,17888550,-3917825,SELL
29-10-20 11:46,11:46,22182250,17732400,-4449850,SELL
29-10-20 11:47,11:47,21373850,18078525,-3295325,SELL
29-10-20 11:48,11:48,21797750,17583100,-4214650,SELL
29-10-20 11:49,11:49,22065600,18193975,-3871625,SELL
29-10-20 11:50,11:50,21340500,18332900,-3007600,SELL
29-10-20 11:51,11:51,21159000,18392175,-2766825,SELL
29-10-20 11:52,11:52,21177150,18066900,-3110250,SELL
29-10-20 11:53,11:53,21409400,18241200,-3168200,SELL
29-10-20 11:54,11:54,21401025,18076325,-3324700,SELL
29-10-20 11:55,11:55,21524425,18469575,-3054850,SELL
29-10-20 11:56,11:56,20875625,18552125,-2323500,SELL
29-10-20 11:57,11:57,20626025,18430675,-2195350,SELL
29-10-20 11:58,11:58,20636575,17984550,-2652025,SELL
29-10-20 11:59,11:59,20908250,18807325,-2100925,SELL
29-10-20 12:00,12:00,20709250,18882600,-1826650,SELL
29-10-20 12:01,12:01,20905150,18808700,-2096450,SELL
29-10-20 12:02,12:02,20236125,19137450,-1098675,SELL
29-10-20 12:03,12:03,20379550,18820025,-1559525,SELL
29-10-20 12:04,12:04,19996925,19363000,-633925,SELL
29-10-20 12:05,12:05,20317925,19385150,-932775,SELL
29-10-20 12:06,12:06,20405575,19137400,-1268175,SELL
29-10-20 12:07,12:07,19877450,18769150,-1108300,SELL
29-10-20 12:08,12:08,20260550,19377300,-883250,SELL
29-10-20 12:09,12:09,20529750,19476600,-1053150,SELL
29-10-20 12:10,12:10,20227675,19226100,-1001575,SELL
29-10-20 12:11,12:11,20269850,19676675,-593175,SELL
29-10-20 12:12,12:12,19905675,19119950,-785725,SELL
29-10-20 12:13,12:13,20088175,19410400,-677775,SELL
29-10-20 12:14,12:14,20423925,19729100,-694825,SELL
29-10-20 12:15,12:15,20279775,19660325,-619450,SELL
29-10-20 12:16,12:16,20457075,19728175,-728900,SELL
29-10-20 12:17,12:17,20092400,19842450,-249950,SELL
29-10-20 12:18,12:18,20421925,19426025,-995900,SELL
29-10-20 12:19,12:19,20499550,19572675,-926875,SELL
29-10-20 12:20,12:20,20710925,19641400,-1069525,SELL
29-10-20 12:21,12:21,20753625,19506200,-1247425,SELL
29-10-20 12:22,12:22,20675250,19224225,-1451025,SELL
29-10-20 12:23,12:23,20823925,19637975,-1185950,SELL
29-10-20 12:24,12:24,19992375,19906850,-85525,SELL
29-10-20 12:25,12:25,20423375,20158225,-265150,SELL
29-10-20 12:26,12:26,20700925,19278750,-1422175,SELL
29-10-20 12:27,12:27,20777750,19770250,-1007500,SELL
29-10-20 12:28,12:28,20993200,19871450,-1121750,SELL
29-10-20 12:29,12:29,20424775,20185650,-239125,SELL
29-10-20 12:30,12:30,20607300,20226275,-381025,SELL
29-10-20 12:31,12:31,20795775,20416350,-379425,SELL
29-10-20 12:32,12:32,20889825,19983275,-906550,SELL
29-10-20 12:33,12:33,21247850,20064375,-1183475,SELL
29-10-20 12:34,12:34,20845725,19571300,-1274425,SELL
29-10-20 12:35,12:35,21165800,19910975,-1254825,SELL
29-10-20 12:36,12:36,21210950,19206550,-2004400,SELL
29-10-20 12:37,12:37,21313550,19850200,-1463350,SELL
29-10-20 12:38,12:38,21176175,19696825,-1479350,SELL
29-10-20 12:39,12:39,21339275,19885250,-1454025,SELL
29-10-20 12:40,12:40,20702075,19306025,-1396050,SELL
29-10-20 12:41,12:41,20833050,19195400,-1637650,SELL
29-10-20 12:42,12:42,21465075,19484050,-1981025,SELL
29-10-20 12:43,12:43,21550025,19351575,-2198450,SELL
29-10-20 12:44,12:44,21215550,19193225,-2022325,SELL
29-10-20 12:45,12:45,21184000,19296275,-1887725,SELL
29-10-20 12:46,12:46,21521400,18766200,-2755200,SELL
29-10-20 12:47,12:47,21489775,19271925,-2217850,SELL
29-10-20 12:48,12:48,21835850,19516625,-2319225,SELL
29-10-20 12:49,12:49,21437325,18708600,-2728725,SELL
29-10-20 12:50,12:50,21615225,18982650,-2632575,SELL
29-10-20 12:51,12:51,22062450,19397425,-2665025,SELL
29-10-20 12:52,12:52,22051475,19538975,-2512500,SELL
29-10-20 12:53,12:53,21951325,19182325,-2769000,SELL
29-10-20 12:54,12:54,21737400,19217875,-2519525,SELL
29-10-20 12:55,12:55,21437600,19633525,-1804075,SELL
29-10-20 12:56,12:56,21907575,19956250,-1951325,SELL
29-10-20 12:57,12:57,21699000,19132850,-2566150,SELL
29-10-20 12:58,12:58,22380575,18845075,-3535500,SELL
29-10-20 12:59,12:59,21966225,18995525,-2970700,SELL
29-10-20 13:00,13:00,21678350,19417125,-2261225,SELL
29-10-20 13:01,13:01,22580650,19219125,-3361525,SELL
29-10-20 13:02,13:02,22046850,19379875,-2666975,SELL
29-10-20 13:03,13:03,22727700,19344300,-3383400,SELL
29-10-20 13:04,13:04,22832525,19083800,-3748725,SELL
29-10-20 13:05,13:05,22931375,19598600,-3332775,SELL
29-10-20 13:06,13:06,22707475,18285300,-4422175,SELL
29-10-20 13:07,13:07,22630600,18390525,-4240075,SELL
29-10-20 13:08,13:08,21733175,18798700,-2934475,SELL
29-10-20 13:09,13:09,22121750,18021625,-4100125,SELL
29-10-20 13:10,13:10,22543650,18659725,-3883925,SELL
29-10-20 13:11,13:11,22973675,18288650,-4685025,SELL
29-10-20 13:12,13:12,23002050,18226800,-4775250,SELL
29-10-20 13:13,13:13,22899700,18415375,-4484325,SELL
29-10-20 13:14,13:14,23141050,18498250,-4642800,SELL
29-10-20 13:15,13:15,23194350,18245550,-4948800,SELL
29-10-20 13:16,13:16,22579125,17922500,-4656625,SELL
29-10-20 13:17,13:17,22995675,18196900,-4798775,SELL
29-10-20 13:18,13:18,23365850,17381450,-5984400,SELL
29-10-20 13:19,13:19,23071300,17413050,-5658250,SELL
29-10-20 13:20,13:20,23226950,17224350,-6002600,SELL
29-10-20 13:21,13:21,23233025,16772800,-6460225,SELL
29-10-20 13:22,13:22,22982050,17521350,-5460700,SELL
29-10-20 13:23,13:23,22808300,16794425,-6013875,SELL
29-10-20 13:24,13:24,22881400,16912625,-5968775,SELL
29-10-20 13:25,13:25,22805100,17093550,-5711550,SELL
29-10-20 13:26,13:26,22882600,17308350,-5574250,SELL
29-10-20 13:27,13:27,23238025,17188325,-6049700,SELL
29-10-20 13:28,13:28,22877125,16800025,-6077100,SELL
29-10-20 13:29,13:29,23123725,17087800,-6035925,SELL
29-10-20 13:30,13:30,23911900,16881975,-7029925,SELL
29-10-20 13:31,13:31,23657725,17421725,-6236000,SELL
29-10-20 13:32,13:32,22955075,17402200,-5552875,SELL
29-10-20 13:33,13:33,23547725,17655175,-5892550,SELL
29-10-20 13:34,13:34,23610975,17488375,-6122600,SELL
29-10-20 13:35,13:35,23553300,17313300,-6240000,SELL
29-10-20 13:36,13:36,23943375,17449650,-6493725,SELL
29-10-20 13:37,13:37,23086275,17627625,-5458650,SELL
29-10-20 13:38,13:38,23899725,17279600,-6620125,SELL
29-10-20 13:39,13:39,24186450,17576200,-6610250,SELL
29-10-20 13:40,13:40,24050775,17669725,-6381050,SELL
29-10-20 13:41,13:41,24160425,17546250,-6614175,SELL
29-10-20 13:42,13:42,23451425,17309075,-6142350,SELL
29-10-20 13:43,13:43,23760900,17490000,-6270900,SELL
29-10-20 13:44,13:44,23892725,17247125,-6645600,SELL
29-10-20 13:45,13:45,23692725,17461400,-6231325,SELL
29-10-20 13:46,13:46,23582475,17553775,-6028700,SELL
29-10-20 13:47,13:47,23694025,17784975,-5909050,SELL
29-10-20 13:48,13:48,23412200,17616250,-5795950,SELL
29-10-20 13:49,13:49,23103600,17728125,-5375475,SELL
29-10-20 13:50,13:50,23980475,17774125,-6206350,SELL
29-10-20 13:51,13:51,23582050,17778250,-5803800,SELL
29-10-20 13:52,13:52,23687050,17949875,-5737175,SELL
29-10-20 13:53,13:53,24060900,18199100,-5861800,SELL
29-10-20 13:54,13:54,23241725,17577950,-5663775,SELL
29-10-20 13:55,13:55,23100450,18193425,-4907025,SELL
29-10-20 13:56,13:56,23215875,17926750,-5289125,SELL
29-10-20 13:57,13:57,23673375,18019000,-5654375,SELL
29-10-20 13:58,13:58,23798250,17795725,-6002525,SELL
29-10-20 13:59,13:59,23490100,17157850,-6332250,SELL
29-10-20 14:00,14:00,23867425,17967025,-5900400,SELL
29-10-20 14:01,14:01,23595750,17877450,-5718300,SELL
29-10-20 14:02,14:02,23897200,17535200,-6362000,SELL
29-10-20 14:03,14:03,23367450,16767000,-6600450,SELL
29-10-20 14:04,14:04,22756200,17078400,-5677800,SELL
29-10-20 14:05,14:05,23315050,16791700,-6523350,SELL
29-10-20 14:06,14:06,23493425,16549650,-6943775,SELL
29-10-20 14:07,14:07,23327075,16993750,-6333325,SELL
29-10-20 14:08,14:08,23144375,17245450,-5898925,SELL
29-10-20 14:09,14:09,23208150,17211325,-5996825,SELL
29-10-20 14:10,14:10,23247425,16551975,-6695450,SELL
29-10-20 14:11,14:11,23345450,16825600,-6519850,SELL
29-10-20 14:12,14:12,23081925,17488000,-5593925,SELL
29-10-20 14:13,14:13,23501700,17513125,-5988575,SELL
29-10-20 14:14,14:14,23453575,16854600,-6598975,SELL
29-10-20 14:15,14:15,23417300,17682275,-5735025,SELL
29-10-20 14:16,14:16,23360450,17770550,-5589900,SELL
29-10-20 14:17,14:17,23513200,17334750,-6178450,SELL
29-10-20 14:18,14:18,22925925,16616225,-6309700,SELL
29-10-20 14:19,14:19,23183950,17406025,-5777925,SELL
29-10-20 14:20,14:20,23397000,17692300,-5704700,SELL
29-10-20 14:21,14:21,23560500,17819200,-5741300,SELL
29-10-20 14:22,14:22,23543225,18014475,-5528750,SELL
29-10-20 14:23,14:23,23400975,17634475,-5766500,SELL
29-10-20 14:24,14:24,23202950,18136500,-5066450,SELL
29-10-20 14:25,14:25,23769650,17750900,-6018750,SELL
29-10-20 14:26,14:26,23747325,18153800,-5593525,SELL
29-10-20 14:27,14:27,23727700,18153700,-5574000,SELL
29-10-20 14:28,14:28,23547150,17448425,-6098725,SELL
29-10-20 14:29,14:29,23668850,17979800,-5689050,SELL
29-10-20 14:30,14:30,23253475,17674500,-5578975,SELL
29-10-20 14:31,14:31,23228200,18447175,-4781025,SELL
29-10-20 14:32,14:32,23540125,18045625,-5494500,SELL
29-10-20 14:33,14:33,23274150,18015925,-5258225,SELL
29-10-20 14:34,14:34,22984950,17380325,-5604625,SELL
29-10-20 14:35,14:35,23472125,18511475,-4960650,SELL
29-10-20 14:36,14:36,23023700,18129475,-4894225,SELL
29-10-20 14:37,14:37,22957700,18381725,-4575975,SELL
29-10-20 14:38,14:38,22628150,17756500,-4871650,SELL
29-10-20 14:39,14:39,23124875,18355625,-4769250,SELL
29-10-20 14:40,14:40,23343775,18241225,-5102550,SELL
29-10-20 14:41,14:41,23298825,18208675,-5090150,SELL
29-10-20 14:42,14:42,23410750,18291425,-5119325,SELL
29-10-20 14:43,14:43,22923500,18433775,-4489725,SELL
29-10-20 14:44,14:44,22696650,18086250,-4610400,SELL
29-10-20 14:45,14:45,22944925,18226175,-4718750,SELL
29-10-20 14:46,14:46,22984450,17964700,-5019750,SELL
29-10-20 14:47,14:47,23305025,18041225,-5263800,SELL
29-10-20 14:48,14:48,22411900,18029625,-4382275,SELL
29-10-20 14:49,14:49,23337525,17731350,-5606175,SELL
29-10-20 14:50,14:50,23172200,17809625,-5362575,SELL
29-10-20 14:51,14:51,23326000,17647925,-5678075,SELL
29-10-20 14:52,14:52,22783750,17664625,-5119125,SELL
29-10-20 14:53,14:53,23129075,17845550,-5283525,SELL
29-10-20 14:54,14:54,23108750,17349900,-5758850,SELL
29-10-20 14:55,14:55,22430475,17931000,-4499475,SELL
29-10-20 14:56,14:56,22976950,17803150,-5173800,SELL
29-10-20 14:57,14:57,23124050,18193250,-4930800,SELL
29-10-20 14:58,14:58,23246625,17796950,-5449675,SELL
29-10-20 14:59,14:59,22991200,17631050,-5360150,SELL
29-10-20 15:00,15:00,22928175,17798175,-5130000,SELL
29-10-20 15:01,15:01,22552125,17372675,-5179450,SELL
29-10-20 15:02,15:02,22809900,17328875,-5481025,SELL
29-10-20 15:03,15:03,22153250,17807150,-4346100,SELL
29-10-20 15:04,15:04,22038075,17992325,-4045750,SELL
29-10-20 15:05,15:05,21957600,18352700,-3604900,SELL
29-10-20 15:06,15:06,21708125,17777725,-3930400,SELL
29-10-20 15:07,15:07,21155875,17772100,-3383775,SELL
29-10-20 15:08,15:08,21800875,17652900,-4147975,SELL
29-10-20 15:09,15:09,21582200,17654175,-3928025,SELL
29-10-20 15:10,15:10,21670950,17438600,-4232350,SELL
29-10-20 15:11,15:11,21629475,17562875,-4066600,SELL
29-10-20 15:12,15:12,20261075,17157850,-3103225,SELL
29-10-20 15:13,15:13,20839275,17147225,-3692050,SELL
29-10-20 15:14,15:14,20878525,17634950,-3243575,SELL
29-10-20 15:15,15:15,21258175,17265250,-3992925,SELL
29-10-20 15:16,15:16,21222200,17189775,-4032425,SELL
29-10-20 15:17,15:17,21402175,17189600,-4212575,SELL
29-10-20 15:18,15:18,21229725,16953775,-4275950,SELL
29-10-20 15:19,15:19,20809925,16657850,-4152075,SELL
29-10-20 15:20,15:20,20942850,16750450,-4192400,SELL
29-10-20 15:21,15:21,21246750,15966675,-5280075,SELL
29-10-20 15:22,15:22,21244825,15459525,-5785300,SELL
29-10-20 15:23,15:23,21178775,16500025,-4678750,SELL
29-10-20 15:24,15:24,20596500,16331325,-4265175,SELL
29-10-20 15:25,15:25,20665975,17031800,-3634175,SELL
29-10-20 15:26,15:26,20283650,16716250,-3567400,SELL
29-10-20 15:27,15:27,18970200,14568975,-4401225,SELL
29-10-20 15:28,15:28,18915700,16214650,-2701050,SELL
29-10-20 15:29,15:29,18954300,16049600,-2904700,SELL
30-10-20 9:15,9:15,2904850,1520350,-1384500,SELL
30-10-20 9:16,9:16,2905425,1520875,-1384550,SELL
30-10-20 9:17,9:17,3164700,1720175,-1444525,SELL
30-10-20 9:18,9:18,3174225,1719700,-1454525,SELL
30-10-20 9:19,9:19,3170125,1713725,-1456400,SELL
30-10-20 9:20,9:20,3477225,1974875,-1502350,SELL
30-10-20 9:21,9:21,3477675,1975825,-1501850,SELL
30-10-20 9:22,9:22,3477975,1972750,-1505225,SELL
30-10-20 9:23,9:23,3690300,2112875,-1577425,SELL
30-10-20 9:24,9:24,3670600,2122175,-1548425,SELL
30-10-20 9:25,9:25,3689150,2126850,-1562300,SELL
30-10-20 9:26,9:26,3831675,2242825,-1588850,SELL
30-10-20 9:27,9:27,3830500,2242000,-1588500,SELL
30-10-20 9:28,9:28,3831425,2239250,-1592175,SELL
30-10-20 9:29,9:29,3935650,2377950,-1557700,SELL
30-10-20 9:30,9:30,3932150,2368400,-1563750,SELL
30-10-20 9:31,9:31,3912625,2381275,-1531350,SELL
30-10-20 9:32,9:32,4085200,2477375,-1607825,SELL
30-10-20 9:33,9:33,4084425,2488275,-1596150,SELL
30-10-20 9:34,9:34,4084050,2491650,-1592400,SELL
30-10-20 9:35,9:35,4164525,2514600,-1649925,SELL
30-10-20 9:36,9:36,4164525,2511850,-1652675,SELL
30-10-20 9:37,9:37,4159600,2510075,-1649525,SELL
30-10-20 9:38,9:38,4265050,2565850,-1699200,SELL
30-10-20 9:39,9:39,4263175,2579650,-1683525,SELL
30-10-20 9:40,9:40,4264025,2571475,-1692550,SELL
30-10-20 9:41,9:41,4409900,2617400,-1792500,SELL
30-10-20 9:42,9:42,4407275,2620875,-1786400,SELL
30-10-20 9:43,9:43,4371225,2623300,-1747925,SELL
30-10-20 9:44,9:44,4490375,2693875,-1796500,SELL
30-10-20 9:45,9:45,4463850,2692150,-1771700,SELL
30-10-20 9:46,9:46,4494125,2698175,-1795950,SELL
30-10-20 9:47,9:47,4521775,2725675,-1796100,SELL
30-10-20 9:48,9:48,4507725,2718825,-1788900,SELL
30-10-20 9:49,9:49,4519650,2714275,-1805375,SELL
30-10-20 9:50,9:50,4570400,2767550,-1802850,SELL
30-10-20 9:51,9:51,4544875,2775225,-1769650,SELL
30-10-20 9:52,9:52,4543000,2777500,-1765500,SELL
30-10-20 9:53,9:53,4651000,2842525,-1808475,SELL
30-10-20 9:54,9:54,4637825,2848225,-1789600,SELL
30-10-20 9:55,9:55,4607350,2837575,-1769775,SELL
30-10-20 9:56,9:56,4755700,2914450,-1841250,SELL
30-10-20 9:57,9:57,4726550,2924100,-1802450,SELL
30-10-20 9:58,9:58,4731575,2924100,-1807475,SELL
30-10-20 9:59,9:59,4793400,2958975,-1834425,SELL
30-10-20 10:00,10:00,4797475,2971700,-1825775,SELL
30-10-20 10:01,10:01,4777900,2965950,-1811950,SELL
30-10-20 10:02,10:02,4832850,2998300,-1834550,SELL
30-10-20 10:03,10:03,4834300,2995850,-1838450,SELL
30-10-20 10:04,10:04,4831825,2995850,-1835975,SELL
30-10-20 10:05,10:05,4911950,3006950,-1905000,SELL
30-10-20 10:06,10:06,4922300,2990150,-1932150,SELL
30-10-20 10:07,10:07,4938250,3007600,-1930650,SELL
30-10-20 10:08,10:08,4966125,3026325,-1939800,SELL
30-10-20 10:09,10:09,4951875,3033475,-1918400,SELL
30-10-20 10:10,10:10,5004100,3034625,-1969475,SELL
30-10-20 10:11,10:11,5047225,3058325,-1988900,SELL
30-10-20 10:12,10:12,5060300,3053725,-2006575,SELL
30-10-20 10:13,10:13,5010650,3053725,-1956925,SELL
30-10-20 10:14,10:14,5120100,3072675,-2047425,SELL
30-10-20 10:15,10:15,5092500,3079775,-2012725,SELL
30-10-20 10:16,10:16,5093875,3075325,-2018550,SELL
30-10-20 10:17,10:17,5173250,3106950,-2066300,SELL
30-10-20 10:18,10:18,5175900,3103925,-2071975,SELL
30-10-20 10:19,10:19,5134000,3099825,-2034175,SELL
30-10-20 10:20,10:20,5217075,3153775,-2063300,SELL
30-10-20 10:21,10:21,5233675,3145625,-2088050,SELL
30-10-20 10:22,10:22,5201950,3138175,-2063775,SELL
30-10-20 10:23,10:23,5256025,3236775,-2019250,SELL
30-10-20 10:24,10:24,5268650,3238675,-2029975,SELL
30-10-20 10:25,10:25,5248450,3235700,-2012750,SELL
30-10-20 10:26,10:26,5340200,3296075,-2044125,SELL
30-10-20 10:27,10:27,5338100,3286500,-2051600,SELL
30-10-20 10:28,10:28,5336000,3279250,-2056750,SELL
30-10-20 10:29,10:29,5349025,3296450,-2052575,SELL
30-10-20 10:30,10:30,5381525,3305925,-2075600,SELL
30-10-20 10:31,10:31,5376675,3295000,-2081675,SELL
30-10-20 10:32,10:32,5352575,3281175,-2071400,SELL
30-10-20 10:33,10:33,5340625,3315025,-2025600,SELL
30-10-20 10:34,10:34,5357675,3305375,-2052300,SELL
30-10-20 10:35,10:35,5386150,3358000,-2028150,SELL
30-10-20 10:36,10:36,5373400,3339025,-2034375,SELL
30-10-20 10:37,10:37,5339125,3351250,-1987875,SELL
30-10-20 10:38,10:38,5363775,3372375,-1991400,SELL
30-10-20 10:39,10:39,5352075,3372450,-1979625,SELL
30-10-20 10:40,10:40,5392200,3384600,-2007600,SELL
30-10-20 10:41,10:41,5440825,3422625,-2018200,SELL
30-10-20 10:42,10:42,5442150,3424550,-2017600,SELL
30-10-20 10:43,10:43,5443600,3421150,-2022450,SELL
30-10-20 10:44,10:44,5469150,3461450,-2007700,SELL
30-10-20 10:45,10:45,5456200,3463675,-1992525,SELL
30-10-20 10:46,10:46,5480675,3464275,-2016400,SELL
30-10-20 10:47,10:47,5424300,3480850,-1943450,SELL
30-10-20 10:48,10:48,5394175,3459600,-1934575,SELL
30-10-20 10:49,10:49,5412150,3474875,-1937275,SELL
30-10-20 10:50,10:50,5488075,3497875,-1990200,SELL
30-10-20 10:51,10:51,5484650,3490275,-1994375,SELL
30-10-20 10:52,10:52,5449125,3472075,-1977050,SELL
30-10-20 10:53,10:53,5478050,3501250,-1976800,SELL
30-10-20 10:54,10:54,5482325,3500975,-1981350,SELL
30-10-20 10:55,10:55,5448125,3512350,-1935775,SELL
30-10-20 10:56,10:56,5491450,3483125,-2008325,SELL
30-10-20 10:57,10:57,5474900,3479450,-1995450,SELL
30-10-20 10:58,10:58,5491450,3475200,-2016250,SELL
30-10-20 10:59,10:59,5426050,3491900,-1934150,SELL
30-10-20 11:00,11:00,5478800,3505250,-1973550,SELL
30-10-20 11:01,11:01,5480625,3501300,-1979325,SELL
30-10-20 11:02,11:02,5478775,3407700,-2071075,SELL
30-10-20 11:03,11:03,5487850,3417350,-2070500,SELL
30-10-20 11:04,11:04,5487850,3400500,-2087350,SELL
30-10-20 11:05,11:05,5514175,3423750,-2090425,SELL
30-10-20 11:06,11:06,5508025,3426850,-2081175,SELL
30-10-20 11:07,11:07,5483625,3434575,-2049050,SELL
30-10-20 11:08,11:08,5525350,3415675,-2109675,SELL
30-10-20 11:09,11:09,5550225,3420400,-2129825,SELL
30-10-20 11:10,11:10,5562275,3419950,-2142325,SELL
30-10-20 11:11,11:11,5612425,3372250,-2240175,SELL
30-10-20 11:12,11:12,5611200,3367875,-2243325,SELL
30-10-20 11:13,11:13,5600500,3367875,-2232625,SELL
30-10-20 11:14,11:14,5653650,3404500,-2249150,SELL
30-10-20 11:15,11:15,5637050,3400700,-2236350,SELL
30-10-20 11:16,11:16,5639700,3406450,-2233250,SELL
30-10-20 11:17,11:17,5737875,3361325,-2376550,SELL
30-10-20 11:18,11:18,5720875,3361300,-2359575,SELL
30-10-20 11:19,11:19,5739375,3353750,-2385625,SELL
30-10-20 11:20,11:20,5833375,3369175,-2464200,SELL
30-10-20 11:21,11:21,5830900,3362850,-2468050,SELL
30-10-20 11:22,11:22,5831650,3366650,-2465000,SELL
30-10-20 11:23,11:23,5822300,3363550,-2458750,SELL
30-10-20 11:24,11:24,5757625,3357375,-2400250,SELL
30-10-20 11:25,11:25,5796675,3351650,-2445025,SELL
30-10-20 11:26,11:26,5869300,3361725,-2507575,SELL
30-10-20 11:27,11:27,5870050,3373000,-2497050,SELL
30-10-20 11:28,11:28,5850550,3367150,-2483400,SELL
30-10-20 11:29,11:29,5897175,3256575,-2640600,SELL
30-10-20 11:30,11:30,5916200,3254025,-2662175,SELL
30-10-20 11:31,11:31,5917775,3253850,-2663925,SELL
30-10-20 11:32,11:32,5975550,3235050,-2740500,SELL
30-10-20 11:33,11:33,5971600,3216925,-2754675,SELL
30-10-20 11:34,11:34,5973850,3227925,-2745925,SELL
30-10-20 11:35,11:35,5991850,3220625,-2771225,SELL
30-10-20 11:36,11:36,5997950,3232625,-2765325,SELL
30-10-20 11:37,11:37,5946425,3223075,-2723350,SELL
30-10-20 11:38,11:38,6033700,3145900,-2887800,SELL
30-10-20 11:39,11:39,6040050,3156850,-2883200,SELL
30-10-20 11:40,11:40,6051700,3155650,-2896050,SELL
30-10-20 11:41,11:41,6065625,3031725,-3033900,SELL
30-10-20 11:42,11:42,6029575,3018675,-3010900,SELL
30-10-20 11:43,11:43,6061800,3022500,-3039300,SELL
30-10-20 11:44,11:44,6023025,3043400,-2979625,SELL
30-10-20 11:45,11:45,6092350,3043300,-3049050,SELL
30-10-20 11:46,11:46,6076000,3039500,-3036500,SELL
30-10-20 11:47,11:47,6250975,2967925,-3283050,SELL
30-10-20 11:48,11:48,6248250,2967475,-3280775,SELL
30-10-20 11:49,11:49,6247450,2968425,-3279025,SELL
30-10-20 11:50,11:50,6297475,3012125,-3285350,SELL
30-10-20 11:51,11:51,6296300,3015800,-3280500,SELL
30-10-20 11:52,11:52,6292525,3011450,-3281075,SELL
30-10-20 11:53,11:53,6363675,3047250,-3316425,SELL
30-10-20 11:54,11:54,6308800,3047500,-3261300,SELL
30-10-20 11:55,11:55,6373725,3052700,-3321025,SELL
30-10-20 11:56,11:56,6412375,3041500,-3370875,SELL
30-10-20 11:57,11:57,6415625,3046700,-3368925,SELL
30-10-20 11:58,11:58,6415325,3042100,-3373225,SELL
30-10-20 11:59,11:59,6402275,3015325,-3386950,SELL
30-10-20 12:00,12:00,6401800,3017650,-3384150,SELL
30-10-20 12:01,12:01,6401625,2973900,-3427725,SELL
30-10-20 12:02,12:02,6364975,3028850,-3336125,SELL
30-10-20 12:03,12:03,6418450,3022550,-3395900,SELL
30-10-20 12:04,12:04,6437725,3024450,-3413275,SELL
30-10-20 12:05,12:05,6463550,3081650,-3381900,SELL
30-10-20 12:06,12:06,6459750,3092950,-3366800,SELL
30-10-20 12:07,12:07,6459750,3040300,-3419450,SELL
30-10-20 12:08,12:08,6474175,3076125,-3398050,SELL
30-10-20 12:09,12:09,6456050,3101400,-3354650,SELL
30-10-20 12:10,12:10,6473275,3092450,-3380825,SELL
30-10-20 12:11,12:11,6455625,3084400,-3371225,SELL
30-10-20 12:12,12:12,6506300,3116000,-3390300,SELL
30-10-20 12:13,12:13,6509075,3097950,-3411125,SELL
30-10-20 12:14,12:14,6517775,3134450,-3383325,SELL
30-10-20 12:15,12:15,6540750,3131900,-3408850,SELL
30-10-20 12:16,12:16,6502725,3090825,-3411900,SELL
30-10-20 12:17,12:17,6517525,3130800,-3386725,SELL
30-10-20 12:18,12:18,6586250,3147000,-3439250,SELL
30-10-20 12:19,12:19,6540275,3148375,-3391900,SELL
30-10-20 12:20,12:20,6556300,3140125,-3416175,SELL
30-10-20 12:21,12:21,6598675,3182525,-3416150,SELL
30-10-20 12:22,12:22,6600775,3145825,-3454950,SELL
30-10-20 12:23,12:23,6601075,3158275,-3442800,SELL
30-10-20 12:24,12:24,6606025,3188725,-3417300,SELL
30-10-20 12:25,12:25,6609250,3156425,-3452825,SELL
30-10-20 12:26,12:26,6657550,3162725,-3494825,SELL
30-10-20 12:27,12:27,6635575,3193175,-3442400,SELL
30-10-20 12:28,12:28,6661300,3169975,-3491325,SELL
30-10-20 12:29,12:29,6612075,3195500,-3416575,SELL
30-10-20 12:30,12:30,6612650,3193175,-3419475,SELL
30-10-20 12:31,12:31,6561875,3186575,-3375300,SELL
30-10-20 12:32,12:32,6584400,3199350,-3385050,SELL
30-10-20 12:33,12:33,6596050,3150000,-3446050,SELL
30-10-20 12:34,12:34,6598125,3202050,-3396075,SELL
30-10-20 12:35,12:35,6574075,3220275,-3353800,SELL
30-10-20 12:36,12:36,6589150,3208625,-3380525,SELL
30-10-20 12:37,12:37,6519575,3214000,-3305575,SELL
30-10-20 12:38,12:38,6575325,3189925,-3385400,SELL
30-10-20 12:39,12:39,6600500,3192825,-3407675,SELL
30-10-20 12:40,12:40,6591600,3188550,-3403050,SELL
30-10-20 12:41,12:41,6477325,3218075,-3259250,SELL
30-10-20 12:42,12:42,6540600,3179450,-3361150,SELL
30-10-20 12:43,12:43,6579350,3171800,-3407550,SELL
30-10-20 12:44,12:44,6538750,3212250,-3326500,SELL
30-10-20 12:45,12:45,6608600,3212050,-3396550,SELL
30-10-20 12:46,12:46,6610175,3187925,-3422250,SELL
30-10-20 12:47,12:47,6551975,3204625,-3347350,SELL
30-10-20 12:48,12:48,6600650,3197375,-3403275,SELL
30-10-20 12:49,12:49,6553750,3178675,-3375075,SELL
30-10-20 12:50,12:50,6623225,3213300,-3409925,SELL
30-10-20 12:51,12:51,6589800,3180725,-3409075,SELL
30-10-20 12:52,12:52,6622425,3188300,-3434125,SELL
30-10-20 12:53,12:53,6636100,3174800,-3461300,SELL
30-10-20 12:54,12:54,6683075,3224900,-3458175,SELL
30-10-20 12:55,12:55,6678300,3216425,-3461875,SELL
30-10-20 12:56,12:56,6649575,3149875,-3499700,SELL
30-10-20 12:57,12:57,6630625,3151700,-3478925,SELL
30-10-20 12:58,12:58,6676000,3142500,-3533500,SELL
30-10-20 12:59,12:59,6709075,3157725,-3551350,SELL
30-10-20 13:00,13:00,6686200,3162225,-3523975,SELL
30-10-20 13:01,13:01,6707775,3151850,-3555925,SELL
30-10-20 13:02,13:02,6715350,3165000,-3550350,SELL
30-10-20 13:03,13:03,6665700,3166650,-3499050,SELL
30-10-20 13:04,13:04,6710600,3143925,-3566675,SELL
30-10-20 13:05,13:05,6688650,3138200,-3550450,SELL
30-10-20 13:06,13:06,6677825,3175000,-3502825,SELL
30-10-20 13:07,13:07,6711750,3170400,-3541350,SELL
30-10-20 13:08,13:08,6693900,3174675,-3519225,SELL
30-10-20 13:09,13:09,6721400,3184075,-3537325,SELL
30-10-20 13:10,13:10,6721400,3177950,-3543450,SELL
30-10-20 13:11,13:11,6667925,3181500,-3486425,SELL
30-10-20 13:12,13:12,6730950,3139500,-3591450,SELL
30-10-20 13:13,13:13,6693350,3156625,-3536725,SELL
30-10-20 13:14,13:14,6642075,3120475,-3521600,SELL
30-10-20 13:15,13:15,6735925,3215525,-3520400,SELL
30-10-20 13:16,13:16,6700600,3207400,-3493200,SELL
30-10-20 13:17,13:17,6667800,3174475,-3493325,SELL
30-10-20 13:18,13:18,6748925,3194925,-3554000,SELL
30-10-20 13:19,13:19,6765100,3214950,-3550150,SELL
30-10-20 13:20,13:20,6681900,3225725,-3456175,SELL
30-10-20 13:21,13:21,6761050,3219625,-3541425,SELL
30-10-20 13:22,13:22,6736700,3194025,-3542675,SELL
30-10-20 13:23,13:23,6647575,3185125,-3462450,SELL
30-10-20 13:24,13:24,6672875,3156475,-3516400,SELL
30-10-20 13:25,13:25,6707950,3068250,-3639700,SELL
30-10-20 13:26,13:26,6664050,3184100,-3479950,SELL
30-10-20 13:27,13:27,6787025,3180450,-3606575,SELL
30-10-20 13:28,13:28,6781325,3194475,-3586850,SELL
30-10-20 13:29,13:29,6775275,3215600,-3559675,SELL
30-10-20 13:30,13:30,6746175,3180550,-3565625,SELL
30-10-20 13:31,13:31,6746200,3226050,-3520150,SELL
30-10-20 13:32,13:32,6732475,3221525,-3510950,SELL
30-10-20 13:33,13:33,6740750,3158300,-3582450,SELL
30-10-20 13:34,13:34,6703575,3151875,-3551700,SELL
30-10-20 13:35,13:35,6742600,3157725,-3584875,SELL
30-10-20 13:36,13:36,6827775,3122950,-3704825,SELL
30-10-20 13:37,13:37,6835050,3128800,-3706250,SELL
30-10-20 13:38,13:38,6794575,3084600,-3709975,SELL
30-10-20 13:39,13:39,6785275,3090925,-3694350,SELL
30-10-20 13:40,13:40,6837175,3134700,-3702475,SELL
30-10-20 13:41,13:41,6813700,3115125,-3698575,SELL
30-10-20 13:42,13:42,6817275,3092000,-3725275,SELL
30-10-20 13:43,13:43,6849025,3092925,-3756100,SELL
30-10-20 13:44,13:44,6823600,3087725,-3735875,SELL
30-10-20 13:45,13:45,6783100,3156550,-3626550,SELL
30-10-20 13:46,13:46,6841950,3153450,-3688500,SELL
30-10-20 13:47,13:47,6787250,3150775,-3636475,SELL
30-10-20 13:48,13:48,6785450,3108575,-3676875,SELL
30-10-20 13:49,13:49,6776050,3072925,-3703125,SELL
30-10-20 13:50,13:50,6806350,3082500,-3723850,SELL
30-10-20 13:51,13:51,6803175,3060100,-3743075,SELL
30-10-20 13:52,13:52,6802500,3112550,-3689950,SELL
30-10-20 13:53,13:53,6804900,3109875,-3695025,SELL
30-10-20 13:54,13:54,6776200,3096600,-3679600,SELL
30-10-20 13:55,13:55,6729250,3066875,-3662375,SELL
30-10-20 13:56,13:56,6776200,3102125,-3674075,SELL
30-10-20 13:57,13:57,6730250,3109800,-3620450,SELL
30-10-20 13:58,13:58,6782300,3116450,-3665850,SELL
30-10-20 13:59,13:59,6769450,3089825,-3679625,SELL
30-10-20 14:00,14:00,6769350,3147650,-3621700,SELL
30-10-20 14:01,14:01,6767600,3138725,-3628875,SELL
30-10-20 14:02,14:02,6792925,3148350,-3644575,SELL
30-10-20 14:03,14:03,6776175,3152200,-3623975,SELL
30-10-20 14:04,14:04,6807225,3153175,-3654050,SELL
30-10-20 14:05,14:05,6755700,3138750,-3616950,SELL
30-10-20 14:06,14:06,6757375,3130875,-3626500,SELL
30-10-20 14:07,14:07,6780475,3136950,-3643525,SELL
30-10-20 14:08,14:08,6762450,3118450,-3644000,SELL
30-10-20 14:09,14:09,6711475,3137900,-3573575,SELL
30-10-20 14:10,14:10,6741625,3135250,-3606375,SELL
30-10-20 14:11,14:11,6726175,3130375,-3595800,SELL
30-10-20 14:12,14:12,6678575,3146100,-3532475,SELL
30-10-20 14:13,14:13,6658300,3141250,-3517050,SELL
30-10-20 14:14,14:14,6706450,3142700,-3563750,SELL
30-10-20 14:15,14:15,6718100,3170200,-3547900,SELL
30-10-20 14:16,14:16,6720375,3169400,-3550975,SELL
30-10-20 14:17,14:17,6720025,3175975,-3544050,SELL
30-10-20 14:18,14:18,6678575,3187025,-3491550,SELL
30-10-20 14:19,14:19,6636225,3186875,-3449350,SELL
30-10-20 14:20,14:20,6617275,3175725,-3441550,SELL
30-10-20 14:21,14:21,6655525,3174450,-3481075,SELL
30-10-20 14:22,14:22,6658125,3207875,-3450250,SELL
30-10-20 14:23,14:23,6644650,3172750,-3471900,SELL
30-10-20 14:24,14:24,6717700,3220600,-3497100,SELL
30-10-20 14:25,14:25,6694125,3211150,-3482975,SELL
30-10-20 14:26,14:26,6672050,3206025,-3466025,SELL
30-10-20 14:27,14:27,6621600,3215800,-3405800,SELL
30-10-20 14:28,14:28,6638725,3223175,-3415550,SELL
30-10-20 14:29,14:29,6605350,3215800,-3389550,SELL
30-10-20 14:30,14:30,6664100,3238800,-3425300,SELL
30-10-20 14:31,14:31,6573400,3202775,-3370625,SELL
30-10-20 14:32,14:32,6621575,3220950,-3400625,SELL
30-10-20 14:33,14:33,6682350,3230575,-3451775,SELL
30-10-20 14:34,14:34,6660850,3204800,-3456050,SELL
30-10-20 14:35,14:35,6661800,3231025,-3430775,SELL
30-10-20 14:36,14:36,6669175,3217350,-3451825,SELL
30-10-20 14:37,14:37,6692375,3206650,-3485725,SELL
30-10-20 14:38,14:38,6689575,3206650,-3482925,SELL
30-10-20 14:39,14:39,6677000,3235475,-3441525,SELL
30-10-20 14:40,14:40,6692125,3227475,-3464650,SELL
30-10-20 14:41,14:41,6692325,3235550,-3456775,SELL
30-10-20 14:42,14:42,6697100,3238700,-3458400,SELL
30-10-20 14:43,14:43,6695050,3205875,-3489175,SELL
30-10-20 14:44,14:44,6690325,3223725,-3466600,SELL
30-10-20 14:45,14:45,6708525,3185950,-3522575,SELL
30-10-20 14:46,14:46,6708525,3186800,-3521725,SELL
30-10-20 14:47,14:47,6684425,3182500,-3501925,SELL
30-10-20 14:48,14:48,6705225,3211400,-3493825,SELL
30-10-20 14:49,14:49,6733250,3215825,-3517425,SELL
30-10-20 14:50,14:50,6728900,3202875,-3526025,SELL
30-10-20 14:51,14:51,6690200,3245150,-3445050,SELL
30-10-20 14:52,14:52,6717275,3229375,-3487900,SELL
30-10-20 14:53,14:53,6720175,3236700,-3483475,SELL
30-10-20 14:54,14:54,6708325,3223525,-3484800,SELL
30-10-20 14:55,14:55,6710825,3225300,-3485525,SELL
30-10-20 14:56,14:56,6706050,3217625,-3488425,SELL
30-10-20 14:57,14:57,6727175,3200800,-3526375,SELL
30-10-20 14:58,14:58,6746125,3187125,-3559000,SELL
30-10-20 14:59,14:59,6727750,3200150,-3527600,SELL
30-10-20 15:00,15:00,6689275,3193150,-3496125,SELL
30-10-20 15:01,15:01,6679925,3186625,-3493300,SELL
30-10-20 15:02,15:02,6674800,3178450,-3496350,SELL
30-10-20 15:03,15:03,6608625,3148200,-3460425,SELL
30-10-20 15:04,15:04,6617075,3149850,-3467225,SELL
30-10-20 15:05,15:05,6551650,3148075,-3403575,SELL
30-10-20 15:06,15:06,6554525,3096425,-3458100,SELL
30-10-20 15:07,15:07,6578050,3130100,-3447950,SELL
30-10-20 15:08,15:08,6583250,3122025,-3461225,SELL
30-10-20 15:09,15:09,6538525,3086225,-3452300,SELL
30-10-20 15:10,15:10,6548600,3092375,-3456225,SELL
30-10-20 15:11,15:11,6533525,3080625,-3452900,SELL
30-10-20 15:12,15:12,6494825,3045100,-3449725,SELL
30-10-20 15:13,15:13,6493250,3045100,-3448150,SELL
30-10-20 15:14,15:14,6479575,3049350,-3430225,SELL
30-10-20 15:15,15:15,6426350,3010800,-3415550,SELL
30-10-20 15:16,15:16,6418275,3011575,-3406700,SELL
30-10-20 15:17,15:17,6367500,3007775,-3359725,SELL
30-10-20 15:18,15:18,6340375,2945175,-3395200,SELL
30-10-20 15:19,15:19,6360600,2957025,-3403575,SELL
30-10-20 15:20,15:20,6352425,2961750,-3390675,SELL
30-10-20 15:21,15:21,6176675,2870300,-3306375,SELL
30-10-20 15:22,15:22,6160625,2858550,-3302075,SELL
30-10-20 15:23,15:23,6164675,2820675,-3344000,SELL
30-10-20 15:24,15:24,6075000,2822900,-3252100,SELL
30-10-20 15:25,15:25,6092950,2843650,-3249300,SELL
30-10-20 15:26,15:26,6080450,2837250,-3243200,SELL
30-10-20 15:27,15:27,5912525,2811125,-3101400,SELL
30-10-20 15:28,15:28,5902800,2793675,-3109125,SELL
30-10-20 15:29,15:29,5912500,2803225,-3109275,SELL
02-11-20 9:15,9:15,5789475,2741675,-3047800,SELL
02-11-20 9:16,9:16,5783725,2738300,-3045425,SELL
02-11-20 9:17,9:17,5977150,3084600,-2892550,SELL
02-11-20 9:18,9:18,5973925,3080950,-2892975,SELL
02-11-20 9:19,9:19,5973925,3082750,-2891175,SELL
02-11-20 9:20,9:20,6245975,3506050,-2739925,SELL
02-11-20 9:21,9:21,6246525,3509200,-2737325,SELL
02-11-20 9:22,9:22,6249700,3505000,-2744700,SELL
02-11-20 9:23,9:23,6334000,3905650,-2428350,SELL
02-11-20 9:24,9:24,6337425,3902400,-2435025,SELL
02-11-20 9:25,9:25,6330300,3899550,-2430750,SELL
02-11-20 9:26,9:26,6407100,3989275,-2417825,SELL
02-11-20 9:27,9:27,6421625,3982225,-2439400,SELL
02-11-20 9:28,9:28,6402700,3983700,-2419000,SELL
02-11-20 9:29,9:29,6444725,4052725,-2392000,SELL
02-11-20 9:30,9:30,6442150,4052725,-2389425,SELL
02-11-20 9:31,9:31,6444725,4049900,-2394825,SELL
02-11-20 9:32,9:32,6538550,4223425,-2315125,SELL
02-11-20 9:33,9:33,6529025,4223425,-2305600,SELL
02-11-20 9:34,9:34,6505625,4220525,-2285100,SELL
02-11-20 9:35,9:35,6605175,4384425,-2220750,SELL
02-11-20 9:36,9:36,6613825,4384425,-2229400,SELL
02-11-20 9:37,9:37,6597750,4386525,-2211225,SELL
02-11-20 9:38,9:38,6660700,4564475,-2096225,SELL
02-11-20 9:39,9:39,6684700,4564475,-2120225,SELL
02-11-20 9:40,9:40,6679400,4564475,-2114925,SELL
02-11-20 9:41,9:41,6678600,4658100,-2020500,SELL
02-11-20 9:42,9:42,6729125,4666075,-2063050,SELL
02-11-20 9:43,9:43,6729550,4659125,-2070425,SELL
02-11-20 9:44,9:44,6751875,4740200,-2011675,SELL
02-11-20 9:45,9:45,6739825,4710400,-2029425,SELL
02-11-20 9:46,9:46,6707725,4730525,-1977200,SELL
02-11-20 9:47,9:47,6784250,4804650,-1979600,SELL
02-11-20 9:48,9:48,6725600,4803575,-1922025,SELL
02-11-20 9:49,9:49,6793100,4798775,-1994325,SELL
02-11-20 9:50,9:50,6805025,4834725,-1970300,SELL
02-11-20 9:51,9:51,6776575,4847450,-1929125,SELL
02-11-20 9:52,9:52,6761075,4826700,-1934375,SELL
02-11-20 9:53,9:53,6860350,4928675,-1931675,SELL
02-11-20 9:54,9:54,6816800,4926150,-1890650,SELL
02-11-20 9:55,9:55,6798725,4923125,-1875600,SELL
02-11-20 9:56,9:56,6931150,4976275,-1954875,SELL
02-11-20 9:57,9:57,6914275,4978875,-1935400,SELL
02-11-20 9:58,9:58,6475700,4976950,-1498750,SELL
02-11-20 9:59,9:59,6943200,4993600,-1949600,SELL
02-11-20 10:00,10:00,6945350,4997525,-1947825,SELL
02-11-20 10:01,10:01,6935175,4997950,-1937225,SELL
02-11-20 10:02,10:02,6972600,5062875,-1909725,SELL
02-11-20 10:03,10:03,6988825,5056475,-1932350,SELL
02-11-20 10:04,10:04,6990000,5066925,-1923075,SELL
02-11-20 10:05,10:05,6959500,5094700,-1864800,SELL
02-11-20 10:06,10:06,6955850,5094200,-1861650,SELL
02-11-20 10:07,10:07,6957375,5090800,-1866575,SELL
02-11-20 10:08,10:08,6937925,5188350,-1749575,SELL
02-11-20 10:09,10:09,6967350,5181825,-1785525,SELL
02-11-20 10:10,10:10,6944125,5182300,-1761825,SELL
02-11-20 10:11,10:11,6990175,5264550,-1725625,SELL
02-11-20 10:12,10:12,6940000,5264800,-1675200,SELL
02-11-20 10:13,10:13,6950000,5272850,-1677150,SELL
02-11-20 10:14,10:14,6885150,5249950,-1635200,SELL
02-11-20 10:15,10:15,6977950,5266775,-1711175,SELL
02-11-20 10:16,10:16,6998900,5266200,-1732700,SELL
02-11-20 10:17,10:17,6765375,5387225,-1378150,SELL
02-11-20 10:18,10:18,6817100,5388525,-1428575,SELL
02-11-20 10:19,10:19,6812025,5388350,-1423675,SELL
02-11-20 10:20,10:20,6906875,5472725,-1434150,SELL
02-11-20 10:21,10:21,6854875,5454725,-1400150,SELL
02-11-20 10:22,10:22,6878150,5455800,-1422350,SELL
02-11-20 10:23,10:23,6953700,5537375,-1416325,SELL
02-11-20 10:24,10:24,6947700,5534400,-1413300,SELL
02-11-20 10:25,10:25,6947700,5536250,-1411450,SELL
02-11-20 10:26,10:26,6920875,5524950,-1395925,SELL
02-11-20 10:27,10:27,6873350,5538800,-1334550,SELL
02-11-20 10:28,10:28,6911725,5519375,-1392350,SELL
02-11-20 10:29,10:29,6958550,5582950,-1375600,SELL
02-11-20 10:30,10:30,6987575,5585925,-1401650,SELL
02-11-20 10:31,10:31,6981150,5582950,-1398200,SELL
02-11-20 10:32,10:32,6974250,5659625,-1314625,SELL
02-11-20 10:33,10:33,6906725,5609125,-1297600,SELL
02-11-20 10:34,10:34,7013100,5659750,-1353350,SELL
02-11-20 10:35,10:35,6951950,5718925,-1233025,SELL
02-11-20 10:36,10:36,6891500,5720750,-1170750,SELL
02-11-20 10:37,10:37,6956050,5725225,-1230825,SELL
02-11-20 10:38,10:38,6984375,5826375,-1158000,SELL
02-11-20 10:39,10:39,6987675,5834625,-1153050,SELL
02-11-20 10:40,10:40,6986675,5836800,-1149875,SELL
02-11-20 10:41,10:41,7011425,5898175,-1113250,SELL
02-11-20 10:42,10:42,6970025,5909050,-1060975,SELL
02-11-20 10:43,10:43,7026825,5909050,-1117775,SELL
02-11-20 10:44,10:44,7002300,5977175,-1025125,SELL
02-11-20 10:45,10:45,7041475,5973700,-1067775,SELL
02-11-20 10:46,10:46,7064200,5981475,-1082725,SELL
02-11-20 10:47,10:47,7037975,6010375,-1027600,SELL
02-11-20 10:48,10:48,7019550,5997450,-1022100,SELL
02-11-20 10:49,10:49,7024775,6006250,-1018525,SELL
02-11-20 10:50,10:50,6962475,6011275,-951200,SELL
02-11-20 10:51,10:51,6968400,5996100,-972300,SELL
02-11-20 10:52,10:52,6916975,5990825,-926150,SELL
02-11-20 10:53,10:53,6839025,6086550,-752475,SELL
02-11-20 10:54,10:54,7000600,6090725,-909875,SELL
02-11-20 10:55,10:55,7013300,6087525,-925775,SELL
02-11-20 10:56,10:56,6963950,6124575,-839375,SELL
02-11-20 10:57,10:57,6901050,6128400,-772650,SELL
02-11-20 10:58,10:58,7010475,6097750,-912725,SELL
02-11-20 10:59,10:59,7008775,6147500,-861275,SELL
02-11-20 11:00,11:00,7056975,6143775,-913200,SELL
02-11-20 11:01,11:01,7050200,6163400,-886800,SELL
02-11-20 11:02,11:02,7035675,6148975,-886700,SELL
02-11-20 11:03,11:03,7056625,6161175,-895450,SELL
02-11-20 11:04,11:04,6919075,6157150,-761925,SELL
02-11-20 11:05,11:05,7105075,6199050,-906025,SELL
02-11-20 11:06,11:06,7014200,6211250,-802950,SELL
02-11-20 11:07,11:07,7003675,6202050,-801625,SELL
02-11-20 11:08,11:08,7111350,6248400,-862950,SELL
02-11-20 11:09,11:09,7065425,6243875,-821550,SELL
02-11-20 11:10,11:10,7081875,6255825,-826050,SELL
02-11-20 11:11,11:11,7102550,6289475,-813075,SELL
02-11-20 11:12,11:12,7071300,6290725,-780575,SELL
02-11-20 11:13,11:13,7098175,6284525,-813650,SELL
02-11-20 11:14,11:14,7157525,6346950,-810575,SELL
02-11-20 11:15,11:15,7155050,6351175,-803875,SELL
02-11-20 11:16,11:16,7158425,6351825,-806600,SELL
02-11-20 11:17,11:17,6997650,6448700,-548950,SELL
02-11-20 11:18,11:18,6981900,6442900,-539000,SELL
02-11-20 11:19,11:19,6967275,6439775,-527500,SELL
02-11-20 11:20,11:20,6936875,6506375,-430500,SELL
02-11-20 11:21,11:21,6903375,6489450,-413925,SELL
02-11-20 11:22,11:22,6932750,6501250,-431500,SELL
02-11-20 11:23,11:23,6910200,6569800,-340400,SELL
02-11-20 11:24,11:24,6945350,6566925,-378425,SELL
02-11-20 11:25,11:25,6889075,6573400,-315675,SELL
02-11-20 11:26,11:26,6861550,6671650,-189900,SELL
02-11-20 11:27,11:27,7021425,6660350,-361075,SELL
02-11-20 11:28,11:28,6831525,6660175,-171350,SELL
02-11-20 11:29,11:29,6963675,6658575,-305100,SELL
02-11-20 11:30,11:30,6962775,6662375,-300400,SELL
02-11-20 11:31,11:31,7058600,6659250,-399350,SELL
02-11-20 11:32,11:32,7008450,6701350,-307100,SELL
02-11-20 11:33,11:33,7032675,6701150,-331525,SELL
02-11-20 11:34,11:34,6990800,6702900,-287900,SELL
02-11-20 11:35,11:35,6984050,6718500,-265550,SELL
02-11-20 11:36,11:36,7039200,6730775,-308425,SELL
02-11-20 11:37,11:37,7054750,6728300,-326450,SELL
02-11-20 11:38,11:38,7031125,6739475,-291650,SELL
02-11-20 11:39,11:39,6877800,6761550,-116250,SELL
02-11-20 11:40,11:40,7001025,6750275,-250750,SELL
02-11-20 11:41,11:41,6957325,6740825,-216500,SELL
02-11-20 11:42,11:42,7000700,6745500,-255200,SELL
02-11-20 11:43,11:43,7022450,6730200,-292250,SELL
02-11-20 11:44,11:44,7026700,6756075,-270625,SELL
02-11-20 11:45,11:45,7113450,6762500,-350950,SELL
02-11-20 11:46,11:46,7069000,6747300,-321700,SELL
02-11-20 11:47,11:47,7094275,6790275,-304000,SELL
02-11-20 11:48,11:48,6989150,6772850,-216300,SELL
02-11-20 11:49,11:49,7029525,6780225,-249300,SELL
02-11-20 11:50,11:50,7090750,6851575,-239175,SELL
02-11-20 11:51,11:51,7045500,6842325,-203175,SELL
02-11-20 11:52,11:52,7094675,6857300,-237375,SELL
02-11-20 11:53,11:53,7127675,6874625,-253050,SELL
02-11-20 11:54,11:54,7036975,6881375,-155600,SELL
02-11-20 11:55,11:55,7163125,6872175,-290950,SELL
02-11-20 11:56,11:56,7063875,6879375,-184500,SELL
02-11-20 11:57,11:57,6970225,6891600,-78625,SELL
02-11-20 11:58,11:58,7138175,6891800,-246375,SELL
02-11-20 11:59,11:59,7128300,6889350,-238950,SELL
02-11-20 12:00,12:00,7223150,6908075,-315075,SELL
02-11-20 12:01,12:01,7176825,6887075,-289750,SELL
02-11-20 12:02,12:02,7107050,6899150,-207900,SELL
02-11-20 12:03,12:03,7098600,6917450,-181150,SELL
02-11-20 12:04,12:04,7105575,6902900,-202675,SELL
02-11-20 12:05,12:05,7138900,6902200,-236700,SELL
02-11-20 12:06,12:06,7193150,6904750,-288400,SELL
02-11-20 12:07,12:07,7012925,6904100,-108825,SELL
02-11-20 12:08,12:08,7141000,6919525,-221475,SELL
02-11-20 12:09,12:09,7170525,6920225,-250300,SELL
02-11-20 12:10,12:10,7144650,6923025,-221625,SELL
02-11-20 12:11,12:11,7053175,6953400,-99775,SELL
02-11-20 12:12,12:12,7154275,6953500,-200775,SELL
02-11-20 12:13,12:13,7189625,6931975,-257650,SELL
02-11-20 12:14,12:14,7134200,6940725,-193475,SELL
02-11-20 12:15,12:15,7138825,6965475,-173350,SELL
02-11-20 12:16,12:16,7035400,6950475,-84925,SELL
02-11-20 12:17,12:17,7158025,6987300,-170725,SELL
02-11-20 12:18,12:18,7099400,6994500,-104900,SELL
02-11-20 12:19,12:19,6995225,6991850,-3375,SELL
02-11-20 12:20,12:20,7200325,7022625,-177700,SELL
02-11-20 12:21,12:21,7204150,7017525,-186625,SELL
02-11-20 12:22,12:22,7113100,7007700,-105400,SELL
02-11-20 12:23,12:23,7207550,7050850,-156700,SELL
02-11-20 12:24,12:24,7140325,7045150,-95175,SELL
02-11-20 12:25,12:25,7088275,7055250,-33025,SELL
02-11-20 12:26,12:26,7212125,7075400,-136725,SELL
02-11-20 12:27,12:27,7276725,7076725,-200000,SELL
02-11-20 12:28,12:28,7182400,7052075,-130325,SELL
02-11-20 12:29,12:29,7105525,7068525,-37000,SELL
02-11-20 12:30,12:30,7162175,7060000,-102175,SELL
02-11-20 12:31,12:31,7041000,7054500,13500,BUY
02-11-20 12:32,12:32,7102975,7093425,-9550,SELL
02-11-20 12:33,12:33,7065025,7121450,56425,BUY
02-11-20 12:34,12:34,7156800,7116375,-40425,SELL
02-11-20 12:35,12:35,7178850,7174975,-3875,SELL
02-11-20 12:36,12:36,7235375,7158875,-76500,SELL
02-11-20 12:37,12:37,7183250,7150375,-32875,SELL
02-11-20 12:38,12:38,7238600,7183975,-54625,SELL
02-11-20 12:39,12:39,7262950,7190850,-72100,SELL
02-11-20 12:40,12:40,7172675,7201000,28325,BUY
02-11-20 12:41,12:41,7217950,7196225,-21725,SELL
02-11-20 12:42,12:42,7170850,7186075,15225,BUY
02-11-20 12:43,12:43,7210250,7181475,-28775,SELL
02-11-20 12:44,12:44,7199875,7191100,-8775,SELL
02-11-20 12:45,12:45,7214175,7212050,-2125,SELL
02-11-20 12:46,12:46,7282750,7198525,-84225,SELL
02-11-20 12:47,12:47,7119425,7237325,117900,BUY
02-11-20 12:48,12:48,7066600,7236575,169975,BUY
02-11-20 12:49,12:49,7069925,7236575,166650,BUY
02-11-20 12:50,12:50,7056300,7280250,223950,BUY
02-11-20 12:51,12:51,7098475,7274825,176350,BUY
02-11-20 12:52,12:52,7055875,7270750,214875,BUY
02-11-20 12:53,12:53,7139075,7300575,161500,BUY
02-11-20 12:54,12:54,7051450,7302550,251100,BUY
02-11-20 12:55,12:55,7110575,7302500,191925,BUY
02-11-20 12:56,12:56,7080100,7308550,228450,BUY
02-11-20 12:57,12:57,7035450,7304575,269125,BUY
02-11-20 12:58,12:58,7044125,7310150,266025,BUY
02-11-20 12:59,12:59,7100150,7306975,206825,BUY
02-11-20 13:00,13:00,7114725,7299825,185100,BUY
02-11-20 13:01,13:01,7088750,7303075,214325,BUY
02-11-20 13:02,13:02,7124225,7349100,224875,BUY
02-11-20 13:03,13:03,7142925,7332475,189550,BUY
02-11-20 13:04,13:04,7122425,7357875,235450,BUY
02-11-20 13:05,13:05,7099275,7317050,217775,BUY
02-11-20 13:06,13:06,7114675,7291900,177225,BUY
02-11-20 13:07,13:07,7039125,7303850,264725,BUY
02-11-20 13:08,13:08,7113250,7301775,188525,BUY
02-11-20 13:09,13:09,7098975,7334800,235825,BUY
02-11-20 13:10,13:10,7042325,7316375,274050,BUY
02-11-20 13:11,13:11,7169300,7369675,200375,BUY
02-11-20 13:12,13:12,7181200,7362025,180825,BUY
02-11-20 13:13,13:13,7176700,7350100,173400,BUY
02-11-20 13:14,13:14,7209100,7384875,175775,BUY
02-11-20 13:15,13:15,7233000,7399350,166350,BUY
02-11-20 13:16,13:16,7174775,7387425,212650,BUY
02-11-20 13:17,13:17,7205775,7452500,246725,BUY
02-11-20 13:18,13:18,7191800,7487325,295525,BUY
02-11-20 13:19,13:19,7272350,7492525,220175,BUY
02-11-20 13:20,13:20,7249875,7504425,254550,BUY
02-11-20 13:21,13:21,7136425,7513850,377425,BUY
02-11-20 13:22,13:22,7209225,7501075,291850,BUY
02-11-20 13:23,13:23,7178450,7511900,333450,BUY
02-11-20 13:24,13:24,7263300,7596650,333350,BUY
02-11-20 13:25,13:25,7289200,7573500,284300,BUY
02-11-20 13:26,13:26,7137750,7594475,456725,BUY
02-11-20 13:27,13:27,7263275,7633725,370450,BUY
02-11-20 13:28,13:28,7162000,7627400,465400,BUY
02-11-20 13:29,13:29,7273025,7632900,359875,BUY
02-11-20 13:30,13:30,7274400,7648050,373650,BUY
02-11-20 13:31,13:31,7312875,7661450,348575,BUY
02-11-20 13:32,13:32,7279875,7660650,380775,BUY
02-11-20 13:33,13:33,7314925,7635375,320450,BUY
02-11-20 13:34,13:34,7318000,7625275,307275,BUY
02-11-20 13:35,13:35,7358750,7636525,277775,BUY
02-11-20 13:36,13:36,7384225,7622350,238125,BUY
02-11-20 13:37,13:37,7343075,7612325,269250,BUY
02-11-20 13:38,13:38,7348550,7623625,275075,BUY
02-11-20 13:39,13:39,7371450,7699350,327900,BUY
02-11-20 13:40,13:40,7365475,7700500,335025,BUY
02-11-20 13:41,13:41,7364325,7710525,346200,BUY
02-11-20 13:42,13:42,7406100,7751925,345825,BUY
02-11-20 13:43,13:43,7328075,7754500,426425,BUY
02-11-20 13:44,13:44,7331350,7768225,436875,BUY
02-11-20 13:45,13:45,7421025,7769325,348300,BUY
02-11-20 13:46,13:46,7395225,7773200,377975,BUY
02-11-20 13:47,13:47,7405500,7755300,349800,BUY
02-11-20 13:48,13:48,7512350,7833725,321375,BUY
02-11-20 13:49,13:49,7469175,7813550,344375,BUY
02-11-20 13:50,13:50,7574550,7834875,260325,BUY
02-11-20 13:51,13:51,7512400,7818625,306225,BUY
02-11-20 13:52,13:52,7574900,7826450,251550,BUY
02-11-20 13:53,13:53,7529775,7819525,289750,BUY
02-11-20 13:54,13:54,7403175,7763825,360650,BUY
02-11-20 13:55,13:55,7285175,7774350,489175,BUY
02-11-20 13:56,13:56,7403175,7755600,352425,BUY
02-11-20 13:57,13:57,7466925,7762475,295550,BUY
02-11-20 13:58,13:58,7388600,7766400,377800,BUY
02-11-20 13:59,13:59,7471325,7756375,285050,BUY
02-11-20 14:00,14:00,7478700,7782275,303575,BUY
02-11-20 14:01,14:01,7481875,7771500,289625,BUY
02-11-20 14:02,14:02,7397800,7772900,375100,BUY
02-11-20 14:03,14:03,7424725,7766925,342200,BUY
02-11-20 14:04,14:04,7455525,7751900,296375,BUY
02-11-20 14:05,14:05,7466800,7772975,306175,BUY
02-11-20 14:06,14:06,7512175,7739325,227150,BUY
02-11-20 14:07,14:07,7437800,7748725,310925,BUY
02-11-20 14:08,14:08,7450800,7735175,284375,BUY
02-11-20 14:09,14:09,7439725,7768250,328525,BUY
02-11-20 14:10,14:10,7616025,7784900,168875,BUY
02-11-20 14:11,14:11,7609575,7771400,161825,BUY
02-11-20 14:12,14:12,7402450,7818900,416450,BUY
02-11-20 14:13,14:13,7463925,7805325,341400,BUY
02-11-20 14:14,14:14,7439675,7818750,379075,BUY
02-11-20 14:15,14:15,7566275,7829950,263675,BUY
02-11-20 14:16,14:16,7578800,7830000,251200,BUY
02-11-20 14:17,14:17,7534600,7831950,297350,BUY
02-11-20 14:18,14:18,7251700,7663725,412025,BUY
02-11-20 14:19,14:19,7232275,7660025,427750,BUY
02-11-20 14:20,14:20,7247600,7661700,414100,BUY
02-11-20 14:21,14:21,7206700,7595325,388625,BUY
02-11-20 14:22,14:22,7170750,7594600,423850,BUY
02-11-20 14:23,14:23,7176725,7601225,424500,BUY
02-11-20 14:24,14:24,7155750,7598250,442500,BUY
02-11-20 14:25,14:25,7124900,7595700,470800,BUY
02-11-20 14:26,14:26,7159500,7598350,438850,BUY
02-11-20 14:27,14:27,7100500,7625550,525050,BUY
02-11-20 14:28,14:28,7115550,7634475,518925,BUY
02-11-20 14:29,14:29,7078350,7632175,553825,BUY
02-11-20 14:30,14:30,6996900,7669050,672150,BUY
02-11-20 14:31,14:31,6969375,7669050,699675,BUY
02-11-20 14:32,14:32,7073325,7665925,592600,BUY
02-11-20 14:33,14:33,7026200,7742600,716400,BUY
02-11-20 14:34,14:34,6975125,7746075,770950,BUY
02-11-20 14:35,14:35,6988650,7742675,754025,BUY
02-11-20 14:36,14:36,6967925,7725600,757675,BUY
02-11-20 14:37,14:37,6984950,7720500,735550,BUY
02-11-20 14:38,14:38,6974000,7719700,745700,BUY
02-11-20 14:39,14:39,6964000,7718525,754525,BUY
02-11-20 14:40,14:40,7006750,7726900,720150,BUY
02-11-20 14:41,14:41,7044325,7726900,682575,BUY
02-11-20 14:42,14:42,7018600,7755725,737125,BUY
02-11-20 14:43,14:43,7104325,7762675,658350,BUY
02-11-20 14:44,14:44,7072850,7758025,685175,BUY
02-11-20 14:45,14:45,7099575,7762525,662950,BUY
02-11-20 14:46,14:46,7110500,7769125,658625,BUY
02-11-20 14:47,14:47,7103675,7752000,648325,BUY
02-11-20 14:48,14:48,7067875,7767375,699500,BUY
02-11-20 14:49,14:49,7069400,7763525,694125,BUY
02-11-20 14:50,14:50,7056125,7763525,707400,BUY
02-11-20 14:51,14:51,7059700,7769175,709475,BUY
02-11-20 14:52,14:52,7051000,7772875,721875,BUY
02-11-20 14:53,14:53,6980275,7757950,777675,BUY
02-11-20 14:54,14:54,7038375,7747650,709275,BUY
02-11-20 14:55,14:55,7001275,7749350,748075,BUY
02-11-20 14:56,14:56,6944925,7748175,803250,BUY
02-11-20 14:57,14:57,6943900,7673150,729250,BUY
02-11-20 14:58,14:58,6888300,7676100,787800,BUY
02-11-20 14:59,14:59,6971875,7671550,699675,BUY
02-11-20 15:00,15:00,6919025,7659150,740125,BUY
02-11-20 15:01,15:01,6845575,7654575,809000,BUY
02-11-20 15:02,15:02,6835425,7658225,822800,BUY
02-11-20 15:03,15:03,6852225,7523700,671475,BUY
02-11-20 15:04,15:04,6683750,7523800,840050,BUY
02-11-20 15:05,15:05,6849875,7530275,680400,BUY
02-11-20 15:06,15:06,6809800,7435375,625575,BUY
02-11-20 15:07,15:07,6674975,7428075,753100,BUY
02-11-20 15:08,15:08,6708500,7436650,728150,BUY
02-11-20 15:09,15:09,6641125,7243800,602675,BUY
02-11-20 15:10,15:10,6653175,7244000,590825,BUY
02-11-20 15:11,15:11,6565650,7228000,662350,BUY
02-11-20 15:13,15:13,6661750,7171725,509975,BUY
02-11-20 15:14,15:14,6625700,7171350,545650,BUY
02-11-20 15:15,15:15,6688675,7069125,380450,BUY
02-11-20 15:16,15:16,6671100,7071100,400000,BUY
02-11-20 15:17,15:17,6712575,7065050,352475,BUY
02-11-20 15:18,15:18,6639475,6853225,213750,BUY
02-11-20 15:19,15:19,6566725,6857975,291250,BUY
02-11-20 15:20,15:20,6643150,6858975,215825,BUY
02-11-20 15:21,15:21,6531675,6758450,226775,BUY
02-11-20 15:22,15:22,6477100,6750775,273675,BUY
02-11-20 15:23,15:23,6492175,6749450,257275,BUY
02-11-20 15:24,15:24,6460925,6697100,236175,BUY
02-11-20 15:25,15:25,6499475,6700575,201100,BUY
02-11-20 15:26,15:26,6391475,6691925,300450,BUY
02-11-20 15:27,15:27,6346875,6493325,146450,BUY
02-11-20 15:28,15:28,6342050,6479275,137225,BUY
02-11-20 15:29,15:29,6366200,6493825,127625,BUY
03-11-20 9:15,9:15,6175500,6280725,105225,BUY
03-11-20 9:16,9:16,6165275,6273050,107775,BUY
03-11-20 9:17,9:17,6158550,6354625,196075,BUY
03-11-20 9:18,9:18,6221225,6362975,141750,BUY
03-11-20 9:19,9:19,6157000,6364350,207350,BUY
03-11-20 9:20,9:20,6364900,6682450,317550,BUY
03-11-20 9:21,9:21,6338425,6680975,342550,BUY
03-11-20 9:22,9:22,6309450,6679250,369800,BUY
03-11-20 9:23,9:23,6666225,7104100,437875,BUY
03-11-20 9:24,9:24,6633550,7091825,458275,BUY
03-11-20 9:25,9:25,6610900,7103150,492250,BUY
03-11-20 9:26,9:26,6542725,7166900,624175,BUY
03-11-20 9:27,9:27,6591450,7168450,577000,BUY
03-11-20 9:28,9:28,6665975,7165775,499800,BUY
03-11-20 9:29,9:29,6837275,7226650,389375,BUY
03-11-20 9:30,9:30,6805150,7238725,433575,BUY
03-11-20 9:31,9:31,6821575,7238850,417275,BUY
03-11-20 9:32,9:32,6871950,7413225,541275,BUY
03-11-20 9:33,9:33,6871850,7411400,539550,BUY
03-11-20 9:34,9:34,6902650,7411400,508750,BUY
03-11-20 9:35,9:35,6898775,7483525,584750,BUY
03-11-20 9:36,9:36,6956925,7484650,527725,BUY
03-11-20 9:37,9:37,6973375,7475675,502300,BUY
03-11-20 9:38,9:38,7163875,7585025,421150,BUY
03-11-20 9:39,9:39,7084200,7583675,499475,BUY
03-11-20 9:40,9:40,7142300,7582275,439975,BUY
03-11-20 9:41,9:41,7066775,7632325,565550,BUY
03-11-20 9:42,9:42,7203325,7635300,431975,BUY
03-11-20 9:43,9:43,7078825,7623775,544950,BUY
03-11-20 9:44,9:44,7150575,7673725,523150,BUY
03-11-20 9:45,9:45,7062425,7685200,622775,BUY
03-11-20 9:46,9:46,7227275,7685200,457925,BUY
03-11-20 9:47,9:47,7163450,7697625,534175,BUY
03-11-20 9:48,9:48,7084250,7710625,626375,BUY
03-11-20 9:49,9:49,7096050,7709075,613025,BUY
03-11-20 9:50,9:50,6999550,7635700,636150,BUY
03-11-20 9:51,9:51,6947775,7634175,686400,BUY
03-11-20 9:52,9:52,6954525,7634175,679650,BUY
03-11-20 9:53,9:53,7028450,7681200,652750,BUY
03-11-20 9:54,9:54,7004150,7680900,676750,BUY
03-11-20 9:55,9:55,7066075,7682450,616375,BUY
03-11-20 9:56,9:56,6953400,7711325,757925,BUY
03-11-20 9:57,9:57,6856050,7713600,857550,BUY
03-11-20 9:58,9:58,6974550,7713275,738725,BUY
03-11-20 9:59,9:59,6962425,7776950,814525,BUY
03-11-20 10:00,10:00,6993025,7771550,778525,BUY
03-11-20 10:01,10:01,6994275,7769250,774975,BUY
03-11-20 10:02,10:02,7130475,7754525,624050,BUY
03-11-20 10:03,10:03,7130500,7756775,626275,BUY
03-11-20 10:04,10:04,7090625,7754525,663900,BUY
03-11-20 10:05,10:05,7113225,7691650,578425,BUY
03-11-20 10:06,10:06,7025475,7691650,666175,BUY
03-11-20 10:07,10:07,7123000,7677150,554150,BUY
03-11-20 10:08,10:08,7108375,7745300,636925,BUY
03-11-20 10:09,10:09,7042175,7746850,704675,BUY
03-11-20 10:10,10:10,7230400,7746850,516450,BUY
03-11-20 10:11,10:11,7301800,7751625,449825,BUY
03-11-20 10:12,10:12,7282600,7765150,482550,BUY
03-11-20 10:13,10:13,7148375,7752525,604150,BUY
03-11-20 10:14,10:14,7109225,7801850,692625,BUY
03-11-20 10:15,10:15,7070325,7802875,732550,BUY
03-11-20 10:16,10:16,7246500,7811600,565100,BUY
03-11-20 10:17,10:17,7209800,7875600,665800,BUY
03-11-20 10:18,10:18,7099775,7875300,775525,BUY
03-11-20 10:19,10:19,7290675,7873100,582425,BUY
03-11-20 10:20,10:20,7275975,7905950,629975,BUY
03-11-20 10:21,10:21,7343350,7909700,566350,BUY
03-11-20 10:22,10:22,7341175,7903700,562525,BUY
03-11-20 10:23,10:23,7243125,7937075,693950,BUY
03-11-20 10:24,10:24,7188000,7937075,749075,BUY
03-11-20 10:25,10:25,7242600,7937075,694475,BUY
03-11-20 10:26,10:26,7263475,7925400,661925,BUY
03-11-20 10:27,10:27,7157800,7926500,768700,BUY
03-11-20 10:28,10:28,7250525,7923850,673325,BUY
03-11-20 10:29,10:29,7287800,7968250,680450,BUY
03-11-20 10:30,10:30,7183375,7968250,784875,BUY
03-11-20 10:31,10:31,7157825,7956575,798750,BUY
03-11-20 10:32,10:32,7133725,8013000,879275,BUY
03-11-20 10:33,10:33,7223650,8013175,789525,BUY
03-11-20 10:34,10:34,7291325,8005825,714500,BUY
03-11-20 10:35,10:35,7318125,8039400,721275,BUY
03-11-20 10:36,10:36,7232050,8033400,801350,BUY
03-11-20 10:37,10:37,7204325,8022725,818400,BUY
03-11-20 10:38,10:38,7250625,8050975,800350,BUY
03-11-20 10:39,10:39,7244625,8059000,814375,BUY
03-11-20 10:40,10:40,7188075,8056850,868775,BUY
03-11-20 10:41,10:41,7297725,8110850,813125,BUY
03-11-20 10:42,10:42,7263450,8108200,844750,BUY
03-11-20 10:43,10:43,7059925,8110550,1050625,BUY
03-11-20 10:44,10:44,7422900,8137100,714200,BUY
03-11-20 10:45,10:45,7233300,8133350,900050,BUY
03-11-20 10:46,10:46,7294100,8133300,839200,BUY
03-11-20 10:47,10:47,7086050,8149850,1063800,BUY
03-11-20 10:48,10:48,7387900,8151775,763875,BUY
03-11-20 10:49,10:49,7274200,8151775,877575,BUY
03-11-20 10:50,10:50,7410125,8181175,771050,BUY
03-11-20 10:51,10:51,7304875,8181550,876675,BUY
03-11-20 10:52,10:52,7135375,8190475,1055100,BUY
03-11-20 10:53,10:53,6961975,8201500,1239525,BUY
03-11-20 10:54,10:54,7253450,8143850,890400,BUY
03-11-20 10:55,10:55,7079675,8186575,1106900,BUY
03-11-20 10:56,10:56,7221625,8214125,992500,BUY
03-11-20 10:57,10:57,7266225,8216425,950200,BUY
03-11-20 10:58,10:58,7408075,8216600,808525,BUY
03-11-20 10:59,10:59,7288200,8248175,959975,BUY
03-11-20 11:00,11:00,7290375,8242975,952600,BUY
03-11-20 11:01,11:01,7357200,8243500,886300,BUY
03-11-20 11:02,11:02,7538050,8270425,732375,BUY
03-11-20 11:03,11:03,7306000,8265100,959100,BUY
03-11-20 11:04,11:04,7360350,8267725,907375,BUY
03-11-20 11:05,11:05,7296975,8278450,981475,BUY
03-11-20 11:06,11:06,7316800,8270525,953725,BUY
03-11-20 11:07,11:07,7294150,8272975,978825,BUY
03-11-20 11:08,11:08,7448000,8316050,868050,BUY
03-11-20 11:09,11:09,7349900,8310475,960575,BUY
03-11-20 11:10,11:10,7181700,8307875,1126175,BUY
03-11-20 11:11,11:11,7192025,8341575,1149550,BUY
03-11-20 11:12,11:12,6956875,8331575,1374700,BUY
03-11-20 11:13,11:13,7390225,8331575,941350,BUY
03-11-20 11:14,11:14,7318975,8325075,1006100,BUY
03-11-20 11:15,11:15,7323150,8387625,1064475,BUY
03-11-20 11:16,11:16,7325950,8372375,1046425,BUY
03-11-20 11:17,11:17,7362700,8406800,1044100,BUY
03-11-20 11:18,11:18,7231675,8421550,1189875,BUY
03-11-20 11:19,11:19,7084075,8406825,1322750,BUY
03-11-20 11:20,11:20,7636375,8446650,810275,BUY
03-11-20 11:21,11:21,7374850,8444175,1069325,BUY
03-11-20 11:22,11:22,7551900,8401975,850075,BUY
03-11-20 11:23,11:23,6991225,8467575,1476350,BUY
03-11-20 11:24,11:24,7186675,8469450,1282775,BUY
03-11-20 11:25,11:25,7460300,8484100,1023800,BUY
03-11-20 11:26,11:26,7424400,8502025,1077625,BUY
03-11-20 11:27,11:27,7323125,8506675,1183550,BUY
03-11-20 11:28,11:28,7381625,8510475,1128850,BUY
03-11-20 11:29,11:29,7077675,8381775,1304100,BUY
03-11-20 11:30,11:30,7198725,8491900,1293175,BUY
03-11-20 11:31,11:31,7407425,8502425,1095000,BUY
03-11-20 11:32,11:32,7375225,8536300,1161075,BUY
03-11-20 11:33,11:33,7274675,8543350,1268675,BUY
03-11-20 11:34,11:34,7281100,8555125,1274025,BUY
03-11-20 11:35,11:35,7378625,8559925,1181300,BUY
03-11-20 11:36,11:36,7358600,8557750,1199150,BUY
03-11-20 11:37,11:37,7250575,8557225,1306650,BUY
03-11-20 11:38,11:38,7317775,8586600,1268825,BUY
03-11-20 11:39,11:39,7198300,8588575,1390275,BUY
03-11-20 11:40,11:40,7463750,8584425,1120675,BUY
03-11-20 11:41,11:41,7365000,8609875,1244875,BUY
03-11-20 11:42,11:42,7333275,8612000,1278725,BUY
03-11-20 11:43,11:43,7615350,8615025,999675,BUY
03-11-20 11:44,11:44,7392300,8668300,1276000,BUY
03-11-20 11:45,11:45,7325925,8668100,1342175,BUY
03-11-20 11:46,11:46,7250550,8668200,1417650,BUY
03-11-20 11:47,11:47,7412275,8733625,1321350,BUY
03-11-20 11:48,11:48,7338150,8743525,1405375,BUY
03-11-20 11:49,11:49,7427775,8743575,1315800,BUY
03-11-20 11:50,11:50,7208050,8785950,1577900,BUY
03-11-20 11:51,11:51,7153125,8781000,1627875,BUY
03-11-20 11:52,11:52,7070100,8784100,1714000,BUY
03-11-20 11:53,11:53,7175625,8775850,1600225,BUY
03-11-20 11:54,11:54,7357700,8786125,1428425,BUY
03-11-20 11:55,11:55,7243525,8784700,1541175,BUY
03-11-20 11:56,11:56,7186600,8791000,1604400,BUY
03-11-20 11:57,11:57,7139450,8777850,1638400,BUY
03-11-20 11:58,11:58,7000800,8779250,1778450,BUY
03-11-20 11:59,11:59,7271250,8753550,1482300,BUY
03-11-20 12:00,12:00,7251475,8742650,1491175,BUY
03-11-20 12:01,12:01,7219625,8747875,1528250,BUY
03-11-20 12:02,12:02,7293750,8766800,1473050,BUY
03-11-20 12:03,12:03,7270575,8611650,1341075,BUY
03-11-20 12:04,12:04,7213700,8614875,1401175,BUY
03-11-20 12:05,12:05,7300450,8752325,1451875,BUY
03-11-20 12:06,12:06,7146400,8788750,1642350,BUY
03-11-20 12:07,12:07,7323650,8784500,1460850,BUY
03-11-20 12:08,12:08,7124050,8808900,1684850,BUY
03-11-20 12:09,12:09,7426975,8811100,1384125,BUY
03-11-20 12:10,12:10,7281275,8816300,1535025,BUY
03-11-20 12:11,12:11,7204550,8813525,1608975,BUY
03-11-20 12:12,12:12,7202000,8826175,1624175,BUY
03-11-20 12:13,12:13,7484475,8823975,1339500,BUY
03-11-20 12:14,12:14,7236375,8837750,1601375,BUY
03-11-20 12:15,12:15,7296925,8828900,1531975,BUY
03-11-20 12:16,12:16,7434675,8838325,1403650,BUY
03-11-20 12:17,12:17,7130675,8828725,1698050,BUY
03-11-20 12:18,12:18,7335075,8837925,1502850,BUY
03-11-20 12:19,12:19,7273725,8837925,1564200,BUY
03-11-20 12:20,12:20,7386700,8857450,1470750,BUY
03-11-20 12:21,12:21,7378425,8860750,1482325,BUY
03-11-20 12:22,12:22,7201675,8800125,1598450,BUY
03-11-20 12:23,12:23,6970100,8892375,1922275,BUY
03-11-20 12:24,12:24,7326075,8893100,1567025,BUY
03-11-20 12:25,12:25,7348125,8893100,1544975,BUY
03-11-20 12:26,12:26,7329550,8952100,1622550,BUY
03-11-20 12:27,12:27,7633600,8962250,1328650,BUY
03-11-20 12:28,12:28,7461925,8962250,1500325,BUY
03-11-20 12:29,12:29,7270225,8976650,1706425,BUY
03-11-20 12:30,12:30,7352900,8974350,1621450,BUY
03-11-20 12:31,12:31,7412300,8976625,1564325,BUY
03-11-20 12:32,12:32,7332750,9024025,1691275,BUY
03-11-20 12:33,12:33,7115625,9017675,1902050,BUY
03-11-20 12:34,12:34,7219200,9028350,1809150,BUY
03-11-20 12:35,12:35,7124525,9070800,1946275,BUY
03-11-20 12:36,12:36,7216375,9071275,1854900,BUY
03-11-20 12:37,12:37,7281800,9063925,1782125,BUY
03-11-20 12:38,12:38,7288775,9101900,1813125,BUY
03-11-20 12:39,12:39,7375900,9100925,1725025,BUY
03-11-20 12:40,12:40,7555575,9101425,1545850,BUY
03-11-20 12:41,12:41,7622450,9147575,1525125,BUY
03-11-20 12:42,12:42,7511650,9155975,1644325,BUY
03-11-20 12:43,12:43,7208225,9146675,1938450,BUY
03-11-20 12:44,12:44,7321350,9108300,1786950,BUY
03-11-20 12:45,12:45,7480800,9111650,1630850,BUY
03-11-20 12:46,12:46,7429200,9104400,1675200,BUY
03-11-20 12:47,12:47,7290500,9142400,1851900,BUY
03-11-20 12:48,12:48,7287800,9149925,1862125,BUY
03-11-20 12:49,12:49,7514550,9158850,1644300,BUY
03-11-20 12:50,12:50,7309450,9177625,1868175,BUY
03-11-20 12:51,12:51,7261275,9174350,1913075,BUY
03-11-20 12:52,12:52,7237450,9175150,1937700,BUY
03-11-20 12:53,12:53,7323600,9198875,1875275,BUY
03-11-20 12:54,12:54,7276400,9215625,1939225,BUY
03-11-20 12:55,12:55,7475475,9216175,1740700,BUY
03-11-20 12:56,12:56,7331500,9204925,1873425,BUY
03-11-20 12:57,12:57,7313400,9204775,1891375,BUY
03-11-20 12:58,12:58,7062550,9206100,2143550,BUY
03-11-20 12:59,12:59,7312725,9212850,1900125,BUY
03-11-20 13:00,13:00,6879700,9222300,2342600,BUY
03-11-20 13:01,13:01,7241450,9219725,1978275,BUY
03-11-20 13:02,13:02,7015450,9239650,2224200,BUY
03-11-20 13:03,13:03,7103650,9244850,2141200,BUY
03-11-20 13:04,13:04,7286650,9250675,1964025,BUY
03-11-20 13:05,13:05,7214825,9250975,2036150,BUY
03-11-20 13:06,13:06,7219125,9252525,2033400,BUY
03-11-20 13:07,13:07,7138775,9261500,2122725,BUY
03-11-20 13:08,13:08,7275875,9274450,1998575,BUY
03-11-20 13:09,13:09,7205500,9280850,2075350,BUY
03-11-20 13:10,13:10,7305125,9275550,1970425,BUY
03-11-20 13:11,13:11,7266100,9276125,2010025,BUY
03-11-20 13:12,13:12,7150025,9283800,2133775,BUY
03-11-20 13:13,13:13,7174575,9279375,2104800,BUY
03-11-20 13:14,13:14,6834025,9295825,2461800,BUY
03-11-20 13:15,13:15,7143100,9309675,2166575,BUY
03-11-20 13:16,13:16,7166200,9300150,2133950,BUY
03-11-20 13:17,13:17,7520675,9304050,1783375,BUY
03-11-20 13:18,13:18,7513675,9282550,1768875,BUY
03-11-20 13:19,13:19,7185625,9279175,2093550,BUY
03-11-20 13:20,13:20,7383500,9290850,1907350,BUY
03-11-20 13:21,13:21,7136875,9303775,2166900,BUY
03-11-20 13:22,13:22,7200975,9313850,2112875,BUY
03-11-20 13:23,13:23,7266250,9294675,2028425,BUY
03-11-20 13:24,13:24,7101275,9307725,2206450,BUY
03-11-20 13:25,13:25,7406175,9307750,1901575,BUY
03-11-20 13:26,13:26,7281900,9319250,2037350,BUY
03-11-20 13:27,13:27,6721125,9340775,2619650,BUY
03-11-20 13:28,13:28,7161775,9330650,2168875,BUY
03-11-20 13:29,13:29,7160800,9330975,2170175,BUY
03-11-20 13:30,13:30,7286925,9355800,2068875,BUY
03-11-20 13:31,13:31,7203525,9340025,2136500,BUY
03-11-20 13:32,13:32,7332575,9346450,2013875,BUY
03-11-20 13:33,13:33,6966675,9366325,2399650,BUY
03-11-20 13:34,13:34,7180325,9369325,2189000,BUY
03-11-20 13:35,13:35,7389500,9375675,1986175,BUY
03-11-20 13:36,13:36,7397525,9409000,2011475,BUY
03-11-20 13:37,13:37,7303200,9397675,2094475,BUY
03-11-20 13:38,13:38,7220475,9400175,2179700,BUY
03-11-20 13:39,13:39,7335250,9400125,2064875,BUY
03-11-20 13:40,13:40,7422025,9402875,1980850,BUY
03-11-20 13:41,13:41,7604700,9425825,1821125,BUY
03-11-20 13:42,13:42,7254450,9386200,2131750,BUY
03-11-20 13:43,13:43,7177400,9385800,2208400,BUY
03-11-20 13:44,13:44,7275625,9390250,2114625,BUY
03-11-20 13:45,13:45,7006725,9394825,2388100,BUY
03-11-20 13:46,13:46,7029100,9404025,2374925,BUY
03-11-20 13:47,13:47,7210275,9406975,2196700,BUY
03-11-20 13:48,13:48,7222575,9457450,2234875,BUY
03-11-20 13:49,13:49,7318400,9449925,2131525,BUY
03-11-20 13:50,13:50,7254725,9456000,2201275,BUY
03-11-20 13:51,13:51,7322625,9505725,2183100,BUY
03-11-20 13:52,13:52,6974150,9506175,2532025,BUY
03-11-20 13:53,13:53,7142000,9509725,2367725,BUY
03-11-20 13:54,13:54,6931900,9515550,2583650,BUY
03-11-20 13:55,13:55,6896675,9511875,2615200,BUY
03-11-20 13:56,13:56,7062725,9505625,2442900,BUY
03-11-20 13:57,13:57,7306850,9515175,2208325,BUY
03-11-20 13:58,13:58,7145450,9514225,2368775,BUY
03-11-20 13:59,13:59,7239025,9516350,2277325,BUY
03-11-20 14:00,14:00,7225575,9556775,2331200,BUY
03-11-20 14:01,14:01,6860375,9546650,2686275,BUY
03-11-20 14:02,14:02,6814350,9539900,2725550,BUY
03-11-20 14:03,14:03,6865700,9619900,2754200,BUY
03-11-20 14:04,14:04,6894725,9613450,2718725,BUY
03-11-20 14:05,14:05,7124750,9611900,2487150,BUY
03-11-20 14:06,14:06,7073425,9611775,2538350,BUY
03-11-20 14:07,14:07,6798025,9617725,2819700,BUY
03-11-20 14:08,14:08,6985425,9607675,2622250,BUY
03-11-20 14:09,14:09,7222900,9658900,2436000,BUY
03-11-20 14:10,14:10,7198500,9655075,2456575,BUY
03-11-20 14:11,14:11,7026575,9662350,2635775,BUY
03-11-20 14:12,14:12,7130700,9655675,2524975,BUY
03-11-20 14:13,14:13,7126900,9647400,2520500,BUY
03-11-20 14:14,14:14,7161100,9647725,2486625,BUY
03-11-20 14:15,14:15,7264575,9605450,2340875,BUY
03-11-20 14:16,14:16,6796925,9602425,2805500,BUY
03-11-20 14:17,14:17,7003075,9602650,2599575,BUY
03-11-20 14:18,14:18,6748425,9650450,2902025,BUY
03-11-20 14:19,14:19,7214600,9658450,2443850,BUY
03-11-20 14:20,14:20,7215000,9648550,2433550,BUY
03-11-20 14:21,14:21,7057875,9657675,2599800,BUY
03-11-20 14:22,14:22,7078000,9667625,2589625,BUY
03-11-20 14:23,14:23,7038925,9668625,2629700,BUY
03-11-20 14:24,14:24,7083350,9679375,2596025,BUY
03-11-20 14:25,14:25,7292775,9694525,2401750,BUY
03-11-20 14:26,14:26,7264800,9679375,2414575,BUY
03-11-20 14:27,14:27,7209750,9648950,2439200,BUY
03-11-20 14:28,14:28,7388200,9646075,2257875,BUY
03-11-20 14:29,14:29,7296125,9646125,2350000,BUY
03-11-20 14:30,14:30,7218375,9543875,2325500,BUY
03-11-20 14:31,14:31,7129750,9552300,2422550,BUY
03-11-20 14:32,14:32,6941825,9539875,2598050,BUY
03-11-20 14:33,14:33,7138775,9498175,2359400,BUY
03-11-20 14:34,14:34,6963200,9502675,2539475,BUY
03-11-20 14:35,14:35,6996125,9499475,2503350,BUY
03-11-20 14:36,14:36,7170675,9534700,2364025,BUY
03-11-20 14:37,14:37,6994950,9540625,2545675,BUY
03-11-20 14:38,14:38,7144600,9540625,2396025,BUY
03-11-20 14:39,14:39,7137825,9554600,2416775,BUY
03-11-20 14:40,14:40,6969600,9554575,2584975,BUY
03-11-20 14:41,14:41,7189025,9554575,2365550,BUY
03-11-20 14:42,14:42,7052425,9604175,2551750,BUY
03-11-20 14:43,14:43,6886750,9586225,2699475,BUY
03-11-20 14:44,14:44,7042525,9581400,2538875,BUY
03-11-20 14:45,14:45,7342125,9625600,2283475,BUY
03-11-20 14:46,14:46,7357875,9632700,2274825,BUY
03-11-20 14:47,14:47,7213075,9620650,2407575,BUY
03-11-20 14:48,14:48,7127400,9598975,2471575,BUY
03-11-20 14:49,14:49,6926950,9614850,2687900,BUY
03-11-20 14:50,14:50,7068825,9602275,2533450,BUY
03-11-20 14:51,14:51,6896000,9521675,2625675,BUY
03-11-20 14:52,14:52,6879175,9502625,2623450,BUY
03-11-20 14:53,14:53,6899750,9506450,2606700,BUY
03-11-20 14:54,14:54,6948125,9519700,2571575,BUY
03-11-20 14:55,14:55,7100450,9532450,2432000,BUY
03-11-20 14:56,14:56,7123150,9531000,2407850,BUY
03-11-20 14:57,14:57,7039675,9581875,2542200,BUY
03-11-20 14:58,14:58,7072125,9587150,2515025,BUY
03-11-20 14:59,14:59,7024050,9581875,2557825,BUY
03-11-20 15:00,15:00,7089700,9451250,2361550,BUY
03-11-20 15:01,15:01,7088675,9461525,2372850,BUY
03-11-20 15:02,15:02,6761900,9465675,2703775,BUY
03-11-20 15:03,15:03,6922625,9372200,2449575,BUY
03-11-20 15:04,15:04,6884000,9391500,2507500,BUY
03-11-20 15:05,15:05,6907800,9383075,2475275,BUY
03-11-20 15:06,15:06,6656200,9267525,2611325,BUY
03-11-20 15:07,15:07,6780500,9263425,2482925,BUY
03-11-20 15:08,15:08,6879925,9263800,2383875,BUY
03-11-20 15:09,15:09,6622375,9254075,2631700,BUY
03-11-20 15:10,15:10,6977775,9264475,2286700,BUY
03-11-20 15:11,15:11,6665300,9258625,2593325,BUY
03-11-20 15:12,15:12,6678175,9176675,2498500,BUY
03-11-20 15:13,15:13,6649750,9178475,2528725,BUY
03-11-20 15:14,15:14,6639825,9168725,2528900,BUY
03-11-20 15:15,15:15,6657250,9052850,2395600,BUY
03-11-20 15:16,15:16,6599400,9052850,2453450,BUY
03-11-20 15:17,15:17,6635950,9052850,2416900,BUY
03-11-20 15:18,15:18,6426775,8926950,2500175,BUY
03-11-20 15:19,15:19,6463875,8923275,2459400,BUY
03-11-20 15:20,15:20,6522700,8923325,2400625,BUY
03-11-20 15:21,15:21,6219800,8785175,2565375,BUY
03-11-20 15:22,15:22,6257650,8784675,2527025,BUY
03-11-20 15:23,15:23,6119050,8780000,2660950,BUY
03-11-20 15:24,15:24,6112900,8674050,2561150,BUY
03-11-20 15:25,15:25,6190250,8683775,2493525,BUY
03-11-20 15:26,15:26,5996900,8692175,2695275,BUY
03-11-20 15:27,15:27,5839625,8529700,2690075,BUY
03-11-20 15:28,15:28,5972025,8542400,2570375,BUY
03-11-20 15:29,15:29,5976675,8546325,2569650,BUY
04-11-20 9:15,9:15,5759625,8321250,2561625,BUY
04-11-20 9:16,9:16,5753375,8316450,2563075,BUY
04-11-20 9:17,9:17,5795450,8455675,2660225,BUY
04-11-20 9:18,9:18,5787450,8450875,2663425,BUY
04-11-20 9:19,9:19,5707725,8443475,2735750,BUY
04-11-20 9:20,9:20,6100425,8705725,2605300,BUY
04-11-20 9:21,9:21,5987600,8703075,2715475,BUY
04-11-20 9:22,9:22,5926800,8706275,2779475,BUY
04-11-20 9:23,9:23,6412700,9032525,2619825,BUY
04-11-20 9:24,9:24,6311175,9028775,2717600,BUY
04-11-20 9:25,9:25,6324675,9024000,2699325,BUY
04-11-20 9:26,9:26,6651100,9372475,2721375,BUY
04-11-20 9:27,9:27,6581175,9372475,2791300,BUY
04-11-20 9:28,9:28,6648625,9370100,2721475,BUY
04-11-20 9:29,9:29,6720825,9562500,2841675,BUY
04-11-20 9:30,9:30,6779150,9563125,2783975,BUY
04-11-20 9:31,9:31,6763675,9569425,2805750,BUY
04-11-20 9:32,9:32,6963975,9715550,2751575,BUY
04-11-20 9:33,9:33,7012750,9701475,2688725,BUY
04-11-20 9:34,9:34,6949325,9709975,2760650,BUY
04-11-20 9:35,9:35,6868725,9494000,2625275,BUY
04-11-20 9:36,9:36,6886750,9490600,2603850,BUY
04-11-20 9:37,9:37,6741925,9476550,2734625,BUY
04-11-20 9:38,9:38,6946550,9561675,2615125,BUY
04-11-20 9:39,9:39,7022725,9567900,2545175,BUY
04-11-20 9:40,9:40,6871125,9565100,2693975,BUY
04-11-20 9:41,9:41,7158475,9673700,2515225,BUY
04-11-20 9:42,9:42,7058025,9673700,2615675,BUY
04-11-20 9:43,9:43,7118800,9674775,2555975,BUY
04-11-20 9:44,9:44,6968525,9659775,2691250,BUY
04-11-20 9:45,9:45,6947000,9672675,2725675,BUY
04-11-20 9:46,9:46,7104275,9666175,2561900,BUY
04-11-20 9:47,9:47,7102725,9762225,2659500,BUY
04-11-20 9:48,9:48,6958100,9745825,2787725,BUY
04-11-20 9:49,9:49,7005325,9740150,2734825,BUY
04-11-20 9:50,9:50,7259225,9795075,2535850,BUY
04-11-20 9:51,9:51,7127900,9815400,2687500,BUY
04-11-20 9:52,9:52,7191425,9786725,2595300,BUY
04-11-20 9:53,9:53,7118175,9891825,2773650,BUY
04-11-20 9:54,9:54,7048775,9869525,2820750,BUY
04-11-20 9:55,9:55,7114075,9872025,2757950,BUY
04-11-20 9:56,9:56,7100225,9936925,2836700,BUY
04-11-20 9:57,9:57,7103800,9935675,2831875,BUY
04-11-20 9:58,9:58,7247300,9939500,2692200,BUY
04-11-20 9:59,9:59,7278600,9928825,2650225,BUY
04-11-20 10:00,10:00,7218500,9948675,2730175,BUY
04-11-20 10:01,10:01,7016725,9936150,2919425,BUY
04-11-20 10:02,10:02,7313500,10041675,2728175,BUY
04-11-20 10:03,10:03,7256775,10049475,2792700,BUY
04-11-20 10:04,10:04,7206675,10052025,2845350,BUY
04-11-20 10:05,10:05,7500775,10147500,2646725,BUY
04-11-20 10:06,10:06,7425675,10147500,2721825,BUY
04-11-20 10:07,10:07,7449500,10143125,2693625,BUY
04-11-20 10:08,10:08,7109425,10152525,3043100,BUY
04-11-20 10:09,10:09,7367850,10136900,2769050,BUY
04-11-20 10:10,10:10,7351200,10142500,2791300,BUY
04-11-20 10:11,10:11,7403575,10206275,2802700,BUY
04-11-20 10:12,10:12,7431800,10210450,2778650,BUY
04-11-20 10:13,10:13,7449350,10222200,2772850,BUY
04-11-20 10:14,10:14,7691625,10231525,2539900,BUY
04-11-20 10:15,10:15,7641725,10231100,2589375,BUY
04-11-20 10:16,10:16,7691600,10231100,2539500,BUY
04-11-20 10:17,10:17,7504425,10052375,2547950,BUY
04-11-20 10:18,10:18,7404850,10050600,2645750,BUY
04-11-20 10:19,10:19,7520225,10031725,2511500,BUY
04-11-20 10:20,10:20,7412725,9885200,2472475,BUY
04-11-20 10:21,10:21,7457250,9881575,2424325,BUY
04-11-20 10:22,10:22,7331500,9859550,2528050,BUY
04-11-20 10:23,10:23,7578925,9903525,2324600,BUY
04-11-20 10:24,10:24,7478675,9916350,2437675,BUY
04-11-20 10:25,10:25,7380400,9912325,2531925,BUY
04-11-20 10:26,10:26,7452850,10020450,2567600,BUY
04-11-20 10:27,10:27,7331950,10020450,2688500,BUY
04-11-20 10:28,10:28,7274225,10022725,2748500,BUY
04-11-20 10:29,10:29,7489250,10051325,2562075,BUY
04-11-20 10:30,10:30,7631150,10046600,2415450,BUY
04-11-20 10:31,10:31,7363800,10049150,2685350,BUY
04-11-20 10:32,10:32,7711275,10084925,2373650,BUY
04-11-20 10:33,10:33,7471300,10092275,2620975,BUY
04-11-20 10:34,10:34,7637475,10085850,2448375,BUY
04-11-20 10:35,10:35,7713625,10162450,2448825,BUY
04-11-20 10:36,10:36,7557900,10146600,2588700,BUY
04-11-20 10:37,10:37,7311025,10133250,2822225,BUY
04-11-20 10:38,10:38,7540475,10265475,2725000,BUY
04-11-20 10:39,10:39,7581125,10249550,2668425,BUY
04-11-20 10:40,10:40,7556650,10260600,2703950,BUY
04-11-20 10:41,10:41,7533525,10250900,2717375,BUY
04-11-20 10:42,10:42,7315325,10238225,2922900,BUY
04-11-20 10:43,10:43,7508775,10231525,2722750,BUY
04-11-20 10:44,10:44,7601200,10239025,2637825,BUY
04-11-20 10:45,10:45,7603950,10262875,2658925,BUY
04-11-20 10:46,10:46,7734400,10279375,2544975,BUY
04-11-20 10:47,10:47,7630500,10282050,2651550,BUY
04-11-20 10:48,10:48,7395950,10290425,2894475,BUY
04-11-20 10:49,10:49,7738325,10258100,2519775,BUY
04-11-20 10:50,10:50,7861250,10313200,2451950,BUY
04-11-20 10:51,10:51,7748200,10317725,2569525,BUY
04-11-20 10:52,10:52,7736125,10326125,2590000,BUY
04-11-20 10:53,10:53,7613400,10348100,2734700,BUY
04-11-20 10:54,10:54,7910800,10351525,2440725,BUY
04-11-20 10:55,10:55,7932475,10330675,2398200,BUY
04-11-20 10:56,10:56,7801925,10384700,2582775,BUY
04-11-20 10:57,10:57,7733000,10372150,2639150,BUY
04-11-20 10:58,10:58,7641450,10391500,2750050,BUY
04-11-20 10:59,10:59,7799275,10431075,2631800,BUY
04-11-20 11:00,11:00,7840425,10432600,2592175,BUY
04-11-20 11:01,11:01,7867800,10383000,2515200,BUY
04-11-20 11:02,11:02,7886675,10581600,2694925,BUY
04-11-20 11:03,11:03,7886350,10477675,2591325,BUY
04-11-20 11:04,11:04,7579325,10474625,2895300,BUY
04-11-20 11:05,11:05,8125700,10585450,2459750,BUY
04-11-20 11:06,11:06,7960275,10564925,2604650,BUY
04-11-20 11:07,11:07,8006050,10563875,2557825,BUY
04-11-20 11:08,11:08,7805700,10489950,2684250,BUY
04-11-20 11:09,11:09,7912025,10483900,2571875,BUY
04-11-20 11:10,11:10,7893975,10467050,2573075,BUY
04-11-20 11:11,11:11,7873600,10533725,2660125,BUY
04-11-20 11:12,11:12,7797700,10540250,2742550,BUY
04-11-20 11:13,11:13,7803725,10538725,2735000,BUY
04-11-20 11:14,11:14,7801950,10557050,2755100,BUY
04-11-20 11:15,11:15,7898200,10564050,2665850,BUY
04-11-20 11:16,11:16,7663275,10573625,2910350,BUY
04-11-20 11:17,11:17,7839100,10600350,2761250,BUY
04-11-20 11:18,11:18,7691500,10593425,2901925,BUY
04-11-20 11:19,11:19,7809475,10605850,2796375,BUY
04-11-20 11:20,11:20,7538275,10619875,3081600,BUY
04-11-20 11:21,11:21,7509800,10615300,3105500,BUY
04-11-20 11:22,11:22,7686850,10611025,2924175,BUY
04-11-20 11:23,11:23,7643775,10657075,3013300,BUY
04-11-20 11:24,11:24,7835250,10682300,2847050,BUY
04-11-20 11:25,11:25,7605250,10679150,3073900,BUY
04-11-20 11:26,11:26,7857825,10662600,2804775,BUY
04-11-20 11:27,11:27,7720975,10682975,2962000,BUY
04-11-20 11:28,11:28,7712300,10692700,2980400,BUY
04-11-20 11:29,11:29,7686925,10688075,3001150,BUY
04-11-20 11:30,11:30,7610600,10698125,3087525,BUY
04-11-20 11:31,11:31,7753525,10703875,2950350,BUY
04-11-20 11:32,11:32,7681050,10645900,2964850,BUY
04-11-20 11:33,11:33,7412200,10708175,3295975,BUY
04-11-20 11:34,11:34,7456050,10715300,3259250,BUY
04-11-20 11:35,11:35,7502000,10717900,3215900,BUY
04-11-20 11:36,11:36,7550650,10663000,3112350,BUY
04-11-20 11:37,11:37,7649500,10714150,3064650,BUY
04-11-20 11:38,11:38,7689425,10754350,3064925,BUY
04-11-20 11:39,11:39,7460375,10732025,3271650,BUY
04-11-20 11:40,11:40,7853450,10737325,2883875,BUY
04-11-20 11:41,11:41,7850800,10741700,2890900,BUY
04-11-20 11:42,11:42,7776750,10745700,2968950,BUY
04-11-20 11:43,11:43,7819825,10708650,2888825,BUY
04-11-20 11:44,11:44,7969000,10801900,2832900,BUY
04-11-20 11:45,11:45,7972375,10799950,2827575,BUY
04-11-20 11:46,11:46,7513025,10732025,3219000,BUY
04-11-20 11:47,11:47,7626000,10796100,3170100,BUY
04-11-20 11:48,11:48,7562550,10723900,3161350,BUY
04-11-20 11:49,11:49,7798125,10794050,2995925,BUY
04-11-20 11:50,11:50,7700925,10740375,3039450,BUY
04-11-20 11:51,11:51,8007100,10797925,2790825,BUY
04-11-20 11:52,11:52,7827425,10802375,2974950,BUY
04-11-20 11:53,11:53,7878100,10741975,2863875,BUY
04-11-20 11:54,11:54,7792275,10713200,2920925,BUY
04-11-20 11:55,11:55,7965475,10781550,2816075,BUY
04-11-20 11:56,11:56,8046525,10747000,2700475,BUY
04-11-20 11:57,11:57,7897275,10740450,2843175,BUY
04-11-20 11:58,11:58,8135425,10798825,2663400,BUY
04-11-20 11:59,11:59,8311225,10770425,2459200,BUY
04-11-20 12:00,12:00,8177550,10830900,2653350,BUY
04-11-20 12:01,12:01,8327850,10856975,2529125,BUY
04-11-20 12:02,12:02,8259400,10834450,2575050,BUY
04-11-20 12:03,12:03,8140750,10828975,2688225,BUY
04-11-20 12:04,12:04,8249150,10831050,2581900,BUY
04-11-20 12:05,12:05,8280975,10756625,2475650,BUY
04-11-20 12:06,12:06,8176600,10745800,2569200,BUY
04-11-20 12:07,12:07,8072000,10753300,2681300,BUY
04-11-20 12:08,12:08,8218025,10715725,2497700,BUY
04-11-20 12:09,12:09,8166225,10666150,2499925,BUY
04-11-20 12:10,12:10,8185625,10752200,2566575,BUY
04-11-20 12:11,12:11,8230875,10703800,2472925,BUY
04-11-20 12:12,12:12,8141375,10767075,2625700,BUY
04-11-20 12:13,12:13,8099975,10704175,2604200,BUY
04-11-20 12:14,12:14,8357975,10740675,2382700,BUY
04-11-20 12:15,12:15,8413325,10752200,2338875,BUY
04-11-20 12:16,12:16,8481650,10757425,2275775,BUY
04-11-20 12:17,12:17,8317775,10691400,2373625,BUY
04-11-20 12:18,12:18,8268825,10683775,2414950,BUY
04-11-20 12:19,12:19,8392525,10691425,2298900,BUY
04-11-20 12:20,12:20,8496800,10706125,2209325,BUY
04-11-20 12:21,12:21,8447000,10733950,2286950,BUY
04-11-20 12:22,12:22,8418275,10722875,2304600,BUY
04-11-20 12:23,12:23,8536675,10726625,2189950,BUY
04-11-20 12:24,12:24,8562925,10745400,2182475,BUY
04-11-20 12:25,12:25,8563600,10746275,2182675,BUY
04-11-20 12:26,12:26,8471625,10795025,2323400,BUY
04-11-20 12:27,12:27,8297475,10780650,2483175,BUY
04-11-20 12:28,12:28,8456800,10768875,2312075,BUY
04-11-20 12:29,12:29,8354950,10829325,2474375,BUY
04-11-20 12:30,12:30,8463125,10770125,2307000,BUY
04-11-20 12:31,12:31,8454925,10835525,2380600,BUY
04-11-20 12:32,12:32,8156625,10873900,2717275,BUY
04-11-20 12:33,12:33,8102000,10872775,2770775,BUY
04-11-20 12:34,12:34,8304725,10876875,2572150,BUY
04-11-20 12:35,12:35,8575950,10872950,2297000,BUY
04-11-20 12:36,12:36,8349550,10887100,2537550,BUY
04-11-20 12:37,12:37,8011650,10768475,2756825,BUY
04-11-20 12:38,12:38,8429050,10973200,2544150,BUY
04-11-20 12:39,12:39,8434925,10952225,2517300,BUY
04-11-20 12:40,12:40,8317950,10952225,2634275,BUY
04-11-20 12:41,12:41,8521375,10973550,2452175,BUY
04-11-20 12:42,12:42,8386925,10974175,2587250,BUY
04-11-20 12:43,12:43,8331075,10990475,2659400,BUY
04-11-20 12:44,12:44,8250350,10973825,2723475,BUY
04-11-20 12:45,12:45,8537025,10994425,2457400,BUY
04-11-20 12:46,12:46,8291825,10986375,2694550,BUY
04-11-20 12:47,12:47,8418850,10947225,2528375,BUY
04-11-20 12:48,12:48,8552400,10926625,2374225,BUY
04-11-20 12:49,12:49,8262425,10925750,2663325,BUY
04-11-20 12:50,12:50,8489850,10925125,2435275,BUY
04-11-20 12:51,12:51,8068125,10766700,2698575,BUY
04-11-20 12:52,12:52,8537500,10869625,2332125,BUY
04-11-20 12:53,12:53,8465350,10854975,2389625,BUY
04-11-20 12:54,12:54,8447825,10914825,2467000,BUY
04-11-20 12:55,12:55,8398375,10861800,2463425,BUY
04-11-20 12:56,12:56,8477350,10968400,2491050,BUY
04-11-20 12:57,12:57,8180800,10972375,2791575,BUY
04-11-20 12:58,12:58,8451275,10977400,2526125,BUY
04-11-20 12:59,12:59,8338000,10962000,2624000,BUY
04-11-20 13:00,13:00,8370825,10987675,2616850,BUY
04-11-20 13:01,13:01,8458600,10860425,2401825,BUY
04-11-20 13:02,13:02,8673125,10904575,2231450,BUY
04-11-20 13:03,13:03,8530725,10906525,2375800,BUY
04-11-20 13:04,13:04,8792525,10931125,2138600,BUY
04-11-20 13:05,13:05,8839275,10790900,1951625,BUY
04-11-20 13:06,13:06,8562350,10779225,2216875,BUY
04-11-20 13:07,13:07,8575800,10769000,2193200,BUY
04-11-20 13:08,13:08,8481400,10851275,2369875,BUY
04-11-20 13:09,13:09,8754825,10867475,2112650,BUY
04-11-20 13:10,13:10,8714400,10882925,2168525,BUY
04-11-20 13:11,13:11,8734325,10837375,2103050,BUY
04-11-20 13:12,13:12,8611450,10845150,2233700,BUY
04-11-20 13:13,13:13,8690450,10847125,2156675,BUY
04-11-20 13:14,13:14,8620050,10607625,1987575,BUY
04-11-20 13:15,13:15,8712775,10613650,1900875,BUY
04-11-20 13:16,13:16,8565675,10611700,2046025,BUY
04-11-20 13:17,13:17,8589825,10513525,1923700,BUY
04-11-20 13:18,13:18,8698375,10528300,1829925,BUY
04-11-20 13:19,13:19,8639700,10510250,1870550,BUY
04-11-20 13:20,13:20,8632750,10478050,1845300,BUY
04-11-20 13:21,13:21,8507450,10433050,1925600,BUY
04-11-20 13:22,13:22,8389025,10429825,2040800,BUY
04-11-20 13:23,13:23,8480000,10321050,1841050,BUY
04-11-20 13:24,13:24,8431500,10178975,1747475,BUY
04-11-20 13:25,13:25,8262350,10183600,1921250,BUY
04-11-20 13:26,13:26,8569900,10192750,1622850,BUY
04-11-20 13:27,13:27,8674025,10189850,1515825,BUY
04-11-20 13:28,13:28,8575450,10175700,1600250,BUY
04-11-20 13:29,13:29,8612025,10139325,1527300,BUY
04-11-20 13:30,13:30,8653825,10197050,1543225,BUY
04-11-20 13:31,13:31,8456175,10191975,1735800,BUY
04-11-20 13:32,13:32,8601750,10205375,1603625,BUY
04-11-20 13:33,13:33,8668850,10249450,1580600,BUY
04-11-20 13:34,13:34,8485025,10229300,1744275,BUY
04-11-20 13:35,13:35,8484625,10240750,1756125,BUY
04-11-20 13:36,13:36,8637225,10173300,1536075,BUY
04-11-20 13:37,13:37,8673225,10157575,1484350,BUY
04-11-20 13:38,13:38,8614000,10149250,1535250,BUY
04-11-20 13:39,13:39,8659025,10203600,1544575,BUY
04-11-20 13:40,13:40,8552150,10200825,1648675,BUY
04-11-20 13:41,13:41,8660775,10209675,1548900,BUY
04-11-20 13:42,13:42,8546375,10249675,1703300,BUY
04-11-20 13:43,13:43,8681475,10249675,1568200,BUY
04-11-20 13:44,13:44,8614375,10256825,1642450,BUY
04-11-20 13:45,13:45,8636125,10190550,1554425,BUY
04-11-20 13:46,13:46,8594825,10174875,1580050,BUY
04-11-20 13:47,13:47,8475400,10173675,1698275,BUY
04-11-20 13:48,13:48,8627250,10268150,1640900,BUY
04-11-20 13:49,13:49,8577900,10261475,1683575,BUY
04-11-20 13:50,13:50,8545000,10259975,1714975,BUY
04-11-20 13:51,13:51,8344725,10251325,1906600,BUY
04-11-20 13:52,13:52,8344775,10271950,1927175,BUY
04-11-20 13:53,13:53,8676400,10273150,1596750,BUY
04-11-20 13:54,13:54,8653375,10334325,1680950,BUY
04-11-20 13:55,13:55,8598875,10333475,1734600,BUY
04-11-20 13:56,13:56,8500475,10316000,1815525,BUY
04-11-20 13:57,13:57,8586800,10385525,1798725,BUY
04-11-20 13:58,13:58,8722075,10399275,1677200,BUY
04-11-20 13:59,13:59,8692825,10389100,1696275,BUY
04-11-20 14:00,14:00,8688575,10319350,1630775,BUY
04-11-20 14:01,14:01,8528150,10314850,1786700,BUY
04-11-20 14:02,14:02,8649375,10316050,1666675,BUY
04-11-20 14:03,14:03,8489250,10392850,1903600,BUY
04-11-20 14:04,14:04,8427175,10388550,1961375,BUY
04-11-20 14:05,14:05,8681525,10351200,1669675,BUY
04-11-20 14:06,14:06,8626400,10258650,1632250,BUY
04-11-20 14:07,14:07,8645125,10258750,1613625,BUY
04-11-20 14:08,14:08,8548600,10254650,1706050,BUY
04-11-20 14:09,14:09,8445675,10334775,1889100,BUY
04-11-20 14:10,14:10,8301525,10357200,2055675,BUY
04-11-20 14:11,14:11,8347250,10336400,1989150,BUY
04-11-20 14:12,14:12,8079800,10360875,2281075,BUY
04-11-20 14:13,14:13,8219375,10362200,2142825,BUY
04-11-20 14:14,14:14,8225900,10361350,2135450,BUY
04-11-20 14:15,14:15,8424075,10438600,2014525,BUY
04-11-20 14:16,14:16,8447400,10425375,1977975,BUY
04-11-20 14:17,14:17,8279475,10421200,2141725,BUY
04-11-20 14:18,14:18,8466550,10475675,2009125,BUY
04-11-20 14:19,14:19,8496275,10490800,1994525,BUY
04-11-20 14:20,14:20,8378550,10488025,2109475,BUY
04-11-20 14:21,14:21,8349900,10568725,2218825,BUY
04-11-20 14:22,14:22,8444125,10568725,2124600,BUY
04-11-20 14:23,14:23,8449125,10569900,2120775,BUY
04-11-20 14:24,14:24,8427200,10533825,2106625,BUY
04-11-20 14:25,14:25,8421775,10487500,2065725,BUY
04-11-20 14:26,14:26,8459025,10547800,2088775,BUY
04-11-20 14:27,14:27,8387750,10571475,2183725,BUY
04-11-20 14:28,14:28,8427425,10571775,2144350,BUY
04-11-20 14:29,14:29,8376450,10573400,2196950,BUY
04-11-20 14:30,14:30,8264250,10653675,2389425,BUY
04-11-20 14:31,14:31,8297550,10593450,2295900,BUY
04-11-20 14:32,14:32,8377225,10650375,2273150,BUY
04-11-20 14:33,14:33,8435425,10691150,2255725,BUY
04-11-20 14:34,14:34,8311925,10692975,2381050,BUY
04-11-20 14:35,14:35,8246675,10694650,2447975,BUY
04-11-20 14:36,14:36,8101400,10713625,2612225,BUY
04-11-20 14:37,14:37,8211525,10777300,2565775,BUY
04-11-20 14:38,14:38,8193250,10777025,2583775,BUY
04-11-20 14:39,14:39,7859600,10636300,2776700,BUY
04-11-20 14:40,14:40,7602875,10648925,3046050,BUY
04-11-20 14:41,14:41,7762525,10637475,2874950,BUY
04-11-20 14:42,14:42,7650100,10673275,3023175,BUY
04-11-20 14:43,14:43,7782700,10668450,2885750,BUY
04-11-20 14:44,14:44,7732025,10687425,2955400,BUY
04-11-20 14:45,14:45,7496225,10746950,3250725,BUY
04-11-20 14:46,14:46,7422175,10618150,3195975,BUY
04-11-20 14:47,14:47,7680650,10762900,3082250,BUY
04-11-20 14:48,14:48,7607575,10894950,3287375,BUY
04-11-20 14:49,14:49,7512825,10893225,3380400,BUY
04-11-20 14:50,14:50,7649975,10894200,3244225,BUY
04-11-20 14:51,14:51,7594700,11005400,3410700,BUY
04-11-20 14:52,14:52,7636675,11017725,3381050,BUY
04-11-20 14:53,14:53,7667775,11017725,3349950,BUY
04-11-20 14:54,14:54,7642500,10998100,3355600,BUY
04-11-20 14:55,14:55,7606875,10998125,3391250,BUY
04-11-20 14:56,14:56,7626800,10998125,3371325,BUY
04-11-20 14:57,14:57,7338900,11018100,3679200,BUY
04-11-20 14:58,14:58,7585125,11033400,3448275,BUY
04-11-20 14:59,14:59,7634200,11034950,3400750,BUY
04-11-20 15:00,15:00,7636600,10962025,3325425,BUY
04-11-20 15:01,15:01,7399500,10961550,3562050,BUY
04-11-20 15:02,15:02,7525125,10965600,3440475,BUY
04-11-20 15:03,15:03,7428200,10948175,3519975,BUY
04-11-20 15:04,15:04,7471750,10946300,3474550,BUY
04-11-20 15:05,15:05,7512675,10948150,3435475,BUY
04-11-20 15:06,15:06,7084525,10879825,3795300,BUY
04-11-20 15:07,15:07,7156650,10870475,3713825,BUY
04-11-20 15:08,15:08,7373125,10870475,3497350,BUY
04-11-20 15:09,15:09,7366900,10832825,3465925,BUY
04-11-20 15:10,15:10,7260825,10832825,3572000,BUY
04-11-20 15:11,15:11,7139625,10830925,3691300,BUY
04-11-20 15:12,15:12,7178550,10753575,3575025,BUY
04-11-20 15:13,15:13,7146625,10755250,3608625,BUY
04-11-20 15:14,15:14,7035575,10749350,3713775,BUY
04-11-20 15:15,15:15,6880700,10663050,3782350,BUY
04-11-20 15:16,15:16,6930925,10691725,3760800,BUY
04-11-20 15:17,15:17,6907600,10683700,3776100,BUY
04-11-20 15:18,15:18,6730475,10542350,3811875,BUY
04-11-20 15:19,15:19,6728950,10548450,3819500,BUY
04-11-20 15:20,15:20,6802900,10566075,3763175,BUY
04-11-20 15:21,15:21,6596600,10465425,3868825,BUY
04-11-20 15:22,15:22,6740850,10469050,3728200,BUY
04-11-20 15:23,15:23,6821975,10452975,3631000,BUY
04-11-20 15:24,15:24,6481825,10154100,3672275,BUY
04-11-20 15:25,15:25,6376250,10147025,3770775,BUY
04-11-20 15:26,15:26,6500575,10155750,3655175,BUY
04-11-20 15:27,15:27,6213950,9927650,3713700,BUY
04-11-20 15:28,15:28,6413950,9915750,3501800,BUY
04-11-20 15:29,15:29,6483525,9912425,3428900,BUY
05-11-20 9:15,9:15,4310675,9671075,5360400,BUY
05-11-20 9:16,9:16,5001625,9671075,4669450,BUY
05-11-20 9:17,9:17,6210700,9880100,3669400,BUY
05-11-20 9:18,9:18,6103400,9883075,3779675,BUY
05-11-20 9:19,9:19,6104625,9843400,3738775,BUY
05-11-20 9:20,9:20,6204025,10284150,4080125,BUY
05-11-20 9:21,9:21,6174875,10284150,4109275,BUY
05-11-20 9:22,9:22,6206725,10281175,4074450,BUY
05-11-20 9:23,9:23,6599275,11242550,4643275,BUY
05-11-20 9:24,9:24,6515400,11241650,4726250,BUY
05-11-20 9:25,9:25,6445950,11241650,4795700,BUY
05-11-20 9:26,9:26,7475850,13194600,5718750,BUY
05-11-20 9:27,9:27,7285700,13192425,5906725,BUY
05-11-20 9:28,9:28,7069700,13147925,6078225,BUY
05-11-20 9:29,9:29,8016625,13981775,5965150,BUY
05-11-20 9:30,9:30,7823950,13981775,6157825,BUY
05-11-20 9:31,9:31,7810125,13968000,6157875,BUY
05-11-20 9:32,9:32,8294825,14410375,6115550,BUY
05-11-20 9:33,9:33,8385100,14413725,6028625,BUY
05-11-20 9:34,9:34,8341400,14376100,6034700,BUY
05-11-20 9:35,9:35,9051000,15069875,6018875,BUY
05-11-20 9:36,9:36,8957500,15026925,6069425,BUY
05-11-20 9:37,9:37,8925100,15069875,6144775,BUY
05-11-20 9:38,9:38,9203950,15678925,6474975,BUY
05-11-20 9:39,9:39,9172825,15723425,6550600,BUY
05-11-20 9:40,9:40,9085350,15721025,6635675,BUY
05-11-20 9:41,9:41,9757275,16108825,6351550,BUY
05-11-20 9:42,9:42,9750800,16072600,6321800,BUY
05-11-20 9:43,9:43,9443250,16070775,6627525,BUY
05-11-20 9:44,9:44,9725275,16454875,6729600,BUY
05-11-20 9:45,9:45,10062100,16451850,6389750,BUY
05-11-20 9:46,9:46,9858425,16368650,6510225,BUY
05-11-20 9:47,9:47,10146400,16677300,6530900,BUY
05-11-20 9:48,9:48,9879650,16771300,6891650,BUY
05-11-20 9:49,9:49,10172725,16730400,6557675,BUY
05-11-20 9:50,9:50,10239450,16741200,6501750,BUY
05-11-20 9:51,9:51,10393300,16781075,6387775,BUY
05-11-20 9:52,9:52,10349525,16767225,6417700,BUY
05-11-20 9:53,9:53,10272925,17109750,6836825,BUY
05-11-20 9:54,9:54,10657775,17159200,6501425,BUY
05-11-20 9:55,9:55,10613250,17156200,6542950,BUY
05-11-20 9:56,9:56,10765250,17368525,6603275,BUY
05-11-20 9:57,9:57,10798325,17403175,6604850,BUY
05-11-20 9:58,9:58,10646175,17412325,6766150,BUY
05-11-20 9:59,9:59,10963400,17649375,6685975,BUY
05-11-20 10:00,10:00,10913275,17530800,6617525,BUY
05-11-20 10:01,10:01,11044325,17446275,6401950,BUY
05-11-20 10:02,10:02,11149125,17970875,6821750,BUY
05-11-20 10:03,10:03,11175500,17951175,6775675,BUY
05-11-20 10:04,10:04,11041525,18034075,6992550,BUY
05-11-20 10:05,10:05,11098400,18247150,7148750,BUY
05-11-20 10:06,10:06,10865725,18334325,7468600,BUY
05-11-20 10:07,10:07,10808650,18334325,7525675,BUY
05-11-20 10:08,10:08,11279100,18358900,7079800,BUY
05-11-20 10:09,10:09,11402425,18557825,7155400,BUY
05-11-20 10:10,10:10,11336275,18602800,7266525,BUY
05-11-20 10:11,10:11,11404050,18774800,7370750,BUY
05-11-20 10:12,10:12,11389550,18835275,7445725,BUY
05-11-20 10:13,10:13,11333650,18835450,7501800,BUY
05-11-20 10:14,10:14,11504250,18980375,7476125,BUY
05-11-20 10:15,10:15,11528300,18913950,7385650,BUY
05-11-20 10:16,10:16,11578550,18886300,7307750,BUY
05-11-20 10:17,10:17,11534400,19122800,7588400,BUY
05-11-20 10:18,10:18,11747675,19155625,7407950,BUY
05-11-20 10:19,10:19,11446925,19213375,7766450,BUY
05-11-20 10:20,10:20,11714025,19048175,7334150,BUY
05-11-20 10:21,10:21,11689375,19203000,7513625,BUY
05-11-20 10:22,10:22,11602525,18758525,7156000,BUY
05-11-20 10:23,10:23,11569775,19162775,7593000,BUY
05-11-20 10:24,10:24,11760450,19199900,7439450,BUY
05-11-20 10:25,10:25,11603350,19341275,7737925,BUY
05-11-20 10:26,10:26,11704975,19440950,7735975,BUY
05-11-20 10:27,10:27,11767075,19202800,7435725,BUY
05-11-20 10:28,10:28,11500100,19436375,7936275,BUY
05-11-20 10:29,10:29,11688500,19367700,7679200,BUY
05-11-20 10:30,10:30,11845275,19471975,7626700,BUY
05-11-20 10:31,10:31,11903450,19309400,7405950,BUY
05-11-20 10:32,10:32,12286700,19369025,7082325,BUY
05-11-20 10:33,10:33,12316650,19469200,7152550,BUY
05-11-20 10:34,10:34,12196250,19372325,7176075,BUY
05-11-20 10:35,10:35,12084375,18916250,6831875,BUY
05-11-20 10:36,10:36,12282375,18933575,6651200,BUY
05-11-20 10:37,10:37,12147700,18830325,6682625,BUY
05-11-20 10:38,10:38,12094225,18786025,6691800,BUY
05-11-20 10:39,10:39,12143275,18861500,6718225,BUY
05-11-20 10:40,10:40,12088175,18819300,6731125,BUY
05-11-20 10:41,10:41,12235850,19009550,6773700,BUY
05-11-20 10:42,10:42,12534825,18750800,6215975,BUY
05-11-20 10:43,10:43,12404400,19115400,6711000,BUY
05-11-20 10:44,10:44,12304775,18697000,6392225,BUY
05-11-20 10:45,10:45,12396300,19008875,6612575,BUY
05-11-20 10:46,10:46,12550050,18944275,6394225,BUY
05-11-20 10:47,10:47,12626400,18956525,6330125,BUY
05-11-20 10:48,10:48,12180650,19011350,6830700,BUY
05-11-20 10:49,10:49,12852500,18875750,6023250,BUY
05-11-20 10:50,10:50,12642400,19024325,6381925,BUY
05-11-20 10:51,10:51,12656700,18839325,6182625,BUY
05-11-20 10:52,10:52,12665125,18801975,6136850,BUY
05-11-20 10:53,10:53,12513150,18958125,6444975,BUY
05-11-20 10:54,10:54,12531350,18988125,6456775,BUY
05-11-20 10:55,10:55,12584475,18748750,6164275,BUY
05-11-20 10:56,10:56,12919500,19274825,6355325,BUY
05-11-20 10:57,10:57,12799000,19274550,6475550,BUY
05-11-20 10:58,10:58,13094975,19077550,5982575,BUY
05-11-20 10:59,10:59,13317200,19072625,5755425,BUY
05-11-20 11:00,11:00,13325175,19124600,5799425,BUY
05-11-20 11:01,11:01,13160400,19122600,5962200,BUY
05-11-20 11:02,11:02,13050575,19066625,6016050,BUY
05-11-20 11:03,11:03,12936600,18887350,5950750,BUY
05-11-20 11:04,11:04,12764100,18914825,6150725,BUY
05-11-20 11:05,11:05,12636400,19039500,6403100,BUY
05-11-20 11:06,11:06,12690200,18614500,5924300,BUY
05-11-20 11:07,11:07,12695175,18822900,6127725,BUY
05-11-20 11:08,11:08,12542725,18662175,6119450,BUY
05-11-20 11:09,11:09,12994300,18907600,5913300,BUY
05-11-20 11:10,11:10,12767925,19109200,6341275,BUY
05-11-20 11:11,11:11,13040875,18949425,5908550,BUY
05-11-20 11:12,11:12,12636025,19093275,6457250,BUY
05-11-20 11:13,11:13,13129725,19384325,6254600,BUY
05-11-20 11:14,11:14,13373725,19467400,6093675,BUY
05-11-20 11:15,11:15,12602750,19567100,6964350,BUY
05-11-20 11:16,11:16,12934075,19385450,6451375,BUY
05-11-20 11:17,11:17,12891275,19432775,6541500,BUY
05-11-20 11:18,11:18,13556100,19658225,6102125,BUY
05-11-20 11:19,11:19,13404375,19700325,6295950,BUY
05-11-20 11:20,11:20,12541600,19668150,7126550,BUY
05-11-20 11:21,11:21,12705100,19712825,7007725,BUY
05-11-20 11:22,11:22,12426350,19681300,7254950,BUY
05-11-20 11:23,11:23,12631250,19862150,7230900,BUY
05-11-20 11:24,11:24,12133475,19734325,7600850,BUY
05-11-20 11:25,11:25,12207775,19533075,7325300,BUY
05-11-20 11:26,11:26,12850125,19945650,7095525,BUY
05-11-20 11:27,11:27,12669675,19964725,7295050,BUY
05-11-20 11:28,11:28,12685100,19738300,7053200,BUY
05-11-20 11:29,11:29,12410400,19960925,7550525,BUY
05-11-20 11:30,11:30,12827075,19905100,7078025,BUY
05-11-20 11:31,11:31,12502975,19382425,6879450,BUY
05-11-20 11:32,11:32,12664175,19847900,7183725,BUY
05-11-20 11:33,11:33,12606900,19785525,7178625,BUY
05-11-20 11:34,11:34,12804575,19686675,6882100,BUY
05-11-20 11:35,11:35,12841350,19550800,6709450,BUY
05-11-20 11:36,11:36,12993025,19837350,6844325,BUY
05-11-20 11:37,11:37,12977175,19912325,6935150,BUY
05-11-20 11:38,11:38,12937775,20056775,7119000,BUY
05-11-20 11:39,11:39,13184275,20102775,6918500,BUY
05-11-20 11:40,11:40,13168725,19973400,6804675,BUY
05-11-20 11:41,11:41,13121800,20056850,6935050,BUY
05-11-20 11:42,11:42,13013475,19943925,6930450,BUY
05-11-20 11:43,11:43,12826250,20030225,7203975,BUY
05-11-20 11:44,11:44,13083000,20180675,7097675,BUY
05-11-20 11:45,11:45,12932625,20067200,7134575,BUY
05-11-20 11:46,11:46,13044175,19144725,6100550,BUY
05-11-20 11:47,11:47,13214300,19865100,6650800,BUY
05-11-20 11:48,11:48,12964550,19946225,6981675,BUY
05-11-20 11:49,11:49,13086600,19735375,6648775,BUY
05-11-20 11:50,11:50,13411875,19947100,6535225,BUY
05-11-20 11:51,11:51,13354725,19858300,6503575,BUY
05-11-20 11:52,11:52,13121925,20067350,6945425,BUY
05-11-20 11:53,11:53,13211850,20370475,7158625,BUY
05-11-20 11:54,11:54,13264625,20383750,7119125,BUY
05-11-20 11:55,11:55,12906775,19889500,6982725,BUY
05-11-20 11:56,11:56,13135550,19972600,6837050,BUY
05-11-20 11:57,11:57,13430975,20390850,6959875,BUY
05-11-20 11:58,11:58,13298075,20151275,6853200,BUY
05-11-20 11:59,11:59,13523775,20512300,6988525,BUY
05-11-20 12:00,12:00,13839500,20163300,6323800,BUY
05-11-20 12:01,12:01,13607450,20394600,6787150,BUY
05-11-20 12:02,12:02,13594400,20344600,6750200,BUY
05-11-20 12:03,12:03,13931950,20564425,6632475,BUY
05-11-20 12:04,12:04,13545900,20278600,6732700,BUY
05-11-20 12:05,12:05,14076950,20422200,6345250,BUY
05-11-20 12:06,12:06,13680700,20290725,6610025,BUY
05-11-20 12:07,12:07,13572575,19923300,6350725,BUY
05-11-20 12:08,12:08,13477000,20101300,6624300,BUY
05-11-20 12:09,12:09,13377900,20580650,7202750,BUY
05-11-20 12:10,12:10,13929525,20366725,6437200,BUY
05-11-20 12:11,12:11,13610000,20004700,6394700,BUY
05-11-20 12:12,12:12,13931100,19909425,5978325,BUY
05-11-20 12:13,12:13,13867250,20690700,6823450,BUY
05-11-20 12:14,12:14,13642600,20140200,6497600,BUY
05-11-20 12:15,12:15,13662050,20802775,7140725,BUY
05-11-20 12:16,12:16,13598475,20739800,7141325,BUY
05-11-20 12:17,12:17,13654225,20706525,7052300,BUY
05-11-20 12:18,12:18,13521425,20912300,7390875,BUY
05-11-20 12:19,12:19,13513900,19800050,6286150,BUY
05-11-20 12:20,12:20,13356600,21056350,7699750,BUY
05-11-20 12:21,12:21,13780350,21116350,7336000,BUY
05-11-20 12:22,12:22,13645825,20972500,7326675,BUY
05-11-20 12:23,12:23,13431550,20507400,7075850,BUY
05-11-20 12:24,12:24,13778975,20726975,6948000,BUY
05-11-20 12:25,12:25,13690750,20520250,6829500,BUY
05-11-20 12:26,12:26,13528400,21321500,7793100,BUY
05-11-20 12:27,12:27,13785175,21138825,7353650,BUY
05-11-20 12:28,12:28,13627350,20368725,6741375,BUY
05-11-20 12:29,12:29,13638800,20702650,7063850,BUY
05-11-20 12:30,12:30,13901475,20921125,7019650,BUY
05-11-20 12:31,12:31,13516600,21301800,7785200,BUY
05-11-20 12:32,12:32,13727425,21384525,7657100,BUY
05-11-20 12:33,12:33,14061375,21420450,7359075,BUY
05-11-20 12:34,12:34,13780900,21427025,7646125,BUY
05-11-20 12:35,12:35,13037325,21162325,8125000,BUY
05-11-20 12:36,12:36,13271725,21378025,8106300,BUY
05-11-20 12:37,12:37,12913550,21298525,8384975,BUY
05-11-20 12:38,12:38,13255000,21435475,8180475,BUY
05-11-20 12:39,12:39,12836400,20989875,8153475,BUY
05-11-20 12:40,12:40,13045675,21297400,8251725,BUY
05-11-20 12:41,12:41,13144000,21530475,8386475,BUY
05-11-20 12:42,12:42,13448350,21350600,7902250,BUY
05-11-20 12:43,12:43,13024550,21546350,8521800,BUY
05-11-20 12:44,12:44,13102025,21102275,8000250,BUY
05-11-20 12:45,12:45,13397625,21495775,8098150,BUY
05-11-20 12:46,12:46,13058600,21736525,8677925,BUY
05-11-20 12:47,12:47,13400375,21741700,8341325,BUY
05-11-20 12:48,12:48,13286550,21491425,8204875,BUY
05-11-20 12:49,12:49,13261850,21807200,8545350,BUY
05-11-20 12:50,12:50,13021350,21315150,8293800,BUY
05-11-20 12:51,12:51,13206550,21988375,8781825,BUY
05-11-20 12:52,12:52,13173175,21351800,8178625,BUY
05-11-20 12:53,12:53,13456975,21569475,8112500,BUY
05-11-20 12:54,12:54,13380425,21871800,8491375,BUY
05-11-20 12:55,12:55,13417700,21606900,8189200,BUY
05-11-20 12:56,12:56,13019900,21328250,8308350,BUY
05-11-20 12:57,12:57,13009050,21689025,8679975,BUY
05-11-20 12:58,12:58,13329700,21710225,8380525,BUY
05-11-20 12:59,12:59,13400200,21836900,8436700,BUY
05-11-20 13:00,13:00,13031975,22028825,8996850,BUY
05-11-20 13:01,13:01,13022025,21866000,8843975,BUY
05-11-20 13:02,13:02,12804975,21882850,9077875,BUY
05-11-20 13:03,13:03,13014525,22090500,9075975,BUY
05-11-20 13:04,13:04,13093725,21704800,8611075,BUY
05-11-20 13:05,13:05,13128450,22058950,8930500,BUY
05-11-20 13:06,13:06,12973350,21917875,8944525,BUY
05-11-20 13:07,13:07,13045625,21763400,8717775,BUY
05-11-20 13:08,13:08,12837375,22026250,9188875,BUY
05-11-20 13:09,13:09,12858900,22149600,9290700,BUY
05-11-20 13:10,13:10,12894675,22038500,9143825,BUY
05-11-20 13:11,13:11,13156775,22354225,9197450,BUY
05-11-20 13:12,13:12,12957800,22200675,9242875,BUY
05-11-20 13:13,13:13,13029450,22020775,8991325,BUY
05-11-20 13:14,13:14,12542675,22099750,9557075,BUY
05-11-20 13:15,13:15,12827600,22351825,9524225,BUY
05-11-20 13:16,13:16,13008775,22075150,9066375,BUY
05-11-20 13:17,13:17,13183800,22320575,9136775,BUY
05-11-20 13:18,13:18,13046025,22077525,9031500,BUY
05-11-20 13:19,13:19,12904525,22057075,9152550,BUY
05-11-20 13:20,13:20,13159625,22255925,9096300,BUY
05-11-20 13:21,13:21,13275950,22423150,9147200,BUY
05-11-20 13:22,13:22,13395050,22351350,8956300,BUY
05-11-20 13:23,13:23,13086350,22572625,9486275,BUY
05-11-20 13:24,13:24,12863625,21694050,8830425,BUY
05-11-20 13:25,13:25,12800025,21965525,9165500,BUY
05-11-20 13:26,13:26,12759575,21814175,9054600,BUY
05-11-20 13:27,13:27,12973950,22044500,9070550,BUY
05-11-20 13:28,13:28,12508725,20818900,8310175,BUY
05-11-20 13:29,13:29,13057100,21662325,8605225,BUY
05-11-20 13:30,13:30,13190075,21991575,8801500,BUY
05-11-20 13:31,13:31,13150200,22121175,8970975,BUY
05-11-20 13:32,13:32,13035350,21801600,8766250,BUY
05-11-20 13:33,13:33,13132625,22183175,9050550,BUY
05-11-20 13:34,13:34,13221975,22137725,8915750,BUY
05-11-20 13:35,13:35,13331125,22139500,8808375,BUY
05-11-20 13:36,13:36,13297500,22077075,8779575,BUY
05-11-20 13:37,13:37,13040600,21434175,8393575,BUY
05-11-20 13:38,13:38,13203525,22318900,9115375,BUY
05-11-20 13:39,13:39,12890250,22455850,9565600,BUY
05-11-20 13:40,13:40,13278975,22061600,8782625,BUY
05-11-20 13:41,13:41,12785000,22405675,9620675,BUY
05-11-20 13:42,13:42,13010375,22595875,9585500,BUY
05-11-20 13:43,13:43,13142575,22504450,9361875,BUY
05-11-20 13:44,13:44,12631300,22570075,9938775,BUY
05-11-20 13:45,13:45,12951725,22443575,9491850,BUY
05-11-20 13:46,13:46,12866425,22518600,9652175,BUY
05-11-20 13:47,13:47,12699225,22169475,9470250,BUY
05-11-20 13:48,13:48,12674125,22339650,9665525,BUY
05-11-20 13:49,13:49,13009300,22278900,9269600,BUY
05-11-20 13:50,13:50,12884875,22294775,9409900,BUY
05-11-20 13:51,13:51,12962000,22378900,9416900,BUY
05-11-20 13:52,13:52,12932500,22633450,9700950,BUY
05-11-20 13:53,13:53,12830750,22751025,9920275,BUY
05-11-20 13:54,13:54,12677850,22637300,9959450,BUY
05-11-20 13:55,13:55,12975100,22677600,9702500,BUY
05-11-20 13:56,13:56,13343675,22611850,9268175,BUY
05-11-20 13:57,13:57,12869900,22573950,9704050,BUY
05-11-20 13:58,13:58,12765775,22325200,9559425,BUY
05-11-20 13:59,13:59,12499625,22615475,10115850,BUY
05-11-20 14:00,14:00,13184575,22329575,9145000,BUY
05-11-20 14:01,14:01,13111250,22661675,9550425,BUY
05-11-20 14:02,14:02,12912225,22700100,9787875,BUY
05-11-20 14:03,14:03,13319575,22656825,9337250,BUY
05-11-20 14:04,14:04,13092825,22728600,9635775,BUY
05-11-20 14:05,14:05,13083075,22455575,9372500,BUY
05-11-20 14:06,14:06,13534850,22763525,9228675,BUY
05-11-20 14:07,14:07,13204650,22731475,9526825,BUY
05-11-20 14:08,14:08,13126450,22537975,9411525,BUY
05-11-20 14:09,14:09,12975725,22593300,9617575,BUY
05-11-20 14:10,14:10,13186075,22686725,9500650,BUY
05-11-20 14:11,14:11,13089325,22150125,9060800,BUY
05-11-20 14:12,14:12,13295525,22550225,9254700,BUY
05-11-20 14:13,14:13,12879300,22552325,9673025,BUY
05-11-20 14:14,14:14,13106475,22555250,9448775,BUY
05-11-20 14:15,14:15,13417525,22453650,9036125,BUY
05-11-20 14:16,14:16,13378775,22581600,9202825,BUY
05-11-20 14:17,14:17,13123050,22635900,9512850,BUY
05-11-20 14:18,14:18,13394700,22223300,8828600,BUY
05-11-20 14:19,14:19,13217050,22371700,9154650,BUY
05-11-20 14:20,14:20,13246650,22275250,9028600,BUY
05-11-20 14:21,14:21,12814875,22316400,9501525,BUY
05-11-20 14:22,14:22,12849525,22191025,9341500,BUY
05-11-20 14:23,14:23,13168200,22316100,9147900,BUY
05-11-20 14:24,14:24,12607225,21960975,9353750,BUY
05-11-20 14:25,14:25,12668800,21949825,9281025,BUY
05-11-20 14:26,14:26,12448900,21969675,9520775,BUY
05-11-20 14:27,14:27,13046025,21989825,8943800,BUY
05-11-20 14:28,14:28,12780800,22041975,9261175,BUY
05-11-20 14:29,14:29,12819325,22044600,9225275,BUY
05-11-20 14:30,14:30,12763050,22001300,9238250,BUY
05-11-20 14:31,14:31,12609850,21866675,9256825,BUY
05-11-20 14:32,14:32,12758675,21910525,9151850,BUY
05-11-20 14:33,14:33,12912125,21663500,8751375,BUY
05-11-20 14:34,14:34,12862325,21600200,8737875,BUY
05-11-20 14:35,14:35,13112950,21864625,8751675,BUY
05-11-20 14:36,14:36,12944775,21596025,8651250,BUY
05-11-20 14:37,14:37,12957400,21676725,8719325,BUY
05-11-20 14:38,14:38,12985200,21575700,8590500,BUY
05-11-20 14:39,14:39,13179400,21736500,8557100,BUY
05-11-20 14:40,14:40,12930500,21874525,8944025,BUY
05-11-20 14:41,14:41,12821900,21735325,8913425,BUY
05-11-20 14:42,14:42,12896225,21633000,8736775,BUY
05-11-20 14:43,14:43,12916825,21610575,8693750,BUY
05-11-20 14:44,14:44,12916800,21755825,8839025,BUY
05-11-20 14:45,14:45,13004500,21518075,8513575,BUY
05-11-20 14:46,14:46,12904625,21453025,8548400,BUY
05-11-20 14:47,14:47,12788900,21479750,8690850,BUY
05-11-20 14:48,14:48,12881800,21119100,8237300,BUY
05-11-20 14:49,14:49,13288725,21199125,7910400,BUY
05-11-20 14:50,14:50,13214425,21162475,7948050,BUY
05-11-20 14:51,14:51,12721950,20528975,7807025,BUY
05-11-20 14:52,14:52,12619350,20357800,7738450,BUY
05-11-20 14:53,14:53,12671075,20429225,7758150,BUY
05-11-20 14:54,14:54,12631650,20419700,7788050,BUY
05-11-20 14:55,14:55,12565150,20201275,7636125,BUY
05-11-20 14:56,14:56,12462475,20150875,7688400,BUY
05-11-20 14:57,14:57,12629750,20565800,7936050,BUY
05-11-20 14:58,14:58,12561650,20586850,8025200,BUY
05-11-20 14:59,14:59,12536975,20622125,8085150,BUY
05-11-20 15:00,15:00,12932450,20510050,7577600,BUY
05-11-20 15:01,15:01,12856750,20465900,7609150,BUY
05-11-20 15:02,15:02,12772525,20452500,7679975,BUY
05-11-20 15:03,15:03,12784775,20204500,7419725,BUY
05-11-20 15:04,15:04,12967075,20197375,7230300,BUY
05-11-20 15:05,15:05,12978750,20191050,7212300,BUY
05-11-20 15:06,15:06,12438950,19610375,7171425,BUY
05-11-20 15:07,15:07,12571075,19547825,6976750,BUY
05-11-20 15:08,15:08,12599875,19542300,6942425,BUY
05-11-20 15:09,15:09,12473450,18909375,6435925,BUY
05-11-20 15:10,15:10,12530975,19181425,6650450,BUY
05-11-20 15:11,15:11,12331150,19202925,6871775,BUY
05-11-20 15:12,15:12,11897550,18750925,6853375,BUY
05-11-20 15:13,15:13,11725800,18440550,6714750,BUY
05-11-20 15:14,15:14,11818100,18523400,6705300,BUY
05-11-20 15:15,15:15,11486300,17820800,6334500,BUY
05-11-20 15:16,15:16,11503125,18072125,6569000,BUY
05-11-20 15:17,15:17,11599100,18133850,6534750,BUY
05-11-20 15:18,15:18,10762700,17725700,6963000,BUY
05-11-20 15:19,15:19,10821250,17735425,6914175,BUY
05-11-20 15:20,15:20,10677325,17801925,7124600,BUY
05-11-20 15:21,15:21,10009725,17086150,7076425,BUY
05-11-20 15:22,15:22,9985850,17271100,7285250,BUY
05-11-20 15:23,15:23,9816925,16969525,7152600,BUY
05-11-20 15:24,15:24,9387625,16124050,6736425,BUY
05-11-20 15:25,15:25,9431325,16216375,6785050,BUY
05-11-20 15:26,15:26,9448675,16209100,6760425,BUY
05-11-20 15:27,15:27,8374500,14796925,6422425,BUY
05-11-20 15:28,15:28,8381725,14910550,6528825,BUY
05-11-20 15:29,15:29,8361175,13891000,5529825,BUY
06-11-20 9:15,9:15,2505250,3545375,1040125,BUY
06-11-20 9:16,9:16,2474200,3537150,1062950,BUY
06-11-20 9:17,9:17,2662375,3712650,1050275,BUY
06-11-20 9:18,9:18,2599625,3698200,1098575,BUY
06-11-20 9:19,9:19,2574575,3705150,1130575,BUY
06-11-20 9:20,9:20,3105675,4190850,1085175,BUY
06-11-20 9:21,9:21,3101300,4181625,1080325,BUY
06-11-20 9:22,9:22,3122500,4193900,1071400,BUY
06-11-20 9:23,9:23,3512950,4618350,1105400,BUY
06-11-20 9:24,9:24,3465150,4615800,1150650,BUY
06-11-20 9:25,9:25,3503250,4600275,1097025,BUY
06-11-20 9:26,9:26,3763000,4861950,1098950,BUY
06-11-20 9:27,9:27,3717950,4861950,1144000,BUY
06-11-20 9:28,9:28,3669025,4882225,1213200,BUY
06-11-20 9:29,9:29,3807825,5049775,1241950,BUY
06-11-20 9:30,9:30,3816550,5075775,1259225,BUY
06-11-20 9:31,9:31,3820700,5075775,1255075,BUY
06-11-20 9:32,9:32,3991000,5206825,1215825,BUY
06-11-20 9:33,9:33,4006250,5195575,1189325,BUY
06-11-20 9:34,9:34,3902375,5214100,1311725,BUY
06-11-20 9:35,9:35,4015350,5293275,1277925,BUY
06-11-20 9:36,9:36,4046150,5318100,1271950,BUY
06-11-20 9:37,9:37,4033950,5298125,1264175,BUY
06-11-20 9:38,9:38,4136425,5311825,1175400,BUY
06-11-20 9:39,9:39,4107825,5324625,1216800,BUY
06-11-20 9:40,9:40,4103475,5345450,1241975,BUY
06-11-20 9:41,9:41,4167225,5447225,1280000,BUY
06-11-20 9:42,9:42,4199275,5430450,1231175,BUY
06-11-20 9:43,9:43,4202500,5437550,1235050,BUY
06-11-20 9:44,9:44,4238625,5461400,1222775,BUY
06-11-20 9:45,9:45,4193875,5465850,1271975,BUY
06-11-20 9:46,9:46,4188125,5457250,1269125,BUY
06-11-20 9:47,9:47,4338400,5477275,1138875,BUY
06-11-20 9:48,9:48,4332200,5462175,1129975,BUY
06-11-20 9:49,9:49,4405225,5466575,1061350,BUY
06-11-20 9:50,9:50,4413375,5519700,1106325,BUY
06-11-20 9:51,9:51,4356825,5536000,1179175,BUY
06-11-20 9:52,9:52,4379725,5495825,1116100,BUY
06-11-20 9:53,9:53,4454225,5507025,1052800,BUY
06-11-20 9:54,9:54,4446700,5518375,1071675,BUY
06-11-20 9:55,9:55,4420950,5535825,1114875,BUY
06-11-20 9:56,9:56,4484725,5606650,1121925,BUY
06-11-20 9:57,9:57,4544375,5596575,1052200,BUY
06-11-20 9:58,9:58,4487950,5551650,1063700,BUY
06-11-20 9:59,9:59,4507675,5643725,1136050,BUY
06-11-20 10:00,10:00,4548300,5624100,1075800,BUY
06-11-20 10:01,10:01,4528400,5627075,1098675,BUY
06-11-20 10:02,10:02,4596375,5723575,1127200,BUY
06-11-20 10:03,10:03,4634525,5753850,1119325,BUY
06-11-20 10:04,10:04,4649975,5744875,1094900,BUY
06-11-20 10:05,10:05,4519675,5806050,1286375,BUY
06-11-20 10:06,10:06,4564425,5807575,1243150,BUY
06-11-20 10:07,10:07,4476900,5796750,1319850,BUY
06-11-20 10:08,10:08,4432375,5839750,1407375,BUY
06-11-20 10:09,10:09,4414950,5842300,1427350,BUY
06-11-20 10:10,10:10,4393275,5846325,1453050,BUY
06-11-20 10:11,10:11,4538525,5924475,1385950,BUY
06-11-20 10:12,10:12,4503775,5914125,1410350,BUY
06-11-20 10:13,10:13,4531950,5939300,1407350,BUY
06-11-20 10:14,10:14,4610400,5937650,1327250,BUY
06-11-20 10:15,10:15,4650300,5977800,1327500,BUY
06-11-20 10:16,10:16,4625950,5948375,1322425,BUY
06-11-20 10:17,10:17,4708725,6021575,1312850,BUY
06-11-20 10:18,10:18,4699625,6006775,1307150,BUY
06-11-20 10:19,10:19,4751650,6004625,1252975,BUY
06-11-20 10:20,10:20,4721425,6080650,1359225,BUY
06-11-20 10:21,10:21,4723475,6038325,1314850,BUY
06-11-20 10:22,10:22,4725550,6051675,1326125,BUY
06-11-20 10:23,10:23,4745150,6087700,1342550,BUY
06-11-20 10:24,10:24,4783725,6072000,1288275,BUY
06-11-20 10:25,10:25,4785850,6098150,1312300,BUY
06-11-20 10:26,10:26,4809500,6113650,1304150,BUY
06-11-20 10:27,10:27,4665150,6093400,1428250,BUY
06-11-20 10:28,10:28,4693850,6116375,1422525,BUY
06-11-20 10:29,10:29,4665475,6135350,1469875,BUY
06-11-20 10:30,10:30,4816750,6135300,1318550,BUY
06-11-20 10:31,10:31,4827550,6112850,1285300,BUY
06-11-20 10:32,10:32,4849475,6150650,1301175,BUY
06-11-20 10:33,10:33,4863800,6058825,1195025,BUY
06-11-20 10:34,10:34,4905075,6170475,1265400,BUY
06-11-20 10:35,10:35,4855125,6192100,1336975,BUY
06-11-20 10:36,10:36,4853800,6173150,1319350,BUY
06-11-20 10:37,10:37,4861750,6173800,1312050,BUY
06-11-20 10:38,10:38,4846125,6246175,1400050,BUY
06-11-20 10:39,10:39,4987600,6236075,1248475,BUY
06-11-20 10:40,10:40,4948850,6205975,1257125,BUY
06-11-20 10:41,10:41,4977800,6208850,1231050,BUY
06-11-20 10:42,10:42,4943375,6164475,1221100,BUY
06-11-20 10:43,10:43,4944500,6187125,1242625,BUY
06-11-20 10:44,10:44,4986225,6246425,1260200,BUY
06-11-20 10:45,10:45,5044375,6288825,1244450,BUY
06-11-20 10:46,10:46,5006225,6279325,1273100,BUY
06-11-20 10:47,10:47,4958750,6308150,1349400,BUY
06-11-20 10:48,10:48,4947750,6317500,1369750,BUY
06-11-20 10:49,10:49,4889400,6308625,1419225,BUY
06-11-20 10:50,10:50,5049300,6354375,1305075,BUY
06-11-20 10:51,10:51,5038550,6368200,1329650,BUY
06-11-20 10:52,10:52,5004325,6360875,1356550,BUY
06-11-20 10:53,10:53,5080100,6288525,1208425,BUY
06-11-20 10:54,10:54,4999475,6283275,1283800,BUY
06-11-20 10:55,10:55,5038900,6290300,1251400,BUY
06-11-20 10:56,10:56,5045375,6356400,1311025,BUY
06-11-20 10:57,10:57,5030800,6322825,1292025,BUY
06-11-20 10:58,10:58,5094300,6354450,1260150,BUY
06-11-20 10:59,10:59,5120000,6394900,1274900,BUY
06-11-20 11:00,11:00,5028925,6364475,1335550,BUY
06-11-20 11:01,11:01,5044925,6430800,1385875,BUY
06-11-20 11:02,11:02,5092475,6421700,1329225,BUY
06-11-20 11:03,11:03,5027925,6420850,1392925,BUY
06-11-20 11:04,11:04,5070600,6439575,1368975,BUY
06-11-20 11:05,11:05,4960950,6499600,1538650,BUY
06-11-20 11:06,11:06,4998400,6483075,1484675,BUY
06-11-20 11:07,11:07,5028950,6470550,1441600,BUY
06-11-20 11:08,11:08,5005150,6505425,1500275,BUY
06-11-20 11:09,11:09,5047400,6538925,1491525,BUY
06-11-20 11:10,11:10,4989350,6528500,1539150,BUY
06-11-20 11:11,11:11,4952550,6566800,1614250,BUY
06-11-20 11:12,11:12,5139850,6588850,1449000,BUY
06-11-20 11:13,11:13,5086750,6535650,1448900,BUY
06-11-20 11:14,11:14,5075775,6550175,1474400,BUY
06-11-20 11:15,11:15,5003700,6588050,1584350,BUY
06-11-20 11:16,11:16,5114025,6540075,1426050,BUY
06-11-20 11:17,11:17,4982825,6565225,1582400,BUY
06-11-20 11:18,11:18,5101325,6573025,1471700,BUY
06-11-20 11:19,11:19,5059550,6555350,1495800,BUY
06-11-20 11:20,11:20,5114175,6629875,1515700,BUY
06-11-20 11:21,11:21,5034875,6547750,1512875,BUY
06-11-20 11:22,11:22,5050425,6592575,1542150,BUY
06-11-20 11:23,11:23,4997550,6668000,1670450,BUY
06-11-20 11:24,11:24,5129850,6665900,1536050,BUY
06-11-20 11:25,11:25,4970625,6565725,1595100,BUY
06-11-20 11:26,11:26,5155025,6670725,1515700,BUY
06-11-20 11:27,11:27,5085875,6667175,1581300,BUY
06-11-20 11:28,11:28,5201275,6668100,1466825,BUY
06-11-20 11:29,11:29,5193275,6789300,1596025,BUY
06-11-20 11:30,11:30,5154300,6779325,1625025,BUY
06-11-20 11:31,11:31,5082900,6779325,1696425,BUY
06-11-20 11:32,11:32,5229075,6794100,1565025,BUY
06-11-20 11:33,11:33,5079225,6755725,1676500,BUY
06-11-20 11:34,11:34,4979625,6804125,1824500,BUY
06-11-20 11:35,11:35,5094400,6836175,1741775,BUY
06-11-20 11:36,11:36,5150550,6791300,1640750,BUY
06-11-20 11:37,11:37,5262300,6872925,1610625,BUY
06-11-20 11:38,11:38,5276950,6927700,1650750,BUY
06-11-20 11:39,11:39,5262925,6881900,1618975,BUY
06-11-20 11:40,11:40,5145875,6866100,1720225,BUY
06-11-20 11:41,11:41,5212800,6920200,1707400,BUY
06-11-20 11:42,11:42,5132150,6942925,1810775,BUY
06-11-20 11:43,11:43,5101975,6888225,1786250,BUY
06-11-20 11:44,11:44,5138450,6991200,1852750,BUY
06-11-20 11:45,11:45,5211075,6935150,1724075,BUY
06-11-20 11:46,11:46,5290000,6932475,1642475,BUY
06-11-20 11:47,11:47,5111350,6924400,1813050,BUY
06-11-20 11:48,11:48,5318175,6996975,1678800,BUY
06-11-20 11:49,11:49,5324775,6961875,1637100,BUY
06-11-20 11:50,11:50,5270775,6931250,1660475,BUY
06-11-20 11:51,11:51,5071000,6987100,1916100,BUY
06-11-20 11:52,11:52,5218500,7025325,1806825,BUY
06-11-20 11:53,11:53,5328300,7030650,1702350,BUY
06-11-20 11:54,11:54,5266825,6974775,1707950,BUY
06-11-20 11:55,11:55,5363050,7010300,1647250,BUY
06-11-20 11:56,11:56,5394350,7010475,1616125,BUY
06-11-20 11:57,11:57,5403050,6975350,1572300,BUY
06-11-20 11:58,11:58,5405100,6927950,1522850,BUY
06-11-20 11:59,11:59,5310825,6945850,1635025,BUY
06-11-20 12:00,12:00,5310600,6982275,1671675,BUY
06-11-20 12:01,12:01,5361975,7003175,1641200,BUY
06-11-20 12:02,12:02,5440050,6962725,1522675,BUY
06-11-20 12:03,12:03,5438125,6989525,1551400,BUY
06-11-20 12:04,12:04,5376775,7022400,1645625,BUY
06-11-20 12:05,12:05,5526550,7118150,1591600,BUY
06-11-20 12:06,12:06,5521550,7043525,1521975,BUY
06-11-20 12:07,12:07,5498675,7035900,1537225,BUY
06-11-20 12:08,12:08,5479050,7082700,1603650,BUY
06-11-20 12:09,12:09,5495975,7118825,1622850,BUY
06-11-20 12:10,12:10,5454025,7108850,1654825,BUY
06-11-20 12:11,12:11,5542925,7112075,1569150,BUY
06-11-20 12:12,12:12,5513775,7196725,1682950,BUY
06-11-20 12:13,12:13,5494800,7148000,1653200,BUY
06-11-20 12:14,12:14,5304650,7131375,1826725,BUY
06-11-20 12:15,12:15,5374850,7115000,1740150,BUY
06-11-20 12:16,12:16,5350925,7058575,1707650,BUY
06-11-20 12:17,12:17,5469475,7197150,1727675,BUY
06-11-20 12:18,12:18,5458800,7277925,1819125,BUY
06-11-20 12:19,12:19,5418475,7238825,1820350,BUY
06-11-20 12:20,12:20,5441550,7395450,1953900,BUY
06-11-20 12:21,12:21,5373225,7387775,2014550,BUY
06-11-20 12:22,12:22,5459125,7484850,2025725,BUY
06-11-20 12:23,12:23,5507200,7567525,2060325,BUY
06-11-20 12:24,12:24,5531050,7569625,2038575,BUY
06-11-20 12:25,12:25,5542525,7582975,2040450,BUY
06-11-20 12:26,12:26,5455850,7602925,2147075,BUY
06-11-20 12:27,12:27,5424425,7605850,2181425,BUY
06-11-20 12:28,12:28,5355125,7542550,2187425,BUY
06-11-20 12:29,12:29,5408175,7582225,2174050,BUY
06-11-20 12:30,12:30,5438975,7584825,2145850,BUY
06-11-20 12:31,12:31,5442775,7572150,2129375,BUY
06-11-20 12:32,12:32,5446025,7660225,2214200,BUY
06-11-20 12:33,12:33,5488525,7568200,2079675,BUY
06-11-20 12:34,12:34,5444450,7642750,2198300,BUY
06-11-20 12:35,12:35,5512400,7706775,2194375,BUY
06-11-20 12:36,12:36,5508650,7602750,2094100,BUY
06-11-20 12:37,12:37,5472975,7669025,2196050,BUY
06-11-20 12:38,12:38,5493825,7666100,2172275,BUY
06-11-20 12:39,12:39,5502450,7474575,1972125,BUY
06-11-20 12:40,12:40,5576825,7675200,2098375,BUY
06-11-20 12:41,12:41,5472525,7743325,2270800,BUY
06-11-20 12:42,12:42,5411400,7739575,2328175,BUY
06-11-20 12:43,12:43,5446275,7776550,2330275,BUY
06-11-20 12:44,12:44,5467550,7826125,2358575,BUY
06-11-20 12:45,12:45,5471400,7787850,2316450,BUY
06-11-20 12:46,12:46,5434650,7812750,2378100,BUY
06-11-20 12:47,12:47,5513650,7845325,2331675,BUY
06-11-20 12:48,12:48,5517975,7878525,2360550,BUY
06-11-20 12:49,12:49,5531700,7934475,2402775,BUY
06-11-20 12:50,12:50,5522875,7863475,2340600,BUY
06-11-20 12:51,12:51,5531725,7928150,2396425,BUY
06-11-20 12:52,12:52,5466000,7902300,2436300,BUY
06-11-20 12:53,12:53,5420300,7967500,2547200,BUY
06-11-20 12:54,12:54,5623800,7910775,2286975,BUY
06-11-20 12:55,12:55,5642600,7997175,2354575,BUY
06-11-20 12:56,12:56,5290150,8020450,2730300,BUY
06-11-20 12:57,12:57,5291200,7994250,2703050,BUY
06-11-20 12:58,12:58,5312300,7926125,2613825,BUY
06-11-20 12:59,12:59,5296150,7931000,2634850,BUY
06-11-20 13:00,13:00,5301750,7890675,2588925,BUY
06-11-20 13:01,13:01,5343750,7906500,2562750,BUY
06-11-20 13:02,13:02,5352575,7967400,2614825,BUY
06-11-20 13:03,13:03,5417800,8002300,2584500,BUY
06-11-20 13:04,13:04,5361175,7959250,2598075,BUY
06-11-20 13:05,13:05,5467800,7999950,2532150,BUY
06-11-20 13:06,13:06,5454450,7962525,2508075,BUY
06-11-20 13:07,13:07,5456325,7956625,2500300,BUY
06-11-20 13:08,13:08,5489375,7993425,2504050,BUY
06-11-20 13:09,13:09,5445425,8034050,2588625,BUY
06-11-20 13:10,13:10,5463975,8054500,2590525,BUY
06-11-20 13:11,13:11,5540550,8032650,2492100,BUY
06-11-20 13:12,13:12,5543525,8050400,2506875,BUY
06-11-20 13:13,13:13,5539650,8056100,2516450,BUY
06-11-20 13:14,13:14,5551425,8014150,2462725,BUY
06-11-20 13:15,13:15,5558775,8042775,2484000,BUY
06-11-20 13:16,13:16,5569650,8017025,2447375,BUY
06-11-20 13:17,13:17,5646700,8069600,2422900,BUY
06-11-20 13:18,13:18,5617375,8058225,2440850,BUY
06-11-20 13:19,13:19,5657225,8066000,2408775,BUY
06-11-20 13:20,13:20,5674275,8060350,2386075,BUY
06-11-20 13:21,13:21,5592750,8014775,2422025,BUY
06-11-20 13:22,13:22,5542275,8023225,2480950,BUY
06-11-20 13:23,13:23,5636775,8068300,2431525,BUY
06-11-20 13:24,13:24,5594575,8045025,2450450,BUY
06-11-20 13:25,13:25,5573400,8053400,2480000,BUY
06-11-20 13:26,13:26,5683150,8100700,2417550,BUY
06-11-20 13:27,13:27,5605850,8036050,2430200,BUY
06-11-20 13:28,13:28,5689800,8068950,2379150,BUY
06-11-20 13:29,13:29,5769850,8166400,2396550,BUY
06-11-20 13:30,13:30,5790025,8183150,2393125,BUY
06-11-20 13:31,13:31,5662300,8120950,2458650,BUY
06-11-20 13:32,13:32,5672650,8177400,2504750,BUY
06-11-20 13:33,13:33,5655850,8148475,2492625,BUY
06-11-20 13:34,13:34,5707600,8206425,2498825,BUY
06-11-20 13:35,13:35,5764500,8208125,2443625,BUY
06-11-20 13:36,13:36,5727550,8235850,2508300,BUY
06-11-20 13:37,13:37,5801525,8243500,2441975,BUY
06-11-20 13:38,13:38,5771225,8260300,2489075,BUY
06-11-20 13:39,13:39,5728900,8240250,2511350,BUY
06-11-20 13:40,13:40,5849425,8247750,2398325,BUY
06-11-20 13:41,13:41,5690475,8285975,2595500,BUY
06-11-20 13:42,13:42,5788875,8261700,2472825,BUY
06-11-20 13:43,13:43,5701650,8323850,2622200,BUY
06-11-20 13:44,13:44,5682825,8261775,2578950,BUY
06-11-20 13:45,13:45,5704675,8296200,2591525,BUY
06-11-20 13:46,13:46,5697500,8306100,2608600,BUY
06-11-20 13:47,13:47,5718450,8330700,2612250,BUY
06-11-20 13:48,13:48,5877000,8378950,2501950,BUY
06-11-20 13:49,13:49,5850425,8402275,2551850,BUY
06-11-20 13:50,13:50,5817050,8370125,2553075,BUY
06-11-20 13:51,13:51,5851575,8358350,2506775,BUY
06-11-20 13:52,13:52,5851575,8413025,2561450,BUY
06-11-20 13:53,13:53,5795125,8386625,2591500,BUY
06-11-20 13:54,13:54,5866850,8397400,2530550,BUY
06-11-20 13:55,13:55,5876650,8372500,2495850,BUY
06-11-20 13:56,13:56,5708550,8347625,2639075,BUY
06-11-20 13:57,13:57,5859175,8360850,2501675,BUY
06-11-20 13:58,13:58,5925175,8415550,2490375,BUY
06-11-20 13:59,13:59,5954700,8438625,2483925,BUY
06-11-20 14:00,14:00,5920975,8371550,2450575,BUY
06-11-20 14:01,14:01,5917425,8389750,2472325,BUY
06-11-20 14:02,14:02,5929175,8392750,2463575,BUY
06-11-20 14:03,14:03,5926975,8393875,2466900,BUY
06-11-20 14:04,14:04,5884050,8424525,2540475,BUY
06-11-20 14:05,14:05,5983800,8486475,2502675,BUY
06-11-20 14:06,14:06,5833100,8414775,2581675,BUY
06-11-20 14:07,14:07,5800600,8462075,2661475,BUY
06-11-20 14:08,14:08,5935700,8409825,2474125,BUY
06-11-20 14:09,14:09,5891275,8476050,2584775,BUY
06-11-20 14:10,14:10,5860250,8463650,2603400,BUY
06-11-20 14:11,14:11,5836925,8476675,2639750,BUY
06-11-20 14:12,14:12,5805925,8490575,2684650,BUY
06-11-20 14:13,14:13,5740600,8438375,2697775,BUY
06-11-20 14:14,14:14,5925550,8519500,2593950,BUY
06-11-20 14:15,14:15,5801525,8560475,2758950,BUY
06-11-20 14:16,14:16,5955925,8550675,2594750,BUY
06-11-20 14:17,14:17,5869175,8585025,2715850,BUY
06-11-20 14:18,14:18,5888400,8589150,2700750,BUY
06-11-20 14:19,14:19,5875775,8572025,2696250,BUY
06-11-20 14:20,14:20,5878225,8560650,2682425,BUY
06-11-20 14:21,14:21,5864875,8601500,2736625,BUY
06-11-20 14:22,14:22,5923225,8611950,2688725,BUY
06-11-20 14:23,14:23,5937575,8566325,2628750,BUY
06-11-20 14:24,14:24,5845050,8570150,2725100,BUY
06-11-20 14:25,14:25,5846900,8649525,2802625,BUY
06-11-20 14:26,14:26,5877200,8590150,2712950,BUY
06-11-20 14:27,14:27,5911225,8636750,2725525,BUY
06-11-20 14:28,14:28,5993500,8678625,2685125,BUY
06-11-20 14:29,14:29,5936900,8685850,2748950,BUY
06-11-20 14:30,14:30,5743100,8535150,2792050,BUY
06-11-20 14:31,14:31,5729350,8496075,2766725,BUY
06-11-20 14:32,14:32,5756900,8521350,2764450,BUY
06-11-20 14:33,14:33,5815550,8447150,2631600,BUY
06-11-20 14:34,14:34,5708225,8461625,2753400,BUY
06-11-20 14:35,14:35,5761150,8431050,2669900,BUY
06-11-20 14:36,14:36,5891700,8478650,2586950,BUY
06-11-20 14:37,14:37,5864800,8507600,2642800,BUY
06-11-20 14:38,14:38,5867075,8434075,2567000,BUY
06-11-20 14:39,14:39,5819275,8331925,2512650,BUY
06-11-20 14:40,14:40,5848700,8337550,2488850,BUY
06-11-20 14:41,14:41,5887700,8304525,2416825,BUY
06-11-20 14:42,14:42,5746300,8171050,2424750,BUY
06-11-20 14:43,14:43,5752125,8179175,2427050,BUY
06-11-20 14:44,14:44,5749225,8172175,2422950,BUY
06-11-20 14:45,14:45,5777225,8179375,2402150,BUY
06-11-20 14:46,14:46,5802225,8191275,2389050,BUY
06-11-20 14:47,14:47,5828075,8201950,2373875,BUY
06-11-20 14:48,14:48,5737650,8161375,2423725,BUY
06-11-20 14:49,14:49,5871650,8139225,2267575,BUY
06-11-20 14:50,14:50,5869850,8160225,2290375,BUY
06-11-20 14:51,14:51,5950725,8173175,2222450,BUY
06-11-20 14:52,14:52,5928025,8107425,2179400,BUY
06-11-20 14:53,14:53,5949700,8135275,2185575,BUY
06-11-20 14:54,14:54,5850325,8155250,2304925,BUY
06-11-20 14:55,14:55,5867700,8127650,2259950,BUY
06-11-20 14:56,14:56,5826050,8142750,2316700,BUY
06-11-20 14:57,14:57,5911575,8134350,2222775,BUY
06-11-20 14:58,14:58,5920450,8161025,2240575,BUY
06-11-20 14:59,14:59,5884150,8150325,2266175,BUY
06-11-20 15:00,15:00,5847750,8171150,2323400,BUY
06-11-20 15:01,15:01,5821925,8176875,2354950,BUY
06-11-20 15:02,15:02,5810175,8166375,2356200,BUY
06-11-20 15:03,15:03,5821025,8112625,2291600,BUY
06-11-20 15:04,15:04,5809700,8111350,2301650,BUY
06-11-20 15:05,15:05,5824125,8089675,2265550,BUY
06-11-20 15:06,15:06,5821600,8078175,2256575,BUY
06-11-20 15:07,15:07,5800475,8139825,2339350,BUY
06-11-20 15:08,15:08,5853350,8146575,2293225,BUY
06-11-20 15:09,15:09,5766325,8146200,2379875,BUY
06-11-20 15:10,15:10,5757100,8115400,2358300,BUY
06-11-20 15:11,15:11,5693500,8168625,2475125,BUY
06-11-20 15:12,15:12,5765225,8045825,2280600,BUY
06-11-20 15:13,15:13,5707975,8084750,2376775,BUY
06-11-20 15:14,15:14,5732050,8065975,2333925,BUY
06-11-20 15:15,15:15,5678850,8076500,2397650,BUY
06-11-20 15:16,15:16,5730375,8058475,2328100,BUY
06-11-20 15:17,15:17,5728175,8062525,2334350,BUY
06-11-20 15:18,15:18,5625025,7946200,2321175,BUY
06-11-20 15:19,15:19,5649475,7982600,2333125,BUY
06-11-20 15:20,15:20,5601350,7974100,2372750,BUY
06-11-20 15:21,15:21,5367625,7766725,2399100,BUY
06-11-20 15:22,15:22,5384450,7771100,2386650,BUY
06-11-20 15:23,15:23,5330875,7758175,2427300,BUY
06-11-20 15:24,15:24,5268200,7711825,2443625,BUY
06-11-20 15:25,15:25,5317775,7725675,2407900,BUY
06-11-20 15:26,15:26,5223725,7676175,2452450,BUY
06-11-20 15:27,15:27,5104650,7538575,2433925,BUY
06-11-20 15:28,15:28,5103925,7554475,2450550,BUY
06-11-20 15:29,15:29,5143875,7556500,2412625,BUY
09-11-20 9:15,9:15,4886250,7272575,2386325,BUY
09-11-20 9:16,9:16,4859675,7297775,2438100,BUY
09-11-20 9:17,9:17,4969650,7303750,2334100,BUY
09-11-20 9:18,9:18,4932150,7303975,2371825,BUY
09-11-20 9:19,9:19,4897700,7291425,2393725,BUY
09-11-20 9:20,9:20,4978850,7373025,2394175,BUY
09-11-20 9:21,9:21,4997075,7361950,2364875,BUY
09-11-20 9:22,9:22,4968000,7363550,2395550,BUY
09-11-20 9:23,9:23,4965025,7309225,2344200,BUY
09-11-20 9:24,9:24,4926625,7309575,2382950,BUY
09-11-20 9:25,9:25,4871700,7216250,2344550,BUY
09-11-20 9:26,9:26,4967725,7461725,2494000,BUY
09-11-20 9:27,9:27,5037925,7453850,2415925,BUY
09-11-20 9:28,9:28,5079050,7435850,2356800,BUY
09-11-20 9:29,9:29,5163150,7647700,2484550,BUY
09-11-20 9:30,9:30,5181225,7654800,2473575,BUY
09-11-20 9:31,9:31,5222925,7581350,2358425,BUY
09-11-20 9:32,9:32,5331750,7823800,2492050,BUY
09-11-20 9:33,9:33,5295800,7804225,2508425,BUY
09-11-20 9:34,9:34,5295375,7721075,2425700,BUY
09-11-20 9:35,9:35,5477025,8051225,2574200,BUY
09-11-20 9:36,9:36,5411450,8106400,2694950,BUY
09-11-20 9:37,9:37,5401125,8112225,2711100,BUY
09-11-20 9:38,9:38,5481025,8252250,2771225,BUY
09-11-20 9:39,9:39,5422400,8265025,2842625,BUY
09-11-20 9:40,9:40,5420975,8262450,2841475,BUY
09-11-20 9:41,9:41,5605725,8456900,2851175,BUY
09-11-20 9:42,9:42,5652000,8432550,2780550,BUY
09-11-20 9:43,9:43,5604125,8437675,2833550,BUY
09-11-20 9:44,9:44,5471325,8211225,2739900,BUY
09-11-20 9:45,9:45,5446375,8275400,2829025,BUY
09-11-20 9:46,9:46,5485375,8263850,2778475,BUY
09-11-20 9:47,9:47,5698650,8499900,2801250,BUY
09-11-20 9:48,9:48,5723175,8518950,2795775,BUY
09-11-20 9:49,9:49,5711950,8396425,2684475,BUY
09-11-20 9:50,9:50,5829050,8503675,2674625,BUY
09-11-20 9:51,9:51,5770975,8512800,2741825,BUY
09-11-20 9:52,9:52,5842425,8478875,2636450,BUY
09-11-20 9:53,9:53,6021825,8571750,2549925,BUY
09-11-20 9:54,9:54,5969225,8641125,2671900,BUY
09-11-20 9:55,9:55,6014950,8655975,2641025,BUY
09-11-20 9:56,9:56,6078550,8704775,2626225,BUY
09-11-20 9:57,9:57,5986350,8674250,2687900,BUY
09-11-20 9:58,9:58,6088475,8731925,2643450,BUY
09-11-20 9:59,9:59,5904125,8897125,2993000,BUY
09-11-20 10:00,10:00,5934650,8897825,2963175,BUY
09-11-20 10:01,10:01,5963175,8936675,2973500,BUY
09-11-20 10:02,10:02,5961275,8960350,2999075,BUY
09-11-20 10:03,10:03,6061000,8904825,2843825,BUY
09-11-20 10:04,10:04,6154050,8955950,2801900,BUY
09-11-20 10:05,10:05,6226200,9125775,2899575,BUY
09-11-20 10:06,10:06,6254200,9180100,2925900,BUY
09-11-20 10:07,10:07,6307875,9135650,2827775,BUY
09-11-20 10:08,10:08,6433175,9197950,2764775,BUY
09-11-20 10:09,10:09,6420050,9267875,2847825,BUY
09-11-20 10:10,10:10,6432775,9191700,2758925,BUY
09-11-20 10:11,10:11,6415650,9205350,2789700,BUY
09-11-20 10:12,10:12,6511050,9258550,2747500,BUY
09-11-20 10:13,10:13,6302650,9170175,2867525,BUY
09-11-20 10:14,10:14,6382150,9250625,2868475,BUY
09-11-20 10:15,10:15,6629675,9330750,2701075,BUY
09-11-20 10:16,10:16,6474200,9291975,2817775,BUY
09-11-20 10:17,10:17,6576375,9306550,2730175,BUY
09-11-20 10:18,10:18,6736625,9279875,2543250,BUY
09-11-20 10:19,10:19,6678825,9334400,2655575,BUY
09-11-20 10:20,10:20,6601100,9340750,2739650,BUY
09-11-20 10:21,10:21,6631175,9350225,2719050,BUY
09-11-20 10:22,10:22,6441425,9338250,2896825,BUY
09-11-20 10:23,10:23,6769350,9400175,2630825,BUY
09-11-20 10:24,10:24,6889075,9423850,2534775,BUY
09-11-20 10:25,10:25,6708950,9313125,2604175,BUY
09-11-20 10:26,10:26,6809150,9311950,2502800,BUY
09-11-20 10:27,10:27,6773075,9164425,2391350,BUY
09-11-20 10:28,10:28,6836300,9334775,2498475,BUY
09-11-20 10:29,10:29,6889650,9380475,2490825,BUY
09-11-20 10:30,10:30,7037275,9369575,2332300,BUY
09-11-20 10:31,10:31,7057825,9421900,2364075,BUY
09-11-20 10:32,10:32,7002600,9419325,2416725,BUY
09-11-20 10:33,10:33,7111300,9395375,2284075,BUY
09-11-20 10:34,10:34,7072325,9423550,2351225,BUY
09-11-20 10:35,10:35,6837200,9449725,2612525,BUY
09-11-20 10:36,10:36,7081200,9415775,2334575,BUY
09-11-20 10:37,10:37,7058500,9465450,2406950,BUY
09-11-20 10:38,10:38,7117650,9403625,2285975,BUY
09-11-20 10:39,10:39,7206300,9369775,2163475,BUY
09-11-20 10:40,10:40,7169025,9357775,2188750,BUY
09-11-20 10:41,10:41,7085100,9339700,2254600,BUY
09-11-20 10:42,10:42,7267375,9356175,2088800,BUY
09-11-20 10:43,10:43,7099125,9328250,2229125,BUY
09-11-20 10:44,10:44,7195850,9107250,1911400,BUY
09-11-20 10:45,10:45,7339300,9140125,1800825,BUY
09-11-20 10:46,10:46,7122150,9156050,2033900,BUY
09-11-20 10:47,10:47,7160550,9053125,1892575,BUY
09-11-20 10:48,10:48,7279500,9044150,1764650,BUY
09-11-20 10:49,10:49,7419600,8984525,1564925,BUY
09-11-20 10:50,10:50,7504025,8961775,1457750,BUY
09-11-20 10:51,10:51,7370625,8913050,1542425,BUY
09-11-20 10:52,10:52,7338950,8887325,1548375,BUY
09-11-20 10:53,10:53,7347325,8787975,1440650,BUY
09-11-20 10:54,10:54,7305725,8865450,1559725,BUY
09-11-20 10:55,10:55,7411575,8682650,1271075,BUY
09-11-20 10:56,10:56,7488825,8900125,1411300,BUY
09-11-20 10:57,10:57,7529850,8787600,1257750,BUY
09-11-20 10:58,10:58,7468200,8860050,1391850,BUY
09-11-20 10:59,10:59,7422800,8721825,1299025,BUY
09-11-20 11:00,11:00,7445000,8786250,1341250,BUY
09-11-20 11:01,11:01,7317700,8804650,1486950,BUY
09-11-20 11:02,11:02,7495700,8898500,1402800,BUY
09-11-20 11:03,11:03,7589675,8886825,1297150,BUY
09-11-20 11:04,11:04,7560800,8905700,1344900,BUY
09-11-20 11:05,11:05,7719650,8890900,1171250,BUY
09-11-20 11:06,11:06,7464050,8868325,1404275,BUY
09-11-20 11:07,11:07,7666150,8852250,1186100,BUY
09-11-20 11:08,11:08,7639425,8884925,1245500,BUY
09-11-20 11:09,11:09,7699075,8925850,1226775,BUY
09-11-20 11:10,11:10,7496250,8912375,1416125,BUY
09-11-20 11:11,11:11,7737325,8927275,1189950,BUY
09-11-20 11:12,11:12,7696525,8875200,1178675,BUY
09-11-20 11:13,11:13,7784675,8940225,1155550,BUY
09-11-20 11:14,11:14,7550925,9033575,1482650,BUY
09-11-20 11:15,11:15,7628525,8941575,1313050,BUY
09-11-20 11:16,11:16,7795750,8548900,753150,BUY
09-11-20 11:17,11:17,7850600,9007050,1156450,BUY
09-11-20 11:18,11:18,7733775,8757825,1024050,BUY
09-11-20 11:19,11:19,7459025,8700725,1241700,BUY
09-11-20 11:20,11:20,7908500,8968250,1059750,BUY
09-11-20 11:21,11:21,7851925,9021375,1169450,BUY
09-11-20 11:22,11:22,7958225,9054000,1095775,BUY
09-11-20 11:23,11:23,7896325,8863325,967000,BUY
09-11-20 11:24,11:24,7739325,8807450,1068125,BUY
09-11-20 11:25,11:25,7857925,8832900,974975,BUY
09-11-20 11:26,11:26,7949275,8815400,866125,BUY
09-11-20 11:27,11:27,7931700,8829925,898225,BUY
09-11-20 11:28,11:28,8048925,8817300,768375,BUY
09-11-20 11:29,11:29,8043725,8885400,841675,BUY
09-11-20 11:30,11:30,8002450,8886475,884025,BUY
09-11-20 11:31,11:31,7829725,8785175,955450,BUY
09-11-20 11:32,11:32,7951650,8835100,883450,BUY
09-11-20 11:33,11:33,7994150,8861175,867025,BUY
09-11-20 11:34,11:34,7835200,8782600,947400,BUY
09-11-20 11:35,11:35,8002300,8812225,809925,BUY
09-11-20 11:36,11:36,8040825,8821100,780275,BUY
09-11-20 11:37,11:37,7846625,8870550,1023925,BUY
09-11-20 11:38,11:38,8205675,8870800,665125,BUY
09-11-20 11:39,11:39,8127475,8617000,489525,BUY
09-11-20 11:40,11:40,8143800,8829400,685600,BUY
09-11-20 11:41,11:41,7993050,8787900,794850,BUY
09-11-20 11:42,11:42,8160025,8398800,238775,BUY
09-11-20 11:43,11:43,8056600,8857625,801025,BUY
09-11-20 11:44,11:44,8105050,8681600,576550,BUY
09-11-20 11:45,11:45,7955125,8833600,878475,BUY
09-11-20 11:46,11:46,8187925,8652500,464575,BUY
09-11-20 11:47,11:47,8194525,8911275,716750,BUY
09-11-20 11:48,11:48,8185775,8674500,488725,BUY
09-11-20 11:49,11:49,8075825,8875025,799200,BUY
09-11-20 11:50,11:50,8103275,8900050,796775,BUY
09-11-20 11:51,11:51,7993950,8722775,728825,BUY
09-11-20 11:52,11:52,8150950,8959400,808450,BUY
09-11-20 11:53,11:53,8182475,8924750,742275,BUY
09-11-20 11:54,11:54,8012225,8846225,834000,BUY
09-11-20 11:55,11:55,8298575,8950600,652025,BUY
09-11-20 11:56,11:56,7980750,8714450,733700,BUY
09-11-20 11:57,11:57,8137525,8914750,777225,BUY
09-11-20 11:58,11:58,7925775,8894700,968925,BUY
09-11-20 11:59,11:59,8124450,8936050,811600,BUY
09-11-20 12:00,12:00,8231625,8845475,613850,BUY
09-11-20 12:01,12:01,8221800,8890900,669100,BUY
09-11-20 12:02,12:02,8127900,8791250,663350,BUY
09-11-20 12:03,12:03,7889825,9061650,1171825,BUY
09-11-20 12:04,12:04,8051175,8838775,787600,BUY
09-11-20 12:05,12:05,8095625,9080850,985225,BUY
09-11-20 12:06,12:06,8430300,8907600,477300,BUY
09-11-20 12:07,12:07,8155000,8516250,361250,BUY
09-11-20 12:08,12:08,8181975,8635675,453700,BUY
09-11-20 12:09,12:09,8055800,8883150,827350,BUY
09-11-20 12:10,12:10,8301175,8895500,594325,BUY
09-11-20 12:11,12:11,8264125,8875400,611275,BUY
09-11-20 12:12,12:12,8237150,8849175,612025,BUY
09-11-20 12:13,12:13,8256375,8895650,639275,BUY
09-11-20 12:14,12:14,8501050,8872475,371425,BUY
09-11-20 12:15,12:15,8285800,8978975,693175,BUY
09-11-20 12:16,12:16,8363425,9047725,684300,BUY
09-11-20 12:17,12:17,8271225,9102200,830975,BUY
09-11-20 12:18,12:18,8297175,8975025,677850,BUY
09-11-20 12:19,12:19,8073700,8598500,524800,BUY
09-11-20 12:20,12:20,8578400,8829075,250675,BUY
09-11-20 12:21,12:21,8485675,9190650,704975,BUY
09-11-20 12:22,12:22,8054300,8974525,920225,BUY
09-11-20 12:23,12:23,7938275,9149900,1211625,BUY
09-11-20 12:24,12:24,8288625,9184900,896275,BUY
09-11-20 12:25,12:25,8110550,9060050,949500,BUY
09-11-20 12:26,12:26,8400025,9116350,716325,BUY
09-11-20 12:27,12:27,8163600,9183200,1019600,BUY
09-11-20 12:28,12:28,8426125,9193625,767500,BUY
09-11-20 12:29,12:29,8551125,9172650,621525,BUY
09-11-20 12:30,12:30,8675250,8795225,119975,BUY
09-11-20 12:31,12:31,8522025,9219600,697575,BUY
09-11-20 12:32,12:32,8689500,8966550,277050,BUY
09-11-20 12:33,12:33,8451525,8731625,280100,BUY
09-11-20 12:34,12:34,8307450,9096300,788850,BUY
09-11-20 12:35,12:35,8542850,9074825,531975,BUY
09-11-20 12:36,12:36,8439775,8699350,259575,BUY
09-11-20 12:37,12:37,8277225,8657000,379775,BUY
09-11-20 12:38,12:38,8289600,8882025,592425,BUY
09-11-20 12:39,12:39,8482775,8500225,17450,BUY
09-11-20 12:40,12:40,8569400,8790350,220950,BUY
09-11-20 12:41,12:41,8368225,9091850,723625,BUY
09-11-20 12:42,12:42,8750425,9112200,361775,BUY
09-11-20 12:43,12:43,8821150,9251350,430200,BUY
09-11-20 12:44,12:44,8398275,9191200,792925,BUY
09-11-20 12:45,12:45,8767250,9273900,506650,BUY
09-11-20 12:46,12:46,8431725,9074875,643150,BUY
09-11-20 12:47,12:47,8548300,9208675,660375,BUY
09-11-20 12:48,12:48,8377450,9244750,867300,BUY
09-11-20 12:49,12:49,8527575,9212925,685350,BUY
09-11-20 12:50,12:50,8668775,9267400,598625,BUY
09-11-20 12:51,12:51,8433050,9231400,798350,BUY
09-11-20 12:52,12:52,8527225,9229725,702500,BUY
09-11-20 12:53,12:53,8402700,9281700,879000,BUY
09-11-20 12:54,12:54,8529075,9229175,700100,BUY
09-11-20 12:55,12:55,8434575,9028125,593550,BUY
09-11-20 12:56,12:56,8454225,9256800,802575,BUY
09-11-20 12:57,12:57,8158675,9242425,1083750,BUY
09-11-20 12:58,12:58,8456100,9053725,597625,BUY
09-11-20 12:59,12:59,8409175,9246275,837100,BUY
09-11-20 13:00,13:00,8534325,9288200,753875,BUY
09-11-20 13:01,13:01,8420700,9334525,913825,BUY
09-11-20 13:02,13:02,7973450,9316700,1343250,BUY
09-11-20 13:03,13:03,8245375,9239650,994275,BUY
09-11-20 13:04,13:04,8284875,9322250,1037375,BUY
09-11-20 13:05,13:05,8358200,9336875,978675,BUY
09-11-20 13:06,13:06,8278775,9315200,1036425,BUY
09-11-20 13:07,13:07,8179125,9343725,1164600,BUY
09-11-20 13:08,13:08,8459300,9100800,641500,BUY
09-11-20 13:09,13:09,8127200,9293600,1166400,BUY
09-11-20 13:10,13:10,8229325,9338275,1108950,BUY
09-11-20 13:11,13:11,8379750,9374075,994325,BUY
09-11-20 13:12,13:12,8289600,9329500,1039900,BUY
09-11-20 13:13,13:13,8323550,9394600,1071050,BUY
09-11-20 13:14,13:14,8358425,9113300,754875,BUY
09-11-20 13:15,13:15,8306475,9369925,1063450,BUY
09-11-20 13:16,13:16,8439200,9408750,969550,BUY
09-11-20 13:17,13:17,8246325,9383525,1137200,BUY
09-11-20 13:18,13:18,8116975,9300275,1183300,BUY
09-11-20 13:19,13:19,8250350,9373825,1123475,BUY
09-11-20 13:20,13:20,8208050,9252900,1044850,BUY
09-11-20 13:21,13:21,8264725,9245125,980400,BUY
09-11-20 13:22,13:22,8273450,9412575,1139125,BUY
09-11-20 13:23,13:23,8065875,9400150,1334275,BUY
09-11-20 13:24,13:24,8082825,9338500,1255675,BUY
09-11-20 13:25,13:25,8286225,9431075,1144850,BUY
09-11-20 13:26,13:26,8159425,9449950,1290525,BUY
09-11-20 13:27,13:27,8428300,9530800,1102500,BUY
09-11-20 13:28,13:28,8131850,9468325,1336475,BUY
09-11-20 13:29,13:29,8564700,9476550,911850,BUY
09-11-20 13:30,13:30,8354600,9471475,1116875,BUY
09-11-20 13:31,13:31,8190850,9292750,1101900,BUY
09-11-20 13:32,13:32,8480500,9521550,1041050,BUY
09-11-20 13:33,13:33,8249525,9486875,1237350,BUY
09-11-20 13:34,13:34,8338400,8935625,597225,BUY
09-11-20 13:35,13:35,8157625,9507350,1349725,BUY
09-11-20 13:36,13:36,8138950,9504250,1365300,BUY
09-11-20 13:37,13:37,8550625,9508200,957575,BUY
09-11-20 13:38,13:38,8617825,9525875,908050,BUY
09-11-20 13:39,13:39,8357675,9472450,1114775,BUY
09-11-20 13:40,13:40,8221100,9486050,1264950,BUY
09-11-20 13:41,13:41,8306775,9546875,1240100,BUY
09-11-20 13:42,13:42,8357850,9365350,1007500,BUY
09-11-20 13:43,13:43,8455900,9320000,864100,BUY
09-11-20 13:44,13:44,8313825,9493050,1179225,BUY
09-11-20 13:45,13:45,8293050,9548300,1255250,BUY
09-11-20 13:46,13:46,8369675,9574950,1205275,BUY
09-11-20 13:47,13:47,8291350,9291750,1000400,BUY
09-11-20 13:48,13:48,8390650,9572725,1182075,BUY
09-11-20 13:49,13:49,8402550,9531250,1128700,BUY
09-11-20 13:50,13:50,8413100,9618475,1205375,BUY
09-11-20 13:51,13:51,8345375,9570350,1224975,BUY
09-11-20 13:52,13:52,8230850,9221150,990300,BUY
09-11-20 13:53,13:53,8180650,9316850,1136200,BUY
09-11-20 13:54,13:54,8242125,9387600,1145475,BUY
09-11-20 13:55,13:55,8475375,9670475,1195100,BUY
09-11-20 13:56,13:56,8179450,9559225,1379775,BUY
09-11-20 13:57,13:57,8237400,9650475,1413075,BUY
09-11-20 13:58,13:58,8224225,9449200,1224975,BUY
09-11-20 13:59,13:59,8318100,9455325,1137225,BUY
09-11-20 14:00,14:00,8301775,9596625,1294850,BUY
09-11-20 14:01,14:01,8312600,9618425,1305825,BUY
09-11-20 14:02,14:02,8290350,9663175,1372825,BUY
09-11-20 14:03,14:03,8240850,9752300,1511450,BUY
09-11-20 14:04,14:04,8461050,9686450,1225400,BUY
09-11-20 14:05,14:05,8323475,9765900,1442425,BUY
09-11-20 14:06,14:06,8290500,9796875,1506375,BUY
09-11-20 14:07,14:07,8283000,9774025,1491025,BUY
09-11-20 14:08,14:08,8321525,9823900,1502375,BUY
09-11-20 14:09,14:09,8127225,9884725,1757500,BUY
09-11-20 14:10,14:10,8513375,9815525,1302150,BUY
09-11-20 14:11,14:11,8380375,9898025,1517650,BUY
09-11-20 14:12,14:12,8284425,9892050,1607625,BUY
09-11-20 14:13,14:13,8276950,9985675,1708725,BUY
09-11-20 14:14,14:14,8402675,9930550,1527875,BUY
09-11-20 14:15,14:15,8416450,10004500,1588050,BUY
09-11-20 14:16,14:16,8451550,10009200,1557650,BUY
09-11-20 14:17,14:17,8276825,10017950,1741125,BUY
09-11-20 14:18,14:18,8268025,9974600,1706575,BUY
09-11-20 14:19,14:19,8201675,9947125,1745450,BUY
09-11-20 14:20,14:20,8001250,9921325,1920075,BUY
09-11-20 14:21,14:21,8384700,9938150,1553450,BUY
09-11-20 14:22,14:22,8542100,9970025,1427925,BUY
09-11-20 14:23,14:23,8433000,9994325,1561325,BUY
09-11-20 14:24,14:24,8374475,9935525,1561050,BUY
09-11-20 14:25,14:25,8418025,9876050,1458025,BUY
09-11-20 14:26,14:26,8247500,9932400,1684900,BUY
09-11-20 14:27,14:27,8423500,10016850,1593350,BUY
09-11-20 14:28,14:28,8223050,10016850,1793800,BUY
09-11-20 14:29,14:29,8286675,10024900,1738225,BUY
09-11-20 14:30,14:30,8596275,10060250,1463975,BUY
09-11-20 14:31,14:31,8424350,9985025,1560675,BUY
09-11-20 14:32,14:32,8129900,9929975,1800075,BUY
09-11-20 14:33,14:33,8443925,10049025,1605100,BUY
09-11-20 14:34,14:34,8406525,9972950,1566425,BUY
09-11-20 14:35,14:35,8221225,10043675,1822450,BUY
09-11-20 14:36,14:36,8290025,10050875,1760850,BUY
09-11-20 14:37,14:37,8138125,10014975,1876850,BUY
09-11-20 14:38,14:38,8240875,9941200,1700325,BUY
09-11-20 14:39,14:39,8303900,10003250,1699350,BUY
09-11-20 14:40,14:40,8408625,9989475,1580850,BUY
09-11-20 14:41,14:41,8368575,9986050,1617475,BUY
09-11-20 14:42,14:42,7840925,9918425,2077500,BUY
09-11-20 14:43,14:43,7776625,9927500,2150875,BUY
09-11-20 14:44,14:44,7862150,9984625,2122475,BUY
09-11-20 14:45,14:45,7991300,9932775,1941475,BUY
09-11-20 14:46,14:46,7818125,9860375,2042250,BUY
09-11-20 14:47,14:47,7942775,9933975,1991200,BUY
09-11-20 14:48,14:48,7796350,9858975,2062625,BUY
09-11-20 14:49,14:49,8005525,9799525,1794000,BUY
09-11-20 14:50,14:50,7845925,9688350,1842425,BUY
09-11-20 14:51,14:51,7762575,9655775,1893200,BUY
09-11-20 14:52,14:52,7813100,9890775,2077675,BUY
09-11-20 14:53,14:53,7829675,9890275,2060600,BUY
09-11-20 14:54,14:54,7907350,9734900,1827550,BUY
09-11-20 14:55,14:55,7894575,9792025,1897450,BUY
09-11-20 14:56,14:56,7700000,9880525,2180525,BUY
09-11-20 14:57,14:57,7555725,9906525,2350800,BUY
09-11-20 14:58,14:58,7746175,9922925,2176750,BUY
09-11-20 14:59,14:59,7728325,9899200,2170875,BUY
09-11-20 15:00,15:00,7955175,9982725,2027550,BUY
09-11-20 15:01,15:01,7850550,9991525,2140975,BUY
09-11-20 15:02,15:02,7886350,10007700,2121350,BUY
09-11-20 15:03,15:03,7747250,9908775,2161525,BUY
09-11-20 15:04,15:04,7694150,9899575,2205425,BUY
09-11-20 15:05,15:05,7795075,9984575,2189500,BUY
09-11-20 15:07,15:07,7615100,9786900,2171800,BUY
09-11-20 15:08,15:08,7534875,9823850,2288975,BUY
09-11-20 15:09,15:09,7660425,9841800,2181375,BUY
09-11-20 15:10,15:10,7517425,9822325,2304900,BUY
09-11-20 15:11,15:11,7594150,9795125,2200975,BUY
09-11-20 15:12,15:12,7433675,9837750,2404075,BUY
09-11-20 15:13,15:13,7575700,9848800,2273100,BUY
09-11-20 15:14,15:14,7615925,9855700,2239775,BUY
09-11-20 15:15,15:15,7583450,9840600,2257150,BUY
09-11-20 15:16,15:16,7603675,9871350,2267675,BUY
09-11-20 15:17,15:17,7601850,9938825,2336975,BUY
09-11-20 15:18,15:18,7355500,9788175,2432675,BUY
09-11-20 15:19,15:19,7371800,9779100,2407300,BUY
09-11-20 15:20,15:20,7360050,9757600,2397550,BUY
09-11-20 15:21,15:21,7240775,9598850,2358075,BUY
09-11-20 15:22,15:22,7229325,9653550,2424225,BUY
09-11-20 15:23,15:23,7194825,9606500,2411675,BUY
09-11-20 15:24,15:24,6984275,9457175,2472900,BUY
09-11-20 15:25,15:25,7219850,9425525,2205675,BUY
09-11-20 15:26,15:26,7167575,9460800,2293225,BUY
09-11-20 15:27,15:27,6883550,9348200,2464650,BUY
09-11-20 15:28,15:28,6949750,9351475,2401725,BUY
09-11-20 15:29,15:29,6955675,9381950,2426275,BUY
10-11-20 9:15,9:15,6240550,9176925,2936375,BUY
10-11-20 9:16,9:16,6208600,9126075,2917475,BUY
10-11-20 9:17,9:17,6679800,9220725,2540925,BUY
10-11-20 9:18,9:18,6688400,9237300,2548900,BUY
10-11-20 9:19,9:19,6724025,9196750,2472725,BUY
10-11-20 9:20,9:20,6593775,9286450,2692675,BUY
10-11-20 9:21,9:21,6560625,9248975,2688350,BUY
10-11-20 9:22,9:22,6619150,9288900,2669750,BUY
10-11-20 9:23,9:23,6521950,9541550,3019600,BUY
10-11-20 9:24,9:24,6702475,9569150,2866675,BUY
10-11-20 9:25,9:25,6768875,9514775,2745900,BUY
10-11-20 9:26,9:26,6688150,9680275,2992125,BUY
10-11-20 9:27,9:27,6666025,9657875,2991850,BUY
10-11-20 9:28,9:28,6622775,9718400,3095625,BUY
10-11-20 9:29,9:29,6628750,9698675,3069925,BUY
10-11-20 9:30,9:30,6587950,9714150,3126200,BUY
10-11-20 9:31,9:31,6627525,9664275,3036750,BUY
10-11-20 9:32,9:32,6523500,9766200,3242700,BUY
10-11-20 9:33,9:33,6643950,9772925,3128975,BUY
10-11-20 9:34,9:34,6566325,9727750,3161425,BUY
10-11-20 9:35,9:35,6528775,9886500,3357725,BUY
10-11-20 9:36,9:36,6354300,9892025,3537725,BUY
10-11-20 9:37,9:37,6471975,9932275,3460300,BUY
10-11-20 9:38,9:38,6517100,10010025,3492925,BUY
10-11-20 9:39,9:39,6535950,10043300,3507350,BUY
10-11-20 9:40,9:40,6734900,10010700,3275800,BUY
10-11-20 9:41,9:41,6827425,10078725,3251300,BUY
10-11-20 9:42,9:42,6994000,10096600,3102600,BUY
10-11-20 9:43,9:43,6579275,10107100,3527825,BUY
10-11-20 9:44,9:44,6759300,10181950,3422650,BUY
10-11-20 9:45,9:45,6888450,10155500,3267050,BUY
10-11-20 9:46,9:46,6976450,10124725,3148275,BUY
10-11-20 9:47,9:47,6809750,10232950,3423200,BUY
10-11-20 9:48,9:48,6803925,10191700,3387775,BUY
10-11-20 9:49,9:49,6754600,10148800,3394200,BUY
10-11-20 9:50,9:50,6796425,10312850,3516425,BUY
10-11-20 9:51,9:51,7011325,10059025,3047700,BUY
10-11-20 9:52,9:52,6912150,10275625,3363475,BUY
10-11-20 9:53,9:53,6994675,10050175,3055500,BUY
10-11-20 9:54,9:54,6948850,10216275,3267425,BUY
10-11-20 9:55,9:55,6869875,9820000,2950125,BUY
10-11-20 9:56,9:56,7322975,10046200,2723225,BUY
10-11-20 9:57,9:57,7191850,10285950,3094100,BUY
10-11-20 9:58,9:58,6949175,10184675,3235500,BUY
10-11-20 9:59,9:59,7147500,10369750,3222250,BUY
10-11-20 10:00,10:00,6962525,10278700,3316175,BUY
10-11-20 10:01,10:01,6788325,10428250,3639925,BUY
10-11-20 10:02,10:02,6983200,10036025,3052825,BUY
10-11-20 10:03,10:03,7192625,10345025,3152400,BUY
10-11-20 10:04,10:04,7164150,10271175,3107025,BUY
10-11-20 10:05,10:05,7031725,10453725,3422000,BUY
10-11-20 10:06,10:06,7079625,10370375,3290750,BUY
10-11-20 10:07,10:07,7174625,10449900,3275275,BUY
10-11-20 10:08,10:08,7164750,10473775,3309025,BUY
10-11-20 10:09,10:09,7238425,10588550,3350125,BUY
10-11-20 10:10,10:10,7539625,10757500,3217875,BUY
10-11-20 10:11,10:11,7388375,10701575,3313200,BUY
10-11-20 10:12,10:12,7272650,10909600,3636950,BUY
10-11-20 10:13,10:13,7335275,10779900,3444625,BUY
10-11-20 10:14,10:14,7329925,10868975,3539050,BUY
10-11-20 10:15,10:15,7234600,10782900,3548300,BUY
10-11-20 10:16,10:16,7576150,10923500,3347350,BUY
10-11-20 10:17,10:17,7287725,11155400,3867675,BUY
10-11-20 10:18,10:18,7331425,11304225,3972800,BUY
10-11-20 10:19,10:19,7201100,11230325,4029225,BUY
10-11-20 10:20,10:20,7117350,11405775,4288425,BUY
10-11-20 10:21,10:21,6995375,11533475,4538100,BUY
10-11-20 10:22,10:22,7107850,11483250,4375400,BUY
10-11-20 10:23,10:23,7041650,11703275,4661625,BUY
10-11-20 10:24,10:24,7143900,11394775,4250875,BUY
10-11-20 10:25,10:25,6945900,11574500,4628600,BUY
10-11-20 10:26,10:26,7451800,11801125,4349325,BUY
10-11-20 10:27,10:27,7394650,11696000,4301350,BUY
10-11-20 10:28,10:28,7075850,11514325,4438475,BUY
10-11-20 10:29,10:29,7637175,11785425,4148250,BUY
10-11-20 10:30,10:30,7489350,12011300,4521950,BUY
10-11-20 10:31,10:31,7366325,11987800,4621475,BUY
10-11-20 10:32,10:32,7707875,11749325,4041450,BUY
10-11-20 10:33,10:33,7241425,11907000,4665575,BUY
10-11-20 10:34,10:34,7688175,12072450,4384275,BUY
10-11-20 10:35,10:35,7557575,12199500,4641925,BUY
10-11-20 10:36,10:36,7725200,12019825,4294625,BUY
10-11-20 10:37,10:37,7152000,11686350,4534350,BUY
10-11-20 10:38,10:38,7878225,12037375,4159150,BUY
10-11-20 10:39,10:39,7886300,12222525,4336225,BUY
10-11-20 10:40,10:40,7654000,12374000,4720000,BUY
10-11-20 10:41,10:41,7922075,12408350,4486275,BUY
10-11-20 10:42,10:42,7727550,12150700,4423150,BUY
10-11-20 10:43,10:43,7869300,12249000,4379700,BUY
10-11-20 10:44,10:44,7796850,12673150,4876300,BUY
10-11-20 10:45,10:45,7810925,12454200,4643275,BUY
10-11-20 10:46,10:46,7748650,12730625,4981975,BUY
10-11-20 10:47,10:47,7776325,12666675,4890350,BUY
10-11-20 10:48,10:48,7947350,12583200,4635850,BUY
10-11-20 10:49,10:49,8167725,12834975,4667250,BUY
10-11-20 10:50,10:50,7746275,12677475,4931200,BUY
10-11-20 10:51,10:51,8034925,12579725,4544800,BUY
10-11-20 10:52,10:52,7954850,12439050,4484200,BUY
10-11-20 10:53,10:53,7458475,12676050,5217575,BUY
10-11-20 10:54,10:54,7650950,12739400,5088450,BUY
10-11-20 10:55,10:55,7815825,12961250,5145425,BUY
10-11-20 10:56,10:56,7893300,12735575,4842275,BUY
10-11-20 10:57,10:57,7805425,12843500,5038075,BUY
10-11-20 10:58,10:58,7806900,12922325,5115425,BUY
10-11-20 10:59,10:59,7715200,13083650,5368450,BUY
10-11-20 11:00,11:00,7619225,13037200,5417975,BUY
10-11-20 11:01,11:01,7515700,12922700,5407000,BUY
10-11-20 11:02,11:02,7802750,13096850,5294100,BUY
10-11-20 11:03,11:03,7768975,13015425,5246450,BUY
10-11-20 11:04,11:04,7692400,12885400,5193000,BUY
10-11-20 11:05,11:05,7611775,12976625,5364850,BUY
10-11-20 11:06,11:06,7563500,13021175,5457675,BUY
10-11-20 11:07,11:07,7756450,13023000,5266550,BUY
10-11-20 11:08,11:08,7196475,13212825,6016350,BUY
10-11-20 11:09,11:09,7498925,13129800,5630875,BUY
10-11-20 11:10,11:10,7304925,13008700,5703775,BUY
10-11-20 11:11,11:11,7610750,13126875,5516125,BUY
10-11-20 11:12,11:12,7538775,13083800,5545025,BUY
10-11-20 11:13,11:13,7334925,13174200,5839275,BUY
10-11-20 11:14,11:14,7620250,12916075,5295825,BUY
10-11-20 11:15,11:15,7635725,12836450,5200725,BUY
10-11-20 11:16,11:16,7618800,13147600,5528800,BUY
10-11-20 11:17,11:17,7490925,12910575,5419650,BUY
10-11-20 11:18,11:18,7400150,12985200,5585050,BUY
10-11-20 11:19,11:19,7537575,13233900,5696325,BUY
10-11-20 11:20,11:20,7495350,13273500,5778150,BUY
10-11-20 11:21,11:21,7757300,13232525,5475225,BUY
10-11-20 11:22,11:22,7712475,13206150,5493675,BUY
10-11-20 11:23,11:23,7773875,13231000,5457125,BUY
10-11-20 11:24,11:24,7855050,13338200,5483150,BUY
10-11-20 11:25,11:25,7910550,13255975,5345425,BUY
10-11-20 11:26,11:26,7676425,13259975,5583550,BUY
10-11-20 11:27,11:27,7517500,13277025,5759525,BUY
10-11-20 11:28,11:28,7827300,13234850,5407550,BUY
10-11-20 11:29,11:29,7503100,12959325,5456225,BUY
10-11-20 11:30,11:30,7751050,13023975,5272925,BUY
10-11-20 11:31,11:31,7801625,12735800,4934175,BUY
10-11-20 11:32,11:32,7445875,12723200,5277325,BUY
10-11-20 11:33,11:33,7454375,12760975,5306600,BUY
10-11-20 11:34,11:34,7608700,12963600,5354900,BUY
10-11-20 11:35,11:35,7733050,13020675,5287625,BUY
10-11-20 11:36,11:36,7629675,13066175,5436500,BUY
10-11-20 11:37,11:37,7719150,13160250,5441100,BUY
10-11-20 11:38,11:38,7618600,13035600,5417000,BUY
10-11-20 11:39,11:39,7572675,12914725,5342050,BUY
10-11-20 11:40,11:40,7886950,13004650,5117700,BUY
10-11-20 11:41,11:41,7430500,13135450,5704950,BUY
10-11-20 11:42,11:42,8049125,13090150,5041025,BUY
10-11-20 11:43,11:43,7632200,13007200,5375000,BUY
10-11-20 11:44,11:44,7540350,12795225,5254875,BUY
10-11-20 11:45,11:45,7632800,13074875,5442075,BUY
10-11-20 11:46,11:46,7796825,12901025,5104200,BUY
10-11-20 11:47,11:47,7644925,13162325,5517400,BUY
10-11-20 11:48,11:48,7695175,13062725,5367550,BUY
10-11-20 11:49,11:49,8050025,13216325,5166300,BUY
10-11-20 11:50,11:50,7967125,13242625,5275500,BUY
10-11-20 11:51,11:51,7786700,13285900,5499200,BUY
10-11-20 11:52,11:52,7521375,13133100,5611725,BUY
10-11-20 11:53,11:53,7918025,12971850,5053825,BUY
10-11-20 11:54,11:54,7727850,12940050,5212200,BUY
10-11-20 11:55,11:55,8311725,13193325,4881600,BUY
10-11-20 11:56,11:56,7906475,13097050,5190575,BUY
10-11-20 11:57,11:57,7468825,13090975,5622150,BUY
10-11-20 11:58,11:58,7863125,13176850,5313725,BUY
10-11-20 11:59,11:59,7733175,13210100,5476925,BUY
10-11-20 12:00,12:00,7997225,13214375,5217150,BUY
10-11-20 12:01,12:01,8031225,13357150,5325925,BUY
10-11-20 12:02,12:02,7942425,13225000,5282575,BUY
10-11-20 12:03,12:03,8018875,13014900,4996025,BUY
10-11-20 12:04,12:04,7719850,12845375,5125525,BUY
10-11-20 12:05,12:05,7922100,12846750,4924650,BUY
10-11-20 12:06,12:06,8085900,13025100,4939200,BUY
10-11-20 12:07,12:07,7838850,13151775,5312925,BUY
10-11-20 12:08,12:08,7913775,13218125,5304350,BUY
10-11-20 12:09,12:09,8361775,13198075,4836300,BUY
10-11-20 12:10,12:10,7991700,12984800,4993100,BUY
10-11-20 12:11,12:11,8138075,13221775,5083700,BUY
10-11-20 12:12,12:12,7755850,13080750,5324900,BUY
10-11-20 12:13,12:13,7950525,13109675,5159150,BUY
10-11-20 12:14,12:14,7850500,13261525,5411025,BUY
10-11-20 12:15,12:15,7814800,13438275,5623475,BUY
10-11-20 12:16,12:16,7993050,13171750,5178700,BUY
10-11-20 12:17,12:17,7763650,13150750,5387100,BUY
10-11-20 12:18,12:18,8047425,13090975,5043550,BUY
10-11-20 12:19,12:19,7664575,12997875,5333300,BUY
10-11-20 12:20,12:20,7895775,13287150,5391375,BUY
10-11-20 12:21,12:21,7943750,13071800,5128050,BUY
10-11-20 12:22,12:22,8089325,13228550,5139225,BUY
10-11-20 12:23,12:23,7377500,13192950,5815450,BUY
10-11-20 12:24,12:24,8016850,13011625,4994775,BUY
10-11-20 12:25,12:25,7850900,13148000,5297100,BUY
10-11-20 12:26,12:26,8005600,13358175,5352575,BUY
10-11-20 12:27,12:27,8248025,13186400,4938375,BUY
10-11-20 12:28,12:28,7953400,13136325,5182925,BUY
10-11-20 12:29,12:29,8279275,13253825,4974550,BUY
10-11-20 12:30,12:30,8466025,13359325,4893300,BUY
10-11-20 12:31,12:31,8120975,13317800,5196825,BUY
10-11-20 12:32,12:32,8103800,13268050,5164250,BUY
10-11-20 12:33,12:33,8180200,13111750,4931550,BUY
10-11-20 12:34,12:34,8186950,13217175,5030225,BUY
10-11-20 12:35,12:35,8085125,13215325,5130200,BUY
10-11-20 12:36,12:36,7458850,13322975,5864125,BUY
10-11-20 12:37,12:37,8038375,13213875,5175500,BUY
10-11-20 12:38,12:38,8169000,13203050,5034050,BUY
10-11-20 12:39,12:39,7810375,13214300,5403925,BUY
10-11-20 12:40,12:40,8025750,13170625,5144875,BUY
10-11-20 12:41,12:41,8160350,13277525,5117175,BUY
10-11-20 12:42,12:42,7799750,12904650,5104900,BUY
10-11-20 12:43,12:43,7964000,13004925,5040925,BUY
10-11-20 12:44,12:44,8111525,13314825,5203300,BUY
10-11-20 12:45,12:45,8166900,13238550,5071650,BUY
10-11-20 12:46,12:46,8198350,13182875,4984525,BUY
10-11-20 12:47,12:47,7820425,13504675,5684250,BUY
10-11-20 12:48,12:48,7851075,13224100,5373025,BUY
10-11-20 12:49,12:49,8073350,13474400,5401050,BUY
10-11-20 12:50,12:50,8275100,13508675,5233575,BUY
10-11-20 12:51,12:51,7649650,13203650,5554000,BUY
10-11-20 12:52,12:52,7794975,13481400,5686425,BUY
10-11-20 12:53,12:53,8148225,13543850,5395625,BUY
10-11-20 12:54,12:54,8288175,13372700,5084525,BUY
10-11-20 12:55,12:55,8188725,12958275,4769550,BUY
10-11-20 12:56,12:56,7984900,12996700,5011800,BUY
10-11-20 12:57,12:57,8025800,13505975,5480175,BUY
10-11-20 12:58,12:58,8091425,13641325,5549900,BUY
10-11-20 12:59,12:59,7974200,13333800,5359600,BUY
10-11-20 13:00,13:00,7952400,13588925,5636525,BUY
10-11-20 13:01,13:01,7679800,13545225,5865425,BUY
10-11-20 13:02,13:02,7689975,13763175,6073200,BUY
10-11-20 13:03,13:03,7459200,13707950,6248750,BUY
10-11-20 13:04,13:04,7627450,13620275,5992825,BUY
10-11-20 13:05,13:05,7431625,13712775,6281150,BUY
10-11-20 13:06,13:06,7411275,13855000,6443725,BUY
10-11-20 13:07,13:07,7326925,13901950,6575025,BUY
10-11-20 13:08,13:08,7193225,13909500,6716275,BUY
10-11-20 13:09,13:09,7590050,13653825,6063775,BUY
10-11-20 13:10,13:10,7642525,13894500,6251975,BUY
10-11-20 13:11,13:11,7531350,13852900,6321550,BUY
10-11-20 13:12,13:12,7467125,13663075,6195950,BUY
10-11-20 13:13,13:13,7179625,13877225,6697600,BUY
10-11-20 13:14,13:14,7564175,13236850,5672675,BUY
10-11-20 13:15,13:15,7345350,13433175,6087825,BUY
10-11-20 13:16,13:16,7326500,13372725,6046225,BUY
10-11-20 13:17,13:17,7552575,13590550,6037975,BUY
10-11-20 13:18,13:18,7499250,13816825,6317575,BUY
10-11-20 13:19,13:19,7416050,13733950,6317900,BUY
10-11-20 13:20,13:20,7442775,13755375,6312600,BUY
10-11-20 13:21,13:21,7659925,13803050,6143125,BUY
10-11-20 13:22,13:22,7392500,13582100,6189600,BUY
10-11-20 13:23,13:23,7544000,13693700,6149700,BUY
10-11-20 13:24,13:24,7296275,13348225,6051950,BUY
10-11-20 13:25,13:25,7309400,13762600,6453200,BUY
10-11-20 13:26,13:26,7764175,13714025,5949850,BUY
10-11-20 13:27,13:27,7726250,13519200,5792950,BUY
10-11-20 13:28,13:28,7648250,13440450,5792200,BUY
10-11-20 13:29,13:29,7693650,13704300,6010650,BUY
10-11-20 13:30,13:30,7630600,13644100,6013500,BUY
10-11-20 13:31,13:31,7616425,13674600,6058175,BUY
10-11-20 13:32,13:32,7423550,13411700,5988150,BUY
10-11-20 13:33,13:33,7467150,13795850,6328700,BUY
10-11-20 13:34,13:34,7446750,13594175,6147425,BUY
10-11-20 13:35,13:35,7110125,13579050,6468925,BUY
10-11-20 13:36,13:36,7644175,13711675,6067500,BUY
10-11-20 13:37,13:37,7531050,13789450,6258400,BUY
10-11-20 13:38,13:38,7638725,13640275,6001550,BUY
10-11-20 13:39,13:39,7232650,13403950,6171300,BUY
10-11-20 13:40,13:40,7100925,13760925,6660000,BUY
10-11-20 13:41,13:41,7571175,13802150,6230975,BUY
10-11-20 13:42,13:42,7411575,13482200,6070625,BUY
10-11-20 13:43,13:43,7475250,13578075,6102825,BUY
10-11-20 13:44,13:44,7664150,13842925,6178775,BUY
10-11-20 13:45,13:45,7813975,13830400,6016425,BUY
10-11-20 13:46,13:46,7705000,13727325,6022325,BUY
10-11-20 13:47,13:47,7744100,13761625,6017525,BUY
10-11-20 13:48,13:48,7575975,13444375,5868400,BUY
10-11-20 13:49,13:49,7602550,13599625,5997075,BUY
10-11-20 13:50,13:50,7569925,13449575,5879650,BUY
10-11-20 13:51,13:51,7384175,13630925,6246750,BUY
10-11-20 13:52,13:52,7420075,13686200,6266125,BUY
10-11-20 13:53,13:53,7390175,13815100,6424925,BUY
10-11-20 13:54,13:54,7537450,13645750,6108300,BUY
10-11-20 13:55,13:55,7365550,13618100,6252550,BUY
10-11-20 13:56,13:56,7352475,13410625,6058150,BUY
10-11-20 13:57,13:57,7313275,13307300,5994025,BUY
10-11-20 13:58,13:58,7351825,13275450,5923625,BUY
10-11-20 13:59,13:59,7380750,13508875,6128125,BUY
10-11-20 14:00,14:00,7694725,13517675,5822950,BUY
10-11-20 14:01,14:01,7553300,13609925,6056625,BUY
10-11-20 14:02,14:02,7318575,13422275,6103700,BUY
10-11-20 14:03,14:03,7546800,13697775,6150975,BUY
10-11-20 14:04,14:04,7710650,13483650,5773000,BUY
10-11-20 14:05,14:05,7756325,13780400,6024075,BUY
10-11-20 14:06,14:06,7662900,13532600,5869700,BUY
10-11-20 14:07,14:07,7773450,13712200,5938750,BUY
10-11-20 14:08,14:08,7881875,13474200,5592325,BUY
10-11-20 14:09,14:09,7705875,13572875,5867000,BUY
10-11-20 14:10,14:10,7885075,13388650,5503575,BUY
10-11-20 14:11,14:11,7785700,13598875,5813175,BUY
10-11-20 14:12,14:12,7699875,13529675,5829800,BUY
10-11-20 14:13,14:13,7514400,13598600,6084200,BUY
10-11-20 14:14,14:14,7509525,13559775,6050250,BUY
10-11-20 14:15,14:15,7789150,13375225,5586075,BUY
10-11-20 14:16,14:16,7541425,13674950,6133525,BUY
10-11-20 14:17,14:17,7549350,13614500,6065150,BUY
10-11-20 14:18,14:18,7525275,13610925,6085650,BUY
10-11-20 14:19,14:19,7281725,13335025,6053300,BUY
10-11-20 14:20,14:20,7175150,13558275,6383125,BUY
10-11-20 14:21,14:21,7568950,13581900,6012950,BUY
10-11-20 14:22,14:22,7544100,13325125,5781025,BUY
10-11-20 14:23,14:23,7254800,13352175,6097375,BUY
10-11-20 14:24,14:24,7460050,13351325,5891275,BUY
10-11-20 14:25,14:25,7787100,13300750,5513650,BUY
10-11-20 14:26,14:26,7468900,13455975,5987075,BUY
10-11-20 14:27,14:27,7360725,13452425,6091700,BUY
10-11-20 14:28,14:28,7525800,13479350,5953550,BUY
10-11-20 14:29,14:29,7434825,13502675,6067850,BUY
10-11-20 14:30,14:30,7648275,13554925,5906650,BUY
10-11-20 14:31,14:31,7594650,13298325,5703675,BUY
10-11-20 14:32,14:32,7355850,13412775,6056925,BUY
10-11-20 14:33,14:33,7364850,13413000,6048150,BUY
10-11-20 14:34,14:34,7660300,13336825,5676525,BUY
10-11-20 14:35,14:35,7563550,13239900,5676350,BUY
10-11-20 14:36,14:36,7331250,13364350,6033100,BUY
10-11-20 14:37,14:37,7289450,13109825,5820375,BUY
10-11-20 14:38,14:38,7541900,13257875,5715975,BUY
10-11-20 14:39,14:39,7477675,13478800,6001125,BUY
10-11-20 14:40,14:40,7685325,13359850,5674525,BUY
10-11-20 14:41,14:41,7220425,13214525,5994100,BUY
10-11-20 14:42,14:42,7810900,13164700,5353800,BUY
10-11-20 14:43,14:43,7701300,13432025,5730725,BUY
10-11-20 14:44,14:44,7188650,13498950,6310300,BUY
10-11-20 14:45,14:45,7459950,13412975,5953025,BUY
10-11-20 14:46,14:46,7457425,13399900,5942475,BUY
10-11-20 14:47,14:47,7582725,13370750,5788025,BUY
10-11-20 14:48,14:48,7715525,13219275,5503750,BUY
10-11-20 14:49,14:49,7789150,12993875,5204725,BUY
10-11-20 14:50,14:50,7871525,13032150,5160625,BUY
10-11-20 14:51,14:51,7708625,13371700,5663075,BUY
10-11-20 14:52,14:52,7603850,13132025,5528175,BUY
10-11-20 14:53,14:53,7764775,13393725,5628950,BUY
10-11-20 14:54,14:54,7972550,13356725,5384175,BUY
10-11-20 14:55,14:55,7646275,13330250,5683975,BUY
10-11-20 14:56,14:56,7747825,13294825,5547000,BUY
10-11-20 14:57,14:57,7831750,13321275,5489525,BUY
10-11-20 14:58,14:58,8022700,13338350,5315650,BUY
10-11-20 14:59,14:59,7850875,13271775,5420900,BUY
10-11-20 15:00,15:00,7966975,13245450,5278475,BUY
10-11-20 15:01,15:01,7909300,13214350,5305050,BUY
10-11-20 15:02,15:02,8087900,13165625,5077725,BUY
10-11-20 15:03,15:03,8108225,12864275,4756050,BUY
10-11-20 15:04,15:04,7809125,12777150,4968025,BUY
10-11-20 15:05,15:05,7786325,12754600,4968275,BUY
10-11-20 15:06,15:06,7726075,12671300,4945225,BUY
10-11-20 15:07,15:07,7790775,12751325,4960550,BUY
10-11-20 15:08,15:08,7719350,12841225,5121875,BUY
10-11-20 15:09,15:09,7580425,12662250,5081825,BUY
10-11-20 15:10,15:10,7583125,12661950,5078825,BUY
10-11-20 15:11,15:11,7856775,12445650,4588875,BUY
10-11-20 15:12,15:12,7665675,12161225,4495550,BUY
10-11-20 15:13,15:13,7762125,12602175,4840050,BUY
10-11-20 15:14,15:14,7591050,12565925,4974875,BUY
10-11-20 15:15,15:15,7735275,12457575,4722300,BUY
10-11-20 15:16,15:16,7832500,12436250,4603750,BUY
10-11-20 15:17,15:17,7643575,12455600,4812025,BUY
10-11-20 15:18,15:18,7524075,12323700,4799625,BUY
10-11-20 15:19,15:19,7484950,12318550,4833600,BUY
10-11-20 15:20,15:20,7671775,12440500,4768725,BUY
10-11-20 15:21,15:21,7671750,12449325,4777575,BUY
10-11-20 15:22,15:22,7759850,12422850,4663000,BUY
10-11-20 15:23,15:23,7577625,12355025,4777400,BUY
10-11-20 15:24,15:24,7536375,12288700,4752325,BUY
10-11-20 15:25,15:25,7842300,12234000,4391700,BUY
10-11-20 15:26,15:26,7894075,12344625,4450550,BUY
10-11-20 15:27,15:27,7445975,11969125,4523150,BUY
10-11-20 15:28,15:28,7445175,11917775,4472600,BUY
10-11-20 15:29,15:29,7423900,11939625,4515725,BUY
11-11-20 9:15,9:15,6871400,11105225,4233825,BUY
11-11-20 9:16,9:16,6629825,11134850,4505025,BUY
11-11-20 9:17,9:17,6945425,11154150,4208725,BUY
11-11-20 9:18,9:18,6698900,11089900,4391000,BUY
11-11-20 9:19,9:19,6859350,11209450,4350100,BUY
11-11-20 9:20,9:20,7026200,11253100,4226900,BUY
11-11-20 9:21,9:21,6866825,11300200,4433375,BUY
11-11-20 9:22,9:22,6765125,11257150,4492025,BUY
11-11-20 9:23,9:23,6947125,11325100,4377975,BUY
11-11-20 9:24,9:24,6939900,11293025,4353125,BUY
11-11-20 9:25,9:25,6709325,10947375,4238050,BUY
11-11-20 9:26,9:26,6795900,11456225,4660325,BUY
11-11-20 9:27,9:27,6893650,11505850,4612200,BUY
11-11-20 9:28,9:28,7086550,11469500,4382950,BUY
11-11-20 9:29,9:29,6918700,11548925,4630225,BUY
11-11-20 9:30,9:30,7003325,11611350,4608025,BUY
11-11-20 9:31,9:31,6928450,11582450,4654000,BUY
11-11-20 9:32,9:32,7235525,11778325,4542800,BUY
11-11-20 9:33,9:33,7074425,11745150,4670725,BUY
11-11-20 9:34,9:34,7090500,11781575,4691075,BUY
11-11-20 9:35,9:35,7091525,11854375,4762850,BUY
11-11-20 9:36,9:36,7218550,11732200,4513650,BUY
11-11-20 9:37,9:37,6741750,11765350,5023600,BUY
11-11-20 9:38,9:38,7124450,11817250,4692800,BUY
11-11-20 9:39,9:39,6975925,11811525,4835600,BUY
11-11-20 9:40,9:40,6977900,11857475,4879575,BUY
11-11-20 9:41,9:41,7271100,11861550,4590450,BUY
11-11-20 9:42,9:42,7241900,11784550,4542650,BUY
11-11-20 9:43,9:43,7183000,11917425,4734425,BUY
11-11-20 9:44,9:44,7365950,11967125,4601175,BUY
11-11-20 9:45,9:45,7688925,12095825,4406900,BUY
11-11-20 9:46,9:46,7420650,12095175,4674525,BUY
11-11-20 9:47,9:47,7547525,12291325,4743800,BUY
11-11-20 9:48,9:48,7502050,12203875,4701825,BUY
11-11-20 9:49,9:49,7751300,12121350,4370050,BUY
11-11-20 9:50,9:50,7615200,12244650,4629450,BUY
11-11-20 9:51,9:51,7575400,12358575,4783175,BUY
11-11-20 9:52,9:52,7449800,12332025,4882225,BUY
11-11-20 9:53,9:53,7807600,12349950,4542350,BUY
11-11-20 9:54,9:54,7824675,12207600,4382925,BUY
11-11-20 9:55,9:55,7182050,12286225,5104175,BUY
11-11-20 9:56,9:56,7752700,12229325,4476625,BUY
11-11-20 9:57,9:57,8023800,12543025,4519225,BUY
11-11-20 9:58,9:58,8236600,12527425,4290825,BUY
11-11-20 9:59,9:59,8009825,12226875,4217050,BUY
11-11-20 10:00,10:00,8122500,12376800,4254300,BUY
11-11-20 10:01,10:01,8071150,12478950,4407800,BUY
11-11-20 10:02,10:02,7695700,12560200,4864500,BUY
11-11-20 10:03,10:03,7673900,12232875,4558975,BUY
11-11-20 10:04,10:04,7615600,12554475,4938875,BUY
11-11-20 10:05,10:05,7778525,12638125,4859600,BUY
11-11-20 10:06,10:06,7788425,12862925,5074500,BUY
11-11-20 10:07,10:07,7823000,12170450,4347450,BUY
11-11-20 10:08,10:08,7672350,12599800,4927450,BUY
11-11-20 10:09,10:09,7799600,12511325,4711725,BUY
11-11-20 10:10,10:10,7925500,12694200,4768700,BUY
11-11-20 10:11,10:11,7646400,12772875,5126475,BUY
11-11-20 10:12,10:12,7701450,12574975,4873525,BUY
11-11-20 10:13,10:13,7524550,12368650,4844100,BUY
11-11-20 10:14,10:14,8007750,12675575,4667825,BUY
11-11-20 10:15,10:15,7736300,12668350,4932050,BUY
11-11-20 10:16,10:16,7782150,12599575,4817425,BUY
11-11-20 10:17,10:17,7991325,12519875,4528550,BUY
11-11-20 10:18,10:18,8051150,12927475,4876325,BUY
11-11-20 10:19,10:19,7944125,12866850,4922725,BUY
11-11-20 10:20,10:20,8556100,13149325,4593225,BUY
11-11-20 10:21,10:21,8340675,13025650,4684975,BUY
11-11-20 10:22,10:22,7981600,12660575,4678975,BUY
11-11-20 10:23,10:23,8150275,13286125,5135850,BUY
11-11-20 10:24,10:24,8055550,12909750,4854200,BUY
11-11-20 10:25,10:25,7933325,12734275,4800950,BUY
11-11-20 10:26,10:26,8340650,13412200,5071550,BUY
11-11-20 10:27,10:27,8605725,13416925,4811200,BUY
11-11-20 10:28,10:28,8388650,13118975,4730325,BUY
11-11-20 10:29,10:29,8675725,13422450,4746725,BUY
11-11-20 10:30,10:30,8979575,13735825,4756250,BUY
11-11-20 10:31,10:31,8751400,13480100,4728700,BUY
11-11-20 10:32,10:32,8520150,13401075,4880925,BUY
11-11-20 10:33,10:33,8559525,13063350,4503825,BUY
11-11-20 10:34,10:34,8533075,13575675,5042600,BUY
11-11-20 10:35,10:35,8909875,13576775,4666900,BUY
11-11-20 10:36,10:36,9205000,13664550,4459550,BUY
11-11-20 10:37,10:37,9039775,13513650,4473875,BUY
11-11-20 10:38,10:38,9035500,13541625,4506125,BUY
11-11-20 10:39,10:39,9184875,13694200,4509325,BUY
11-11-20 10:40,10:40,8959475,13695275,4735800,BUY
11-11-20 10:41,10:41,9274050,13742775,4468725,BUY
11-11-20 10:42,10:42,9233400,13664925,4431525,BUY
11-11-20 10:43,10:43,9101425,13358725,4257300,BUY
11-11-20 10:44,10:44,9263475,13778550,4515075,BUY
11-11-20 10:45,10:45,9574275,13742000,4167725,BUY
11-11-20 10:46,10:46,8932850,13482450,4549600,BUY
11-11-20 10:47,10:47,9168475,13803550,4635075,BUY
11-11-20 10:48,10:48,8977775,13362725,4384950,BUY
11-11-20 10:49,10:49,9491100,13832225,4341125,BUY
11-11-20 10:50,10:50,9322400,13637100,4314700,BUY
11-11-20 10:51,10:51,8721675,13204400,4482725,BUY
11-11-20 10:52,10:52,9206950,13272600,4065650,BUY
11-11-20 10:53,10:53,8915200,13666800,4751600,BUY
11-11-20 10:54,10:54,9252300,13748975,4496675,BUY
11-11-20 10:55,10:55,8698275,13691075,4992800,BUY
11-11-20 10:56,10:56,8809700,14286175,5476475,BUY
11-11-20 10:57,10:57,8801250,13958600,5157350,BUY
11-11-20 10:58,10:58,8828675,14013200,5184525,BUY
11-11-20 10:59,10:59,8930100,14357875,5427775,BUY
11-11-20 11:00,11:00,8541900,14375825,5833925,BUY
11-11-20 11:01,11:01,8676325,13746075,5069750,BUY
11-11-20 11:02,11:02,8487700,14197325,5709625,BUY
11-11-20 11:03,11:03,8807800,13832125,5024325,BUY
11-11-20 11:04,11:04,8882350,13857600,4975250,BUY
11-11-20 11:05,11:05,8821675,14572325,5750650,BUY
11-11-20 11:06,11:06,8660125,14356700,5696575,BUY
11-11-20 11:07,11:07,8433450,13560100,5126650,BUY
11-11-20 11:08,11:08,8673375,14334350,5660975,BUY
11-11-20 11:09,11:09,8664200,14483100,5818900,BUY
11-11-20 11:10,11:10,8706025,14434875,5728850,BUY
11-11-20 11:11,11:11,8665000,13965950,5300950,BUY
11-11-20 11:12,11:12,8724550,14462900,5738350,BUY
11-11-20 11:13,11:13,8671875,14625600,5953725,BUY
11-11-20 11:14,11:14,9335525,14865175,5529650,BUY
11-11-20 11:15,11:15,9191850,14910025,5718175,BUY
11-11-20 11:16,11:16,8774325,14804100,6029775,BUY
11-11-20 11:17,11:17,8891425,14701825,5810400,BUY
11-11-20 11:18,11:18,9076350,14881850,5805500,BUY
11-11-20 11:19,11:19,8814150,14843375,6029225,BUY
11-11-20 11:20,11:20,8801300,14790525,5989225,BUY
11-11-20 11:21,11:21,9094700,14777325,5682625,BUY
11-11-20 11:22,11:22,9111900,14684950,5573050,BUY
11-11-20 11:23,11:23,8589525,14696525,6107000,BUY
11-11-20 11:24,11:24,9127175,14886025,5758850,BUY
11-11-20 11:25,11:25,8806375,14642450,5836075,BUY
11-11-20 11:26,11:26,8716575,14650925,5934350,BUY
11-11-20 11:27,11:27,9070300,14657825,5587525,BUY
11-11-20 11:28,11:28,8969950,14554000,5584050,BUY
11-11-20 11:29,11:29,8807950,14716450,5908500,BUY
11-11-20 11:30,11:30,8724600,14620900,5896300,BUY
11-11-20 11:31,11:31,8542775,14756850,6214075,BUY
11-11-20 11:32,11:32,8952075,14745175,5793100,BUY
11-11-20 11:33,11:33,8582275,14753125,6170850,BUY
11-11-20 11:34,11:34,8364475,14472875,6108400,BUY
11-11-20 11:35,11:35,9126725,14521875,5395150,BUY
11-11-20 11:36,11:36,8653350,14659000,6005650,BUY
11-11-20 11:37,11:37,8978600,14493475,5514875,BUY
11-11-20 11:38,11:38,8469150,14579825,6110675,BUY
11-11-20 11:39,11:39,8602275,14822375,6220100,BUY
11-11-20 11:40,11:40,9060500,14775200,5714700,BUY
11-11-20 11:41,11:41,9334625,14778300,5443675,BUY
11-11-20 11:42,11:42,8720875,14772750,6051875,BUY
11-11-20 11:43,11:43,8928675,14754850,5826175,BUY
11-11-20 11:44,11:44,8595600,14847125,6251525,BUY
11-11-20 11:45,11:45,8626625,14696300,6069675,BUY
11-11-20 11:46,11:46,8764000,14827650,6063650,BUY
11-11-20 11:47,11:47,8831025,14158750,5327725,BUY
11-11-20 11:48,11:48,8913025,14541975,5628950,BUY
11-11-20 11:49,11:49,8844200,14306625,5462425,BUY
11-11-20 11:50,11:50,8707675,14502975,5795300,BUY
11-11-20 11:51,11:51,8713950,14258025,5544075,BUY
11-11-20 11:52,11:52,8637700,14128475,5490775,BUY
11-11-20 11:53,11:53,8474975,14352475,5877500,BUY
11-11-20 11:54,11:54,9167025,14479300,5312275,BUY
11-11-20 11:55,11:55,9158250,14561550,5403300,BUY
11-11-20 11:56,11:56,9135750,14321000,5185250,BUY
11-11-20 11:57,11:57,8971925,14254625,5282700,BUY
11-11-20 11:58,11:58,8983225,14523875,5540650,BUY
11-11-20 11:59,11:59,8799150,14297225,5498075,BUY
11-11-20 12:00,12:00,9005800,14377800,5372000,BUY
11-11-20 12:01,12:01,9051850,14275450,5223600,BUY
11-11-20 12:02,12:02,8504575,13946025,5441450,BUY
11-11-20 12:03,12:03,8627325,13656675,5029350,BUY
11-11-20 12:04,12:04,8663925,13713175,5049250,BUY
11-11-20 12:05,12:05,8842675,13990475,5147800,BUY
11-11-20 12:06,12:06,8951225,13678500,4727275,BUY
11-11-20 12:07,12:07,8770725,14113275,5342550,BUY
11-11-20 12:08,12:08,9046725,13752900,4706175,BUY
11-11-20 12:09,12:09,8861350,13690775,4829425,BUY
11-11-20 12:10,12:10,8796900,13740075,4943175,BUY
11-11-20 12:11,12:11,8911275,13838550,4927275,BUY
11-11-20 12:12,12:12,9124950,13921150,4796200,BUY
11-11-20 12:13,12:13,8731325,13988825,5257500,BUY
11-11-20 12:14,12:14,8928275,13833750,4905475,BUY
11-11-20 12:15,12:15,9320750,13875675,4554925,BUY
11-11-20 12:16,12:16,8921825,13752175,4830350,BUY
11-11-20 12:17,12:17,9221475,13741075,4519600,BUY
11-11-20 12:18,12:18,9188825,13554400,4365575,BUY
11-11-20 12:19,12:19,9055175,13027025,3971850,BUY
11-11-20 12:20,12:20,9001675,13462525,4460850,BUY
11-11-20 12:21,12:21,8975275,13857350,4882075,BUY
11-11-20 12:22,12:22,9098500,13636450,4537950,BUY
11-11-20 12:23,12:23,9261100,14110725,4849625,BUY
11-11-20 12:24,12:24,9343225,13989525,4646300,BUY
11-11-20 12:25,12:25,8847950,13667475,4819525,BUY
11-11-20 12:26,12:26,8987525,14099850,5112325,BUY
11-11-20 12:27,12:27,8816150,14006200,5190050,BUY
11-11-20 12:28,12:28,9079100,14105525,5026425,BUY
11-11-20 12:29,12:29,9476850,14018075,4541225,BUY
11-11-20 12:30,12:30,9165725,14198550,5032825,BUY
11-11-20 12:31,12:31,9196750,13652600,4455850,BUY
11-11-20 12:32,12:32,9221225,13708850,4487625,BUY
11-11-20 12:33,12:33,9193850,14054125,4860275,BUY
11-11-20 12:34,12:34,9186325,14162500,4976175,BUY
11-11-20 12:35,12:35,9255675,13768700,4513025,BUY
11-11-20 12:36,12:36,9353700,13838675,4484975,BUY
11-11-20 12:37,12:37,9441925,13989100,4547175,BUY
11-11-20 12:38,12:38,9254025,13943925,4689900,BUY
11-11-20 12:39,12:39,9331850,13930650,4598800,BUY
11-11-20 12:40,12:40,9236325,13674150,4437825,BUY
11-11-20 12:41,12:41,8920450,13891550,4971100,BUY
11-11-20 12:42,12:42,9285525,13779075,4493550,BUY
11-11-20 12:43,12:43,9202725,13914075,4711350,BUY
11-11-20 12:44,12:44,9145800,13628350,4482550,BUY
11-11-20 12:45,12:45,9288300,13556725,4268425,BUY
11-11-20 12:46,12:46,8709600,13654125,4944525,BUY
11-11-20 12:47,12:47,9330525,13556275,4225750,BUY
11-11-20 12:48,12:48,9099200,13672100,4572900,BUY
11-11-20 12:49,12:49,9216500,13629750,4413250,BUY
11-11-20 12:50,12:50,9263450,13468375,4204925,BUY
11-11-20 12:51,12:51,9363700,13680250,4316550,BUY
11-11-20 12:52,12:52,9074850,13450950,4376100,BUY
11-11-20 12:53,12:53,8764750,13159000,4394250,BUY
11-11-20 12:54,12:54,9113525,13805500,4691975,BUY
11-11-20 12:55,12:55,9264350,13048250,3783900,BUY
11-11-20 12:56,12:56,8806525,14070050,5263525,BUY
11-11-20 12:57,12:57,9685400,13901975,4216575,BUY
11-11-20 12:58,12:58,9744500,14103675,4359175,BUY
11-11-20 12:59,12:59,9434600,14082750,4648150,BUY
11-11-20 13:00,13:00,9305400,14180275,4874875,BUY
11-11-20 13:01,13:01,9363550,13853925,4490375,BUY
11-11-20 13:02,13:02,9061500,13565275,4503775,BUY
11-11-20 13:03,13:03,8986725,13763300,4776575,BUY
11-11-20 13:04,13:04,8607425,13572925,4965500,BUY
11-11-20 13:05,13:05,9106450,14067025,4960575,BUY
11-11-20 13:06,13:06,9629250,14139750,4510500,BUY
11-11-20 13:07,13:07,9295500,14172375,4876875,BUY
11-11-20 13:08,13:08,9233025,13828275,4595250,BUY
11-11-20 13:09,13:09,9176450,13931650,4755200,BUY
11-11-20 13:10,13:10,9229825,14214900,4985075,BUY
11-11-20 13:11,13:11,9308900,13776975,4468075,BUY
11-11-20 13:12,13:12,9651175,14058325,4407150,BUY
11-11-20 13:13,13:13,9684950,13745900,4060950,BUY
11-11-20 13:14,13:14,9717450,14079075,4361625,BUY
11-11-20 13:15,13:15,9671950,14109550,4437600,BUY
11-11-20 13:16,13:16,9856325,13745600,3889275,BUY
11-11-20 13:17,13:17,9726350,14033250,4306900,BUY
11-11-20 13:18,13:18,9974350,13969925,3995575,BUY
11-11-20 13:19,13:19,9792175,14156900,4364725,BUY
11-11-20 13:20,13:20,9659950,13600075,3940125,BUY
11-11-20 13:21,13:21,9642500,14040125,4397625,BUY
11-11-20 13:22,13:22,9540750,13940725,4399975,BUY
11-11-20 13:23,13:23,9582225,14211250,4629025,BUY
11-11-20 13:24,13:24,9507150,13720975,4213825,BUY
11-11-20 13:25,13:25,9356200,14199450,4843250,BUY
11-11-20 13:26,13:26,9609700,14218500,4608800,BUY
11-11-20 13:27,13:27,9519550,14138100,4618550,BUY
11-11-20 13:28,13:28,9573800,14071000,4497200,BUY
11-11-20 13:29,13:29,9701400,13398200,3696800,BUY
11-11-20 13:30,13:30,9495050,14144625,4649575,BUY
11-11-20 13:31,13:31,9931825,14111500,4179675,BUY
11-11-20 13:32,13:32,9916275,14213700,4297425,BUY
11-11-20 13:33,13:33,10056800,14132650,4075850,BUY
11-11-20 13:34,13:34,9943950,13971675,4027725,BUY
11-11-20 13:35,13:35,10054625,14164750,4110125,BUY
11-11-20 13:36,13:36,9686900,14089675,4402775,BUY
11-11-20 13:37,13:37,9573550,13782025,4208475,BUY
11-11-20 13:38,13:38,9720225,14069225,4349000,BUY
11-11-20 13:39,13:39,9919450,13905525,3986075,BUY
11-11-20 13:40,13:40,9721950,14190650,4468700,BUY
11-11-20 13:41,13:41,9615375,13882600,4267225,BUY
11-11-20 13:42,13:42,9837925,14004900,4166975,BUY
11-11-20 13:43,13:43,9428700,14047925,4619225,BUY
11-11-20 13:44,13:44,9547325,14240525,4693200,BUY
11-11-20 13:45,13:45,9619625,14172775,4553150,BUY
11-11-20 13:46,13:46,9873650,14299500,4425850,BUY
11-11-20 13:47,13:47,9221025,14031925,4810900,BUY
11-11-20 13:48,13:48,9664350,14044500,4380150,BUY
11-11-20 13:49,13:49,9245650,14128550,4882900,BUY
11-11-20 13:50,13:50,9629975,14171675,4541700,BUY
11-11-20 13:51,13:51,10143825,14280950,4137125,BUY
11-11-20 13:52,13:52,9993675,14026800,4033125,BUY
11-11-20 13:53,13:53,9760800,14371325,4610525,BUY
11-11-20 13:54,13:54,9598575,13955975,4357400,BUY
11-11-20 13:55,13:55,9905150,14167275,4262125,BUY
11-11-20 13:56,13:56,9563400,14027800,4464400,BUY
11-11-20 13:57,13:57,9995975,12978500,2982525,BUY
11-11-20 13:58,13:58,9727225,13707200,3979975,BUY
11-11-20 13:59,13:59,9240775,13799300,4558525,BUY
11-11-20 14:00,14:00,9783550,13917925,4134375,BUY
11-11-20 14:01,14:01,9792650,14103450,4310800,BUY
11-11-20 14:02,14:02,10192325,14177775,3985450,BUY
11-11-20 14:03,14:03,10179575,13931675,3752100,BUY
11-11-20 14:04,14:04,10071250,14090000,4018750,BUY
11-11-20 14:05,14:05,9939600,14053900,4114300,BUY
11-11-20 14:06,14:06,10344800,13454275,3109475,BUY
11-11-20 14:07,14:07,10118925,12907150,2788225,BUY
11-11-20 14:08,14:08,10113825,13621425,3507600,BUY
11-11-20 14:09,14:09,10494250,13694025,3199775,BUY
11-11-20 14:10,14:10,10635725,13778425,3142700,BUY
11-11-20 14:11,14:11,10126100,13604975,3478875,BUY
11-11-20 14:12,14:12,10256300,13436550,3180250,BUY
11-11-20 14:13,14:13,9978225,12838750,2860525,BUY
11-11-20 14:14,14:14,10258275,13233050,2974775,BUY
11-11-20 14:15,14:15,10678900,13096050,2417150,BUY
11-11-20 14:16,14:16,10292875,13075075,2782200,BUY
11-11-20 14:17,14:17,10296750,13255700,2958950,BUY
11-11-20 14:18,14:18,10412875,13506850,3093975,BUY
11-11-20 14:19,14:19,10554625,13485725,2931100,BUY
11-11-20 14:20,14:20,10477050,13261875,2784825,BUY
11-11-20 14:21,14:21,10463900,13171550,2707650,BUY
11-11-20 14:22,14:22,10649875,13224950,2575075,BUY
11-11-20 14:23,14:23,10330900,13445850,3114950,BUY
11-11-20 14:24,14:24,10689025,13255975,2566950,BUY
11-11-20 14:25,14:25,10360500,13635625,3275125,BUY
11-11-20 14:26,14:26,10586300,13345325,2759025,BUY
11-11-20 14:27,14:27,10439950,13846825,3406875,BUY
11-11-20 14:28,14:28,10996075,13882000,2885925,BUY
11-11-20 14:29,14:29,10471175,13829625,3358450,BUY
11-11-20 14:30,14:30,10485825,13627175,3141350,BUY
11-11-20 14:31,14:31,10506675,13666650,3159975,BUY
11-11-20 14:32,14:32,10320275,13526775,3206500,BUY
11-11-20 14:33,14:33,10251525,13698225,3446700,BUY
11-11-20 14:34,14:34,10288925,13851300,3562375,BUY
11-11-20 14:35,14:35,10485700,13691575,3205875,BUY
11-11-20 14:36,14:36,9923075,13807400,3884325,BUY
11-11-20 14:37,14:37,10008600,14105100,4096500,BUY
11-11-20 14:38,14:38,10537075,14063300,3526225,BUY
11-11-20 14:39,14:39,10342200,13785575,3443375,BUY
11-11-20 14:40,14:40,10382750,13796875,3414125,BUY
11-11-20 14:41,14:41,10232125,14080450,3848325,BUY
11-11-20 14:42,14:42,9848500,13643750,3795250,BUY
11-11-20 14:43,14:43,9847400,14031925,4184525,BUY
11-11-20 14:44,14:44,9971850,13969175,3997325,BUY
11-11-20 14:45,14:45,10195950,14028050,3832100,BUY
11-11-20 14:46,14:46,9991075,13929850,3938775,BUY
11-11-20 14:47,14:47,10032200,13935525,3903325,BUY
11-11-20 14:48,14:48,9769200,13798600,4029400,BUY
11-11-20 14:49,14:49,9973700,13924125,3950425,BUY
11-11-20 14:50,14:50,9887400,13853675,3966275,BUY
11-11-20 14:51,14:51,9645125,13970725,4325600,BUY
11-11-20 14:52,14:52,10000775,13857425,3856650,BUY
11-11-20 14:53,14:53,9634100,13980525,4346425,BUY
11-11-20 14:54,14:54,9797300,13506775,3709475,BUY
11-11-20 14:55,14:55,10198625,13633300,3434675,BUY
11-11-20 14:56,14:56,10070250,13798300,3728050,BUY
11-11-20 14:57,14:57,9937350,13943725,4006375,BUY
11-11-20 14:58,14:58,9811250,13754200,3942950,BUY
11-11-20 14:59,14:59,9877450,13699125,3821675,BUY
11-11-20 15:00,15:00,9947950,13916825,3968875,BUY
11-11-20 15:01,15:01,10082925,13995050,3912125,BUY
11-11-20 15:02,15:02,9629125,13480500,3851375,BUY
11-11-20 15:03,15:03,9147625,13489100,4341475,BUY
11-11-20 15:04,15:04,9511700,13899525,4387825,BUY
11-11-20 15:05,15:05,9539050,13903600,4364550,BUY
11-11-20 15:06,15:06,9348450,13847200,4498750,BUY
11-11-20 15:07,15:07,9379225,13936000,4556775,BUY
11-11-20 15:08,15:08,9521800,13886250,4364450,BUY
11-11-20 15:09,15:09,9371750,13953175,4581425,BUY
11-11-20 15:10,15:10,9494400,14006350,4511950,BUY
11-11-20 15:11,15:11,9374525,13980425,4605900,BUY
11-11-20 15:12,15:12,9182325,13961150,4778825,BUY
11-11-20 15:13,15:13,9762550,13965625,4203075,BUY
11-11-20 15:14,15:14,9298675,13966975,4668300,BUY
11-11-20 15:15,15:15,9632100,14087850,4455750,BUY
11-11-20 15:16,15:16,9780375,14017900,4237525,BUY
11-11-20 15:17,15:17,9803525,13998800,4195275,BUY
11-11-20 15:18,15:18,9486300,14170400,4684100,BUY
11-11-20 15:19,15:19,9349500,14113275,4763775,BUY
11-11-20 15:20,15:20,9502950,14113125,4610175,BUY
11-11-20 15:21,15:21,9304175,14010825,4706650,BUY
11-11-20 15:22,15:22,9413400,14019700,4606300,BUY
11-11-20 15:23,15:23,9301600,13951325,4649725,BUY
11-11-20 15:24,15:24,9085100,13603000,4517900,BUY
11-11-20 15:25,15:25,9501625,13646150,4144525,BUY
11-11-20 15:26,15:26,9207275,13744375,4537100,BUY
11-11-20 15:27,15:27,9497025,13831300,4334275,BUY
11-11-20 15:28,15:28,9379125,13780250,4401125,BUY
11-11-20 15:29,15:29,9462550,13852350,4389800,BUY
12-11-20 9:15,9:15,6646200,12027975,5381775,BUY
12-11-20 9:16,9:16,7523675,12316825,4793150,BUY
12-11-20 9:17,9:17,7786775,12207375,4420600,BUY
12-11-20 9:18,9:18,7728925,12376775,4647850,BUY
12-11-20 9:19,9:19,7732225,12344600,4612375,BUY
12-11-20 9:20,9:20,8058950,12453275,4394325,BUY
12-11-20 9:21,9:21,7965500,12296575,4331075,BUY
12-11-20 9:22,9:22,7891975,12454400,4562425,BUY
12-11-20 9:23,9:23,7791075,12338825,4547750,BUY
12-11-20 9:24,9:24,7951375,12407825,4456450,BUY
12-11-20 9:25,9:25,8082650,12450075,4367425,BUY
12-11-20 9:26,9:26,7798300,12434475,4636175,BUY
12-11-20 9:27,9:27,7826925,12442575,4615650,BUY
12-11-20 9:28,9:28,7809275,12239450,4430175,BUY
12-11-20 9:29,9:29,8045525,12348525,4303000,BUY
12-11-20 9:30,9:30,8039625,12428950,4389325,BUY
12-11-20 9:31,9:31,7925200,12475025,4549825,BUY
12-11-20 9:32,9:32,7972850,12502025,4529175,BUY
12-11-20 9:33,9:33,8043700,12508175,4464475,BUY
12-11-20 9:34,9:34,8308875,12303150,3994275,BUY
12-11-20 9:35,9:35,8053200,12080075,4026875,BUY
12-11-20 9:36,9:36,8421625,12308625,3887000,BUY
12-11-20 9:37,9:37,8497575,12279450,3781875,BUY
12-11-20 9:38,9:38,8198250,12558600,4360350,BUY
12-11-20 9:39,9:39,8157850,12564725,4406875,BUY
12-11-20 9:40,9:40,8555575,12610375,4054800,BUY
12-11-20 9:41,9:41,8138400,12410950,4272550,BUY
12-11-20 9:42,9:42,8515600,12512925,3997325,BUY
12-11-20 9:43,9:43,8356450,12663575,4307125,BUY
12-11-20 9:44,9:44,8688400,12817350,4128950,BUY
12-11-20 9:45,9:45,8901775,12877125,3975350,BUY
12-11-20 9:46,9:46,8659925,12853650,4193725,BUY
12-11-20 9:47,9:47,8870950,12941625,4070675,BUY
12-11-20 9:48,9:48,8649575,12885425,4235850,BUY
12-11-20 9:49,9:49,8915100,12928175,4013075,BUY
12-11-20 9:50,9:50,9212000,13008750,3796750,BUY
12-11-20 9:51,9:51,9242550,12924350,3681800,BUY
12-11-20 9:52,9:52,9112075,13248125,4136050,BUY
12-11-20 9:53,9:53,9680400,13351200,3670800,BUY
12-11-20 9:54,9:54,9445375,12993500,3548125,BUY
12-11-20 9:55,9:55,9269350,12952925,3683575,BUY
12-11-20 9:56,9:56,9825425,13333575,3508150,BUY
12-11-20 9:57,9:57,9847025,13697000,3849975,BUY
12-11-20 9:58,9:58,9717500,12919050,3201550,BUY
12-11-20 9:59,9:59,10366675,13493100,3126425,BUY
12-11-20 10:00,10:00,10412475,13781975,3369500,BUY
12-11-20 10:01,10:01,10311875,13546625,3234750,BUY
12-11-20 10:02,10:02,10390450,13276550,2886100,BUY
12-11-20 10:03,10:03,10824650,13749950,2925300,BUY
12-11-20 10:04,10:04,10993975,13499350,2505375,BUY
12-11-20 10:05,10:05,10727875,14018850,3290975,BUY
12-11-20 10:06,10:06,11192525,14130250,2937725,BUY
12-11-20 10:07,10:07,11427000,14187700,2760700,BUY
12-11-20 10:08,10:08,11721075,13589400,1868325,BUY
12-11-20 10:09,10:09,11856325,14036550,2180225,BUY
12-11-20 10:10,10:10,11978900,14102650,2123750,BUY
12-11-20 10:11,10:11,12587600,14689575,2101975,BUY
12-11-20 10:12,10:12,12305325,14811100,2505775,BUY
12-11-20 10:13,10:13,12300625,14733050,2432425,BUY
12-11-20 10:14,10:14,13278950,14993225,1714275,BUY
12-11-20 10:15,10:15,13376950,14958800,1581850,BUY
12-11-20 10:16,10:16,13205050,14508875,1303825,BUY
12-11-20 10:17,10:17,13920350,14575800,655450,BUY
12-11-20 10:18,10:18,13917250,15351875,1434625,BUY
12-11-20 10:19,10:19,13765825,15650650,1884825,BUY
12-11-20 10:20,10:20,14605375,14874000,268625,BUY
12-11-20 10:21,10:21,14628075,14997200,369125,BUY
12-11-20 10:22,10:22,14640975,14772350,131375,BUY
12-11-20 10:23,10:23,14756400,14992050,235650,BUY
12-11-20 10:24,10:24,14835925,15166550,330625,BUY
12-11-20 10:25,10:25,15324200,15005525,-318675,SELL
12-11-20 10:26,10:26,14561825,14248950,-312875,SELL
12-11-20 10:27,10:27,15016025,14315600,-700425,SELL
12-11-20 10:28,10:28,15392250,14714875,-677375,SELL
12-11-20 10:29,10:29,15538775,14146275,-1392500,SELL
12-11-20 10:30,10:30,15307300,14769475,-537825,SELL
12-11-20 10:31,10:31,15824150,14622825,-1201325,SELL
12-11-20 10:32,10:32,15876850,14190725,-1686125,SELL
12-11-20 10:33,10:33,15651850,13403400,-2248450,SELL
12-11-20 10:34,10:34,15205600,14450075,-755525,SELL
12-11-20 10:35,10:35,15699075,15104150,-594925,SELL
12-11-20 10:36,10:36,15897400,15297425,-599975,SELL
12-11-20 10:37,10:37,16055600,14645775,-1409825,SELL
12-11-20 10:38,10:38,16061350,14929150,-1132200,SELL
12-11-20 10:39,10:39,16220250,15318375,-901875,SELL
12-11-20 10:40,10:40,16398250,15018050,-1380200,SELL
12-11-20 10:41,10:41,15775100,15833600,58500,BUY
12-11-20 10:42,10:42,15738000,15386800,-351200,SELL
12-11-20 10:43,10:43,16271125,15470950,-800175,SELL
12-11-20 10:44,10:44,16150800,16123575,-27225,SELL
12-11-20 10:45,10:45,16214575,15929500,-285075,SELL
12-11-20 10:46,10:46,16122550,15532000,-590550,SELL
12-11-20 10:47,10:47,16846125,16241550,-604575,SELL
12-11-20 10:48,10:48,16628825,15311725,-1317100,SELL
12-11-20 10:49,10:49,16517300,15593350,-923950,SELL
12-11-20 10:50,10:50,16688600,15593900,-1094700,SELL
12-11-20 10:51,10:51,17045000,16002975,-1042025,SELL
12-11-20 10:52,10:52,16909325,16117800,-791525,SELL
12-11-20 10:53,10:53,17075300,15957050,-1118250,SELL
12-11-20 10:54,10:54,17140500,16512400,-628100,SELL
12-11-20 10:55,10:55,16734600,15845150,-889450,SELL
12-11-20 10:56,10:56,17035550,16547825,-487725,SELL
12-11-20 10:57,10:57,16754125,15374525,-1379600,SELL
12-11-20 10:58,10:58,16719200,15674900,-1044300,SELL
12-11-20 10:59,10:59,17013000,15746350,-1266650,SELL
12-11-20 11:00,11:00,17115025,16127475,-987550,SELL
12-11-20 11:01,11:01,16919000,16218325,-700675,SELL
12-11-20 11:02,11:02,16916200,16102600,-813600,SELL
12-11-20 11:03,11:03,16894225,16791350,-102875,SELL
12-11-20 11:04,11:04,16935400,15800525,-1134875,SELL
12-11-20 11:05,11:05,16876825,16362550,-514275,SELL
12-11-20 11:06,11:06,16989175,16214600,-774575,SELL
12-11-20 11:07,11:07,16951150,16143225,-807925,SELL
12-11-20 11:08,11:08,17720850,16409375,-1311475,SELL
12-11-20 11:09,11:09,17446100,14749975,-2696125,SELL
12-11-20 11:10,11:10,17584075,16144800,-1439275,SELL
12-11-20 11:11,11:11,17798125,16503600,-1294525,SELL
12-11-20 11:12,11:12,17537225,16091400,-1445825,SELL
12-11-20 11:13,11:13,17698200,16315025,-1383175,SELL
12-11-20 11:14,11:14,17918050,16744200,-1173850,SELL
12-11-20 11:15,11:15,17375575,16442425,-933150,SELL
12-11-20 11:16,11:16,17400600,16124925,-1275675,SELL
12-11-20 11:17,11:17,18048200,15739050,-2309150,SELL
12-11-20 11:18,11:18,18031375,17045775,-985600,SELL
12-11-20 11:19,11:19,17909850,16882525,-1027325,SELL
12-11-20 11:20,11:20,17834950,16261550,-1573400,SELL
12-11-20 11:21,11:21,17916075,16182825,-1733250,SELL
12-11-20 11:22,11:22,17749650,16936250,-813400,SELL
12-11-20 11:23,11:23,17835525,16137050,-1698475,SELL
12-11-20 11:24,11:24,17943575,16924650,-1018925,SELL
12-11-20 11:25,11:25,17947225,16295175,-1652050,SELL
12-11-20 11:26,11:26,18350050,17056900,-1293150,SELL
12-11-20 11:27,11:27,18236500,16394275,-1842225,SELL
12-11-20 11:28,11:28,17727825,15893875,-1833950,SELL
12-11-20 11:29,11:29,18620400,16138025,-2482375,SELL
12-11-20 11:30,11:30,18617025,16551875,-2065150,SELL
12-11-20 11:31,11:31,18510875,16290250,-2220625,SELL
12-11-20 11:32,11:32,18646125,16653000,-1993125,SELL
12-11-20 11:33,11:33,18468550,17006025,-1462525,SELL
12-11-20 11:34,11:34,18547925,16541725,-2006200,SELL
12-11-20 11:35,11:35,18718450,17186850,-1531600,SELL
12-11-20 11:36,11:36,18254625,16570775,-1683850,SELL
12-11-20 11:37,11:37,18267225,16733025,-1534200,SELL
12-11-20 11:38,11:38,18519375,16851400,-1667975,SELL
12-11-20 11:39,11:39,18385550,17420675,-964875,SELL
12-11-20 11:40,11:40,18256700,16412525,-1844175,SELL
12-11-20 11:41,11:41,18089300,17039925,-1049375,SELL
12-11-20 11:42,11:42,18281000,15868275,-2412725,SELL
12-11-20 11:43,11:43,18430925,17200700,-1230225,SELL
12-11-20 11:44,11:44,18432350,17186050,-1246300,SELL
12-11-20 11:45,11:45,18703325,17289700,-1413625,SELL
12-11-20 11:46,11:46,18514475,16474300,-2040175,SELL
12-11-20 11:47,11:47,18496325,15985025,-2511300,SELL
12-11-20 11:48,11:48,18829550,16523725,-2305825,SELL
12-11-20 11:49,11:49,18824600,16314575,-2510025,SELL
12-11-20 11:50,11:50,18589175,16952375,-1636800,SELL
12-11-20 11:51,11:51,18792700,16600025,-2192675,SELL
12-11-20 11:52,11:52,18692725,15637400,-3055325,SELL
12-11-20 11:53,11:53,19529875,17475025,-2054850,SELL
12-11-20 11:54,11:54,18653600,16365700,-2287900,SELL
12-11-20 11:55,11:55,19086425,16624025,-2462400,SELL
12-11-20 11:56,11:56,19607450,17138175,-2469275,SELL
12-11-20 11:57,11:57,19164400,15776225,-3388175,SELL
12-11-20 11:58,11:58,18937375,15930350,-3007025,SELL
12-11-20 11:59,11:59,18555700,16218850,-2336850,SELL
12-11-20 12:00,12:00,18900150,16111075,-2789075,SELL
12-11-20 12:01,12:01,18830000,16363100,-2466900,SELL
12-11-20 12:02,12:02,18984250,16411675,-2572575,SELL
12-11-20 12:03,12:03,19243650,16835075,-2408575,SELL
12-11-20 12:04,12:04,19201950,16505800,-2696150,SELL
12-11-20 12:05,12:05,19391475,16777150,-2614325,SELL
12-11-20 12:06,12:06,19057950,16786700,-2271250,SELL
12-11-20 12:07,12:07,19202250,17074800,-2127450,SELL
12-11-20 12:08,12:08,19279075,16717550,-2561525,SELL
12-11-20 12:09,12:09,19341775,16145450,-3196325,SELL
12-11-20 12:10,12:10,19401725,16786450,-2615275,SELL
12-11-20 12:11,12:11,19333000,16833475,-2499525,SELL
12-11-20 12:12,12:12,19433600,16717375,-2716225,SELL
12-11-20 12:13,12:13,19211700,16476400,-2735300,SELL
12-11-20 12:14,12:14,19371575,16348275,-3023300,SELL
12-11-20 12:15,12:15,19679200,16973650,-2705550,SELL
12-11-20 12:16,12:16,20315950,17457350,-2858600,SELL
12-11-20 12:17,12:17,20026850,16362550,-3664300,SELL
12-11-20 12:18,12:18,20166275,16182525,-3983750,SELL
12-11-20 12:19,12:19,19900125,16575175,-3324950,SELL
12-11-20 12:20,12:20,20173675,16423275,-3750400,SELL
12-11-20 12:21,12:21,20015850,16165625,-3850225,SELL
12-11-20 12:22,12:22,19813225,16190950,-3622275,SELL
12-11-20 12:23,12:23,19772550,16135200,-3637350,SELL
12-11-20 12:24,12:24,19893050,16691175,-3201875,SELL
12-11-20 12:25,12:25,20148875,16319750,-3829125,SELL
12-11-20 12:26,12:26,20084375,16367900,-3716475,SELL
12-11-20 12:27,12:27,20085625,16579850,-3505775,SELL
12-11-20 12:28,12:28,20296450,16243775,-4052675,SELL
12-11-20 12:29,12:29,20250025,15550475,-4699550,SELL
12-11-20 12:30,12:30,20374375,16126475,-4247900,SELL
12-11-20 12:31,12:31,20386200,16719950,-3666250,SELL
12-11-20 12:32,12:32,19065175,16464825,-2600350,SELL
12-11-20 12:33,12:33,19260450,16514850,-2745600,SELL
12-11-20 12:34,12:34,19088875,16048175,-3040700,SELL
12-11-20 12:35,12:35,19454525,16283050,-3171475,SELL
12-11-20 12:36,12:36,19217250,15832175,-3385075,SELL
12-11-20 12:37,12:37,19369850,16193500,-3176350,SELL
12-11-20 12:38,12:38,19320225,15525800,-3794425,SELL
12-11-20 12:39,12:39,19448650,16153575,-3295075,SELL
12-11-20 12:40,12:40,19671925,16186450,-3485475,SELL
12-11-20 12:41,12:41,19769550,16255200,-3514350,SELL
12-11-20 12:42,12:42,19642550,16304900,-3337650,SELL
12-11-20 12:43,12:43,19522500,16335275,-3187225,SELL
12-11-20 12:44,12:44,19538875,16628525,-2910350,SELL
12-11-20 12:45,12:45,19506375,16170175,-3336200,SELL
12-11-20 12:46,12:46,20030425,16427000,-3603425,SELL
12-11-20 12:47,12:47,19838950,16056700,-3782250,SELL
12-11-20 12:48,12:48,19569900,15974600,-3595300,SELL
12-11-20 12:49,12:49,19571425,16107175,-3464250,SELL
12-11-20 12:50,12:50,19792225,15988125,-3804100,SELL
12-11-20 12:51,12:51,19605800,15616125,-3989675,SELL
12-11-20 12:52,12:52,19632200,15734325,-3897875,SELL
12-11-20 12:53,12:53,19837100,15266750,-4570350,SELL
12-11-20 12:54,12:54,19559275,15124650,-4434625,SELL
12-11-20 12:55,12:55,19663450,14773000,-4890450,SELL
12-11-20 12:56,12:56,19838700,16517975,-3320725,SELL
12-11-20 12:57,12:57,19931050,16177425,-3753625,SELL
12-11-20 12:58,12:58,19534425,15541375,-3993050,SELL
12-11-20 12:59,12:59,19489550,16126475,-3363075,SELL
12-11-20 13:00,13:00,19819275,16307850,-3511425,SELL
12-11-20 13:01,13:01,19996925,16384675,-3612250,SELL
12-11-20 13:02,13:02,19652550,15971000,-3681550,SELL
12-11-20 13:03,13:03,19695350,16537625,-3157725,SELL
12-11-20 13:04,13:04,20074900,16556675,-3518225,SELL
12-11-20 13:05,13:05,19768200,16063900,-3704300,SELL
12-11-20 13:06,13:06,19722950,15904725,-3818225,SELL
12-11-20 13:07,13:07,19829275,16309550,-3519725,SELL
12-11-20 13:08,13:08,19522375,16630125,-2892250,SELL
12-11-20 13:13,13:13,19977025,15941200,-4035825,SELL
12-11-20 13:14,13:14,20213475,16175425,-4038050,SELL
12-11-20 13:15,13:15,20265325,16571675,-3693650,SELL
12-11-20 13:16,13:16,20774675,16848875,-3925800,SELL
12-11-20 13:17,13:17,20374075,16531625,-3842450,SELL
12-11-20 13:18,13:18,20926975,17201575,-3725400,SELL
12-11-20 13:19,13:19,20716475,16907525,-3808950,SELL
12-11-20 13:20,13:20,20509725,16734100,-3775625,SELL
12-11-20 13:21,13:21,20887050,16975250,-3911800,SELL
12-11-20 13:22,13:22,20638975,16199050,-4439925,SELL
12-11-20 13:27,13:27,21207750,17219100,-3988650,SELL
12-11-20 13:28,13:28,21160500,17263925,-3896575,SELL
12-11-20 13:29,13:29,21050075,17262500,-3787575,SELL
12-11-20 13:30,13:30,20975625,16897925,-4077700,SELL
12-11-20 13:31,13:31,20801975,16853125,-3948850,SELL
12-11-20 13:32,13:32,21007850,16068150,-4939700,SELL
12-11-20 13:33,13:33,20875150,16532450,-4342700,SELL
12-11-20 13:34,13:34,21044425,15944100,-5100325,SELL
12-11-20 13:35,13:35,21166125,15972825,-5193300,SELL
12-11-20 13:36,13:36,21167825,16338050,-4829775,SELL
12-11-20 13:37,13:37,21453150,16125975,-5327175,SELL
12-11-20 13:38,13:38,20763975,16645550,-4118425,SELL
12-11-20 13:39,13:39,21620625,16551750,-5068875,SELL
12-11-20 13:40,13:40,21431675,16203175,-5228500,SELL
12-11-20 13:41,13:41,21739225,16834600,-4904625,SELL
12-11-20 13:42,13:42,21604175,16390075,-5214100,SELL
12-11-20 13:43,13:43,21984125,16427300,-5556825,SELL
12-11-20 13:44,13:44,21777925,16267425,-5510500,SELL
12-11-20 13:45,13:45,21517300,16902675,-4614625,SELL
12-11-20 13:46,13:46,21832200,16229200,-5603000,SELL
12-11-20 13:47,13:47,21548850,16481650,-5067200,SELL
12-11-20 13:48,13:48,21451725,15909375,-5542350,SELL
12-11-20 13:49,13:49,21567300,16634375,-4932925,SELL
12-11-20 13:50,13:50,21862050,16602250,-5259800,SELL
12-11-20 13:51,13:51,22020100,16138400,-5881700,SELL
12-11-20 13:52,13:52,21974000,16229900,-5744100,SELL
12-11-20 13:53,13:53,21908725,16137900,-5770825,SELL
12-11-20 13:54,13:54,22028575,16111550,-5917025,SELL
12-11-20 13:55,13:55,21897600,17065300,-4832300,SELL
12-11-20 13:56,13:56,22089575,16951600,-5137975,SELL
12-11-20 13:57,13:57,22286950,16806150,-5480800,SELL
12-11-20 13:58,13:58,22313375,16824725,-5488650,SELL
12-11-20 13:59,13:59,22292225,16506050,-5786175,SELL
12-11-20 14:00,14:00,22674875,16732600,-5942275,SELL
12-11-20 14:01,14:01,22608325,16858150,-5750175,SELL
12-11-20 14:02,14:02,22388450,16636475,-5751975,SELL
12-11-20 14:03,14:03,22422075,16744900,-5677175,SELL
12-11-20 14:04,14:04,22525150,16236400,-6288750,SELL
12-11-20 14:05,14:05,22601175,16719600,-5881575,SELL
12-11-20 14:06,14:06,22594325,16632000,-5962325,SELL
12-11-20 14:07,14:07,22753900,16624050,-6129850,SELL
12-11-20 14:08,14:08,22575425,16479675,-6095750,SELL
12-11-20 14:09,14:09,22430125,16649300,-5780825,SELL
12-11-20 14:10,14:10,22629625,15550800,-7078825,SELL
12-11-20 14:11,14:11,22467175,15923825,-6543350,SELL
12-11-20 14:12,14:12,22239000,16427300,-5811700,SELL
12-11-20 14:13,14:13,22432625,16931250,-5501375,SELL
12-11-20 14:14,14:14,22440050,16536000,-5904050,SELL
12-11-20 14:15,14:15,21896925,17220650,-4676275,SELL
12-11-20 14:16,14:16,22508575,16038525,-6470050,SELL
12-11-20 14:17,14:17,22350725,16898925,-5451800,SELL
12-11-20 14:18,14:18,22029600,16082975,-5946625,SELL
12-11-20 14:19,14:19,22021325,16631175,-5390150,SELL
12-11-20 14:20,14:20,21966575,17059600,-4906975,SELL
12-11-20 14:21,14:21,22090175,17094575,-4995600,SELL
12-11-20 14:22,14:22,22049950,16886025,-5163925,SELL
12-11-20 14:23,14:23,22098700,16430975,-5667725,SELL
12-11-20 14:24,14:24,22189375,16505950,-5683425,SELL
12-11-20 14:25,14:25,22198200,16569000,-5629200,SELL
12-11-20 14:26,14:26,22221950,16715575,-5506375,SELL
12-11-20 14:27,14:27,22284925,16993325,-5291600,SELL
12-11-20 14:28,14:28,22072300,16929200,-5143100,SELL
12-11-20 14:29,14:29,22142200,16660550,-5481650,SELL
12-11-20 14:30,14:30,22672525,16747000,-5925525,SELL
12-11-20 14:31,14:31,22489150,16593925,-5895225,SELL
12-11-20 14:32,14:32,22710500,16859750,-5850750,SELL
12-11-20 14:33,14:33,22455550,16806925,-5648625,SELL
12-11-20 14:34,14:34,22384175,16851250,-5532925,SELL
12-11-20 14:35,14:35,22553525,16915650,-5637875,SELL
12-11-20 14:36,14:36,22780025,16980925,-5799100,SELL
12-11-20 14:37,14:37,22495800,16635075,-5860725,SELL
12-11-20 14:38,14:38,22516975,17126325,-5390650,SELL
12-11-20 14:39,14:39,22246675,16761775,-5484900,SELL
12-11-20 14:40,14:40,22295550,16404025,-5891525,SELL
12-11-20 14:41,14:41,22286950,16505875,-5781075,SELL
12-11-20 14:42,14:42,22329750,16678825,-5650925,SELL
12-11-20 14:43,14:43,22481625,16199425,-6282200,SELL
12-11-20 14:44,14:44,22520675,16657475,-5863200,SELL
12-11-20 14:45,14:45,22360150,16588600,-5771550,SELL
12-11-20 14:46,14:46,22373175,16043175,-6330000,SELL
12-11-20 14:47,14:47,22262025,16527800,-5734225,SELL
12-11-20 14:48,14:48,22707650,16870875,-5836775,SELL
12-11-20 14:49,14:49,22712875,16534650,-6178225,SELL
12-11-20 14:50,14:50,22561825,16303125,-6258700,SELL
12-11-20 14:51,14:51,22472975,16485325,-5987650,SELL
12-11-20 14:52,14:52,22319675,16623000,-5696675,SELL
12-11-20 14:53,14:53,22354600,16431750,-5922850,SELL
12-11-20 14:54,14:54,22634300,16595075,-6039225,SELL
12-11-20 14:55,14:55,22494300,16035250,-6459050,SELL
12-11-20 14:56,14:56,22643450,16179600,-6463850,SELL
12-11-20 14:57,14:57,22488300,16059075,-6429225,SELL
12-11-20 14:58,14:58,22492025,16166900,-6325125,SELL
12-11-20 14:59,14:59,22384775,16188300,-6196475,SELL
12-11-20 15:00,15:00,22162050,15138600,-7023450,SELL
12-11-20 15:01,15:01,22237325,16403975,-5833350,SELL
12-11-20 15:02,15:02,22316075,15892100,-6423975,SELL
12-11-20 15:03,15:03,21722450,16209200,-5513250,SELL
12-11-20 15:04,15:04,21707925,16366125,-5341800,SELL
12-11-20 15:05,15:05,21832900,16281000,-5551900,SELL
12-11-20 15:06,15:06,21334950,16347100,-4987850,SELL
12-11-20 15:07,15:07,21317550,16015250,-5302300,SELL
12-11-20 15:08,15:08,21393975,16465975,-4928000,SELL
12-11-20 15:09,15:09,21353925,16084250,-5269675,SELL
12-11-20 15:10,15:10,21322125,16410050,-4912075,SELL
12-11-20 15:11,15:11,21380825,15848175,-5532650,SELL
12-11-20 15:12,15:12,21164850,16325750,-4839100,SELL
12-11-20 15:13,15:13,20789750,15658425,-5131325,SELL
12-11-20 15:14,15:14,20802625,16176025,-4626600,SELL
12-11-20 15:15,15:15,21008550,16301575,-4706975,SELL
12-11-20 15:16,15:16,20588025,16248350,-4339675,SELL
12-11-20 15:17,15:17,21005175,16241325,-4763850,SELL
12-11-20 15:18,15:18,20838475,15984325,-4854150,SELL
12-11-20 15:19,15:19,20739450,15916900,-4822550,SELL
12-11-20 15:20,15:20,20838600,16317200,-4521400,SELL
12-11-20 15:21,15:21,20379700,15651850,-4727850,SELL
12-11-20 15:26,15:26,19146075,14359850,-4786225,SELL
12-11-20 15:27,15:27,18257575,14197950,-4059625,SELL
12-11-20 15:28,15:28,18295825,13987825,-4308000,SELL
13-11-20 9:15,9:15,2963200,2752450,-210750,SELL
13-11-20 9:16,9:16,2964550,2752750,-211800,SELL
13-11-20 9:17,9:17,3109500,2873025,-236475,SELL
13-11-20 9:18,9:18,3108475,2863925,-244550,SELL
13-11-20 9:19,9:19,3108675,2860000,-248675,SELL
13-11-20 9:20,9:20,3327700,3180050,-147650,SELL
13-11-20 9:21,9:21,3314850,3175600,-139250,SELL
13-11-20 9:22,9:22,3309475,3162975,-146500,SELL
13-11-20 9:23,9:23,3568700,3496425,-72275,SELL
13-11-20 9:24,9:24,3570325,3496700,-73625,SELL
13-11-20 9:25,9:25,3584625,3492075,-92550,SELL
13-11-20 9:26,9:26,3810450,3828200,17750,BUY
13-11-20 9:27,9:27,3783950,3808675,24725,BUY
13-11-20 9:28,9:28,3798750,3812575,13825,BUY
13-11-20 9:29,9:29,4024475,4019425,-5050,SELL
13-11-20 9:30,9:30,4013625,4006875,-6750,SELL
13-11-20 9:31,9:31,4019400,4024200,4800,BUY
13-11-20 9:32,9:32,4279500,4333275,53775,BUY
13-11-20 9:33,9:33,4282200,4330025,47825,BUY
13-11-20 9:34,9:34,4257550,4336800,79250,BUY
13-11-20 9:35,9:35,4398675,4441400,42725,BUY
13-11-20 9:36,9:36,4397775,4435500,37725,BUY
13-11-20 9:37,9:37,4398725,4434025,35300,BUY
13-11-20 9:38,9:38,4462625,4320100,-142525,SELL
13-11-20 9:39,9:39,4473925,4305625,-168300,SELL
13-11-20 9:40,9:40,4489075,4327575,-161500,SELL
13-11-20 9:41,9:41,4544350,4430950,-113400,SELL
13-11-20 9:42,9:42,4541325,4415000,-126325,SELL
13-11-20 9:43,9:43,4531600,4433075,-98525,SELL
13-11-20 9:44,9:44,4635900,4468875,-167025,SELL
13-11-20 9:45,9:45,4616950,4467575,-149375,SELL
13-11-20 9:46,9:46,4626875,4488200,-138675,SELL
13-11-20 9:47,9:47,4707525,4628250,-79275,SELL
13-11-20 9:48,9:48,4720725,4599050,-121675,SELL
13-11-20 9:49,9:49,4722850,4611600,-111250,SELL
13-11-20 9:50,9:50,4784625,4709275,-75350,SELL
13-11-20 9:51,9:51,4779825,4709875,-69950,SELL
13-11-20 9:52,9:52,4795350,4616900,-178450,SELL
13-11-20 9:53,9:53,4838350,4795050,-43300,SELL
13-11-20 9:54,9:54,4780150,4788450,8300,BUY
13-11-20 9:55,9:55,4805175,4797000,-8175,SELL
13-11-20 9:56,9:56,4848900,4848450,-450,SELL
13-11-20 9:57,9:57,4881075,4868150,-12925,SELL
13-11-20 9:58,9:58,4850125,4867225,17100,BUY
13-11-20 9:59,9:59,4933800,4874025,-59775,SELL
13-11-20 10:00,10:00,4950575,4919550,-31025,SELL
13-11-20 10:01,10:01,4940425,4930325,-10100,SELL
13-11-20 10:02,10:02,4938025,4942500,4475,BUY
13-11-20 10:03,10:03,4963900,4945625,-18275,SELL
13-11-20 10:04,10:04,4985050,4866725,-118325,SELL
13-11-20 10:05,10:05,5053025,5023800,-29225,SELL
13-11-20 10:06,10:06,5027000,5022250,-4750,SELL
13-11-20 10:07,10:07,5051600,4976100,-75500,SELL
13-11-20 10:08,10:08,5051575,4977300,-74275,SELL
13-11-20 10:09,10:09,5051025,4981800,-69225,SELL
13-11-20 10:10,10:10,5080775,5013100,-67675,SELL
13-11-20 10:11,10:11,5114675,5022150,-92525,SELL
13-11-20 10:12,10:12,5132000,5059500,-72500,SELL
13-11-20 10:13,10:13,5121750,5077475,-44275,SELL
13-11-20 10:14,10:14,5109700,5079350,-30350,SELL
13-11-20 10:15,10:15,5132475,5072200,-60275,SELL
13-11-20 10:16,10:16,5135125,5097550,-37575,SELL
13-11-20 10:17,10:17,5103825,5125350,21525,BUY
13-11-20 10:18,10:18,5114750,5172550,57800,BUY
13-11-20 10:19,10:19,5112775,5164075,51300,BUY
13-11-20 10:20,10:20,5045175,5156500,111325,BUY
13-11-20 10:21,10:21,5035075,5154025,118950,BUY
13-11-20 10:22,10:22,5041325,5155175,113850,BUY
13-11-20 10:23,10:23,5009775,5221575,211800,BUY
13-11-20 10:24,10:24,5011550,5239550,228000,BUY
13-11-20 10:25,10:25,5018575,5243275,224700,BUY
13-11-20 10:26,10:26,4751425,5317550,566125,BUY
13-11-20 10:27,10:27,4741025,5302925,561900,BUY
13-11-20 10:28,10:28,4733350,5307300,573950,BUY
13-11-20 10:29,10:29,4693700,5369700,676000,BUY
13-11-20 10:30,10:30,4698100,5353900,655800,BUY
13-11-20 10:31,10:31,4691950,5370150,678200,BUY
13-11-20 10:32,10:32,4906525,5448850,542325,BUY
13-11-20 10:33,10:33,4908425,5454250,545825,BUY
13-11-20 10:34,10:34,4908625,5438975,530350,BUY
13-11-20 10:35,10:35,4952325,5433075,480750,BUY
13-11-20 10:36,10:36,4933625,5458975,525350,BUY
13-11-20 10:37,10:37,4971675,5457600,485925,BUY
13-11-20 10:38,10:38,4984750,5395225,410475,BUY
13-11-20 10:39,10:39,4990950,5386950,396000,BUY
13-11-20 10:40,10:40,4970125,5396550,426425,BUY
13-11-20 10:41,10:41,4959100,5386975,427875,BUY
13-11-20 10:42,10:42,4992625,5434625,442000,BUY
13-11-20 10:43,10:43,5023075,5427375,404300,BUY
13-11-20 10:44,10:44,4984700,5463550,478850,BUY
13-11-20 10:45,10:45,5042825,5471725,428900,BUY
13-11-20 10:46,10:46,5054525,5475650,421125,BUY
13-11-20 10:47,10:47,4981475,5470100,488625,BUY
13-11-20 10:48,10:48,4977125,5434000,456875,BUY
13-11-20 10:49,10:49,4972025,5457025,485000,BUY
13-11-20 10:50,10:50,5050375,5489225,438850,BUY
13-11-20 10:51,10:51,5074150,5482250,408100,BUY
13-11-20 10:52,10:52,5072000,5499575,427575,BUY
13-11-20 10:53,10:53,5123450,5498575,375125,BUY
13-11-20 10:54,10:54,5109450,5509225,399775,BUY
13-11-20 10:55,10:55,5121850,5504100,382250,BUY
13-11-20 10:56,10:56,5165575,5528700,363125,BUY
13-11-20 10:57,10:57,5124950,5507675,382725,BUY
13-11-20 10:58,10:58,5108500,5454325,345825,BUY
13-11-20 10:59,10:59,5169175,5562675,393500,BUY
13-11-20 11:00,11:00,5153275,5553725,400450,BUY
13-11-20 11:01,11:01,5186175,5576275,390100,BUY
13-11-20 11:02,11:02,5185075,5500150,315075,BUY
13-11-20 11:03,11:03,5206475,5594500,388025,BUY
13-11-20 11:04,11:04,5199600,5602175,402575,BUY
13-11-20 11:05,11:05,5175200,5581650,406450,BUY
13-11-20 11:06,11:06,5190150,5578575,388425,BUY
13-11-20 11:07,11:07,5138925,5601125,462200,BUY
13-11-20 11:08,11:08,5227000,5629500,402500,BUY
13-11-20 11:09,11:09,5201875,5517550,315675,BUY
13-11-20 11:10,11:10,5225250,5560275,335025,BUY
13-11-20 11:11,11:11,5293600,5549225,255625,BUY
13-11-20 11:12,11:12,5282925,5578600,295675,BUY
13-11-20 11:13,11:13,5235375,5580350,344975,BUY
13-11-20 11:14,11:14,5233175,5630050,396875,BUY
13-11-20 11:15,11:15,5243050,5618250,375200,BUY
13-11-20 11:16,11:16,5259050,5593400,334350,BUY
13-11-20 11:17,11:17,5275700,5658325,382625,BUY
13-11-20 11:18,11:18,5280925,5610275,329350,BUY
13-11-20 11:19,11:19,5266900,5570550,303650,BUY
13-11-20 11:20,11:20,5175700,5562700,387000,BUY
13-11-20 11:21,11:21,5280250,5576075,295825,BUY
13-11-20 11:22,11:22,5259725,5597425,337700,BUY
13-11-20 11:23,11:23,5225900,5622700,396800,BUY
13-11-20 11:24,11:24,5212000,5572450,360450,BUY
13-11-20 11:25,11:25,5295800,5711475,415675,BUY
13-11-20 11:26,11:26,5267800,5710725,442925,BUY
13-11-20 11:27,11:27,5307550,5690625,383075,BUY
13-11-20 11:28,11:28,5352425,5662650,310225,BUY
13-11-20 11:29,11:29,5391300,5727850,336550,BUY
13-11-20 11:30,11:30,5403325,5738975,335650,BUY
13-11-20 11:31,11:31,5346275,5720150,373875,BUY
13-11-20 11:32,11:32,5326975,5704450,377475,BUY
13-11-20 11:33,11:33,5262675,5662775,400100,BUY
13-11-20 11:34,11:34,5331475,5501950,170475,BUY
13-11-20 11:35,11:35,5352475,5724775,372300,BUY
13-11-20 11:36,11:36,5305575,5768925,463350,BUY
13-11-20 11:37,11:37,5308800,5745975,437175,BUY
13-11-20 11:38,11:38,5294450,5749050,454600,BUY
13-11-20 11:39,11:39,5294925,5792400,497475,BUY
13-11-20 11:40,11:40,5349675,5742200,392525,BUY
13-11-20 11:41,11:41,5384450,5717675,333225,BUY
13-11-20 11:42,11:42,5388725,5732725,344000,BUY
13-11-20 11:43,11:43,5414400,5822300,407900,BUY
13-11-20 11:44,11:44,5393875,5724025,330150,BUY
13-11-20 11:45,11:45,5345250,5837800,492550,BUY
13-11-20 11:46,11:46,5393600,5671725,278125,BUY
13-11-20 11:47,11:47,5418150,5742825,324675,BUY
13-11-20 11:48,11:48,5441325,5882825,441500,BUY
13-11-20 11:49,11:49,5344125,5837925,493800,BUY
13-11-20 11:50,11:50,5433500,5931300,497800,BUY
13-11-20 11:51,11:51,5439375,5904775,465400,BUY
13-11-20 11:52,11:52,5419325,5804475,385150,BUY
13-11-20 11:53,11:53,5423850,5900725,476875,BUY
13-11-20 11:54,11:54,5423750,5919650,495900,BUY
13-11-20 11:55,11:55,5452675,5935450,482775,BUY
13-11-20 11:56,11:56,5438125,5947000,508875,BUY
13-11-20 11:57,11:57,5408700,5627525,218825,BUY
13-11-20 11:58,11:58,5423075,5842950,419875,BUY
13-11-20 11:59,11:59,5491900,5915400,423500,BUY
13-11-20 12:00,12:00,5511375,6015775,504400,BUY
13-11-20 12:01,12:01,5436800,5995250,558450,BUY
13-11-20 12:02,12:02,5407075,5982975,575900,BUY
13-11-20 12:03,12:03,5493100,5984650,491550,BUY
13-11-20 12:04,12:04,5452600,5958775,506175,BUY
13-11-20 12:05,12:05,5480125,5947700,467575,BUY
13-11-20 12:06,12:06,5483775,5953275,469500,BUY
13-11-20 12:07,12:07,5430650,5852900,422250,BUY
13-11-20 12:08,12:08,5457300,5997850,540550,BUY
13-11-20 12:09,12:09,5501850,6057525,555675,BUY
13-11-20 12:10,12:10,5489425,6046775,557350,BUY
13-11-20 12:11,12:11,5481575,6029625,548050,BUY
13-11-20 12:12,12:12,5409700,6009250,599550,BUY
13-11-20 12:13,12:13,5470150,6054650,584500,BUY
13-11-20 12:14,12:14,5482150,6102675,620525,BUY
13-11-20 12:15,12:15,5461850,5995900,534050,BUY
13-11-20 12:16,12:16,5557600,6076725,519125,BUY
13-11-20 12:17,12:17,5509625,6086900,577275,BUY
13-11-20 12:18,12:18,5556125,6107525,551400,BUY
13-11-20 12:19,12:19,5494450,6063800,569350,BUY
13-11-20 12:20,12:20,5546050,6050700,504650,BUY
13-11-20 12:21,12:21,5507925,6055925,548000,BUY
13-11-20 12:22,12:22,5502425,6040900,538475,BUY
13-11-20 12:23,12:23,5532875,6052150,519275,BUY
13-11-20 12:24,12:24,5503325,6041225,537900,BUY
13-11-20 12:25,12:25,5472250,5967600,495350,BUY
13-11-20 12:26,12:26,5501175,6020125,518950,BUY
13-11-20 12:27,12:27,5569675,6007725,438050,BUY
13-11-20 12:28,12:28,5534075,5988400,454325,BUY
13-11-20 12:29,12:29,5548225,5967800,419575,BUY
13-11-20 12:30,12:30,5353425,6066400,712975,BUY
13-11-20 12:31,12:31,5556650,6077600,520950,BUY
13-11-20 12:32,12:32,5564225,6096875,532650,BUY
13-11-20 12:33,12:33,5528050,6073850,545800,BUY
13-11-20 12:34,12:34,5536450,6079950,543500,BUY
13-11-20 12:35,12:35,5557750,6027425,469675,BUY
13-11-20 12:36,12:36,5555350,6038000,482650,BUY
13-11-20 12:37,12:37,5564400,6091550,527150,BUY
13-11-20 12:38,12:38,5579950,6053800,473850,BUY
13-11-20 12:39,12:39,5597700,6079025,481325,BUY
13-11-20 12:40,12:40,5604150,6093875,489725,BUY
13-11-20 12:41,12:41,5618250,6080525,462275,BUY
13-11-20 12:42,12:42,5499075,6016625,517550,BUY
13-11-20 12:43,12:43,5597425,6052325,454900,BUY
13-11-20 12:44,12:44,5596725,6051625,454900,BUY
13-11-20 12:45,12:45,5667450,6104750,437300,BUY
13-11-20 12:46,12:46,5637000,6111300,474300,BUY
13-11-20 12:47,12:47,5675025,5986000,310975,BUY
13-11-20 12:48,12:48,5648825,6038100,389275,BUY
13-11-20 12:49,12:49,5659050,6140375,481325,BUY
13-11-20 12:50,12:50,5638000,6114100,476100,BUY
13-11-20 12:51,12:51,5651375,6165525,514150,BUY
13-11-20 12:52,12:52,5644250,6155375,511125,BUY
13-11-20 12:53,12:53,5557950,6083875,525925,BUY
13-11-20 12:54,12:54,5565825,6085200,519375,BUY
13-11-20 12:55,12:55,5586025,6103825,517800,BUY
13-11-20 12:56,12:56,5535050,6089925,554875,BUY
13-11-20 12:57,12:57,5501975,6118025,616050,BUY
13-11-20 12:58,12:58,5535750,6084375,548625,BUY
13-11-20 12:59,12:59,5415350,6067300,651950,BUY
13-11-20 13:00,13:00,5465750,6047750,582000,BUY
13-11-20 13:01,13:01,5425375,6119300,693925,BUY
13-11-20 13:02,13:02,5499850,6147725,647875,BUY
13-11-20 13:03,13:03,5504700,6157025,652325,BUY
13-11-20 13:04,13:04,5490325,6087550,597225,BUY
13-11-20 13:05,13:05,5441550,6123375,681825,BUY
13-11-20 13:06,13:06,5465100,6102150,637050,BUY
13-11-20 13:07,13:07,5424325,6079450,655125,BUY
13-11-20 13:08,13:08,5465900,6120150,654250,BUY
13-11-20 13:09,13:09,5459400,6113000,653600,BUY
13-11-20 13:10,13:10,5419075,6069575,650500,BUY
13-11-20 13:11,13:11,5427700,6075575,647875,BUY
13-11-20 13:12,13:12,5386650,6086500,699850,BUY
13-11-20 13:13,13:13,5403725,6152925,749200,BUY
13-11-20 13:14,13:14,5442075,6046200,604125,BUY
13-11-20 13:15,13:15,5393275,6182800,789525,BUY
13-11-20 13:16,13:16,5432350,6145075,712725,BUY
13-11-20 13:17,13:17,5448800,6156625,707825,BUY
13-11-20 13:18,13:18,5455375,6123700,668325,BUY
13-11-20 13:19,13:19,5416025,6155200,739175,BUY
13-11-20 13:20,13:20,5403150,6184100,780950,BUY
13-11-20 13:21,13:21,5396200,6093750,697550,BUY
13-11-20 13:22,13:22,5394425,6134325,739900,BUY
13-11-20 13:23,13:23,5414775,6104400,689625,BUY
13-11-20 13:24,13:24,5434225,5973325,539100,BUY
13-11-20 13:25,13:25,5434575,6123400,688825,BUY
13-11-20 13:26,13:26,5448500,6150550,702050,BUY
13-11-20 13:27,13:27,5466525,6180075,713550,BUY
13-11-20 13:28,13:28,5458925,6091150,632225,BUY
13-11-20 13:29,13:29,5461750,6191725,729975,BUY
13-11-20 13:30,13:30,5477675,6194425,716750,BUY
13-11-20 13:31,13:31,5457050,6186825,729775,BUY
13-11-20 13:32,13:32,5471875,6210700,738825,BUY
13-11-20 13:33,13:33,5455425,6202325,746900,BUY
13-11-20 13:34,13:34,5488875,6173600,684725,BUY
13-11-20 13:35,13:35,5482125,6154150,672025,BUY
13-11-20 13:36,13:36,5529375,6245225,715850,BUY
13-11-20 13:37,13:37,5449125,6200125,751000,BUY
13-11-20 13:38,13:38,5517900,6247875,729975,BUY
13-11-20 13:39,13:39,5496425,6152750,656325,BUY
13-11-20 13:40,13:40,5473400,6174225,700825,BUY
13-11-20 13:41,13:41,5506625,6128400,621775,BUY
13-11-20 13:42,13:42,5500150,6114750,614600,BUY
13-11-20 13:43,13:43,5524650,6155600,630950,BUY
13-11-20 13:44,13:44,5430075,6275150,845075,BUY
13-11-20 13:45,13:45,5449150,6310700,861550,BUY
13-11-20 13:46,13:46,5452425,6276700,824275,BUY
13-11-20 13:47,13:47,5512450,6259575,747125,BUY
13-11-20 13:48,13:48,5517075,6346250,829175,BUY
13-11-20 13:49,13:49,5524175,6370150,845975,BUY
13-11-20 13:50,13:50,5516125,6368500,852375,BUY
13-11-20 13:51,13:51,5310125,6307225,997100,BUY
13-11-20 13:52,13:52,5292525,6275125,982600,BUY
13-11-20 13:53,13:53,5295000,6294275,999275,BUY
13-11-20 13:54,13:54,5378600,6319175,940575,BUY
13-11-20 13:55,13:55,5388625,6348250,959625,BUY
13-11-20 13:56,13:56,5373025,6307000,933975,BUY
13-11-20 13:57,13:57,5266925,6365775,1098850,BUY
13-11-20 13:58,13:58,5264150,6322625,1058475,BUY
13-11-20 13:59,13:59,5265725,6365475,1099750,BUY
13-11-20 14:00,14:00,5314475,6285225,970750,BUY
13-11-20 14:01,14:01,5304425,6270825,966400,BUY
13-11-20 14:02,14:02,5261225,6385725,1124500,BUY
13-11-20 14:03,14:03,5374750,6449400,1074650,BUY
13-11-20 14:04,14:04,5397750,6436950,1039200,BUY
13-11-20 14:05,14:05,5374325,6443750,1069425,BUY
13-11-20 14:06,14:06,5229075,6336275,1107200,BUY
13-11-20 14:07,14:07,5267350,6393850,1126500,BUY
13-11-20 14:08,14:08,5246175,6342875,1096700,BUY
13-11-20 14:09,14:09,5348200,6260725,912525,BUY
13-11-20 14:10,14:10,5343950,6391325,1047375,BUY
13-11-20 14:11,14:11,5331675,6391400,1059725,BUY
13-11-20 14:12,14:12,5318100,6447550,1129450,BUY
13-11-20 14:13,14:13,5309325,6445475,1136150,BUY
13-11-20 14:14,14:14,5338350,6409875,1071525,BUY
13-11-20 14:15,14:15,5361675,6386150,1024475,BUY
13-11-20 14:16,14:16,5339875,6463875,1124000,BUY
13-11-20 14:17,14:17,5329475,6436675,1107200,BUY
13-11-20 14:18,14:18,5453725,6490950,1037225,BUY
13-11-20 14:19,14:19,5427000,6503550,1076550,BUY
13-11-20 14:20,14:20,5463875,6506250,1042375,BUY
13-11-20 14:21,14:21,5543350,6521550,978200,BUY
13-11-20 14:22,14:22,5520650,6495650,975000,BUY
13-11-20 14:23,14:23,5528675,6536550,1007875,BUY
13-11-20 14:24,14:24,5441175,6513900,1072725,BUY
13-11-20 14:25,14:25,5450575,6467950,1017375,BUY
13-11-20 14:26,14:26,5410800,6485150,1074350,BUY
13-11-20 14:27,14:27,5442625,6524500,1081875,BUY
13-11-20 14:28,14:28,5393725,6403625,1009900,BUY
13-11-20 14:29,14:29,5457300,6435150,977850,BUY
13-11-20 14:30,14:30,5466800,6540375,1073575,BUY
13-11-20 14:31,14:31,5461000,6483275,1022275,BUY
13-11-20 14:32,14:32,5448975,6443375,994400,BUY
13-11-20 14:33,14:33,5439900,6486850,1046950,BUY
13-11-20 14:34,14:34,5463425,6563200,1099775,BUY
13-11-20 14:35,14:35,5464450,6532575,1068125,BUY
13-11-20 14:36,14:36,5489500,6454200,964700,BUY
13-11-20 14:37,14:37,5502075,6467150,965075,BUY
13-11-20 14:38,14:38,5483300,6482575,999275,BUY
13-11-20 14:39,14:39,5435375,6390800,955425,BUY
13-11-20 14:40,14:40,5396300,6404050,1007750,BUY
13-11-20 14:41,14:41,5445675,6441150,995475,BUY
13-11-20 14:42,14:42,5435900,6414400,978500,BUY
13-11-20 14:43,14:43,5394700,6424625,1029925,BUY
13-11-20 14:44,14:44,5442625,6445600,1002975,BUY
13-11-20 14:45,14:45,5470000,6461225,991225,BUY
13-11-20 14:46,14:46,5509850,6348625,838775,BUY
13-11-20 14:47,14:47,5536625,6464775,928150,BUY
13-11-20 14:48,14:48,5462625,6276200,813575,BUY
13-11-20 14:49,14:49,5463750,6393200,929450,BUY
13-11-20 14:50,14:50,5461925,6372350,910425,BUY
13-11-20 14:51,14:51,5429500,6369575,940075,BUY
13-11-20 14:52,14:52,5438250,6364550,926300,BUY
13-11-20 14:53,14:53,5432275,6336475,904200,BUY
13-11-20 14:54,14:54,5244625,6199675,955050,BUY
13-11-20 14:55,14:55,5279775,6235450,955675,BUY
13-11-20 14:56,14:56,5282925,6247325,964400,BUY
13-11-20 14:57,14:57,5208075,6209100,1001025,BUY
13-11-20 14:58,14:58,5215075,6190850,975775,BUY
13-11-20 14:59,14:59,5231100,6214400,983300,BUY
13-11-20 15:00,15:00,5233525,6209725,976200,BUY
13-11-20 15:01,15:01,5228700,6182650,953950,BUY
13-11-20 15:02,15:02,5176375,6192975,1016600,BUY
13-11-20 15:03,15:03,5181025,6132600,951575,BUY
13-11-20 15:04,15:04,5154300,6108950,954650,BUY
13-11-20 15:05,15:05,5181200,6136000,954800,BUY
13-11-20 15:06,15:06,5107700,6070450,962750,BUY
13-11-20 15:07,15:07,5132500,6128400,995900,BUY
13-11-20 15:08,15:08,5121300,6107275,985975,BUY
13-11-20 15:09,15:09,5055200,6102550,1047350,BUY
13-11-20 15:10,15:10,5089075,6095400,1006325,BUY
13-11-20 15:11,15:11,5051425,6084000,1032575,BUY
13-11-20 15:12,15:12,5010275,6094750,1084475,BUY
13-11-20 15:13,15:13,5057300,6092025,1034725,BUY
13-11-20 15:14,15:14,5051275,6067450,1016175,BUY
13-11-20 15:15,15:15,5031200,6025825,994625,BUY
13-11-20 15:16,15:16,5030875,6039525,1008650,BUY
13-11-20 15:17,15:17,5027475,6018075,990600,BUY
13-11-20 15:18,15:18,4973275,5962675,989400,BUY
13-11-20 15:19,15:19,4964100,5972875,1008775,BUY
13-11-20 15:20,15:20,4974050,5982400,1008350,BUY
13-11-20 15:21,15:21,4895500,5901125,1005625,BUY
13-11-20 15:22,15:22,4872875,5880350,1007475,BUY
13-11-20 15:23,15:23,4824800,5876625,1051825,BUY
13-11-20 15:24,15:24,4753550,5754875,1001325,BUY
13-11-20 15:25,15:25,4787175,5766675,979500,BUY
13-11-20 15:26,15:26,4773400,5765275,991875,BUY
13-11-20 15:27,15:27,4750200,5795250,1045050,BUY
13-11-20 15:28,15:28,4754175,5786200,1032025,BUY
13-11-20 15:29,15:29,4762750,5792100,1029350,BUY
14-11-20 18:15,18:15,4657475,5600050,942575,BUY
14-11-20 18:16,18:16,4615550,5612225,996675,BUY
14-11-20 18:17,18:17,5092725,5802925,710200,BUY
14-11-20 18:18,18:18,5086200,5867075,780875,BUY
14-11-20 18:19,18:19,5098925,5861725,762800,BUY
14-11-20 18:20,18:20,5399900,6035400,635500,BUY
14-11-20 18:21,18:21,5402200,6152000,749800,BUY
14-11-20 18:22,18:22,5397925,6122625,724700,BUY
14-11-20 18:23,18:23,5509875,6191600,681725,BUY
14-11-20 18:24,18:24,5521300,6178825,657525,BUY
14-11-20 18:25,18:25,5501000,6213325,712325,BUY
14-11-20 18:26,18:26,5651725,6311875,660150,BUY
14-11-20 18:27,18:27,5560850,6303150,742300,BUY
14-11-20 18:28,18:28,5646425,6283050,636625,BUY
14-11-20 18:29,18:29,5761075,6361275,600200,BUY
14-11-20 18:30,18:30,5760550,6349475,588925,BUY
14-11-20 18:31,18:31,5669950,6316050,646100,BUY
14-11-20 18:32,18:32,5840350,6377450,537100,BUY
14-11-20 18:33,18:33,5778025,6237850,459825,BUY
14-11-20 18:34,18:34,5892900,6361175,468275,BUY
14-11-20 18:35,18:35,5984675,6410275,425600,BUY
14-11-20 18:36,18:36,5894375,6387175,492800,BUY
14-11-20 18:37,18:37,5963800,6379750,415950,BUY
14-11-20 18:38,18:38,6005100,6447025,441925,BUY
14-11-20 18:39,18:39,5929175,6414450,485275,BUY
14-11-20 18:40,18:40,5867025,6294000,426975,BUY
14-11-20 18:41,18:41,5961575,6418375,456800,BUY
14-11-20 18:42,18:42,5982250,6473775,491525,BUY
14-11-20 18:43,18:43,6059200,6487825,428625,BUY
14-11-20 18:44,18:44,6034400,6488575,454175,BUY
14-11-20 18:45,18:45,6028200,6468550,440350,BUY
14-11-20 18:46,18:46,6012750,6480900,468150,BUY
14-11-20 18:47,18:47,5975750,6459650,483900,BUY
14-11-20 18:48,18:48,5966050,6509775,543725,BUY
14-11-20 18:49,18:49,5916350,6471475,555125,BUY
14-11-20 18:50,18:50,6042600,6495725,453125,BUY
14-11-20 18:51,18:51,6087825,6515550,427725,BUY
14-11-20 18:52,18:52,6038650,6511825,473175,BUY
14-11-20 18:53,18:53,6037775,6516075,478300,BUY
14-11-20 18:54,18:54,6041275,6507650,466375,BUY
14-11-20 18:55,18:55,6092875,6502425,409550,BUY
14-11-20 18:56,18:56,6030700,6475475,444775,BUY
14-11-20 18:57,18:57,6052500,6445400,392900,BUY
14-11-20 18:58,18:58,6026450,6554450,528000,BUY
14-11-20 18:59,18:59,5922100,6493700,571600,BUY
14-11-20 19:00,19:00,5884875,6521675,636800,BUY
14-11-20 19:01,19:01,5931725,6538550,606825,BUY
14-11-20 19:02,19:02,5858225,6544200,685975,BUY
14-11-20 19:03,19:03,5858500,6550150,691650,BUY
14-11-20 19:04,19:04,5867250,6488250,621000,BUY
14-11-20 19:05,19:05,5928550,6489900,561350,BUY
14-11-20 19:06,19:06,5929175,6493075,563900,BUY
14-11-20 19:07,19:07,5930725,6500025,569300,BUY
14-11-20 19:08,19:08,5836250,6363925,527675,BUY
14-11-20 19:09,19:09,5790650,6370150,579500,BUY
14-11-20 19:10,19:10,5801750,6333650,531900,BUY
14-11-20 19:11,19:11,5729950,6296525,566575,BUY
14-11-20 19:12,19:12,5735775,6287725,551950,BUY
14-11-20 19:13,19:13,5763425,6289400,525975,BUY
14-11-20 19:14,19:14,5784150,6262150,478000,BUY
17-11-20 9:15,9:15,3428725,2827600,-601125,SELL
17-11-20 9:16,9:16,3711175,4215050,503875,BUY
17-11-20 9:17,9:17,3835050,4696075,861025,BUY
17-11-20 9:18,9:18,4708800,5238775,529975,BUY
17-11-20 9:19,9:19,5723225,5337550,-385675,SELL
17-11-20 9:20,9:20,5715225,5991300,276075,BUY
17-11-20 9:21,9:21,5728300,6096000,367700,BUY
17-11-20 9:22,9:22,5727025,6112825,385800,BUY
17-11-20 9:23,9:23,5729700,6241650,511950,BUY
17-11-20 9:24,9:24,5710300,6251500,541200,BUY
17-11-20 9:25,9:25,5681675,6214500,532825,BUY
17-11-20 9:26,9:26,5749250,6272150,522900,BUY
17-11-20 9:27,9:27,5711425,6243800,532375,BUY
17-11-20 9:28,9:28,5709325,6237650,528325,BUY
17-11-20 9:29,9:29,5855900,6271125,415225,BUY
17-11-20 9:30,9:30,5832600,6269450,436850,BUY
17-11-20 9:31,9:31,5799550,6279025,479475,BUY
17-11-20 9:32,9:32,5864675,6409475,544800,BUY
17-11-20 9:33,9:33,5811075,6348925,537850,BUY
17-11-20 9:34,9:34,5856775,6391075,534300,BUY
17-11-20 9:35,9:35,6229175,6927525,698350,BUY
17-11-20 9:36,9:36,6240575,6844000,603425,BUY
17-11-20 9:37,9:37,6280525,6823250,542725,BUY
17-11-20 9:38,9:38,6360775,7379075,1018300,BUY
17-11-20 9:39,9:39,6407275,7397950,990675,BUY
17-11-20 9:40,9:40,6425650,7346450,920800,BUY
17-11-20 9:41,9:41,6305925,7552600,1246675,BUY
17-11-20 9:42,9:42,6320700,7601300,1280600,BUY
17-11-20 9:43,9:43,6304225,7553725,1249500,BUY
17-11-20 9:44,9:44,6500325,7714600,1214275,BUY
17-11-20 9:45,9:45,6514575,7793350,1278775,BUY
17-11-20 9:46,9:46,6487975,7697600,1209625,BUY
17-11-20 9:47,9:47,6553800,8122475,1568675,BUY
17-11-20 9:48,9:48,6518700,8034600,1515900,BUY
17-11-20 9:49,9:49,6543200,8135850,1592650,BUY
17-11-20 9:50,9:50,6432200,8352575,1920375,BUY
17-11-20 9:51,9:51,6416750,8431675,2014925,BUY
17-11-20 9:52,9:52,6412700,8429250,2016550,BUY
17-11-20 9:53,9:53,6362625,8619750,2257125,BUY
17-11-20 9:54,9:54,6416400,8586350,2169950,BUY
17-11-20 9:55,9:55,6400350,8621875,2221525,BUY
17-11-20 9:56,9:56,6319000,8772750,2453750,BUY
17-11-20 9:57,9:57,6210750,8753100,2542350,BUY
17-11-20 9:58,9:58,6326100,8803950,2477850,BUY
17-11-20 9:59,9:59,6423375,9022700,2599325,BUY
17-11-20 10:00,10:00,6394100,8980675,2586575,BUY
17-11-20 10:01,10:01,6407800,8925200,2517400,BUY
17-11-20 10:02,10:02,6560275,9080650,2520375,BUY
17-11-20 10:03,10:03,6501750,9126350,2624600,BUY
17-11-20 10:04,10:04,6582125,9118300,2536175,BUY
17-11-20 10:05,10:05,6651100,9121925,2470825,BUY
17-11-20 10:06,10:06,6724775,9151325,2426550,BUY
17-11-20 10:07,10:07,6724450,9199175,2474725,BUY
17-11-20 10:08,10:08,6726750,9195350,2468600,BUY
17-11-20 10:09,10:09,6815275,9276700,2461425,BUY
17-11-20 10:10,10:10,6795150,9136100,2340950,BUY
17-11-20 10:11,10:11,6846075,9342525,2496450,BUY
17-11-20 10:12,10:12,6839325,9354250,2514925,BUY
17-11-20 10:13,10:13,6835450,9324450,2489000,BUY
17-11-20 10:14,10:14,6937125,9386850,2449725,BUY
17-11-20 10:15,10:15,6976350,9420725,2444375,BUY
17-11-20 10:16,10:16,6962700,9434900,2472200,BUY
17-11-20 10:17,10:17,6904075,9321425,2417350,BUY
17-11-20 10:18,10:18,7013050,9393925,2380875,BUY
17-11-20 10:19,10:19,7021775,9407450,2385675,BUY
17-11-20 10:20,10:20,7061875,9444650,2382775,BUY
17-11-20 10:21,10:21,7206175,9435800,2229625,BUY
17-11-20 10:22,10:22,7184750,9409000,2224250,BUY
17-11-20 10:23,10:23,7231750,9322275,2090525,BUY
17-11-20 10:24,10:24,7245400,9304800,2059400,BUY
17-11-20 10:25,10:25,7261100,9379125,2118025,BUY
17-11-20 10:26,10:26,7302450,9496350,2193900,BUY
17-11-20 10:27,10:27,7366700,9480000,2113300,BUY
17-11-20 10:28,10:28,7364975,9409075,2044100,BUY
17-11-20 10:29,10:29,7440650,9649650,2209000,BUY
17-11-20 10:30,10:30,7460950,9661975,2201025,BUY
17-11-20 10:31,10:31,7360175,9605300,2245125,BUY
17-11-20 10:32,10:32,7553750,9539975,1986225,BUY
17-11-20 10:33,10:33,7503600,9631850,2128250,BUY
17-11-20 10:34,10:34,7544400,9406025,1861625,BUY
17-11-20 10:35,10:35,7658450,9488200,1829750,BUY
17-11-20 10:36,10:36,7603175,9566050,1962875,BUY
17-11-20 10:37,10:37,7588975,9507800,1918825,BUY
17-11-20 10:38,10:38,7758175,9474200,1716025,BUY
17-11-20 10:39,10:39,7701350,9452750,1751400,BUY
17-11-20 10:40,10:40,7747450,9469200,1721750,BUY
17-11-20 10:41,10:41,7815400,9247075,1431675,BUY
17-11-20 10:42,10:42,7743025,9241075,1498050,BUY
17-11-20 10:43,10:43,7734075,9229700,1495625,BUY
17-11-20 10:44,10:44,7831450,9360725,1529275,BUY
17-11-20 10:45,10:45,7840625,9234625,1394000,BUY
17-11-20 10:46,10:46,7814700,9209200,1394500,BUY
17-11-20 10:47,10:47,7895450,9335775,1440325,BUY
17-11-20 10:48,10:48,7904575,9335625,1431050,BUY
17-11-20 10:49,10:49,7776125,9134600,1358475,BUY
17-11-20 10:50,10:50,7908450,9082150,1173700,BUY
17-11-20 10:51,10:51,7941400,9313000,1371600,BUY
17-11-20 10:52,10:52,8003650,9249925,1246275,BUY
17-11-20 10:53,10:53,7931150,9165400,1234250,BUY
17-11-20 10:54,10:54,8031750,9313950,1282200,BUY
17-11-20 10:55,10:55,7990500,9212975,1222475,BUY
17-11-20 10:56,10:56,8004250,9198425,1194175,BUY
17-11-20 10:57,10:57,7934650,9239125,1304475,BUY
17-11-20 10:58,10:58,7943900,9076925,1133025,BUY
17-11-20 10:59,10:59,7821200,9183500,1362300,BUY
17-11-20 11:00,11:00,7860825,9195450,1334625,BUY
17-11-20 11:01,11:01,7811150,9156475,1345325,BUY
17-11-20 11:02,11:02,7846300,9252750,1406450,BUY
17-11-20 11:03,11:03,7792500,9235825,1443325,BUY
17-11-20 11:04,11:04,7912375,9254200,1341825,BUY
17-11-20 11:05,11:05,7839725,9184825,1345100,BUY
17-11-20 11:06,11:06,7859600,9111775,1252175,BUY
17-11-20 11:07,11:07,7925325,9283800,1358475,BUY
17-11-20 11:08,11:08,7881125,9352500,1471375,BUY
17-11-20 11:09,11:09,7897375,9293475,1396100,BUY
17-11-20 11:10,11:10,7916350,9292150,1375800,BUY
17-11-20 11:11,11:11,7906625,9319550,1412925,BUY
17-11-20 11:12,11:12,7867775,9340150,1472375,BUY
17-11-20 11:13,11:13,7867775,9393325,1525550,BUY
17-11-20 11:14,11:14,7877050,9259925,1382875,BUY
17-11-20 11:15,11:15,8004300,9337625,1333325,BUY
17-11-20 11:16,11:16,8092800,9391200,1298400,BUY
17-11-20 11:17,11:17,7896575,9430075,1533500,BUY
17-11-20 11:18,11:18,7993375,9456800,1463425,BUY
17-11-20 11:19,11:19,8078350,9358450,1280100,BUY
17-11-20 11:20,11:20,8038775,9506325,1467550,BUY
17-11-20 11:21,11:21,8112250,9463400,1351150,BUY
17-11-20 11:22,11:22,7997925,9470925,1473000,BUY
17-11-20 11:23,11:23,8032675,9473375,1440700,BUY
17-11-20 11:24,11:24,7972925,9453375,1480450,BUY
17-11-20 11:25,11:25,8051000,9485675,1434675,BUY
17-11-20 11:26,11:26,8043750,9289050,1245300,BUY
17-11-20 11:27,11:27,8028500,9259075,1230575,BUY
17-11-20 11:28,11:28,7977625,9455225,1477600,BUY
17-11-20 11:29,11:29,7976450,9539675,1563225,BUY
17-11-20 11:30,11:30,7996575,9483625,1487050,BUY
17-11-20 11:31,11:31,7996575,9458650,1462075,BUY
17-11-20 11:32,11:32,7930400,9501075,1570675,BUY
17-11-20 11:33,11:33,7918550,9488500,1569950,BUY
17-11-20 11:34,11:34,8062450,9610650,1548200,BUY
17-11-20 11:35,11:35,8109500,9533200,1423700,BUY
17-11-20 11:36,11:36,8092650,9529675,1437025,BUY
17-11-20 11:37,11:37,8030650,9564250,1533600,BUY
17-11-20 11:38,11:38,8040925,9403075,1362150,BUY
17-11-20 11:39,11:39,8028675,9611725,1583050,BUY
17-11-20 11:40,11:40,8040650,9304975,1264325,BUY
17-11-20 11:41,11:41,8074000,9487050,1413050,BUY
17-11-20 11:42,11:42,8212025,9581825,1369800,BUY
17-11-20 11:43,11:43,8139900,9563200,1423300,BUY
17-11-20 11:44,11:44,8089550,9640125,1550575,BUY
17-11-20 11:45,11:45,8098375,9632825,1534450,BUY
17-11-20 11:46,11:46,7972350,9435400,1463050,BUY
17-11-20 11:47,11:47,8089950,9480175,1390225,BUY
17-11-20 11:48,11:48,8020225,9445100,1424875,BUY
17-11-20 11:49,11:49,7996450,9649950,1653500,BUY
17-11-20 11:50,11:50,7978600,9650300,1671700,BUY
17-11-20 11:51,11:51,8093225,9669875,1576650,BUY
17-11-20 11:52,11:52,8064125,9691950,1627825,BUY
17-11-20 11:53,11:53,8073950,9374225,1300275,BUY
17-11-20 11:54,11:54,8099250,9095950,996700,BUY
17-11-20 11:55,11:55,8096550,9653875,1557325,BUY
17-11-20 11:56,11:56,8084150,9687825,1603675,BUY
17-11-20 11:57,11:57,8008275,9412075,1403800,BUY
17-11-20 11:58,11:58,8043675,9635925,1592250,BUY
17-11-20 11:59,11:59,8133050,9577700,1444650,BUY
17-11-20 12:00,12:00,7999275,9560275,1561000,BUY
17-11-20 12:01,12:01,7874475,9215650,1341175,BUY
17-11-20 12:02,12:02,8104950,9626275,1521325,BUY
17-11-20 12:03,12:03,8101575,9525550,1423975,BUY
17-11-20 12:04,12:04,8132925,9394000,1261075,BUY
17-11-20 12:05,12:05,8190350,9473900,1283550,BUY
17-11-20 12:06,12:06,8119875,9411925,1292050,BUY
17-11-20 12:07,12:07,7913125,9629125,1716000,BUY
17-11-20 12:08,12:08,8034925,9310925,1276000,BUY
17-11-20 12:09,12:09,8068025,9506575,1438550,BUY
17-11-20 12:10,12:10,8178225,9418825,1240600,BUY
17-11-20 12:11,12:11,8092225,9603075,1510850,BUY
17-11-20 12:12,12:12,8177250,9651475,1474225,BUY
17-11-20 12:13,12:13,8162850,9748875,1586025,BUY
17-11-20 12:14,12:14,8169275,9257625,1088350,BUY
17-11-20 12:15,12:15,8234300,9757375,1523075,BUY
17-11-20 12:16,12:16,8141375,9583625,1442250,BUY
17-11-20 12:17,12:17,8304125,9447700,1143575,BUY
17-11-20 12:18,12:18,8199650,9544000,1344350,BUY
17-11-20 12:19,12:19,8300375,9638800,1338425,BUY
17-11-20 12:20,12:20,8295875,9648325,1352450,BUY
17-11-20 12:21,12:21,8215525,9718375,1502850,BUY
17-11-20 12:22,12:22,8257650,9578475,1320825,BUY
17-11-20 12:23,12:23,8183925,9632600,1448675,BUY
17-11-20 12:24,12:24,8342450,9470850,1128400,BUY
17-11-20 12:25,12:25,8187000,9324300,1137300,BUY
17-11-20 12:26,12:26,8287250,9602475,1315225,BUY
17-11-20 12:27,12:27,8290600,9731150,1440550,BUY
17-11-20 12:28,12:28,8303325,9605900,1302575,BUY
17-11-20 12:29,12:29,8408325,9826025,1417700,BUY
17-11-20 12:30,12:30,8392200,9755775,1363575,BUY
17-11-20 12:31,12:31,8377800,9795350,1417550,BUY
17-11-20 12:32,12:32,8242350,9537150,1294800,BUY
17-11-20 12:33,12:33,8127650,9234075,1106425,BUY
17-11-20 12:34,12:34,8243625,9578425,1334800,BUY
17-11-20 12:35,12:35,8346875,9699600,1352725,BUY
17-11-20 12:36,12:36,8331325,9598525,1267200,BUY
17-11-20 12:37,12:37,8204200,9607100,1402900,BUY
17-11-20 12:38,12:38,8472375,9802600,1330225,BUY
17-11-20 12:39,12:39,8423275,9649350,1226075,BUY
17-11-20 12:40,12:40,8405075,9754500,1349425,BUY
17-11-20 12:41,12:41,8241400,9469550,1228150,BUY
17-11-20 12:42,12:42,8277600,9404625,1127025,BUY
17-11-20 12:43,12:43,8230775,9549650,1318875,BUY
17-11-20 12:44,12:44,8401950,9213825,811875,BUY
17-11-20 12:45,12:45,8418650,9578425,1159775,BUY
17-11-20 12:46,12:46,8318825,9586075,1267250,BUY
17-11-20 12:47,12:47,8482000,9633950,1151950,BUY
17-11-20 12:48,12:48,8375575,9629200,1253625,BUY
17-11-20 12:49,12:49,8343075,9464175,1121100,BUY
17-11-20 12:50,12:50,8408300,9575625,1167325,BUY
17-11-20 12:51,12:51,8458200,9510600,1052400,BUY
17-11-20 12:52,12:52,8403625,9632300,1228675,BUY
17-11-20 12:53,12:53,8465200,9239250,774050,BUY
17-11-20 12:54,12:54,8466500,9693200,1226700,BUY
17-11-20 12:55,12:55,8431200,9741500,1310300,BUY
17-11-20 12:56,12:56,8474525,9676550,1202025,BUY
17-11-20 12:57,12:57,8540325,9590625,1050300,BUY
17-11-20 12:58,12:58,8411575,9849000,1437425,BUY
17-11-20 12:59,12:59,8499500,9756175,1256675,BUY
17-11-20 13:00,13:00,8447250,9819025,1371775,BUY
17-11-20 13:01,13:01,8629350,9862700,1233350,BUY
17-11-20 13:02,13:02,8546225,9860100,1313875,BUY
17-11-20 13:03,13:03,8481475,9854275,1372800,BUY
17-11-20 13:04,13:04,8535075,9714750,1179675,BUY
17-11-20 13:05,13:05,8571625,9963150,1391525,BUY
17-11-20 13:06,13:06,8434550,9922050,1487500,BUY
17-11-20 13:07,13:07,8624750,9993350,1368600,BUY
17-11-20 13:08,13:08,8466525,9873700,1407175,BUY
17-11-20 13:09,13:09,8596875,9968300,1371425,BUY
17-11-20 13:10,13:10,8607050,9831425,1224375,BUY
17-11-20 13:11,13:11,8580325,9880675,1300350,BUY
17-11-20 13:12,13:12,8479200,9458200,979000,BUY
17-11-20 13:13,13:13,8518525,9790525,1272000,BUY
17-11-20 13:14,13:14,8409025,9721150,1312125,BUY
17-11-20 13:15,13:15,8554550,9863825,1309275,BUY
17-11-20 13:16,13:16,8601025,9936600,1335575,BUY
17-11-20 13:17,13:17,8564575,10000550,1435975,BUY
17-11-20 13:18,13:18,8530725,9792225,1261500,BUY
17-11-20 13:19,13:19,8627925,10087375,1459450,BUY
17-11-20 13:20,13:20,8667800,9684450,1016650,BUY
17-11-20 13:21,13:21,8637300,10140750,1503450,BUY
17-11-20 13:22,13:22,8584800,9977050,1392250,BUY
17-11-20 13:23,13:23,8639200,10010500,1371300,BUY
17-11-20 13:24,13:24,8485075,9764900,1279825,BUY
17-11-20 13:25,13:25,8596475,9774225,1177750,BUY
17-11-20 13:26,13:26,8600475,9928250,1327775,BUY
17-11-20 13:27,13:27,8484700,9783150,1298450,BUY
17-11-20 13:28,13:28,8556050,9866175,1310125,BUY
17-11-20 13:29,13:29,8613925,9835100,1221175,BUY
17-11-20 13:30,13:30,8656750,10225150,1568400,BUY
17-11-20 13:31,13:31,8628325,10284850,1656525,BUY
17-11-20 13:32,13:32,8706825,10252325,1545500,BUY
17-11-20 13:33,13:33,8586750,10240850,1654100,BUY
17-11-20 13:34,13:34,8528175,10166525,1638350,BUY
17-11-20 13:35,13:35,8628025,10271400,1643375,BUY
17-11-20 13:36,13:36,8592525,10283225,1690700,BUY
17-11-20 13:37,13:37,8506200,10090500,1584300,BUY
17-11-20 13:38,13:38,8483775,10184075,1700300,BUY
17-11-20 13:39,13:39,8538425,10302075,1763650,BUY
17-11-20 13:40,13:40,8562725,10380000,1817275,BUY
17-11-20 13:41,13:41,8392975,10406000,2013025,BUY
17-11-20 13:42,13:42,8486500,10410450,1923950,BUY
17-11-20 13:43,13:43,8450650,10004375,1553725,BUY
17-11-20 13:44,13:44,8491625,10398625,1907000,BUY
17-11-20 13:45,13:45,8561550,10400550,1839000,BUY
17-11-20 13:46,13:46,8475300,10171950,1696650,BUY
17-11-20 13:47,13:47,8478650,10272975,1794325,BUY
17-11-20 13:48,13:48,8488700,10364950,1876250,BUY
17-11-20 13:49,13:49,8532450,9937075,1404625,BUY
17-11-20 13:50,13:50,8624775,10495675,1870900,BUY
17-11-20 13:51,13:51,8570950,10493400,1922450,BUY
17-11-20 13:52,13:52,8525400,10496475,1971075,BUY
17-11-20 13:53,13:53,8478825,9946575,1467750,BUY
17-11-20 13:54,13:54,8394850,10089175,1694325,BUY
17-11-20 13:55,13:55,8579075,10328200,1749125,BUY
17-11-20 13:56,13:56,8492925,10074800,1581875,BUY
17-11-20 13:57,13:57,8465525,10323225,1857700,BUY
17-11-20 13:58,13:58,8414025,10284600,1870575,BUY
17-11-20 13:59,13:59,8541300,10532350,1991050,BUY
17-11-20 14:00,14:00,8646125,10597550,1951425,BUY
17-11-20 14:01,14:01,8611775,10568325,1956550,BUY
17-11-20 14:02,14:02,8588075,10581125,1993050,BUY
17-11-20 14:03,14:03,8307550,10516325,2208775,BUY
17-11-20 14:04,14:04,8340200,10268700,1928500,BUY
17-11-20 14:05,14:05,8271100,10500650,2229550,BUY
17-11-20 14:06,14:06,8351150,10578750,2227600,BUY
17-11-20 14:07,14:07,8280950,10646725,2365775,BUY
17-11-20 14:08,14:08,8271275,10588925,2317650,BUY
17-11-20 14:09,14:09,8295050,10013625,1718575,BUY
17-11-20 14:10,14:10,8445275,10588700,2143425,BUY
17-11-20 14:11,14:11,8440175,10744825,2304650,BUY
17-11-20 14:12,14:12,8322425,10523725,2201300,BUY
17-11-20 14:13,14:13,8280125,10429900,2149775,BUY
17-11-20 14:14,14:14,8347825,10598850,2251025,BUY
17-11-20 14:15,14:15,8321050,10717075,2396025,BUY
17-11-20 14:16,14:16,8309875,10754875,2445000,BUY
17-11-20 14:17,14:17,8270775,10689925,2419150,BUY
17-11-20 14:18,14:18,8309000,10419950,2110950,BUY
17-11-20 14:19,14:19,8321550,10637200,2315650,BUY
17-11-20 14:20,14:20,8337275,10522200,2184925,BUY
17-11-20 14:21,14:21,8354575,10670600,2316025,BUY
17-11-20 14:22,14:22,8267375,10159375,1892000,BUY
17-11-20 14:23,14:23,8362650,10254325,1891675,BUY
17-11-20 14:24,14:24,8304125,10785350,2481225,BUY
17-11-20 14:25,14:25,8319150,10817800,2498650,BUY
17-11-20 14:26,14:26,8311850,10732500,2420650,BUY
17-11-20 14:27,14:27,8346325,10797875,2451550,BUY
17-11-20 14:28,14:28,8346100,10828800,2482700,BUY
17-11-20 14:29,14:29,8240600,10735375,2494775,BUY
17-11-20 14:30,14:30,8322175,10787625,2465450,BUY
17-11-20 14:31,14:31,8318400,10742800,2424400,BUY
17-11-20 14:32,14:32,8344675,10759100,2414425,BUY
17-11-20 14:33,14:33,8324575,10763575,2439000,BUY
17-11-20 14:34,14:34,8350775,10842875,2492100,BUY
17-11-20 14:35,14:35,8324575,10828800,2504225,BUY
17-11-20 14:36,14:36,8391750,10954225,2562475,BUY
17-11-20 14:37,14:37,8465550,10918950,2453400,BUY
17-11-20 14:38,14:38,8496200,10941050,2444850,BUY
17-11-20 14:39,14:39,8550300,10977100,2426800,BUY
17-11-20 14:40,14:40,8448800,10963000,2514200,BUY
17-11-20 14:41,14:41,8491475,10886775,2395300,BUY
17-11-20 14:42,14:42,8268425,10833075,2564650,BUY
17-11-20 14:43,14:43,8277000,10875250,2598250,BUY
17-11-20 14:44,14:44,8279225,10870700,2591475,BUY
17-11-20 14:45,14:45,8338675,10977300,2638625,BUY
17-11-20 14:46,14:46,8267500,10962675,2695175,BUY
17-11-20 14:47,14:47,8361075,10974900,2613825,BUY
17-11-20 14:48,14:48,8196225,11012700,2816475,BUY
17-11-20 14:49,14:49,8281050,11010550,2729500,BUY
17-11-20 14:50,14:50,8270225,10895125,2624900,BUY
17-11-20 14:51,14:51,8263775,10666750,2402975,BUY
17-11-20 14:52,14:52,8263875,10781300,2517425,BUY
17-11-20 14:53,14:53,8217850,10605075,2387225,BUY
17-11-20 14:54,14:54,8177350,10776750,2599400,BUY
17-11-20 14:55,14:55,8281650,10610325,2328675,BUY
17-11-20 14:56,14:56,8241575,10672875,2431300,BUY
17-11-20 14:57,14:57,8316475,10784425,2467950,BUY
17-11-20 14:58,14:58,8279200,10800500,2521300,BUY
17-11-20 14:59,14:59,8255325,10738775,2483450,BUY
17-11-20 15:00,15:00,7904975,10671050,2766075,BUY
17-11-20 15:01,15:01,7906875,10674575,2767700,BUY
17-11-20 15:02,15:02,7891875,10700075,2808200,BUY
17-11-20 15:03,15:03,7727750,10643925,2916175,BUY
17-11-20 15:04,15:04,7774525,10701325,2926800,BUY
17-11-20 15:05,15:05,7781825,10675775,2893950,BUY
17-11-20 15:06,15:06,7659050,10557450,2898400,BUY
17-11-20 15:07,15:07,7695825,10551300,2855475,BUY
17-11-20 15:08,15:08,7739650,10500900,2761250,BUY
17-11-20 15:09,15:09,7584250,10339475,2755225,BUY
17-11-20 15:10,15:10,7587250,10430250,2843000,BUY
17-11-20 15:11,15:11,7618250,10424225,2805975,BUY
17-11-20 15:12,15:12,7566075,10386325,2820250,BUY
17-11-20 15:13,15:13,7602650,10383975,2781325,BUY
17-11-20 15:14,15:14,7521750,10391375,2869625,BUY
17-11-20 15:15,15:15,7506025,10376875,2870850,BUY
17-11-20 15:16,15:16,7483525,10399225,2915700,BUY
17-11-20 15:17,15:17,7443450,10396575,2953125,BUY
17-11-20 15:18,15:18,7264475,10017625,2753150,BUY
17-11-20 15:19,15:19,7272400,10117250,2844850,BUY
17-11-20 15:20,15:20,7253775,10116900,2863125,BUY
17-11-20 15:21,15:21,7161050,9905625,2744575,BUY
17-11-20 15:22,15:22,7155000,9902500,2747500,BUY
17-11-20 15:23,15:23,7122400,9725925,2603525,BUY
17-11-20 15:24,15:24,6905875,9820000,2914125,BUY
17-11-20 15:25,15:25,6934600,9759950,2825350,BUY
17-11-20 15:26,15:26,6913125,9787200,2874075,BUY
17-11-20 15:27,15:27,6870575,9769525,2898950,BUY
17-11-20 15:28,15:28,6865675,9789125,2923450,BUY
17-11-20 15:29,15:29,6908675,9786475,2877800,BUY
18-11-20 9:15,9:15,6726450,9473725,2747275,BUY
18-11-20 9:16,9:16,6688050,9501875,2813825,BUY
18-11-20 9:17,9:17,6829325,9628875,2799550,BUY
18-11-20 9:18,9:18,6832425,9631475,2799050,BUY
18-11-20 9:19,9:19,6824700,9617925,2793225,BUY
18-11-20 9:20,9:20,6936975,9780850,2843875,BUY
18-11-20 9:21,9:21,6994600,9840950,2846350,BUY
18-11-20 9:22,9:22,6990025,9798150,2808125,BUY
18-11-20 9:23,9:23,7181875,9934325,2752450,BUY
18-11-20 9:24,9:24,7038825,9946900,2908075,BUY
18-11-20 9:25,9:25,7172500,9841325,2668825,BUY
18-11-20 9:26,9:26,7445250,10154875,2709625,BUY
18-11-20 9:27,9:27,7534925,10110400,2575475,BUY
18-11-20 9:28,9:28,7523275,10099775,2576500,BUY
18-11-20 9:29,9:29,7908750,10533750,2625000,BUY
18-11-20 9:30,9:30,7874100,10401950,2527850,BUY
18-11-20 9:31,9:31,7923750,10524550,2600800,BUY
18-11-20 9:32,9:32,7998300,10850775,2852475,BUY
18-11-20 9:33,9:33,8018650,10829500,2810850,BUY
18-11-20 9:34,9:34,8025750,10820200,2794450,BUY
18-11-20 9:35,9:35,8243075,11139150,2896075,BUY
18-11-20 9:36,9:36,8231225,11324900,3093675,BUY
18-11-20 9:37,9:37,8137575,11288675,3151100,BUY
18-11-20 9:38,9:38,8324325,11562750,3238425,BUY
18-11-20 9:39,9:39,8459650,11557400,3097750,BUY
18-11-20 9:40,9:40,8346925,11581100,3234175,BUY
18-11-20 9:41,9:41,8518550,11774250,3255700,BUY
18-11-20 9:42,9:42,8582600,11731700,3149100,BUY
18-11-20 9:43,9:43,8475875,11758825,3282950,BUY
18-11-20 9:44,9:44,8839975,11730425,2890450,BUY
18-11-20 9:45,9:45,8851500,11857700,3006200,BUY
18-11-20 9:46,9:46,8847350,11718550,2871200,BUY
18-11-20 9:47,9:47,8810275,11652100,2841825,BUY
18-11-20 9:48,9:48,8758075,11710050,2951975,BUY
18-11-20 9:49,9:49,8930075,11711925,2781850,BUY
18-11-20 9:50,9:50,9028650,12062400,3033750,BUY
18-11-20 9:51,9:51,9083050,12134725,3051675,BUY
18-11-20 9:52,9:52,8990225,12114575,3124350,BUY
18-11-20 9:53,9:53,8830925,11986725,3155800,BUY
18-11-20 9:54,9:54,8874925,12210625,3335700,BUY
18-11-20 9:55,9:55,8906075,12215550,3309475,BUY
18-11-20 9:56,9:56,8818025,12014025,3196000,BUY
18-11-20 9:57,9:57,8862825,12248200,3385375,BUY
18-11-20 9:58,9:58,8901600,12399100,3497500,BUY
18-11-20 9:59,9:59,9025150,12449325,3424175,BUY
18-11-20 10:00,10:00,9000600,12489675,3489075,BUY
18-11-20 10:01,10:01,9158150,12484600,3326450,BUY
18-11-20 10:02,10:02,8994850,12580450,3585600,BUY
18-11-20 10:03,10:03,8931225,12523050,3591825,BUY
18-11-20 10:04,10:04,9033175,12426300,3393125,BUY
18-11-20 10:05,10:05,9120850,12478550,3357700,BUY
18-11-20 10:06,10:06,9032475,12154600,3122125,BUY
18-11-20 10:07,10:07,9079725,12653400,3573675,BUY
18-11-20 10:08,10:08,9250975,12732650,3481675,BUY
18-11-20 10:09,10:09,9196650,12604950,3408300,BUY
18-11-20 10:10,10:10,9225600,12647550,3421950,BUY
18-11-20 10:11,10:11,9202000,12700600,3498600,BUY
18-11-20 10:12,10:12,9243575,12743125,3499550,BUY
18-11-20 10:13,10:13,9241800,12763025,3521225,BUY
18-11-20 10:14,10:14,9333925,12841975,3508050,BUY
18-11-20 10:15,10:15,9399200,12873200,3474000,BUY
18-11-20 10:16,10:16,9148225,12551825,3403600,BUY
18-11-20 10:17,10:17,9353075,12881325,3528250,BUY
18-11-20 10:18,10:18,9316300,12770325,3454025,BUY
18-11-20 10:19,10:19,9346375,12848875,3502500,BUY
18-11-20 10:20,10:20,9483850,12758200,3274350,BUY
18-11-20 10:21,10:21,9396850,12385050,2988200,BUY
18-11-20 10:22,10:22,9457300,12698550,3241250,BUY
18-11-20 10:23,10:23,9184300,12809225,3624925,BUY
18-11-20 10:24,10:24,9284525,12634875,3350350,BUY
18-11-20 10:25,10:25,9332450,12964500,3632050,BUY
18-11-20 10:26,10:26,9395000,12953050,3558050,BUY
18-11-20 10:27,10:27,9480675,12804500,3323825,BUY
18-11-20 10:28,10:28,9396900,12742250,3345350,BUY
18-11-20 10:29,10:29,9265000,12674600,3409600,BUY
18-11-20 10:30,10:30,9161800,12502300,3340500,BUY
18-11-20 10:31,10:31,9364250,12694875,3330625,BUY
18-11-20 10:32,10:32,9428550,13009325,3580775,BUY
18-11-20 10:33,10:33,9462750,12802650,3339900,BUY
18-11-20 10:34,10:34,9386050,12710200,3324150,BUY
18-11-20 10:35,10:35,9520650,12904175,3383525,BUY
18-11-20 10:36,10:36,9526200,12804100,3277900,BUY
18-11-20 10:37,10:37,9472425,12969100,3496675,BUY
18-11-20 10:38,10:38,9506650,13038950,3532300,BUY
18-11-20 10:39,10:39,9427125,12755000,3327875,BUY
18-11-20 10:40,10:40,9398575,12747050,3348475,BUY
18-11-20 10:41,10:41,9548750,13078975,3530225,BUY
18-11-20 10:42,10:42,9553200,13070625,3517425,BUY
18-11-20 10:43,10:43,9441250,12857850,3416600,BUY
18-11-20 10:44,10:44,9474775,12990825,3516050,BUY
18-11-20 10:45,10:45,9447950,13084975,3637025,BUY
18-11-20 10:46,10:46,9399125,13142225,3743100,BUY
18-11-20 10:47,10:47,9361650,12615525,3253875,BUY
18-11-20 10:48,10:48,9488725,12206225,2717500,BUY
18-11-20 10:49,10:49,9430450,13094950,3664500,BUY
18-11-20 10:50,10:50,9370575,13068525,3697950,BUY
18-11-20 10:51,10:51,9410525,12969000,3558475,BUY
18-11-20 10:52,10:52,9436800,13077800,3641000,BUY
18-11-20 10:53,10:53,9481000,12872350,3391350,BUY
18-11-20 10:54,10:54,9441275,12906525,3465250,BUY
18-11-20 10:55,10:55,9472150,13039550,3567400,BUY
18-11-20 10:56,10:56,9519225,12978375,3459150,BUY
18-11-20 10:57,10:57,9577200,12713275,3136075,BUY
18-11-20 10:58,10:58,9466175,13042000,3575825,BUY
18-11-20 10:59,10:59,9423775,12792325,3368550,BUY
18-11-20 11:00,11:00,9450925,12870575,3419650,BUY
18-11-20 11:01,11:01,9635425,12490600,2855175,BUY
18-11-20 11:02,11:02,9647125,12569500,2922375,BUY
18-11-20 11:03,11:03,9677950,12302800,2624850,BUY
18-11-20 11:04,11:04,9753200,12963850,3210650,BUY
18-11-20 11:05,11:05,9786500,13202175,3415675,BUY
18-11-20 11:06,11:06,9799675,13120200,3320525,BUY
18-11-20 11:07,11:07,9827925,13142225,3314300,BUY
18-11-20 11:08,11:08,9757300,12662050,2904750,BUY
18-11-20 11:09,11:09,9838200,13229400,3391200,BUY
18-11-20 11:10,11:10,9888525,13154975,3266450,BUY
18-11-20 11:11,11:11,9706125,12951550,3245425,BUY
18-11-20 11:12,11:12,9780375,13158825,3378450,BUY
18-11-20 11:13,11:13,9756850,12835700,3078850,BUY
18-11-20 11:14,11:14,9734650,12943425,3208775,BUY
18-11-20 11:15,11:15,9792250,12981200,3188950,BUY
18-11-20 11:16,11:16,9680100,12956125,3276025,BUY
18-11-20 11:17,11:17,9831075,12835925,3004850,BUY
18-11-20 11:18,11:18,9933575,12820500,2886925,BUY
18-11-20 11:19,11:19,9912100,12839975,2927875,BUY
18-11-20 11:20,11:20,10012075,12840050,2827975,BUY
18-11-20 11:21,11:21,9950875,13020500,3069625,BUY
18-11-20 11:22,11:22,9975200,12786575,2811375,BUY
18-11-20 11:23,11:23,9845100,12820150,2975050,BUY
18-11-20 11:24,11:24,9852375,12931850,3079475,BUY
18-11-20 11:25,11:25,9824025,12853025,3029000,BUY
18-11-20 11:26,11:26,9804775,12591650,2786875,BUY
18-11-20 11:27,11:27,9912950,12837025,2924075,BUY
18-11-20 11:28,11:28,9837400,12966300,3128900,BUY
18-11-20 11:29,11:29,9876475,12868450,2991975,BUY
18-11-20 11:30,11:30,9887475,12760550,2873075,BUY
18-11-20 11:31,11:31,9829075,12734625,2905550,BUY
18-11-20 11:32,11:32,9894000,12942400,3048400,BUY
18-11-20 11:33,11:33,9990300,12827425,2837125,BUY
18-11-20 11:34,11:34,10044925,12724900,2679975,BUY
18-11-20 11:35,11:35,10019375,12720550,2701175,BUY
18-11-20 11:36,11:36,9934675,12572000,2637325,BUY
18-11-20 11:37,11:37,9934675,12535275,2600600,BUY
18-11-20 11:38,11:38,9795075,12827225,3032150,BUY
18-11-20 11:39,11:39,10093525,12996575,2903050,BUY
18-11-20 11:40,11:40,10033000,13041200,3008200,BUY
18-11-20 11:41,11:41,9808475,12809325,3000850,BUY
18-11-20 11:42,11:42,9969175,13002075,3032900,BUY
18-11-20 11:43,11:43,9920200,11999925,2079725,BUY
18-11-20 11:44,11:44,10014475,12813450,2798975,BUY
18-11-20 11:45,11:45,10155925,12879050,2723125,BUY
18-11-20 11:46,11:46,10120275,12692025,2571750,BUY
18-11-20 11:47,11:47,9905025,12952450,3047425,BUY
18-11-20 11:48,11:48,10010200,12797650,2787450,BUY
18-11-20 11:49,11:49,9855525,12824625,2969100,BUY
18-11-20 11:50,11:50,9877000,12638275,2761275,BUY
18-11-20 11:51,11:51,9830375,13098800,3268425,BUY
18-11-20 11:52,11:52,9914175,12729450,2815275,BUY
18-11-20 11:53,11:53,9974050,12820375,2846325,BUY
18-11-20 11:54,11:54,9898525,12931725,3033200,BUY
18-11-20 11:55,11:55,9925300,12710125,2784825,BUY
18-11-20 11:56,11:56,9997850,12788150,2790300,BUY
18-11-20 11:57,11:57,10083275,13033650,2950375,BUY
18-11-20 11:58,11:58,9949275,12838450,2889175,BUY
18-11-20 11:59,11:59,9891825,13032775,3140950,BUY
18-11-20 12:00,12:00,10022100,12943425,2921325,BUY
18-11-20 12:01,12:01,9981350,13024425,3043075,BUY
18-11-20 12:02,12:02,10025825,13028400,3002575,BUY
18-11-20 12:03,12:03,10081525,12952450,2870925,BUY
18-11-20 12:04,12:04,9749375,12921700,3172325,BUY
18-11-20 12:05,12:05,9931525,13060675,3129150,BUY
18-11-20 12:06,12:06,10073450,13042250,2968800,BUY
18-11-20 12:07,12:07,9932825,13028875,3096050,BUY
18-11-20 12:08,12:08,9965725,12620925,2655200,BUY
18-11-20 12:09,12:09,10075575,12527625,2452050,BUY
18-11-20 12:10,12:10,9783300,12464475,2681175,BUY
18-11-20 12:11,12:11,9933375,13243675,3310300,BUY
18-11-20 12:12,12:12,9967650,12478825,2511175,BUY
18-11-20 12:13,12:13,9983700,12712475,2728775,BUY
18-11-20 12:14,12:14,10049300,12867675,2818375,BUY
18-11-20 12:15,12:15,9993250,12278875,2285625,BUY
18-11-20 12:16,12:16,10018075,12832350,2814275,BUY
18-11-20 12:17,12:17,10011425,12503150,2491725,BUY
18-11-20 12:18,12:18,9974350,13004125,3029775,BUY
18-11-20 12:19,12:19,9826725,12757850,2931125,BUY
18-11-20 12:20,12:20,10074375,13171800,3097425,BUY
18-11-20 12:21,12:21,9994775,12639425,2644650,BUY
18-11-20 12:22,12:22,9866850,12629375,2762525,BUY
18-11-20 12:23,12:23,9794100,13109225,3315125,BUY
18-11-20 12:24,12:24,10012475,13136350,3123875,BUY
18-11-20 12:25,12:25,9932250,13161125,3228875,BUY
18-11-20 12:26,12:26,9913375,12859125,2945750,BUY
18-11-20 12:27,12:27,9962350,12883325,2920975,BUY
18-11-20 12:28,12:28,9876675,12889425,3012750,BUY
18-11-20 12:29,12:29,9849400,12867700,3018300,BUY
18-11-20 12:30,12:30,9780575,12914775,3134200,BUY
18-11-20 12:31,12:31,9912025,12925525,3013500,BUY
18-11-20 12:32,12:32,9730325,12467750,2737425,BUY
18-11-20 12:33,12:33,9732650,13004850,3272200,BUY
18-11-20 12:34,12:34,10014075,12994725,2980650,BUY
18-11-20 12:35,12:35,9852325,12966350,3114025,BUY
18-11-20 12:36,12:36,9853950,12757050,2903100,BUY
18-11-20 12:37,12:37,9954850,12879250,2924400,BUY
18-11-20 12:38,12:38,10087550,13092650,3005100,BUY
18-11-20 12:39,12:39,10071125,13060725,2989600,BUY
18-11-20 12:40,12:40,9903575,12948350,3044775,BUY
18-11-20 12:41,12:41,10111400,13150925,3039525,BUY
18-11-20 12:42,12:42,10003125,13187225,3184100,BUY
18-11-20 12:43,12:43,9975250,13084525,3109275,BUY
18-11-20 12:44,12:44,9892850,13192775,3299925,BUY
18-11-20 12:45,12:45,10087650,13187925,3100275,BUY
18-11-20 12:46,12:46,9897400,12874250,2976850,BUY
18-11-20 12:47,12:47,9804100,13060925,3256825,BUY
18-11-20 12:48,12:48,9934000,12345150,2411150,BUY
18-11-20 12:49,12:49,9841800,13198575,3356775,BUY
18-11-20 12:50,12:50,10083775,13294500,3210725,BUY
18-11-20 12:51,12:51,10111175,13269100,3157925,BUY
18-11-20 12:52,12:52,10083100,13299325,3216225,BUY
18-11-20 12:53,12:53,10070925,13207225,3136300,BUY
18-11-20 12:54,12:54,9680075,12827350,3147275,BUY
18-11-20 12:55,12:55,9683125,12981700,3298575,BUY
18-11-20 12:56,12:56,9590750,13136650,3545900,BUY
18-11-20 12:57,12:57,9614400,13114300,3499900,BUY
18-11-20 12:58,12:58,9521325,13062175,3540850,BUY
18-11-20 12:59,12:59,9665650,13155200,3489550,BUY
18-11-20 13:00,13:00,9753150,13027950,3274800,BUY
18-11-20 13:01,13:01,9683875,13078400,3394525,BUY
18-11-20 13:02,13:02,9755225,13260775,3505550,BUY
18-11-20 13:03,13:03,9781725,13306575,3524850,BUY
18-11-20 13:04,13:04,9823025,13199925,3376900,BUY
18-11-20 13:05,13:05,9857225,13304150,3446925,BUY
18-11-20 13:06,13:06,9517425,13083475,3566050,BUY
18-11-20 13:07,13:07,9537375,12779300,3241925,BUY
18-11-20 13:08,13:08,9491950,12909200,3417250,BUY
18-11-20 13:09,13:09,9544725,12880250,3335525,BUY
18-11-20 13:10,13:10,9543525,12978625,3435100,BUY
18-11-20 13:11,13:11,9513900,12875275,3361375,BUY
18-11-20 13:12,13:12,9464350,12503850,3039500,BUY
18-11-20 13:13,13:13,9440900,12476200,3035300,BUY
18-11-20 13:14,13:14,9362325,12703375,3341050,BUY
18-11-20 13:15,13:15,9534025,12515175,2981150,BUY
18-11-20 13:16,13:16,9480850,12914625,3433775,BUY
18-11-20 13:17,13:17,9454025,12730625,3276600,BUY
18-11-20 13:18,13:18,9410800,12892400,3481600,BUY
18-11-20 13:19,13:19,9420775,12635525,3214750,BUY
18-11-20 13:20,13:20,9446125,12306000,2859875,BUY
18-11-20 13:21,13:21,9411700,12715175,3303475,BUY
18-11-20 13:22,13:22,9468375,12665275,3196900,BUY
18-11-20 13:23,13:23,9566875,12865550,3298675,BUY
18-11-20 13:24,13:24,9416250,12777575,3361325,BUY
18-11-20 13:25,13:25,9368750,12390325,3021575,BUY
18-11-20 13:26,13:26,9451700,12694100,3242400,BUY
18-11-20 13:27,13:27,9360650,12625175,3264525,BUY
18-11-20 13:28,13:28,9458875,12676625,3217750,BUY
18-11-20 13:29,13:29,9466925,12410425,2943500,BUY
18-11-20 13:30,13:30,9333900,12789000,3455100,BUY
18-11-20 13:31,13:31,9283950,12747175,3463225,BUY
18-11-20 13:32,13:32,9150700,12748700,3598000,BUY
18-11-20 13:33,13:33,9130100,12304775,3174675,BUY
18-11-20 13:34,13:34,9260025,12418425,3158400,BUY
18-11-20 13:35,13:35,9288450,12644750,3356300,BUY
18-11-20 13:36,13:36,9409350,12383600,2974250,BUY
18-11-20 13:37,13:37,9305550,12630100,3324550,BUY
18-11-20 13:38,13:38,9436375,12563175,3126800,BUY
18-11-20 13:39,13:39,9036925,12472900,3435975,BUY
18-11-20 13:40,13:40,9195575,12698075,3502500,BUY
18-11-20 13:41,13:41,9134850,12788025,3653175,BUY
18-11-20 13:42,13:42,8489000,12587750,4098750,BUY
18-11-20 13:43,13:43,8479075,12730450,4251375,BUY
18-11-20 13:44,13:44,8455000,12686900,4231900,BUY
18-11-20 13:45,13:45,8544775,12580800,4036025,BUY
18-11-20 13:46,13:46,8528975,12608225,4079250,BUY
18-11-20 13:47,13:47,8560350,12556950,3996600,BUY
18-11-20 13:48,13:48,8180850,12660250,4479400,BUY
18-11-20 13:49,13:49,8211025,12442625,4231600,BUY
18-11-20 13:50,13:50,8178300,12577425,4399125,BUY
18-11-20 13:51,13:51,8147125,12613825,4466700,BUY
18-11-20 13:52,13:52,8089325,12157375,4068050,BUY
18-11-20 13:53,13:53,8182900,12537950,4355050,BUY
18-11-20 13:54,13:54,8121125,12306200,4185075,BUY
18-11-20 13:55,13:55,8149475,12443200,4293725,BUY
18-11-20 13:56,13:56,8084425,12574225,4489800,BUY
18-11-20 13:57,13:57,8096050,12349800,4253750,BUY
18-11-20 13:58,13:58,8133650,12562725,4429075,BUY
18-11-20 13:59,13:59,8165950,12521950,4356000,BUY
18-11-20 14:00,14:00,7982275,12635875,4653600,BUY
18-11-20 14:01,14:01,7930050,12601725,4671675,BUY
18-11-20 14:02,14:02,8010800,12636950,4626150,BUY
18-11-20 14:03,14:03,7700650,12434050,4733400,BUY
18-11-20 14:04,14:04,7656525,12365775,4709250,BUY
18-11-20 14:05,14:05,7603900,12358300,4754400,BUY
18-11-20 14:06,14:06,7698725,12138050,4439325,BUY
18-11-20 14:07,14:07,7797850,12180200,4382350,BUY
18-11-20 14:08,14:08,7775950,12186575,4410625,BUY
18-11-20 14:09,14:09,7815950,12090125,4274175,BUY
18-11-20 14:10,14:10,7889700,12154600,4264900,BUY
18-11-20 14:11,14:11,7892100,12121900,4229800,BUY
18-11-20 14:12,14:12,7724100,12060825,4336725,BUY
18-11-20 14:13,14:13,7803250,12087675,4284425,BUY
18-11-20 14:14,14:14,7803250,11942900,4139650,BUY
18-11-20 14:15,14:15,7779650,11855625,4075975,BUY
18-11-20 14:16,14:16,7787250,11766625,3979375,BUY
18-11-20 14:17,14:17,7825700,11988450,4162750,BUY
18-11-20 14:18,14:18,7848150,11739000,3890850,BUY
18-11-20 14:19,14:19,7902800,11759275,3856475,BUY
18-11-20 14:20,14:20,7905700,11717950,3812250,BUY
18-11-20 14:21,14:21,8013875,11593175,3579300,BUY
18-11-20 14:22,14:22,8006500,11572675,3566175,BUY
18-11-20 14:23,14:23,8036450,11648350,3611900,BUY
18-11-20 14:24,14:24,7890375,11448450,3558075,BUY
18-11-20 14:25,14:25,7998225,11611275,3613050,BUY
18-11-20 14:26,14:26,7872125,11533100,3660975,BUY
18-11-20 14:27,14:27,7812725,11463875,3651150,BUY
18-11-20 14:28,14:28,7978150,11524050,3545900,BUY
18-11-20 14:29,14:29,7863275,11286975,3423700,BUY
18-11-20 14:30,14:30,7991350,11210400,3219050,BUY
18-11-20 14:31,14:31,7976625,11438575,3461950,BUY
18-11-20 14:32,14:32,8066725,11528400,3461675,BUY
18-11-20 14:33,14:33,8030775,11555925,3525150,BUY
18-11-20 14:34,14:34,7944025,11475325,3531300,BUY
18-11-20 14:35,14:35,7956000,11605900,3649900,BUY
18-11-20 14:36,14:36,8011550,11532000,3520450,BUY
18-11-20 14:37,14:37,8085575,11571500,3485925,BUY
18-11-20 14:38,14:38,8048400,11284300,3235900,BUY
18-11-20 14:39,14:39,7831125,11198750,3367625,BUY
18-11-20 14:40,14:40,7854750,11341250,3486500,BUY
18-11-20 14:41,14:41,7872200,11586425,3714225,BUY
18-11-20 14:42,14:42,7739925,11385025,3645100,BUY
18-11-20 14:43,14:43,7843875,11396975,3553100,BUY
18-11-20 14:44,14:44,7817700,11493625,3675925,BUY
18-11-20 14:45,14:45,7752300,11370775,3618475,BUY
18-11-20 14:46,14:46,7769475,11416025,3646550,BUY
18-11-20 14:47,14:47,7778325,11472600,3694275,BUY
18-11-20 14:48,14:48,7885200,11244250,3359050,BUY
18-11-20 14:49,14:49,7840625,11435900,3595275,BUY
18-11-20 14:50,14:50,7852025,11122100,3270075,BUY
18-11-20 14:51,14:51,7774400,11365250,3590850,BUY
18-11-20 14:52,14:52,7794925,11227200,3432275,BUY
18-11-20 14:53,14:53,7753100,11422225,3669125,BUY
18-11-20 14:54,14:54,7626950,11269200,3642250,BUY
18-11-20 14:55,14:55,7587500,11456050,3868550,BUY
18-11-20 14:56,14:56,7679075,11305425,3626350,BUY
18-11-20 14:57,14:57,7517975,11374300,3856325,BUY
18-11-20 14:58,14:58,7631200,11461900,3830700,BUY
18-11-20 14:59,14:59,7628875,11005900,3377025,BUY
18-11-20 15:00,15:00,7501700,11606250,4104550,BUY
18-11-20 15:01,15:01,7526325,11406200,3879875,BUY
18-11-20 15:02,15:02,7557900,11512025,3954125,BUY
18-11-20 15:03,15:03,7500050,11522925,4022875,BUY
18-11-20 15:04,15:04,7490875,11443325,3952450,BUY
18-11-20 15:05,15:05,7459475,11500725,4041250,BUY
18-11-20 15:06,15:06,7123600,10998925,3875325,BUY
18-11-20 15:07,15:07,7177350,11034900,3857550,BUY
18-11-20 15:08,15:08,7115500,11046250,3930750,BUY
18-11-20 15:09,15:09,7189000,10931575,3742575,BUY
18-11-20 15:10,15:10,7029600,10905725,3876125,BUY
18-11-20 15:11,15:11,7026900,10901950,3875050,BUY
18-11-20 15:12,15:12,7068675,10508225,3439550,BUY
18-11-20 15:13,15:13,6924475,10764500,3840025,BUY
18-11-20 15:14,15:14,7053475,10870800,3817325,BUY
18-11-20 15:15,15:15,6969475,10628150,3658675,BUY
18-11-20 15:16,15:16,7000050,10692625,3692575,BUY
18-11-20 15:17,15:17,6954250,10726425,3772175,BUY
18-11-20 15:18,15:18,6861325,10546900,3685575,BUY
18-11-20 15:19,15:19,6817550,10578825,3761275,BUY
18-11-20 15:20,15:20,6869750,10516775,3647025,BUY
18-11-20 15:21,15:21,6657925,10269500,3611575,BUY
18-11-20 15:22,15:22,6689850,10259550,3569700,BUY
18-11-20 15:23,15:23,6626900,10169900,3543000,BUY
18-11-20 15:24,15:24,6657875,10189725,3531850,BUY
18-11-20 15:25,15:25,6645200,9984825,3339625,BUY
18-11-20 15:26,15:26,6543825,10148900,3605075,BUY
18-11-20 15:27,15:27,6496775,10071150,3574375,BUY
18-11-20 15:28,15:28,6526275,10042925,3516650,BUY
18-11-20 15:29,15:29,6537675,10083775,3546100,BUY
19-11-20 9:15,9:15,6340725,9530875,3190150,BUY
19-11-20 9:16,9:16,6290900,9768350,3477450,BUY
19-11-20 9:17,9:17,6449025,9798925,3349900,BUY
19-11-20 9:18,9:18,6451000,9785825,3334825,BUY
19-11-20 9:19,9:19,6484075,9771650,3287575,BUY
19-11-20 9:20,9:20,6687525,9857350,3169825,BUY
19-11-20 9:21,9:21,6721625,9755425,3033800,BUY
19-11-20 9:22,9:22,6726100,9861725,3135625,BUY
19-11-20 9:23,9:23,6811725,9979025,3167300,BUY
19-11-20 9:24,9:24,6847325,10041675,3194350,BUY
19-11-20 9:25,9:25,6820075,9931200,3111125,BUY
19-11-20 9:26,9:26,7144075,10156150,3012075,BUY
19-11-20 9:27,9:27,7178700,10193275,3014575,BUY
19-11-20 9:28,9:28,7075375,10153025,3077650,BUY
19-11-20 9:29,9:29,7544025,10493450,2949425,BUY
19-11-20 9:30,9:30,7550550,10394125,2843575,BUY
19-11-20 9:31,9:31,7468050,10319475,2851425,BUY
19-11-20 9:32,9:32,8232150,10598900,2366750,BUY
19-11-20 9:33,9:33,8106150,10571575,2465425,BUY
19-11-20 9:34,9:34,8038725,10554950,2516225,BUY
19-11-20 9:35,9:35,8812450,10894775,2082325,BUY
19-11-20 9:36,9:36,8761700,10869375,2107675,BUY
19-11-20 9:37,9:37,8676750,10870650,2193900,BUY
19-11-20 9:38,9:38,9057675,11148325,2090650,BUY
19-11-20 9:39,9:39,9068250,11256175,2187925,BUY
19-11-20 9:40,9:40,9091625,10868675,1777050,BUY
19-11-20 9:41,9:41,9553000,11417450,1864450,BUY
19-11-20 9:42,9:42,9529750,11339875,1810125,BUY
19-11-20 9:43,9:43,9536750,11326175,1789425,BUY
19-11-20 9:44,9:44,9710675,11864075,2153400,BUY
19-11-20 9:45,9:45,9799875,11356325,1556450,BUY
19-11-20 9:46,9:46,9789675,11637925,1848250,BUY
19-11-20 9:47,9:47,9911825,12173675,2261850,BUY
19-11-20 9:48,9:48,9976925,12183050,2206125,BUY
19-11-20 9:49,9:49,8523675,9969950,1446275,BUY
19-11-20 9:50,9:50,10275275,12462025,2186750,BUY
19-11-20 9:51,9:51,10223100,12305300,2082200,BUY
19-11-20 9:52,9:52,10223050,12596975,2373925,BUY
19-11-20 9:53,9:53,10608000,12537625,1929625,BUY
19-11-20 9:54,9:54,10608075,12447500,1839425,BUY
19-11-20 9:55,9:55,10465525,12849175,2383650,BUY
19-11-20 9:56,9:56,10878275,12726050,1847775,BUY
19-11-20 9:57,9:57,11048950,12886875,1837925,BUY
19-11-20 9:58,9:58,10887550,13013950,2126400,BUY
19-11-20 9:59,9:59,11236575,13336250,2099675,BUY
19-11-20 10:00,10:00,11168650,13230500,2061850,BUY
19-11-20 10:01,10:01,11402850,13090175,1687325,BUY
19-11-20 10:02,10:02,10898525,13678825,2780300,BUY
19-11-20 10:03,10:03,10872225,13588175,2715950,BUY
19-11-20 10:04,10:04,10863850,13642250,2778400,BUY
19-11-20 10:05,10:05,11210250,13230475,2020225,BUY
19-11-20 10:06,10:06,11088425,13808150,2719725,BUY
19-11-20 10:07,10:07,11121675,13980975,2859300,BUY
19-11-20 10:08,10:08,10947675,14046275,3098600,BUY
19-11-20 10:09,10:09,10896375,13537750,2641375,BUY
19-11-20 10:10,10:10,11074750,13768325,2693575,BUY
19-11-20 10:11,10:11,11251375,14416000,3164625,BUY
19-11-20 10:12,10:12,11112025,13806750,2694725,BUY
19-11-20 10:13,10:13,11024025,14253275,3229250,BUY
19-11-20 10:14,10:14,11184325,13873600,2689275,BUY
19-11-20 10:15,10:15,11219450,14538975,3319525,BUY
19-11-20 10:16,10:16,11179900,14444125,3264225,BUY
19-11-20 10:17,10:17,11525900,14904300,3378400,BUY
19-11-20 10:18,10:18,11573275,14451300,2878025,BUY
19-11-20 10:19,10:19,11554025,14221500,2667475,BUY
19-11-20 10:20,10:20,11933425,15278150,3344725,BUY
19-11-20 10:21,10:21,11882350,15209300,3326950,BUY
19-11-20 10:22,10:22,11502875,14324550,2821675,BUY
19-11-20 10:23,10:23,12135200,14525900,2390700,BUY
19-11-20 10:24,10:24,12137600,15315400,3177800,BUY
19-11-20 10:25,10:25,12004275,14973375,2969100,BUY
19-11-20 10:26,10:26,12897250,15498575,2601325,BUY
19-11-20 10:27,10:27,12737500,15391475,2653975,BUY
19-11-20 10:28,10:28,12897900,15479425,2581525,BUY
19-11-20 10:29,10:29,12819725,16123275,3303550,BUY
19-11-20 10:30,10:30,13001750,16065675,3063925,BUY
19-11-20 10:31,10:31,12899525,16007525,3108000,BUY
19-11-20 10:32,10:32,13308125,16038350,2730225,BUY
19-11-20 10:33,10:33,13320975,15421125,2100150,BUY
19-11-20 10:34,10:34,13392900,16115125,2722225,BUY
19-11-20 10:35,10:35,13526950,16155650,2628700,BUY
19-11-20 10:36,10:36,13218450,15975600,2757150,BUY
19-11-20 10:37,10:37,13492025,16805550,3313525,BUY
19-11-20 10:38,10:38,13901800,17071150,3169350,BUY
19-11-20 10:39,10:39,13776400,15836475,2060075,BUY
19-11-20 10:40,10:40,14165075,16716175,2551100,BUY
19-11-20 10:41,10:41,14212225,16893600,2681375,BUY
19-11-20 10:42,10:42,14192725,16287075,2094350,BUY
19-11-20 10:43,10:43,14322800,16404575,2081775,BUY
19-11-20 10:44,10:44,14288850,16824150,2535300,BUY
19-11-20 10:45,10:45,14322725,16915550,2592825,BUY
19-11-20 10:46,10:46,14319475,16716125,2396650,BUY
19-11-20 10:47,10:47,14176375,16699550,2523175,BUY
19-11-20 10:48,10:48,14267000,16070150,1803150,BUY
19-11-20 10:49,10:49,14214750,16703225,2488475,BUY
19-11-20 10:50,10:50,14611625,16900375,2288750,BUY
19-11-20 10:51,10:51,14658525,16456175,1797650,BUY
19-11-20 10:52,10:52,14652100,16835300,2183200,BUY
19-11-20 10:53,10:53,14757325,16835675,2078350,BUY
19-11-20 10:54,10:54,14724700,15946700,1222000,BUY
19-11-20 10:55,10:55,14730975,16615650,1884675,BUY
19-11-20 10:56,10:56,14391625,15867250,1475625,BUY
19-11-20 10:57,10:57,14614700,15901250,1286550,BUY
19-11-20 10:58,10:58,14761325,16061650,1300325,BUY
19-11-20 10:59,10:59,15021375,16533525,1512150,BUY
19-11-20 11:00,11:00,14915825,16184875,1269050,BUY
19-11-20 11:01,11:01,14911700,15931075,1019375,BUY
19-11-20 11:02,11:02,15202050,15683300,481250,BUY
19-11-20 11:03,11:03,15355000,15493400,138400,BUY
19-11-20 11:04,11:04,15267500,15759200,491700,BUY
19-11-20 11:05,11:05,15220575,15231975,11400,BUY
19-11-20 11:06,11:06,15247225,15949075,701850,BUY
19-11-20 11:07,11:07,15444475,16205500,761025,BUY
19-11-20 11:08,11:08,15708300,16492375,784075,BUY
19-11-20 11:09,11:09,15672050,15958300,286250,BUY
19-11-20 11:10,11:10,15399575,15586225,186650,BUY
19-11-20 11:11,11:11,15884275,15934625,50350,BUY
19-11-20 11:12,11:12,16031100,15410900,-620200,SELL
19-11-20 11:13,11:13,15898900,15253850,-645050,SELL
19-11-20 11:14,11:14,16181625,16092000,-89625,SELL
19-11-20 11:15,11:15,16316600,15877300,-439300,SELL
19-11-20 11:16,11:16,16203350,16018700,-184650,SELL
19-11-20 11:17,11:17,16022650,15938800,-83850,SELL
19-11-20 11:18,11:18,16252400,15703550,-548850,SELL
19-11-20 11:19,11:19,16109675,15230000,-879675,SELL
19-11-20 11:20,11:20,16508725,16508850,125,BUY
19-11-20 11:21,11:21,16628825,16585550,-43275,SELL
19-11-20 11:22,11:22,16646625,16107775,-538850,SELL
19-11-20 11:23,11:23,16684250,15893750,-790500,SELL
19-11-20 11:24,11:24,16718075,15725175,-992900,SELL
19-11-20 11:25,11:25,16519350,16434725,-84625,SELL
19-11-20 11:26,11:26,16801800,16403825,-397975,SELL
19-11-20 11:27,11:27,16827925,16434350,-393575,SELL
19-11-20 11:28,11:28,16690250,16396800,-293450,SELL
19-11-20 11:29,11:29,16838025,16816750,-21275,SELL
19-11-20 11:30,11:30,17010125,15837825,-1172300,SELL
19-11-20 11:31,11:31,16745825,16721200,-24625,SELL
19-11-20 11:32,11:32,16804175,16788550,-15625,SELL
19-11-20 11:33,11:33,16923400,16264025,-659375,SELL
19-11-20 11:34,11:34,16867600,16335075,-532525,SELL
19-11-20 11:35,11:35,17129750,17062800,-66950,SELL
19-11-20 11:36,11:36,16850750,17133000,282250,BUY
19-11-20 11:37,11:37,17148525,16695725,-452800,SELL
19-11-20 11:38,11:38,17164350,17131975,-32375,SELL
19-11-20 11:39,11:39,17150400,16804325,-346075,SELL
19-11-20 11:40,11:40,17115975,17262925,146950,BUY
19-11-20 11:41,11:41,16776950,15949125,-827825,SELL
19-11-20 11:42,11:42,16776175,17568400,792225,BUY
19-11-20 11:43,11:43,16706650,16744900,38250,BUY
19-11-20 11:44,11:44,16863525,16770275,-93250,SELL
19-11-20 11:45,11:45,16783000,17819425,1036425,BUY
19-11-20 11:46,11:46,16852900,17383550,530650,BUY
19-11-20 11:47,11:47,16902200,16609875,-292325,SELL
19-11-20 11:48,11:48,16897225,17739650,842425,BUY
19-11-20 11:49,11:49,16868525,17665550,797025,BUY
19-11-20 11:50,11:50,17185825,16815250,-370575,SELL
19-11-20 11:51,11:51,16985675,16832325,-153350,SELL
19-11-20 11:52,11:52,16896600,17245375,348775,BUY
19-11-20 11:53,11:53,17155850,17548700,392850,BUY
19-11-20 11:54,11:54,17018650,16718375,-300275,SELL
19-11-20 11:55,11:55,17154525,16853425,-301100,SELL
19-11-20 11:56,11:56,17533375,16950950,-582425,SELL
19-11-20 11:57,11:57,17013400,17449425,436025,BUY
19-11-20 11:58,11:58,16986225,17028600,42375,BUY
19-11-20 11:59,11:59,17347450,17165975,-181475,SELL
19-11-20 12:00,12:00,17294675,16747525,-547150,SELL
19-11-20 12:01,12:01,17556725,17632725,76000,BUY
19-11-20 12:02,12:02,17481625,16831575,-650050,SELL
19-11-20 12:03,12:03,17618575,17359050,-259525,SELL
19-11-20 12:04,12:04,17577350,17430575,-146775,SELL
19-11-20 12:05,12:05,17584950,17906625,321675,BUY
19-11-20 12:06,12:06,17470175,17414600,-55575,SELL
19-11-20 12:07,12:07,17030875,18067600,1036725,BUY
19-11-20 12:08,12:08,17431250,18229075,797825,BUY
19-11-20 12:09,12:09,17333300,18088500,755200,BUY
19-11-20 12:10,12:10,17320900,17732300,411400,BUY
19-11-20 12:11,12:11,17372475,17303525,-68950,SELL
19-11-20 12:12,12:12,17558375,18073825,515450,BUY
19-11-20 12:13,12:13,17243300,17159025,-84275,SELL
19-11-20 12:14,12:14,17537650,17584425,46775,BUY
19-11-20 12:15,12:15,17588425,17784450,196025,BUY
19-11-20 12:16,12:16,17657925,17297375,-360550,SELL
19-11-20 12:17,12:17,17523850,18133125,609275,BUY
19-11-20 12:18,12:18,17489800,17201950,-287850,SELL
19-11-20 12:19,12:19,17479975,17775275,295300,BUY
19-11-20 12:20,12:20,17291875,18300000,1008125,BUY
19-11-20 12:21,12:21,17609250,17541625,-67625,SELL
19-11-20 12:22,12:22,17331175,17725500,394325,BUY
19-11-20 12:23,12:23,17381350,17867950,486600,BUY
19-11-20 12:24,12:24,17560200,17051525,-508675,SELL
19-11-20 12:25,12:25,17084775,17120625,35850,BUY
19-11-20 12:26,12:26,17513950,17415725,-98225,SELL
19-11-20 12:27,12:27,17358450,17059700,-298750,SELL
19-11-20 12:28,12:28,17544375,17563875,19500,BUY
19-11-20 12:29,12:29,17288575,18051875,763300,BUY
19-11-20 12:30,12:30,17284925,18374750,1089825,BUY
19-11-20 12:31,12:31,17462400,18329775,867375,BUY
19-11-20 12:32,12:32,17058350,18044200,985850,BUY
19-11-20 12:33,12:33,17710700,18192650,481950,BUY
19-11-20 12:34,12:34,17542975,17914750,371775,BUY
19-11-20 12:35,12:35,17760050,17512250,-247800,SELL
19-11-20 12:36,12:36,17598300,17679450,81150,BUY
19-11-20 12:37,12:37,17598300,17774525,176225,BUY
19-11-20 12:38,12:38,17530600,18145825,615225,BUY
19-11-20 12:39,12:39,17476350,18028350,552000,BUY
19-11-20 12:40,12:40,17340825,18127950,787125,BUY
19-11-20 12:41,12:41,17545050,17651450,106400,BUY
19-11-20 12:42,12:42,17423050,18107375,684325,BUY
19-11-20 12:43,12:43,17199500,17570575,371075,BUY
19-11-20 12:44,12:44,17548950,18329800,780850,BUY
19-11-20 12:45,12:45,17409575,18119475,709900,BUY
19-11-20 12:46,12:46,17622025,17534300,-87725,SELL
19-11-20 12:47,12:47,17512300,18420325,908025,BUY
19-11-20 12:48,12:48,17507400,18609700,1102300,BUY
19-11-20 12:49,12:49,17508550,18226500,717950,BUY
19-11-20 12:50,12:50,17465500,18260375,794875,BUY
19-11-20 12:51,12:51,17206425,18231925,1025500,BUY
19-11-20 12:52,12:52,17806500,18297425,490925,BUY
19-11-20 12:53,12:53,17844525,18147000,302475,BUY
19-11-20 12:54,12:54,17802725,17720150,-82575,SELL
19-11-20 12:55,12:55,17758175,17987150,228975,BUY
19-11-20 12:56,12:56,17800025,18239150,439125,BUY
19-11-20 12:57,12:57,17693150,18339550,646400,BUY
19-11-20 12:58,12:58,17735550,18307350,571800,BUY
19-11-20 12:59,12:59,17836700,18077450,240750,BUY
19-11-20 13:00,13:00,17967625,18424650,457025,BUY
19-11-20 13:01,13:01,17989400,18243775,254375,BUY
19-11-20 13:02,13:02,17809875,18435750,625875,BUY
19-11-20 13:03,13:03,17798025,18123075,325050,BUY
19-11-20 13:04,13:04,17695950,18156550,460600,BUY
19-11-20 13:05,13:05,17798625,17837625,39000,BUY
19-11-20 13:06,13:06,17667525,16985400,-682125,SELL
19-11-20 13:07,13:07,17511225,17308150,-203075,SELL
19-11-20 13:08,13:08,17582000,16740900,-841100,SELL
19-11-20 13:09,13:09,17739500,17571875,-167625,SELL
19-11-20 13:10,13:10,17973175,17382400,-590775,SELL
19-11-20 13:11,13:11,17861350,17431900,-429450,SELL
19-11-20 13:12,13:12,18083100,17183750,-899350,SELL
19-11-20 13:13,13:13,17998750,17948775,-49975,SELL
19-11-20 13:14,13:14,17788550,17566775,-221775,SELL
19-11-20 13:15,13:15,18002025,17708350,-293675,SELL
19-11-20 13:16,13:16,18110525,17796200,-314325,SELL
19-11-20 13:17,13:17,18033525,17736500,-297025,SELL
19-11-20 13:18,13:18,18118300,17251375,-866925,SELL
19-11-20 13:19,13:19,18063500,17637425,-426075,SELL
19-11-20 13:20,13:20,18253075,17746175,-506900,SELL
19-11-20 13:21,13:21,17904950,17470625,-434325,SELL
19-11-20 13:22,13:22,18297150,17665875,-631275,SELL
19-11-20 13:23,13:23,18238975,17814075,-424900,SELL
19-11-20 13:24,13:24,18415650,18197625,-218025,SELL
19-11-20 13:25,13:25,18697100,17794625,-902475,SELL
19-11-20 13:26,13:26,18763925,17973675,-790250,SELL
19-11-20 13:27,13:27,18481925,17530600,-951325,SELL
19-11-20 13:28,13:28,18565200,18118450,-446750,SELL
19-11-20 13:29,13:29,18489825,17491000,-998825,SELL
19-11-20 13:30,13:30,18311425,17599250,-712175,SELL
19-11-20 13:31,13:31,18288675,16530225,-1758450,SELL
19-11-20 13:32,13:32,18232625,16952875,-1279750,SELL
19-11-20 13:33,13:33,18099175,16946125,-1153050,SELL
19-11-20 13:34,13:34,18188975,16924150,-1264825,SELL
19-11-20 13:35,13:35,18123425,17165050,-958375,SELL
19-11-20 13:36,13:36,18465525,17093075,-1372450,SELL
19-11-20 13:37,13:37,18380575,16641950,-1738625,SELL
19-11-20 13:38,13:38,18342050,16826175,-1515875,SELL
19-11-20 13:39,13:39,18451975,17163150,-1288825,SELL
19-11-20 13:40,13:40,18523250,17504500,-1018750,SELL
19-11-20 13:41,13:41,18446400,17259800,-1186600,SELL
19-11-20 13:42,13:42,18456850,16556750,-1900100,SELL
19-11-20 13:43,13:43,18490550,16591225,-1899325,SELL
19-11-20 13:44,13:44,18339900,16517100,-1822800,SELL
19-11-20 13:45,13:45,18587775,16381525,-2206250,SELL
19-11-20 13:46,13:46,18478325,16210325,-2268000,SELL
19-11-20 13:47,13:47,18188800,16182725,-2006075,SELL
19-11-20 13:48,13:48,18530925,15193375,-3337550,SELL
19-11-20 13:49,13:49,18509425,15701650,-2807775,SELL
19-11-20 13:50,13:50,18471200,15003850,-3467350,SELL
19-11-20 13:51,13:51,18543650,15623250,-2920400,SELL
19-11-20 13:52,13:52,18604375,14969125,-3635250,SELL
19-11-20 13:53,13:53,18525425,15599000,-2926425,SELL
19-11-20 13:54,13:54,18508525,15497300,-3011225,SELL
19-11-20 13:55,13:55,18604125,15618950,-2985175,SELL
19-11-20 13:56,13:56,18557725,15439950,-3117775,SELL
19-11-20 13:57,13:57,18558850,15800350,-2758500,SELL
19-11-20 13:58,13:58,18564775,15070650,-3494125,SELL
19-11-20 13:59,13:59,18457375,15617250,-2840125,SELL
19-11-20 14:00,14:00,18638000,15116075,-3521925,SELL
19-11-20 14:01,14:01,18676550,16007425,-2669125,SELL
19-11-20 14:02,14:02,18794075,15785175,-3008900,SELL
19-11-20 14:03,14:03,18553275,15513225,-3040050,SELL
19-11-20 14:04,14:04,18797100,15427175,-3369925,SELL
19-11-20 14:05,14:05,18846250,15823575,-3022675,SELL
19-11-20 14:06,14:06,18674150,15435425,-3238725,SELL
19-11-20 14:07,14:07,18731275,15673725,-3057550,SELL
19-11-20 14:08,14:08,18822175,15733100,-3089075,SELL
19-11-20 14:09,14:09,18751425,15322425,-3429000,SELL
19-11-20 14:10,14:10,18756725,15131825,-3624900,SELL
19-11-20 14:11,14:11,18794400,14834550,-3959850,SELL
19-11-20 14:12,14:12,18837200,14637650,-4199550,SELL
19-11-20 14:13,14:13,18808000,15057675,-3750325,SELL
19-11-20 14:14,14:14,18822675,15418325,-3404350,SELL
19-11-20 14:15,14:15,18877975,15014050,-3863925,SELL
19-11-20 14:16,14:16,19041625,14976225,-4065400,SELL
19-11-20 14:17,14:17,18369200,15100800,-3268400,SELL
19-11-20 14:18,14:18,19220900,15136075,-4084825,SELL
19-11-20 14:19,14:19,19196675,15171125,-4025550,SELL
19-11-20 14:20,14:20,19209075,15315600,-3893475,SELL
19-11-20 14:21,14:21,19199825,15547350,-3652475,SELL
19-11-20 14:22,14:22,19136700,15507575,-3629125,SELL
19-11-20 14:23,14:23,19204350,15352625,-3851725,SELL
19-11-20 14:24,14:24,19205500,14949250,-4256250,SELL
19-11-20 14:25,14:25,19214450,14902550,-4311900,SELL
19-11-20 14:26,14:26,19147525,15040400,-4107125,SELL
19-11-20 14:27,14:27,19245775,15151125,-4094650,SELL
19-11-20 14:28,14:28,19275850,15275875,-3999975,SELL
19-11-20 14:29,14:29,19280300,15160775,-4119525,SELL
19-11-20 14:30,14:30,19268100,15512250,-3755850,SELL
19-11-20 14:31,14:31,19288450,15021400,-4267050,SELL
19-11-20 14:32,14:32,19215375,14928000,-4287375,SELL
19-11-20 14:33,14:33,19233250,15432075,-3801175,SELL
19-11-20 14:34,14:34,19259425,15258225,-4001200,SELL
19-11-20 14:35,14:35,19288225,15550600,-3737625,SELL
19-11-20 14:36,14:36,19147250,15282250,-3865000,SELL
19-11-20 14:37,14:37,19169050,15738975,-3430075,SELL
19-11-20 14:38,14:38,19176000,15358225,-3817775,SELL
19-11-20 14:39,14:39,19180050,15440275,-3739775,SELL
19-11-20 14:40,14:40,19238725,15430700,-3808025,SELL
19-11-20 14:41,14:41,19200050,15531375,-3668675,SELL
19-11-20 14:42,14:42,19121000,15430825,-3690175,SELL
19-11-20 14:43,14:43,19113300,15790325,-3322975,SELL
19-11-20 14:44,14:44,19120975,15319025,-3801950,SELL
19-11-20 14:45,14:45,19273100,15310225,-3962875,SELL
19-11-20 14:46,14:46,19348425,15256950,-4091475,SELL
19-11-20 14:47,14:47,19117850,15125575,-3992275,SELL
19-11-20 14:48,14:48,19119300,14494225,-4625075,SELL
19-11-20 14:49,14:49,19241300,14998925,-4242375,SELL
19-11-20 14:50,14:50,19180225,15229525,-3950700,SELL
19-11-20 14:51,14:51,19330650,15325025,-4005625,SELL
19-11-20 14:52,14:52,19174925,15449875,-3725050,SELL
19-11-20 14:53,14:53,19266250,15209250,-4057000,SELL
19-11-20 14:54,14:54,19105250,14251500,-4853750,SELL
19-11-20 14:55,14:55,18981025,14624850,-4356175,SELL
19-11-20 14:56,14:56,18838700,14597425,-4241275,SELL
19-11-20 14:57,14:57,19414700,14532025,-4882675,SELL
19-11-20 14:58,14:58,19431550,14443850,-4987700,SELL
19-11-20 14:59,14:59,19352050,14068975,-5283075,SELL
19-11-20 15:00,15:00,19456400,13340700,-6115700,SELL
19-11-20 15:01,15:01,19381575,13551500,-5830075,SELL
19-11-20 15:02,15:02,18995650,13454450,-5541200,SELL
19-11-20 15:03,15:03,19217225,13693525,-5523700,SELL
19-11-20 15:04,15:04,19401500,13496950,-5904550,SELL
19-11-20 15:05,15:05,19468650,13346725,-6121925,SELL
19-11-20 15:06,15:06,19156775,13377450,-5779325,SELL
19-11-20 15:07,15:07,19517850,13675625,-5842225,SELL
19-11-20 15:08,15:08,19329975,13618100,-5711875,SELL
19-11-20 15:09,15:09,19600900,13722800,-5878100,SELL
19-11-20 15:10,15:10,19677525,13293600,-6383925,SELL
19-11-20 15:11,15:11,19624650,13450775,-6173875,SELL
19-11-20 15:12,15:12,19780300,13140350,-6639950,SELL
19-11-20 15:13,15:13,19770300,13468975,-6301325,SELL
19-11-20 15:14,15:14,19677425,13432375,-6245050,SELL
19-11-20 15:15,15:15,19764175,12906750,-6857425,SELL
19-11-20 15:16,15:16,19772450,12159050,-7613400,SELL
19-11-20 15:17,15:17,19752775,11732100,-8020675,SELL
19-11-20 15:18,15:18,19993700,11300650,-8693050,SELL
19-11-20 15:19,15:19,19878400,11319900,-8558500,SELL
19-11-20 15:20,15:20,19946375,11864000,-8082375,SELL
19-11-20 15:21,15:21,19799550,12064825,-7734725,SELL
19-11-20 15:22,15:22,19745350,11320975,-8424375,SELL
19-11-20 15:23,15:23,19550975,10490000,-9060975,SELL
19-11-20 15:24,15:24,19424550,11400900,-8023650,SELL
19-11-20 15:25,15:25,19667325,11952000,-7715325,SELL
19-11-20 15:26,15:26,19584125,11559650,-8024475,SELL
19-11-20 15:27,15:27,19319525,11310350,-8009175,SELL
19-11-20 15:28,15:28,19382400,11497150,-7885250,SELL
19-11-20 15:29,15:29,19423050,10332250,-9090800,SELL
20-11-20 9:15,9:15,5443350,6093875,650525,BUY
20-11-20 9:16,9:16,5394075,5937750,543675,BUY
20-11-20 9:17,9:17,5428950,6189600,760650,BUY
20-11-20 9:18,9:18,5441225,5470450,29225,BUY
20-11-20 9:19,9:19,5504725,5887925,383200,BUY
20-11-20 9:20,9:20,5774800,6310475,535675,BUY
20-11-20 9:21,9:21,5613775,6173650,559875,BUY
20-11-20 9:22,9:22,5461300,5622000,160700,BUY
20-11-20 9:23,9:23,5665150,5941525,276375,BUY
20-11-20 9:24,9:24,5659900,5879275,219375,BUY
20-11-20 9:25,9:25,5659825,6110150,450325,BUY
20-11-20 9:26,9:26,5418675,6090300,671625,BUY
20-11-20 9:27,9:27,5540625,6141750,601125,BUY
20-11-20 9:28,9:28,5621650,6111800,490150,BUY
20-11-20 9:29,9:29,5553625,6295550,741925,BUY
20-11-20 9:30,9:30,5730575,6143075,412500,BUY
20-11-20 9:31,9:31,5826800,6365200,538400,BUY
20-11-20 9:32,9:32,5556175,5962675,406500,BUY
20-11-20 9:33,9:33,5717200,6236400,519200,BUY
20-11-20 9:34,9:34,5838600,6223950,385350,BUY
20-11-20 9:35,9:35,5867825,6317900,450075,BUY
20-11-20 9:36,9:36,5926150,6146350,220200,BUY
20-11-20 9:37,9:37,5873100,6417450,544350,BUY
20-11-20 9:38,9:38,5715350,6416750,701400,BUY
20-11-20 9:39,9:39,5646175,6358600,712425,BUY
20-11-20 9:40,9:40,5970375,6226000,255625,BUY
20-11-20 9:41,9:41,5653100,6484225,831125,BUY
20-11-20 9:42,9:42,5445725,6414650,968925,BUY
20-11-20 9:43,9:43,5967175,6427175,460000,BUY
20-11-20 9:44,9:44,5719975,6209850,489875,BUY
20-11-20 9:45,9:45,5790500,6700200,909700,BUY
20-11-20 9:46,9:46,5570350,6440950,870600,BUY
20-11-20 9:47,9:47,5686725,6760650,1073925,BUY
20-11-20 9:48,9:48,5836200,6871800,1035600,BUY
20-11-20 9:49,9:49,5818925,6533550,714625,BUY
20-11-20 9:50,9:50,6197200,6806575,609375,BUY
20-11-20 9:51,9:51,6147900,6601950,454050,BUY
20-11-20 9:52,9:52,6306100,6770950,464850,BUY
20-11-20 9:53,9:53,6460500,6795525,335025,BUY
20-11-20 9:54,9:54,6477375,6856875,379500,BUY
20-11-20 9:55,9:55,6578450,6823800,245350,BUY
20-11-20 9:56,9:56,6928950,6731350,-197600,SELL
20-11-20 9:57,9:57,7171100,7369750,198650,BUY
20-11-20 9:58,9:58,6853875,7189125,335250,BUY
20-11-20 9:59,9:59,7244375,7286400,42025,BUY
20-11-20 10:00,10:00,7198575,7273325,74750,BUY
20-11-20 10:01,10:01,7224475,7087325,-137150,SELL
20-11-20 10:02,10:02,7169125,7343100,173975,BUY
20-11-20 10:03,10:03,7261325,7016025,-245300,SELL
20-11-20 10:04,10:04,6931725,6546350,-385375,SELL
20-11-20 10:05,10:05,7175725,7178050,2325,BUY
20-11-20 10:06,10:06,7192550,7427775,235225,BUY
20-11-20 10:07,10:07,7180400,7118850,-61550,SELL
20-11-20 10:08,10:08,7445025,7197700,-247325,SELL
20-11-20 10:09,10:09,7341450,7064125,-277325,SELL
20-11-20 10:10,10:10,7282850,6831125,-451725,SELL
20-11-20 10:11,10:11,7475100,6686750,-788350,SELL
20-11-20 10:12,10:12,7406125,7099850,-306275,SELL
20-11-20 10:13,10:13,7395275,7148000,-247275,SELL
20-11-20 10:14,10:14,7729775,6970850,-758925,SELL
20-11-20 10:15,10:15,7436825,7588550,151725,BUY
20-11-20 10:16,10:16,7923300,7171525,-751775,SELL
20-11-20 10:17,10:17,8097475,7603350,-494125,SELL
20-11-20 10:18,10:18,7948375,7721175,-227200,SELL
20-11-20 10:19,10:19,7714925,7232550,-482375,SELL
20-11-20 10:20,10:20,7914000,7968600,54600,BUY
20-11-20 10:21,10:21,7722350,7870175,147825,BUY
20-11-20 10:22,10:22,7911700,7827500,-84200,SELL
20-11-20 10:23,10:23,8881850,8631650,-250200,SELL
20-11-20 10:24,10:24,8161150,8567875,406725,BUY
20-11-20 10:25,10:25,8285950,8365675,79725,BUY
20-11-20 10:26,10:26,8609025,8320000,-289025,SELL
20-11-20 10:27,10:27,8240600,8422225,181625,BUY
20-11-20 10:28,10:28,8567375,8288650,-278725,SELL
20-11-20 10:29,10:29,8128700,8352650,223950,BUY
20-11-20 10:30,10:30,8356050,8133400,-222650,SELL
20-11-20 10:31,10:31,8166800,7903675,-263125,SELL
20-11-20 10:32,10:32,8088050,7888975,-199075,SELL
20-11-20 10:33,10:33,8283125,8239200,-43925,SELL
20-11-20 10:34,10:34,8133625,8367575,233950,BUY
20-11-20 10:35,10:35,8326725,7983550,-343175,SELL
20-11-20 10:36,10:36,8268225,8004750,-263475,SELL
20-11-20 10:37,10:37,8535475,8280975,-254500,SELL
20-11-20 10:38,10:38,8406300,8112675,-293625,SELL
20-11-20 10:39,10:39,8771825,8498175,-273650,SELL
20-11-20 10:40,10:40,8485775,8584275,98500,BUY
20-11-20 10:41,10:41,8562475,8176475,-386000,SELL
20-11-20 10:42,10:42,8413000,8439625,26625,BUY
20-11-20 10:43,10:43,8635275,8711600,76325,BUY
20-11-20 10:44,10:44,8656300,8719675,63375,BUY
20-11-20 10:45,10:45,8590575,8491150,-99425,SELL
20-11-20 10:46,10:46,8794600,8521675,-272925,SELL
20-11-20 10:47,10:47,9118675,8462225,-656450,SELL
20-11-20 10:48,10:48,8994150,8611075,-383075,SELL
20-11-20 10:49,10:49,8960475,8553500,-406975,SELL
20-11-20 10:50,10:50,8696475,8511225,-185250,SELL
20-11-20 10:51,10:51,8895300,8362775,-532525,SELL
20-11-20 10:52,10:52,9285000,8637500,-647500,SELL
20-11-20 10:53,10:53,8612175,8472550,-139625,SELL
20-11-20 10:54,10:54,8670925,8698450,27525,BUY
20-11-20 10:55,10:55,8992200,8339950,-652250,SELL
20-11-20 10:56,10:56,8799375,8517450,-281925,SELL
20-11-20 10:57,10:57,9250400,8568200,-682200,SELL
20-11-20 10:58,10:58,8824325,8778075,-46250,SELL
20-11-20 10:59,10:59,9020825,8809100,-211725,SELL
20-11-20 11:00,11:00,8737350,8788200,50850,BUY
20-11-20 11:01,11:01,8705825,8509625,-196200,SELL
20-11-20 11:02,11:02,8576325,8312900,-263425,SELL
20-11-20 11:03,11:03,8848950,8832725,-16225,SELL
20-11-20 11:04,11:04,8897000,8754600,-142400,SELL
20-11-20 11:05,11:05,8813200,8327375,-485825,SELL
20-11-20 11:06,11:06,8745875,8411175,-334700,SELL
20-11-20 11:07,11:07,8700800,8949725,248925,BUY
20-11-20 11:08,11:08,8683975,8658350,-25625,SELL
20-11-20 11:09,11:09,8990100,8881050,-109050,SELL
20-11-20 11:10,11:10,8842825,8527850,-314975,SELL
20-11-20 11:11,11:11,8760700,8827525,66825,BUY
20-11-20 11:12,11:12,8785100,8952075,166975,BUY
20-11-20 11:13,11:13,8765375,9082275,316900,BUY
20-11-20 11:14,11:14,9492125,8998375,-493750,SELL
20-11-20 11:15,11:15,9397425,9228200,-169225,SELL
20-11-20 11:16,11:16,9022750,8918625,-104125,SELL
20-11-20 11:17,11:17,9057850,8847850,-210000,SELL
20-11-20 11:18,11:18,8768300,9084725,316425,BUY
20-11-20 11:19,11:19,8988275,9085675,97400,BUY
20-11-20 11:20,11:20,9230800,8879850,-350950,SELL
20-11-20 11:21,11:21,9077400,8535275,-542125,SELL
20-11-20 11:22,11:22,8944425,8836000,-108425,SELL
20-11-20 11:23,11:23,9103175,8720500,-382675,SELL
20-11-20 11:24,11:24,9235525,8635825,-599700,SELL
20-11-20 11:25,11:25,9198475,8780725,-417750,SELL
20-11-20 11:26,11:26,9355175,9017925,-337250,SELL
20-11-20 11:27,11:27,9290975,9357675,66700,BUY
20-11-20 11:28,11:28,9270850,9092075,-178775,SELL
20-11-20 11:29,11:29,8851575,8733100,-118475,SELL
20-11-20 11:30,11:30,9192250,9018425,-173825,SELL
20-11-20 11:31,11:31,8867775,8899825,32050,BUY
20-11-20 11:32,11:32,8909700,9132600,222900,BUY
20-11-20 11:33,11:33,8904375,8916900,12525,BUY
20-11-20 11:34,11:34,8973925,8638800,-335125,SELL
20-11-20 11:35,11:35,8875975,8894825,18850,BUY
20-11-20 11:36,11:36,9200800,8670100,-530700,SELL
20-11-20 11:37,11:37,9172600,9025950,-146650,SELL
20-11-20 11:38,11:38,9414050,9037250,-376800,SELL
20-11-20 11:39,11:39,9013900,9114900,101000,BUY
20-11-20 11:40,11:40,9021600,9110300,88700,BUY
20-11-20 11:41,11:41,8781625,8781775,150,BUY
20-11-20 11:42,11:42,8902900,8657475,-245425,SELL
20-11-20 11:43,11:43,9046875,8465600,-581275,SELL
20-11-20 11:44,11:44,8837275,8910650,73375,BUY
20-11-20 11:45,11:45,8936675,9245400,308725,BUY
20-11-20 11:46,11:46,8854725,8952375,97650,BUY
20-11-20 11:47,11:47,8841900,8793350,-48550,SELL
20-11-20 11:48,11:48,8715300,8865750,150450,BUY
20-11-20 11:49,11:49,8819275,9187175,367900,BUY
20-11-20 11:50,11:50,9165900,8715450,-450450,SELL
20-11-20 11:51,11:51,8943025,8991175,48150,BUY
20-11-20 11:52,11:52,9193075,9100400,-92675,SELL
20-11-20 11:53,11:53,9150450,9063950,-86500,SELL
20-11-20 11:54,11:54,8945700,8769225,-176475,SELL
20-11-20 11:55,11:55,8947225,8993175,45950,BUY
20-11-20 11:56,11:56,9219750,9274200,54450,BUY
20-11-20 11:57,11:57,9504175,9443025,-61150,SELL
20-11-20 11:58,11:58,9567350,9612675,45325,BUY
20-11-20 11:59,11:59,9394600,9112275,-282325,SELL
20-11-20 12:00,12:00,9265950,9405300,139350,BUY
20-11-20 12:01,12:01,9222075,9322475,100400,BUY
20-11-20 12:02,12:02,9062425,9332000,269575,BUY
20-11-20 12:03,12:03,9260275,9211675,-48600,SELL
20-11-20 12:04,12:04,8743000,9292500,549500,BUY
20-11-20 12:05,12:05,9264000,8953575,-310425,SELL
20-11-20 12:06,12:06,8715375,9163950,448575,BUY
20-11-20 12:07,12:07,8683450,8973325,289875,BUY
20-11-20 12:08,12:08,9147500,9166975,19475,BUY
20-11-20 12:09,12:09,8870675,9177325,306650,BUY
20-11-20 12:10,12:10,8898650,9108500,209850,BUY
20-11-20 12:11,12:11,8814300,9126275,311975,BUY
20-11-20 12:12,12:12,8890650,9329850,439200,BUY
20-11-20 12:13,12:13,9075750,9392325,316575,BUY
20-11-20 12:14,12:14,8757100,9107625,350525,BUY
20-11-20 12:15,12:15,8970900,9267825,296925,BUY
20-11-20 12:16,12:16,9027250,8940875,-86375,SELL
20-11-20 12:17,12:17,9257775,9236525,-21250,SELL
20-11-20 12:18,12:18,9132500,9468075,335575,BUY
20-11-20 12:19,12:19,8946800,9073375,126575,BUY
20-11-20 12:20,12:20,8951225,9064150,112925,BUY
20-11-20 12:21,12:21,9213975,8936475,-277500,SELL
20-11-20 12:22,12:22,8907650,9121125,213475,BUY
20-11-20 12:23,12:23,8865325,8736050,-129275,SELL
20-11-20 12:24,12:24,9004975,8631475,-373500,SELL
20-11-20 12:25,12:25,8695025,9060625,365600,BUY
20-11-20 12:26,12:26,8850850,9061425,210575,BUY
20-11-20 12:27,12:27,9071550,8994525,-77025,SELL
20-11-20 12:28,12:28,8889350,8776800,-112550,SELL
20-11-20 12:29,12:29,8940525,8328975,-611550,SELL
20-11-20 12:30,12:30,8799975,8654000,-145975,SELL
20-11-20 12:31,12:31,8888625,8370125,-518500,SELL
20-11-20 12:32,12:32,9350600,9235950,-114650,SELL
20-11-20 12:33,12:33,9331700,9223125,-108575,SELL
20-11-20 12:34,12:34,8723000,9230325,507325,BUY
20-11-20 12:35,12:35,8846725,8867800,21075,BUY
20-11-20 12:36,12:36,9168650,8919325,-249325,SELL
20-11-20 12:37,12:37,9223200,9184600,-38600,SELL
20-11-20 12:38,12:38,9184600,8890275,-294325,SELL
20-11-20 12:39,12:39,9273400,8858625,-414775,SELL
20-11-20 12:40,12:40,8828375,9432800,604425,BUY
20-11-20 12:41,12:41,9366575,9172000,-194575,SELL
20-11-20 12:42,12:42,9281200,9115650,-165550,SELL
20-11-20 12:43,12:43,9447725,9732300,284575,BUY
20-11-20 12:44,12:44,9497250,9727575,230325,BUY
20-11-20 12:45,12:45,8992375,9138675,146300,BUY
20-11-20 12:46,12:46,9091500,8821650,-269850,SELL
20-11-20 12:47,12:47,8836075,9092800,256725,BUY
20-11-20 12:48,12:48,9025025,8978050,-46975,SELL
20-11-20 12:49,12:49,8859375,9140875,281500,BUY
20-11-20 12:50,12:50,9254325,9051725,-202600,SELL
20-11-20 12:51,12:51,9125800,8993250,-132550,SELL
20-11-20 12:52,12:52,9065700,9082200,16500,BUY
20-11-20 12:53,12:53,9202400,9051325,-151075,SELL
20-11-20 12:54,12:54,9053875,8541850,-512025,SELL
20-11-20 12:55,12:55,9164550,9039600,-124950,SELL
20-11-20 12:56,12:56,8918875,9059125,140250,BUY
20-11-20 12:57,12:57,8929625,9150725,221100,BUY
20-11-20 12:58,12:58,8951125,9107700,156575,BUY
20-11-20 12:59,12:59,9296300,8884650,-411650,SELL
20-11-20 13:00,13:00,9519675,9641125,121450,BUY
20-11-20 13:01,13:01,9653025,10016675,363650,BUY
20-11-20 13:02,13:02,9064325,9441025,376700,BUY
20-11-20 13:03,13:03,9199700,9643125,443425,BUY
20-11-20 13:04,13:04,9147600,9321250,173650,BUY
20-11-20 13:05,13:05,9274800,9603450,328650,BUY
20-11-20 13:06,13:06,9191950,9488975,297025,BUY
20-11-20 13:07,13:07,9004125,9432500,428375,BUY
20-11-20 13:08,13:08,8817825,9628175,810350,BUY
20-11-20 13:09,13:09,8727200,9425150,697950,BUY
20-11-20 13:10,13:10,8586225,9674275,1088050,BUY
20-11-20 13:11,13:11,8668675,9268700,600025,BUY
20-11-20 13:12,13:12,8603400,9052850,449450,BUY
20-11-20 13:13,13:13,9014550,9278475,263925,BUY
20-11-20 13:14,13:14,8640475,9523975,883500,BUY
20-11-20 13:15,13:15,8859950,9753100,893150,BUY
20-11-20 13:16,13:16,8726000,9689400,963400,BUY
20-11-20 13:17,13:17,8797400,9471875,674475,BUY
20-11-20 13:18,13:18,8621875,9503300,881425,BUY
20-11-20 13:19,13:19,8951375,9616400,665025,BUY
20-11-20 13:20,13:20,8742825,9148900,406075,BUY
20-11-20 13:21,13:21,8623000,9284250,661250,BUY
20-11-20 13:22,13:22,8680300,9392425,712125,BUY
20-11-20 13:23,13:23,8633450,9279350,645900,BUY
20-11-20 13:24,13:24,8778575,9528900,750325,BUY
20-11-20 13:25,13:25,9219400,9586575,367175,BUY
20-11-20 13:26,13:26,8587150,9419350,832200,BUY
20-11-20 13:27,13:27,8625775,8872575,246800,BUY
20-11-20 13:28,13:28,8650400,9056050,405650,BUY
20-11-20 13:29,13:29,8478625,9422725,944100,BUY
20-11-20 13:30,13:30,9109350,9387375,278025,BUY
20-11-20 13:31,13:31,8804575,9878850,1074275,BUY
20-11-20 13:32,13:32,8716700,9718775,1002075,BUY
20-11-20 13:33,13:33,8318000,9661600,1343600,BUY
20-11-20 13:34,13:34,8621150,9744875,1123725,BUY
20-11-20 13:35,13:35,8530525,9213000,682475,BUY
20-11-20 13:36,13:36,8584175,9437550,853375,BUY
20-11-20 13:37,13:37,8717300,8934150,216850,BUY
20-11-20 13:38,13:38,8589975,9075000,485025,BUY
20-11-20 13:39,13:39,8494875,9361550,866675,BUY
20-11-20 13:40,13:40,8509050,9432425,923375,BUY
20-11-20 13:41,13:41,8608200,9405500,797300,BUY
20-11-20 13:42,13:42,8198475,9022850,824375,BUY
20-11-20 13:43,13:43,8892400,9420725,528325,BUY
20-11-20 13:44,13:44,8718275,9388250,669975,BUY
20-11-20 13:45,13:45,9116125,10052725,936600,BUY
20-11-20 13:46,13:46,8694725,9794475,1099750,BUY
20-11-20 13:47,13:47,8483475,9847650,1364175,BUY
20-11-20 13:48,13:48,8266125,9525125,1259000,BUY
20-11-20 13:49,13:49,8417725,9728050,1310325,BUY
20-11-20 13:50,13:50,8350625,9588125,1237500,BUY
20-11-20 13:51,13:51,8095325,9653900,1558575,BUY
20-11-20 13:52,13:52,8244675,9785500,1540825,BUY
20-11-20 13:53,13:53,8268725,9720675,1451950,BUY
20-11-20 13:54,13:54,7908675,9737075,1828400,BUY
20-11-20 13:55,13:55,8078450,9743000,1664550,BUY
20-11-20 13:56,13:56,8021100,9282625,1261525,BUY
20-11-20 13:57,13:57,8002350,10056575,2054225,BUY
20-11-20 13:58,13:58,7865675,9064550,1198875,BUY
20-11-20 13:59,13:59,7857400,9582050,1724650,BUY
20-11-20 14:00,14:00,7801250,9538175,1736925,BUY
20-11-20 14:01,14:01,8017600,9364050,1346450,BUY
20-11-20 14:02,14:02,7711825,9309000,1597175,BUY
20-11-20 14:03,14:03,7530125,9546750,2016625,BUY
20-11-20 14:04,14:04,7537125,9596700,2059575,BUY
20-11-20 14:05,14:05,7679375,9816350,2136975,BUY
20-11-20 14:06,14:06,7735400,9625025,1889625,BUY
20-11-20 14:07,14:07,7833125,9756125,1923000,BUY
20-11-20 14:08,14:08,7557825,9536250,1978425,BUY
20-11-20 14:09,14:09,7787025,9643250,1856225,BUY
20-11-20 14:10,14:10,7718625,9786100,2067475,BUY
20-11-20 14:11,14:11,7944550,9849075,1904525,BUY
20-11-20 14:12,14:12,7811725,9790150,1978425,BUY
20-11-20 14:13,14:13,7779750,10012500,2232750,BUY
20-11-20 14:14,14:14,7738700,9961475,2222775,BUY
20-11-20 14:15,14:15,7994275,9557400,1563125,BUY
20-11-20 14:16,14:16,8158550,9864000,1705450,BUY
20-11-20 14:17,14:17,8017600,9768350,1750750,BUY
20-11-20 14:18,14:18,7917875,9797425,1879550,BUY
20-11-20 14:19,14:19,7808900,10137250,2328350,BUY
20-11-20 14:20,14:20,7644625,9907975,2263350,BUY
20-11-20 14:21,14:21,7544025,9969925,2425900,BUY
20-11-20 14:22,14:22,7678450,9886225,2207775,BUY
20-11-20 14:23,14:23,7688800,9894425,2205625,BUY
20-11-20 14:24,14:24,7778700,10128175,2349475,BUY
20-11-20 14:25,14:25,7973200,9779900,1806700,BUY
20-11-20 14:26,14:26,7778975,9630200,1851225,BUY
20-11-20 14:27,14:27,7813850,9504575,1690725,BUY
20-11-20 14:28,14:28,8113425,9912100,1798675,BUY
20-11-20 14:29,14:29,7918475,9833150,1914675,BUY
20-11-20 14:30,14:30,7774950,9903225,2128275,BUY
20-11-20 14:31,14:31,7836850,9414275,1577425,BUY
20-11-20 14:32,14:32,7687425,9756100,2068675,BUY
20-11-20 14:33,14:33,7494250,9053475,1559225,BUY
20-11-20 14:34,14:34,7694900,9711375,2016475,BUY
20-11-20 14:35,14:35,7628450,9766950,2138500,BUY
20-11-20 14:36,14:36,7503025,9814400,2311375,BUY
20-11-20 14:37,14:37,7444725,9797925,2353200,BUY
20-11-20 14:38,14:38,7706250,10017725,2311475,BUY
20-11-20 14:39,14:39,7522025,9948900,2426875,BUY
20-11-20 14:40,14:40,7366450,9666000,2299550,BUY
20-11-20 14:41,14:41,7747750,9956550,2208800,BUY
20-11-20 14:42,14:42,7542250,9711575,2169325,BUY
20-11-20 14:43,14:43,7873525,9759125,1885600,BUY
20-11-20 14:44,14:44,7554775,10128700,2573925,BUY
20-11-20 14:45,14:45,7870625,9898025,2027400,BUY
20-11-20 14:46,14:46,7958150,9898775,1940625,BUY
20-11-20 14:47,14:47,7580025,9843450,2263425,BUY
20-11-20 14:48,14:48,7266300,10113250,2846950,BUY
20-11-20 14:49,14:49,7541825,9898475,2356650,BUY
20-11-20 14:50,14:50,7638600,9764150,2125550,BUY
20-11-20 14:51,14:51,7773725,9485650,1711925,BUY
20-11-20 14:52,14:52,7735850,9633825,1897975,BUY
20-11-20 14:53,14:53,7400025,10007475,2607450,BUY
20-11-20 14:54,14:54,7409750,9530125,2120375,BUY
20-11-20 14:55,14:55,7366250,9920050,2553800,BUY
20-11-20 14:56,14:56,7733975,10157200,2423225,BUY
20-11-20 14:57,14:57,7192575,9700300,2507725,BUY
20-11-20 14:58,14:58,7470875,9828200,2357325,BUY
20-11-20 14:59,14:59,7614725,9930000,2315275,BUY
20-11-20 15:00,15:00,7324200,9925900,2601700,BUY
20-11-20 15:01,15:01,7327125,9802150,2475025,BUY
20-11-20 15:02,15:02,7612900,9557775,1944875,BUY
20-11-20 15:03,15:03,7358875,10026700,2667825,BUY
20-11-20 15:04,15:04,7720450,10000175,2279725,BUY
20-11-20 15:05,15:05,7124125,9777500,2653375,BUY
20-11-20 15:06,15:06,7350950,9945950,2595000,BUY
20-11-20 15:07,15:07,7411600,9942400,2530800,BUY
20-11-20 15:08,15:08,7601800,10107050,2505250,BUY
20-11-20 15:09,15:09,7152325,9624675,2472350,BUY
20-11-20 15:10,15:10,7226400,9696775,2470375,BUY
20-11-20 15:11,15:11,7197850,9800725,2602875,BUY
20-11-20 15:12,15:12,7071200,9985175,2913975,BUY
20-11-20 15:13,15:13,7169825,9631600,2461775,BUY
20-11-20 15:14,15:14,7389300,10083225,2693925,BUY
20-11-20 15:15,15:15,7426350,9903750,2477400,BUY
20-11-20 15:16,15:16,7369475,9823150,2453675,BUY
20-11-20 15:17,15:17,7334750,9744475,2409725,BUY
20-11-20 15:18,15:18,7069000,9833475,2764475,BUY
20-11-20 15:19,15:19,7236575,9379650,2143075,BUY
20-11-20 15:20,15:20,7267425,9948775,2681350,BUY
20-11-20 15:21,15:21,7516700,9663550,2146850,BUY
20-11-20 15:22,15:22,7238550,9525725,2287175,BUY
20-11-20 15:23,15:23,7132275,9406675,2274400,BUY
20-11-20 15:24,15:24,7486875,9662125,2175250,BUY
20-11-20 15:25,15:25,7388075,9683925,2295850,BUY
20-11-20 15:26,15:26,7050550,9721175,2670625,BUY
20-11-20 15:27,15:27,6852350,9371000,2518650,BUY
20-11-20 15:28,15:28,7014125,9634975,2620850,BUY
20-11-20 15:29,15:29,7124600,9581850,2457250,BUY
23-11-20 9:15,9:15,7094250,9253425,2159175,BUY
23-11-20 9:16,9:16,6997000,9295950,2298950,BUY
23-11-20 9:17,9:17,7396475,8969975,1573500,BUY
23-11-20 9:18,9:18,7325575,8666175,1340600,BUY
23-11-20 9:19,9:19,6964900,9041100,2076200,BUY
23-11-20 9:20,9:20,7490700,8867425,1376725,BUY
23-11-20 9:21,9:21,6948450,8894850,1946400,BUY
23-11-20 9:22,9:22,7306000,8515950,1209950,BUY
23-11-20 9:23,9:23,7090300,8344400,1254100,BUY
23-11-20 9:24,9:24,7380050,8891225,1511175,BUY
23-11-20 9:25,9:25,6998900,8766775,1767875,BUY
23-11-20 9:26,9:26,7346175,9026300,1680125,BUY
23-11-20 9:27,9:27,7203900,9360200,2156300,BUY
23-11-20 9:28,9:28,6906125,9072975,2166850,BUY
23-11-20 9:29,9:29,7115400,8947975,1832575,BUY
23-11-20 9:30,9:30,7466675,9186950,1720275,BUY
23-11-20 9:31,9:31,7349075,9416800,2067725,BUY
23-11-20 9:32,9:32,7054625,9103575,2048950,BUY
23-11-20 9:33,9:33,7050825,9226750,2175925,BUY
23-11-20 9:34,9:34,7258725,8870300,1611575,BUY
23-11-20 9:35,9:35,7160175,9116175,1956000,BUY
23-11-20 9:36,9:36,7386250,8708750,1322500,BUY
23-11-20 9:37,9:37,7076075,9041525,1965450,BUY
23-11-20 9:38,9:38,7461100,9277375,1816275,BUY
23-11-20 9:39,9:39,7415275,9400200,1984925,BUY
23-11-20 9:40,9:40,7926800,9567575,1640775,BUY
23-11-20 9:41,9:41,7540325,8684000,1143675,BUY
23-11-20 9:42,9:42,7392975,9245700,1852725,BUY
23-11-20 9:43,9:43,7687900,9255650,1567750,BUY
23-11-20 9:44,9:44,7775200,9522200,1747000,BUY
23-11-20 9:45,9:45,7655175,9532550,1877375,BUY
23-11-20 9:46,9:46,7681125,9421900,1740775,BUY
23-11-20 9:47,9:47,7552625,9404775,1852150,BUY
23-11-20 9:48,9:48,7535400,9377800,1842400,BUY
23-11-20 9:49,9:49,7753050,9369825,1616775,BUY
23-11-20 9:50,9:50,7900000,9584675,1684675,BUY
23-11-20 9:51,9:51,7787125,9611350,1824225,BUY
23-11-20 9:52,9:52,7617325,9681600,2064275,BUY
23-11-20 9:53,9:53,8223075,9478550,1255475,BUY
23-11-20 9:54,9:54,8091650,9663125,1571475,BUY
23-11-20 9:55,9:55,8131825,9476600,1344775,BUY
23-11-20 9:56,9:56,8244900,9478200,1233300,BUY
23-11-20 9:57,9:57,8101625,9642875,1541250,BUY
23-11-20 9:58,9:58,8055700,9428050,1372350,BUY
23-11-20 9:59,9:59,8085425,9623300,1537875,BUY
23-11-20 10:00,10:00,8442400,9846075,1403675,BUY
23-11-20 10:01,10:01,8403750,9500700,1096950,BUY
23-11-20 10:02,10:02,7984525,9760700,1776175,BUY
23-11-20 10:03,10:03,7824825,9659775,1834950,BUY
23-11-20 10:04,10:04,7701950,9467750,1765800,BUY
23-11-20 10:05,10:05,8303425,9393650,1090225,BUY
23-11-20 10:06,10:06,8043075,9721150,1678075,BUY
23-11-20 10:07,10:07,8256950,9733425,1476475,BUY
23-11-20 10:08,10:08,8007250,9624375,1617125,BUY
23-11-20 10:09,10:09,8114350,9719850,1605500,BUY
23-11-20 10:10,10:10,8077875,9769575,1691700,BUY
23-11-20 10:11,10:11,7977325,9034925,1057600,BUY
23-11-20 10:12,10:12,8104675,9719875,1615200,BUY
23-11-20 10:13,10:13,8173550,9508575,1335025,BUY
23-11-20 10:14,10:14,8183400,9420500,1237100,BUY
23-11-20 10:15,10:15,8041950,9498250,1456300,BUY
23-11-20 10:16,10:16,8358200,9812925,1454725,BUY
23-11-20 10:17,10:17,8130800,9513675,1382875,BUY
23-11-20 10:18,10:18,8311175,9374175,1063000,BUY
23-11-20 10:19,10:19,8313375,10126700,1813325,BUY
23-11-20 10:20,10:20,8422675,9906025,1483350,BUY
23-11-20 10:21,10:21,8215525,10084300,1868775,BUY
23-11-20 10:22,10:22,8165175,9099300,934125,BUY
23-11-20 10:23,10:23,8375900,9766475,1390575,BUY
23-11-20 10:24,10:24,8199675,9545050,1345375,BUY
23-11-20 10:25,10:25,8226800,9555300,1328500,BUY
23-11-20 10:26,10:26,8318075,9798225,1480150,BUY
23-11-20 10:27,10:27,8270875,9865575,1594700,BUY
23-11-20 10:28,10:28,8486050,9237325,751275,BUY
23-11-20 10:29,10:29,8135400,9838125,1702725,BUY
23-11-20 10:30,10:30,8137175,9402150,1264975,BUY
23-11-20 10:31,10:31,8274975,9430800,1155825,BUY
23-11-20 10:32,10:32,8254950,9713600,1458650,BUY
23-11-20 10:33,10:33,8015225,9499725,1484500,BUY
23-11-20 10:34,10:34,8240100,9478825,1238725,BUY
23-11-20 10:35,10:35,8649325,9786725,1137400,BUY
23-11-20 10:36,10:36,8453950,9419000,965050,BUY
23-11-20 10:37,10:37,8419525,10045050,1625525,BUY
23-11-20 10:38,10:38,8170675,9318075,1147400,BUY
23-11-20 10:39,10:39,8194275,9201000,1006725,BUY
23-11-20 10:40,10:40,8591775,10066850,1475075,BUY
23-11-20 10:41,10:41,8777950,10156225,1378275,BUY
23-11-20 10:42,10:42,8435875,9853150,1417275,BUY
23-11-20 10:43,10:43,8497475,9962350,1464875,BUY
23-11-20 10:44,10:44,8583625,10098625,1515000,BUY
23-11-20 10:45,10:45,8865050,10560200,1695150,BUY
23-11-20 10:46,10:46,9167825,10745150,1577325,BUY
23-11-20 10:47,10:47,8631000,10446550,1815550,BUY
23-11-20 10:48,10:48,8481550,10194850,1713300,BUY
23-11-20 10:49,10:49,8877975,9986825,1108850,BUY
23-11-20 10:50,10:50,8513850,9996400,1482550,BUY
23-11-20 10:51,10:51,8434450,10516400,2081950,BUY
23-11-20 10:52,10:52,8887400,10339300,1451900,BUY
23-11-20 10:53,10:53,8443350,10133875,1690525,BUY
23-11-20 10:54,10:54,8828050,10014600,1186550,BUY
23-11-20 10:55,10:55,8731925,10083975,1352050,BUY
23-11-20 10:56,10:56,8819550,10556325,1736775,BUY
23-11-20 10:57,10:57,8762550,10561550,1799000,BUY
23-11-20 10:58,10:58,8769100,10187075,1417975,BUY
23-11-20 10:59,10:59,8972225,10169550,1197325,BUY
23-11-20 11:00,11:00,8632250,9699325,1067075,BUY
23-11-20 11:01,11:01,8726100,10472875,1746775,BUY
23-11-20 11:02,11:02,8923650,10046300,1122650,BUY
23-11-20 11:03,11:03,8499350,9985575,1486225,BUY
23-11-20 11:04,11:04,8734475,10203100,1468625,BUY
23-11-20 11:05,11:05,8646325,9968125,1321800,BUY
23-11-20 11:06,11:06,8741200,10062350,1321150,BUY
23-11-20 11:07,11:07,8619925,9877100,1257175,BUY
23-11-20 11:08,11:08,8922825,10133600,1210775,BUY
23-11-20 11:09,11:09,9077250,10419850,1342600,BUY
23-11-20 11:10,11:10,8978100,9483575,505475,BUY
23-11-20 11:11,11:11,8853200,9879775,1026575,BUY
23-11-20 11:12,11:12,8821000,9540875,719875,BUY
23-11-20 11:13,11:13,8926225,9765625,839400,BUY
23-11-20 11:14,11:14,8796875,9112125,315250,BUY
23-11-20 11:15,11:15,8821925,9874175,1052250,BUY
23-11-20 11:16,11:16,9018675,10021350,1002675,BUY
23-11-20 11:17,11:17,8985550,9858750,873200,BUY
23-11-20 11:18,11:18,9083225,9466325,383100,BUY
23-11-20 11:19,11:19,9225100,9709250,484150,BUY
23-11-20 11:20,11:20,9792800,10398225,605425,BUY
23-11-20 11:21,11:21,9327700,10178100,850400,BUY
23-11-20 11:22,11:22,9597575,9721600,124025,BUY
23-11-20 11:23,11:23,9352075,10073000,720925,BUY
23-11-20 11:24,11:24,9690625,9948375,257750,BUY
23-11-20 11:25,11:25,9306625,10047500,740875,BUY
23-11-20 11:26,11:26,9093700,10078700,985000,BUY
23-11-20 11:27,11:27,9309250,10543100,1233850,BUY
23-11-20 11:28,11:28,9975675,10338600,362925,BUY
23-11-20 11:29,11:29,9418500,10688975,1270475,BUY
23-11-20 11:30,11:30,9379300,10760425,1381125,BUY
23-11-20 11:31,11:31,10159900,10662275,502375,BUY
23-11-20 11:32,11:32,9230200,10511625,1281425,BUY
23-11-20 11:33,11:33,9427525,10197375,769850,BUY
23-11-20 11:34,11:34,9441700,10397675,955975,BUY
23-11-20 11:35,11:35,9569700,9676950,107250,BUY
23-11-20 11:36,11:36,9285400,9870800,585400,BUY
23-11-20 11:37,11:37,9399000,9832450,433450,BUY
23-11-20 11:38,11:38,9250725,9895750,645025,BUY
23-11-20 11:39,11:39,9694375,10058400,364025,BUY
23-11-20 11:40,11:40,9605575,10035500,429925,BUY
23-11-20 11:41,11:41,9373375,9380475,7100,BUY
23-11-20 11:42,11:42,9342550,10019300,676750,BUY
23-11-20 11:43,11:43,9824000,9871700,47700,BUY
23-11-20 11:44,11:44,9755050,10082725,327675,BUY
23-11-20 11:45,11:45,9851025,9995075,144050,BUY
23-11-20 11:46,11:46,9871950,9940575,68625,BUY
23-11-20 11:47,11:47,9905175,9481250,-423925,SELL
23-11-20 11:48,11:48,10108400,9871625,-236775,SELL
23-11-20 11:49,11:49,10401075,9606000,-795075,SELL
23-11-20 11:50,11:50,10157800,9812225,-345575,SELL
23-11-20 11:51,11:51,9842925,9870150,27225,BUY
23-11-20 11:52,11:52,10037675,9780350,-257325,SELL
23-11-20 11:53,11:53,9959650,9724275,-235375,SELL
23-11-20 11:54,11:54,10009575,9682800,-326775,SELL
23-11-20 11:55,11:55,10365575,9856550,-509025,SELL
23-11-20 11:56,11:56,10686800,9401000,-1285800,SELL
23-11-20 11:57,11:57,10430225,9310500,-1119725,SELL
23-11-20 11:58,11:58,10418700,9694275,-724425,SELL
23-11-20 11:59,11:59,11050850,9619325,-1431525,SELL
23-11-20 12:00,12:00,10722800,9989425,-733375,SELL
23-11-20 12:01,12:01,11028050,10118400,-909650,SELL
23-11-20 12:02,12:02,11057850,9586275,-1471575,SELL
23-11-20 12:03,12:03,11283650,10048975,-1234675,SELL
23-11-20 12:04,12:04,11489750,9686675,-1803075,SELL
23-11-20 12:05,12:05,11445125,10109400,-1335725,SELL
23-11-20 12:06,12:06,11070875,10013700,-1057175,SELL
23-11-20 12:07,12:07,11167700,10286950,-880750,SELL
23-11-20 12:08,12:08,11734975,10591100,-1143875,SELL
23-11-20 12:09,12:09,11638325,9797550,-1840775,SELL
23-11-20 12:10,12:10,11334525,10073425,-1261100,SELL
23-11-20 12:11,12:11,11452825,10502575,-950250,SELL
23-11-20 12:12,12:12,11479900,10519325,-960575,SELL
23-11-20 12:13,12:13,11653950,10474775,-1179175,SELL
23-11-20 12:14,12:14,11566975,10566400,-1000575,SELL
23-11-20 12:15,12:15,12066975,10758350,-1308625,SELL
23-11-20 12:16,12:16,11614550,10399225,-1215325,SELL
23-11-20 12:17,12:17,11515025,10345650,-1169375,SELL
23-11-20 12:18,12:18,11867975,10096550,-1771425,SELL
23-11-20 12:19,12:19,11678800,9961350,-1717450,SELL
23-11-20 12:20,12:20,11545375,10689050,-856325,SELL
23-11-20 12:21,12:21,11668625,10722600,-946025,SELL
23-11-20 12:22,12:22,11759700,10297450,-1462250,SELL
23-11-20 12:23,12:23,11798450,10346925,-1451525,SELL
23-11-20 12:24,12:24,11760125,10972800,-787325,SELL
23-11-20 12:25,12:25,11811225,10577475,-1233750,SELL
23-11-20 12:26,12:26,11682175,10607275,-1074900,SELL
23-11-20 12:27,12:27,12202550,10736050,-1466500,SELL
23-11-20 12:28,12:28,11826925,10868100,-958825,SELL
23-11-20 12:29,12:29,12657550,11077300,-1580250,SELL
23-11-20 12:30,12:30,12304625,10808775,-1495850,SELL
23-11-20 12:31,12:31,12196200,10852050,-1344150,SELL
23-11-20 12:32,12:32,12235350,10858850,-1376500,SELL
23-11-20 12:33,12:33,12095450,10843600,-1251850,SELL
23-11-20 12:34,12:34,12443900,11212425,-1231475,SELL
23-11-20 12:35,12:35,12585775,11589425,-996350,SELL
23-11-20 12:36,12:36,11965475,11244775,-720700,SELL
23-11-20 12:37,12:37,12122225,11440350,-681875,SELL
23-11-20 12:38,12:38,12041300,11393425,-647875,SELL
23-11-20 12:39,12:39,12074325,11280875,-793450,SELL
23-11-20 12:40,12:40,12013650,11087975,-925675,SELL
23-11-20 12:41,12:41,12119200,11071375,-1047825,SELL
23-11-20 12:42,12:42,12081200,11124850,-956350,SELL
23-11-20 12:43,12:43,12224800,11376650,-848150,SELL
23-11-20 12:44,12:44,12128900,10601500,-1527400,SELL
23-11-20 12:45,12:45,12251975,11511600,-740375,SELL
23-11-20 12:46,12:46,12150200,10816725,-1333475,SELL
23-11-20 12:47,12:47,12178925,11177825,-1001100,SELL
23-11-20 12:48,12:48,12243025,11041600,-1201425,SELL
23-11-20 12:49,12:49,12512875,11232775,-1280100,SELL
23-11-20 12:50,12:50,12500475,11407750,-1092725,SELL
23-11-20 12:51,12:51,12623900,11554500,-1069400,SELL
23-11-20 12:52,12:52,12517975,11398800,-1119175,SELL
23-11-20 12:53,12:53,12136050,11072900,-1063150,SELL
23-11-20 12:54,12:54,12421075,11222675,-1198400,SELL
23-11-20 12:55,12:55,12058375,11130700,-927675,SELL
23-11-20 12:56,12:56,11984150,11023100,-961050,SELL
23-11-20 12:57,12:57,11975225,10853250,-1121975,SELL
23-11-20 12:58,12:58,11845125,10436750,-1408375,SELL
23-11-20 12:59,12:59,12017350,10232475,-1784875,SELL
23-11-20 13:00,13:00,11955500,10964700,-990800,SELL
23-11-20 13:01,13:01,12297100,10704025,-1593075,SELL
23-11-20 13:02,13:02,12032975,10483875,-1549100,SELL
23-11-20 13:03,13:03,12051200,10920275,-1130925,SELL
23-11-20 13:04,13:04,11979475,10490600,-1488875,SELL
23-11-20 13:05,13:05,12482550,10887600,-1594950,SELL
23-11-20 13:06,13:06,12105550,11390975,-714575,SELL
23-11-20 13:07,13:07,12121350,11086775,-1034575,SELL
23-11-20 13:08,13:08,12117700,10698650,-1419050,SELL
23-11-20 13:09,13:09,12053350,10796800,-1256550,SELL
23-11-20 13:10,13:10,12072550,11294475,-778075,SELL
23-11-20 13:11,13:11,12880675,11235500,-1645175,SELL
23-11-20 13:12,13:12,12641225,11152200,-1489025,SELL
23-11-20 13:13,13:13,12164625,11139050,-1025575,SELL
23-11-20 13:14,13:14,12125775,11140950,-984825,SELL
23-11-20 13:15,13:15,12112225,10983850,-1128375,SELL
23-11-20 13:16,13:16,12045925,10799800,-1246125,SELL
23-11-20 13:17,13:17,12115800,11045175,-1070625,SELL
23-11-20 13:18,13:18,12401025,10621050,-1779975,SELL
23-11-20 13:19,13:19,12115250,10986475,-1128775,SELL
23-11-20 13:20,13:20,12181600,10777975,-1403625,SELL
23-11-20 13:21,13:21,12074925,10350300,-1724625,SELL
23-11-20 13:22,13:22,12236925,11337550,-899375,SELL
23-11-20 13:23,13:23,11920100,11072725,-847375,SELL
23-11-20 13:24,13:24,11954400,10926725,-1027675,SELL
23-11-20 13:25,13:25,11953200,10522800,-1430400,SELL
23-11-20 13:26,13:26,11962375,10806575,-1155800,SELL
23-11-20 13:27,13:27,11889075,11175850,-713225,SELL
23-11-20 13:28,13:28,12039525,10567725,-1471800,SELL
23-11-20 13:29,13:29,12066900,11059525,-1007375,SELL
23-11-20 13:30,13:30,12158075,11253850,-904225,SELL
23-11-20 13:31,13:31,12112550,10871225,-1241325,SELL
23-11-20 13:32,13:32,12296100,10879725,-1416375,SELL
23-11-20 13:33,13:33,11881925,10599250,-1282675,SELL
23-11-20 13:34,13:34,11948925,10640975,-1307950,SELL
23-11-20 13:35,13:35,11918000,10280725,-1637275,SELL
23-11-20 13:36,13:36,12165050,11312350,-852700,SELL
23-11-20 13:37,13:37,12413975,11383425,-1030550,SELL
23-11-20 13:38,13:38,12286750,11496250,-790500,SELL
23-11-20 13:39,13:39,11823850,11094750,-729100,SELL
23-11-20 13:40,13:40,11797000,11336025,-460975,SELL
23-11-20 13:41,13:41,11866850,10960775,-906075,SELL
23-11-20 13:42,13:42,11785125,10848200,-936925,SELL
23-11-20 13:43,13:43,11570925,10979825,-591100,SELL
23-11-20 13:44,13:44,11568675,10776050,-792625,SELL
23-11-20 13:45,13:45,11671200,10570000,-1101200,SELL
23-11-20 13:46,13:46,11695575,10705650,-989925,SELL
23-11-20 13:47,13:47,11779975,10869125,-910850,SELL
23-11-20 13:48,13:48,11711650,11199875,-511775,SELL
23-11-20 13:49,13:49,11655625,10970400,-685225,SELL
23-11-20 13:50,13:50,11578350,10892550,-685800,SELL
23-11-20 13:51,13:51,11571275,10883100,-688175,SELL
23-11-20 13:52,13:52,11931475,10784650,-1146825,SELL
23-11-20 13:53,13:53,11598500,11210625,-387875,SELL
23-11-20 13:54,13:54,11707675,10989275,-718400,SELL
23-11-20 13:55,13:55,11647450,11305475,-341975,SELL
23-11-20 13:56,13:56,11570350,11029150,-541200,SELL
23-11-20 13:57,13:57,11912175,10151575,-1760600,SELL
23-11-20 13:58,13:58,11736050,11076550,-659500,SELL
23-11-20 13:59,13:59,11468250,10782000,-686250,SELL
23-11-20 14:00,14:00,11752600,11284600,-468000,SELL
23-11-20 14:01,14:01,11503650,10573250,-930400,SELL
23-11-20 14:02,14:02,11594900,10716125,-878775,SELL
23-11-20 14:03,14:03,11518125,10642875,-875250,SELL
23-11-20 14:04,14:04,11193800,10538275,-655525,SELL
23-11-20 14:05,14:05,11868625,11014200,-854425,SELL
23-11-20 14:06,14:06,11276475,11431450,154975,BUY
23-11-20 14:07,14:07,11537825,10892600,-645225,SELL
23-11-20 14:08,14:08,11624400,11046925,-577475,SELL
23-11-20 14:09,14:09,11167450,10857275,-310175,SELL
23-11-20 14:10,14:10,11217275,11061175,-156100,SELL
23-11-20 14:11,14:11,11314500,10785750,-528750,SELL
23-11-20 14:12,14:12,11375975,10971550,-404425,SELL
23-11-20 14:13,14:13,11327025,10960150,-366875,SELL
23-11-20 14:14,14:14,11253350,10919375,-333975,SELL
23-11-20 14:15,14:15,10981725,10879350,-102375,SELL
23-11-20 14:16,14:16,11665825,10689975,-975850,SELL
23-11-20 14:17,14:17,11054600,10584500,-470100,SELL
23-11-20 14:18,14:18,11093700,10955950,-137750,SELL
23-11-20 14:19,14:19,11009675,10555300,-454375,SELL
23-11-20 14:20,14:20,11659675,10870275,-789400,SELL
23-11-20 14:21,14:21,10952775,10153250,-799525,SELL
23-11-20 14:22,14:22,11187550,10541100,-646450,SELL
23-11-20 14:23,14:23,11217750,10751150,-466600,SELL
23-11-20 14:24,14:24,11066075,11108125,42050,BUY
23-11-20 14:25,14:25,11068325,10907175,-161150,SELL
23-11-20 14:26,14:26,11175950,10840475,-335475,SELL
23-11-20 14:27,14:27,11032125,11045350,13225,BUY
23-11-20 14:28,14:28,10939600,10807750,-131850,SELL
23-11-20 14:29,14:29,10952000,10987600,35600,BUY
23-11-20 14:30,14:30,11214900,10708025,-506875,SELL
23-11-20 14:31,14:31,11175425,10752500,-422925,SELL
23-11-20 14:32,14:32,11340100,10713800,-626300,SELL
23-11-20 14:33,14:33,10955175,10980325,25150,BUY
23-11-20 14:34,14:34,10953525,10668600,-284925,SELL
23-11-20 14:35,14:35,10963450,10650825,-312625,SELL
23-11-20 14:36,14:36,10878700,10230600,-648100,SELL
23-11-20 14:37,14:37,10823125,10690100,-133025,SELL
23-11-20 14:38,14:38,11044625,10368150,-676475,SELL
23-11-20 14:39,14:39,11240850,11055250,-185600,SELL
23-11-20 14:40,14:40,11484400,11531450,47050,BUY
23-11-20 14:41,14:41,11420075,11391725,-28350,SELL
23-11-20 14:42,14:42,11093500,11022000,-71500,SELL
23-11-20 14:43,14:43,11100725,11228725,128000,BUY
23-11-20 14:44,14:44,10994225,11128925,134700,BUY
23-11-20 14:45,14:45,11173500,10920775,-252725,SELL
23-11-20 14:46,14:46,10916475,11175650,259175,BUY
23-11-20 14:47,14:47,11242150,11208850,-33300,SELL
23-11-20 14:48,14:48,11357850,10782375,-575475,SELL
23-11-20 14:49,14:49,11275450,10727450,-548000,SELL
23-11-20 14:50,14:50,11246525,11137225,-109300,SELL
23-11-20 14:51,14:51,11088375,10917275,-171100,SELL
23-11-20 14:52,14:52,11335700,11187125,-148575,SELL
23-11-20 14:53,14:53,11390325,11448975,58650,BUY
23-11-20 14:54,14:54,11370375,11193700,-176675,SELL
23-11-20 14:55,14:55,11234850,10711375,-523475,SELL
23-11-20 14:56,14:56,11121950,10294625,-827325,SELL
23-11-20 14:57,14:57,11417600,11242200,-175400,SELL
23-11-20 14:58,14:58,11189025,11025575,-163450,SELL
23-11-20 14:59,14:59,11349025,11287725,-61300,SELL
23-11-20 15:00,15:00,11247475,10873850,-373625,SELL
23-11-20 15:01,15:01,11151400,11195725,44325,BUY
23-11-20 15:02,15:02,11291450,10707600,-583850,SELL
23-11-20 15:03,15:03,11237075,11030275,-206800,SELL
23-11-20 15:04,15:04,11009525,11111150,101625,BUY
23-11-20 15:05,15:05,11194075,11079050,-115025,SELL
23-11-20 15:06,15:06,11149550,10928800,-220750,SELL
23-11-20 15:07,15:07,11156050,10926950,-229100,SELL
23-11-20 15:08,15:08,11409800,10824975,-584825,SELL
23-11-20 15:09,15:09,11145650,10202875,-942775,SELL
23-11-20 15:10,15:10,11125125,10890225,-234900,SELL
23-11-20 15:11,15:11,11097100,11008500,-88600,SELL
23-11-20 15:12,15:12,11081200,10708850,-372350,SELL
23-11-20 15:13,15:13,11139425,10905975,-233450,SELL
23-11-20 15:14,15:14,10984700,10927875,-56825,SELL
23-11-20 15:15,15:15,11143225,10925100,-218125,SELL
23-11-20 15:16,15:16,11039475,10980950,-58525,SELL
23-11-20 15:17,15:17,11138425,10715575,-422850,SELL
23-11-20 15:18,15:18,11061675,10639650,-422025,SELL
23-11-20 15:19,15:19,10864025,10518600,-345425,SELL
23-11-20 15:20,15:20,11442350,10885300,-557050,SELL
23-11-20 15:21,15:21,11055500,9958625,-1096875,SELL
23-11-20 15:22,15:22,11084775,10569150,-515625,SELL
23-11-20 15:23,15:23,11089150,10630900,-458250,SELL
23-11-20 15:24,15:24,10792900,10522725,-270175,SELL
23-11-20 15:25,15:25,11089400,10384725,-704675,SELL
23-11-20 15:26,15:26,11088925,10467250,-621675,SELL
23-11-20 15:27,15:27,11121425,10438925,-682500,SELL
23-11-20 15:28,15:28,11069100,10440050,-629050,SELL
23-11-20 15:29,15:29,10925700,10615850,-309850,SELL
24-11-20 9:15,9:15,10720950,9580525,-1140425,SELL
24-11-20 9:16,9:16,10747350,9755425,-991925,SELL
24-11-20 9:17,9:17,10862125,9665925,-1196200,SELL
24-11-20 9:18,9:18,11193775,9873850,-1319925,SELL
24-11-20 9:19,9:19,10727625,10344575,-383050,SELL
24-11-20 9:20,9:20,11409950,10370225,-1039725,SELL
24-11-20 9:21,9:21,11162400,10441275,-721125,SELL
24-11-20 9:22,9:22,11079675,10493575,-586100,SELL
24-11-20 9:23,9:23,11106175,10832550,-273625,SELL
24-11-20 9:24,9:24,11254825,11018450,-236375,SELL
24-11-20 9:25,9:25,11196575,11163775,-32800,SELL
24-11-20 9:26,9:26,11045350,11348100,302750,BUY
24-11-20 9:27,9:27,11269350,11503875,234525,BUY
24-11-20 9:28,9:28,11244700,11033075,-211625,SELL
24-11-20 9:29,9:29,11268800,11559150,290350,BUY
24-11-20 9:30,9:30,11244575,11734550,489975,BUY
24-11-20 9:31,9:31,11219450,11814250,594800,BUY
24-11-20 9:32,9:32,11039475,11659250,619775,BUY
24-11-20 9:33,9:33,11039500,12056700,1017200,BUY
24-11-20 9:34,9:34,10913800,11978325,1064525,BUY
24-11-20 9:35,9:35,11227250,12166475,939225,BUY
24-11-20 9:36,9:36,11459675,12330500,870825,BUY
24-11-20 9:37,9:37,10950700,12211525,1260825,BUY
24-11-20 9:38,9:38,10760125,12118250,1358125,BUY
24-11-20 9:39,9:39,11004750,11880100,875350,BUY
24-11-20 9:40,9:40,11163000,12128975,965975,BUY
24-11-20 9:41,9:41,10875225,12494200,1618975,BUY
24-11-20 9:42,9:42,10858150,11970775,1112625,BUY
24-11-20 9:43,9:43,11098275,12356750,1258475,BUY
24-11-20 9:44,9:44,11040150,12471225,1431075,BUY
24-11-20 9:45,9:45,11001700,12304950,1303250,BUY
24-11-20 9:46,9:46,10883925,12198275,1314350,BUY
24-11-20 9:47,9:47,11057425,12241050,1183625,BUY
24-11-20 9:48,9:48,11027800,11909350,881550,BUY
24-11-20 9:49,9:49,11066950,12312625,1245675,BUY
24-11-20 9:50,9:50,11128375,11779400,651025,BUY
24-11-20 9:51,9:51,11144575,11880325,735750,BUY
24-11-20 9:52,9:52,11133125,12239300,1106175,BUY
24-11-20 9:53,9:53,11085650,12259750,1174100,BUY
24-11-20 9:54,9:54,10824725,12580700,1755975,BUY
24-11-20 9:55,9:55,11410275,12417350,1007075,BUY
24-11-20 9:56,9:56,11055875,12395525,1339650,BUY
24-11-20 9:57,9:57,11348775,12332350,983575,BUY
24-11-20 9:58,9:58,11407675,12465700,1058025,BUY
24-11-20 9:59,9:59,10956050,12061975,1105925,BUY
24-11-20 10:00,10:00,11253725,12213600,959875,BUY
24-11-20 10:01,10:01,10873225,12163925,1290700,BUY
24-11-20 10:02,10:02,10880075,12374950,1494875,BUY
24-11-20 10:03,10:03,10861675,12248100,1386425,BUY
24-11-20 10:04,10:04,10700275,12533775,1833500,BUY
24-11-20 10:05,10:05,10928175,12568800,1640625,BUY
24-11-20 10:06,10:06,10819050,12344825,1525775,BUY
24-11-20 10:07,10:07,10941375,12520275,1578900,BUY
24-11-20 10:08,10:08,10831325,12529250,1697925,BUY
24-11-20 10:09,10:09,10648600,12306700,1658100,BUY
24-11-20 10:10,10:10,11081075,12591550,1510475,BUY
24-11-20 10:11,10:11,10859400,12559250,1699850,BUY
24-11-20 10:12,10:12,10876900,12287100,1410200,BUY
24-11-20 10:13,10:13,10655750,12418875,1763125,BUY
24-11-20 10:14,10:14,11141625,12551400,1409775,BUY
24-11-20 10:15,10:15,11004350,12746600,1742250,BUY
24-11-20 10:16,10:16,10876775,12322725,1445950,BUY
24-11-20 10:17,10:17,10804050,12634925,1830875,BUY
24-11-20 10:18,10:18,10789375,12424125,1634750,BUY
24-11-20 10:19,10:19,10815525,12681350,1865825,BUY
24-11-20 10:20,10:20,10596775,12152025,1555250,BUY
24-11-20 10:21,10:21,10692400,12656350,1963950,BUY
24-11-20 10:22,10:22,10781675,12417925,1636250,BUY
24-11-20 10:23,10:23,10767575,12494550,1726975,BUY
24-11-20 10:24,10:24,10614625,12307625,1693000,BUY
24-11-20 10:25,10:25,11059975,13400925,2340950,BUY
24-11-20 10:26,10:26,10463950,12714875,2250925,BUY
24-11-20 10:27,10:27,10507250,12871275,2364025,BUY
24-11-20 10:28,10:28,10805150,12791700,1986550,BUY
24-11-20 10:29,10:29,10419300,12946675,2527375,BUY
24-11-20 10:30,10:30,10627525,12562575,1935050,BUY
24-11-20 10:31,10:31,10807475,13120500,2313025,BUY
24-11-20 10:32,10:32,11106425,13455700,2349275,BUY
24-11-20 10:33,10:33,11137400,13393450,2256050,BUY
24-11-20 10:34,10:34,10557100,12911000,2353900,BUY
24-11-20 10:35,10:35,10877000,13194525,2317525,BUY
24-11-20 10:36,10:36,10701925,12771500,2069575,BUY
24-11-20 10:37,10:37,10868450,12844700,1976250,BUY
24-11-20 10:38,10:38,10618050,12774325,2156275,BUY
24-11-20 10:39,10:39,10917850,13265075,2347225,BUY
24-11-20 10:40,10:40,10830575,13054325,2223750,BUY
24-11-20 10:41,10:41,10756150,12979475,2223325,BUY
24-11-20 10:42,10:42,10812775,13289900,2477125,BUY
24-11-20 10:43,10:43,10702025,12955100,2253075,BUY
24-11-20 10:44,10:44,10949575,12829150,1879575,BUY
24-11-20 10:45,10:45,10648600,13552600,2904000,BUY
24-11-20 10:46,10:46,10701675,12807475,2105800,BUY
24-11-20 10:47,10:47,10809175,12844775,2035600,BUY
24-11-20 10:48,10:48,10894725,13097150,2202425,BUY
24-11-20 10:49,10:49,11143775,13793625,2649850,BUY
24-11-20 10:50,10:50,10732075,13437675,2705600,BUY
24-11-20 10:51,10:51,10466225,12556125,2089900,BUY
24-11-20 10:52,10:52,10860500,13353700,2493200,BUY
24-11-20 10:53,10:53,10614050,13148850,2534800,BUY
24-11-20 10:54,10:54,10302675,13077700,2775025,BUY
24-11-20 10:55,10:55,10872900,13639000,2766100,BUY
24-11-20 10:56,10:56,10424600,13028850,2604250,BUY
24-11-20 10:57,10:57,10618350,13625475,3007125,BUY
24-11-20 10:58,10:58,10657075,13563125,2906050,BUY
24-11-20 10:59,10:59,10434975,13427825,2992850,BUY
24-11-20 11:00,11:00,10879575,13190350,2310775,BUY
24-11-20 11:01,11:01,10388225,12965375,2577150,BUY
24-11-20 11:02,11:02,10748025,13890850,3142825,BUY
24-11-20 11:03,11:03,10675775,13597775,2922000,BUY
24-11-20 11:04,11:04,10719525,13037775,2318250,BUY
24-11-20 11:05,11:05,10513600,13105475,2591875,BUY
24-11-20 11:06,11:06,10421500,12214850,1793350,BUY
24-11-20 11:07,11:07,10165025,13022825,2857800,BUY
24-11-20 11:08,11:08,10949500,13714525,2765025,BUY
24-11-20 11:09,11:09,10539200,12555350,2016150,BUY
24-11-20 11:10,11:10,10447225,11973500,1526275,BUY
24-11-20 11:11,11:11,10481150,12898700,2417550,BUY
24-11-20 11:12,11:12,10818725,13504525,2685800,BUY
24-11-20 11:13,11:13,10409400,13350450,2941050,BUY
24-11-20 11:14,11:14,10239325,13147425,2908100,BUY
24-11-20 11:15,11:15,10469375,13345700,2876325,BUY
24-11-20 11:16,11:16,10641900,13162550,2520650,BUY
24-11-20 11:17,11:17,10908575,13201500,2292925,BUY
24-11-20 11:18,11:18,10848575,13189525,2340950,BUY
24-11-20 11:19,11:19,10458600,13141325,2682725,BUY
24-11-20 11:20,11:20,10675575,13215875,2540300,BUY
24-11-20 11:21,11:21,10766425,13577850,2811425,BUY
24-11-20 11:22,11:22,10572600,13156300,2583700,BUY
24-11-20 11:23,11:23,10889650,13524125,2634475,BUY
24-11-20 11:24,11:24,10683925,13177225,2493300,BUY
24-11-20 11:25,11:25,10611450,13145300,2533850,BUY
24-11-20 11:26,11:26,10654625,13432500,2777875,BUY
24-11-20 11:27,11:27,11079050,12554825,1475775,BUY
24-11-20 11:28,11:28,10782500,12236825,1454325,BUY
24-11-20 11:29,11:29,11377575,13484925,2107350,BUY
24-11-20 11:30,11:30,10794425,13414250,2619825,BUY
24-11-20 11:31,11:31,11154450,13922250,2767800,BUY
24-11-20 11:32,11:32,10751375,13749525,2998150,BUY
24-11-20 11:33,11:33,11066250,13735125,2668875,BUY
24-11-20 11:34,11:34,10726050,13792225,3066175,BUY
24-11-20 11:35,11:35,11084800,13743350,2658550,BUY
24-11-20 11:36,11:36,10915650,13774275,2858625,BUY
24-11-20 11:37,11:37,10927825,13821725,2893900,BUY
24-11-20 11:38,11:38,10560200,13564125,3003925,BUY
24-11-20 11:39,11:39,10586425,13483750,2897325,BUY
24-11-20 11:40,11:40,10351650,13334850,2983200,BUY
24-11-20 11:41,11:41,11164275,13872850,2708575,BUY
24-11-20 11:42,11:42,10978400,13720250,2741850,BUY
24-11-20 11:43,11:43,10520800,13830000,3309200,BUY
24-11-20 11:44,11:44,10533550,13841125,3307575,BUY
24-11-20 11:45,11:45,9884250,13770425,3886175,BUY
24-11-20 11:46,11:46,10470950,13633750,3162800,BUY
24-11-20 11:47,11:47,9904950,13642275,3737325,BUY
24-11-20 11:48,11:48,10982050,13518775,2536725,BUY
24-11-20 11:49,11:49,10622975,13554525,2931550,BUY
24-11-20 11:50,11:50,10720525,13811250,3090725,BUY
24-11-20 11:51,11:51,10673150,13193950,2520800,BUY
24-11-20 11:52,11:52,10966575,13909950,2943375,BUY
24-11-20 11:53,11:53,10765525,13756900,2991375,BUY
24-11-20 11:54,11:54,10971250,13854550,2883300,BUY
24-11-20 11:55,11:55,11495550,14328325,2832775,BUY
24-11-20 11:56,11:56,10547975,13742325,3194350,BUY
24-11-20 11:57,11:57,10608800,13955150,3346350,BUY
24-11-20 11:58,11:58,10457500,13483650,3026150,BUY
24-11-20 11:59,11:59,10900075,13572650,2672575,BUY
24-11-20 12:00,12:00,10800900,13963400,3162500,BUY
24-11-20 12:01,12:01,10866000,14148700,3282700,BUY
24-11-20 12:02,12:02,10698500,14325150,3626650,BUY
24-11-20 12:03,12:03,10761225,14139775,3378550,BUY
24-11-20 12:04,12:04,10797750,14177375,3379625,BUY
24-11-20 12:05,12:05,10730900,13841175,3110275,BUY
24-11-20 12:06,12:06,10958525,14008625,3050100,BUY
24-11-20 12:07,12:07,11216225,14248475,3032250,BUY
24-11-20 12:08,12:08,10523650,14113450,3589800,BUY
24-11-20 12:09,12:09,10738250,13890125,3151875,BUY
24-11-20 12:10,12:10,10612725,13935100,3322375,BUY
24-11-20 12:11,12:11,10974075,13797500,2823425,BUY
24-11-20 12:12,12:12,10955600,13922800,2967200,BUY
24-11-20 12:13,12:13,10655525,13620625,2965100,BUY
24-11-20 12:14,12:14,10383875,13730425,3346550,BUY
24-11-20 12:15,12:15,10699300,13545650,2846350,BUY
24-11-20 12:16,12:16,10596500,13629075,3032575,BUY
24-11-20 12:17,12:17,10422700,13797675,3374975,BUY
24-11-20 12:18,12:18,11223075,14520800,3297725,BUY
24-11-20 12:19,12:19,10540225,13660350,3120125,BUY
24-11-20 12:20,12:20,10597250,13714325,3117075,BUY
24-11-20 12:21,12:21,10408150,13883000,3474850,BUY
24-11-20 12:22,12:22,10553150,13712925,3159775,BUY
24-11-20 12:23,12:23,10658425,13440750,2782325,BUY
24-11-20 12:24,12:24,10869350,14009650,3140300,BUY
24-11-20 12:25,12:25,10254100,13239100,2985000,BUY
24-11-20 12:26,12:26,11031450,14258500,3227050,BUY
24-11-20 12:27,12:27,10473625,13840250,3366625,BUY
24-11-20 12:28,12:28,10406700,13522650,3115950,BUY
24-11-20 12:29,12:29,10462575,13651075,3188500,BUY
24-11-20 12:30,12:30,10950225,13503175,2552950,BUY
24-11-20 12:31,12:31,11471750,14298300,2826550,BUY
24-11-20 12:32,12:32,10829550,13650325,2820775,BUY
24-11-20 12:33,12:33,10818600,14003975,3185375,BUY
24-11-20 12:34,12:34,10682950,14113725,3430775,BUY
24-11-20 12:35,12:35,10738000,14169125,3431125,BUY
24-11-20 12:36,12:36,10759800,14217400,3457600,BUY
24-11-20 12:37,12:37,10759800,14532225,3772425,BUY
24-11-20 12:38,12:38,10745625,13981125,3235500,BUY
24-11-20 12:39,12:39,10972725,13890250,2917525,BUY
24-11-20 12:40,12:40,10863175,13658825,2795650,BUY
24-11-20 12:41,12:41,10526850,13781850,3255000,BUY
24-11-20 12:42,12:42,10641550,13863125,3221575,BUY
24-11-20 12:43,12:43,10615975,13011900,2395925,BUY
24-11-20 12:44,12:44,11516175,14326125,2809950,BUY
24-11-20 12:45,12:45,11109525,13749750,2640225,BUY
24-11-20 12:46,12:46,10918925,13785350,2866425,BUY
24-11-20 12:47,12:47,10914550,13616100,2701550,BUY
24-11-20 12:48,12:48,10736625,13181925,2445300,BUY
24-11-20 12:49,12:49,10856750,13852525,2995775,BUY
24-11-20 12:50,12:50,11124650,13869150,2744500,BUY
24-11-20 12:51,12:51,11048800,13351700,2302900,BUY
24-11-20 12:52,12:52,10948300,13656925,2708625,BUY
24-11-20 12:53,12:53,10899750,13385000,2485250,BUY
24-11-20 12:54,12:54,10760825,13383975,2623150,BUY
24-11-20 12:55,12:55,10973625,13777525,2803900,BUY
24-11-20 12:56,12:56,10820125,13840450,3020325,BUY
24-11-20 12:57,12:57,11271525,13732950,2461425,BUY
24-11-20 12:58,12:58,10881750,13246850,2365100,BUY
24-11-20 12:59,12:59,10929350,13498425,2569075,BUY
24-11-20 13:00,13:00,10997625,13739425,2741800,BUY
24-11-20 13:01,13:01,11145025,14298525,3153500,BUY
24-11-20 13:02,13:02,10895225,13403975,2508750,BUY
24-11-20 13:03,13:03,10717975,13464050,2746075,BUY
24-11-20 13:04,13:04,10804175,13451400,2647225,BUY
24-11-20 13:05,13:05,10918900,13779600,2860700,BUY
24-11-20 13:06,13:06,11172025,13806600,2634575,BUY
24-11-20 13:07,13:07,10844075,13621425,2777350,BUY
24-11-20 13:08,13:08,10907525,13639075,2731550,BUY
24-11-20 13:09,13:09,10824375,13112850,2288475,BUY
24-11-20 13:10,13:10,10707475,12562550,1855075,BUY
24-11-20 13:11,13:11,10721050,13290175,2569125,BUY
24-11-20 13:12,13:12,11364650,13239775,1875125,BUY
24-11-20 13:13,13:13,10866450,13245750,2379300,BUY
24-11-20 13:14,13:14,10895975,13347950,2451975,BUY
24-11-20 13:15,13:15,10745450,13294650,2549200,BUY
24-11-20 13:16,13:16,11145450,13070725,1925275,BUY
24-11-20 13:17,13:17,11407775,13687175,2279400,BUY
24-11-20 13:18,13:18,11045600,13951575,2905975,BUY
24-11-20 13:19,13:19,11297625,13650975,2353350,BUY
24-11-20 13:20,13:20,10868125,13571425,2703300,BUY
24-11-20 13:21,13:21,11375375,13131125,1755750,BUY
24-11-20 13:22,13:22,10818250,12763700,1945450,BUY
24-11-20 13:23,13:23,10973650,13219650,2246000,BUY
24-11-20 13:24,13:24,10840650,12922575,2081925,BUY
24-11-20 13:25,13:25,10965700,13162850,2197150,BUY
24-11-20 13:26,13:26,11422600,13558325,2135725,BUY
24-11-20 13:27,13:27,11108625,13725550,2616925,BUY
24-11-20 13:28,13:28,10928450,13269225,2340775,BUY
24-11-20 13:29,13:29,11289325,13193275,1903950,BUY
24-11-20 13:30,13:30,11470650,13363150,1892500,BUY
24-11-20 13:31,13:31,11017550,13277550,2260000,BUY
24-11-20 13:32,13:32,11097750,13618350,2520600,BUY
24-11-20 13:33,13:33,11085975,13495225,2409250,BUY
24-11-20 13:34,13:34,10892150,13504775,2612625,BUY
24-11-20 13:35,13:35,11127800,13685325,2557525,BUY
24-11-20 13:36,13:36,11079650,13614650,2535000,BUY
24-11-20 13:37,13:37,11135600,13638050,2502450,BUY
24-11-20 13:38,13:38,10927025,13373275,2446250,BUY
24-11-20 13:39,13:39,10935950,13757550,2821600,BUY
24-11-20 13:40,13:40,11062950,13763900,2700950,BUY
24-11-20 13:41,13:41,11133650,13131300,1997650,BUY
24-11-20 13:42,13:42,11188700,13022800,1834100,BUY
24-11-20 13:43,13:43,10847775,13677575,2829800,BUY
24-11-20 13:44,13:44,11254725,13318150,2063425,BUY
24-11-20 13:45,13:45,11365075,13520875,2155800,BUY
24-11-20 13:46,13:46,11115450,13309975,2194525,BUY
24-11-20 13:47,13:47,11350300,13506775,2156475,BUY
24-11-20 13:48,13:48,11074000,12815525,1741525,BUY
24-11-20 13:49,13:49,10712600,12879975,2167375,BUY
24-11-20 13:50,13:50,11134025,13537075,2403050,BUY
24-11-20 13:51,13:51,11110075,13745600,2635525,BUY
24-11-20 13:52,13:52,11011425,13221900,2210475,BUY
24-11-20 13:53,13:53,11169600,13116775,1947175,BUY
24-11-20 13:54,13:54,11591925,13853150,2261225,BUY
24-11-20 13:55,13:55,11493125,13426475,1933350,BUY
24-11-20 13:56,13:56,10940500,13080775,2140275,BUY
24-11-20 13:57,13:57,11038825,13478475,2439650,BUY
24-11-20 13:58,13:58,11008825,13340075,2331250,BUY
24-11-20 13:59,13:59,11312075,13986450,2674375,BUY
24-11-20 14:00,14:00,11003550,13454725,2451175,BUY
24-11-20 14:01,14:01,11376700,13721600,2344900,BUY
24-11-20 14:02,14:02,11268050,13513750,2245700,BUY
24-11-20 14:03,14:03,11109275,13294325,2185050,BUY
24-11-20 14:04,14:04,10999450,13388850,2389400,BUY
24-11-20 14:05,14:05,11459075,13293000,1833925,BUY
24-11-20 14:06,14:06,11261275,13402525,2141250,BUY
24-11-20 14:07,14:07,11110525,13281050,2170525,BUY
24-11-20 14:08,14:08,11306125,13599475,2293350,BUY
24-11-20 14:09,14:09,10876375,12622500,1746125,BUY
24-11-20 14:10,14:10,11168250,13331850,2163600,BUY
24-11-20 14:11,14:11,11187550,13147000,1959450,BUY
24-11-20 14:12,14:12,11622300,13539000,1916700,BUY
24-11-20 14:13,14:13,11231300,12335600,1104300,BUY
24-11-20 14:14,14:14,11182650,13731875,2549225,BUY
24-11-20 14:15,14:15,11061550,12795575,1734025,BUY
24-11-20 14:16,14:16,10922150,12976300,2054150,BUY
24-11-20 14:17,14:17,11179825,12893975,1714150,BUY
24-11-20 14:18,14:18,11495100,14055100,2560000,BUY
24-11-20 14:19,14:19,11178700,13095800,1917100,BUY
24-11-20 14:20,14:20,11724775,13642325,1917550,BUY
24-11-20 14:21,14:21,10889975,13655875,2765900,BUY
24-11-20 14:22,14:22,10768100,13419150,2651050,BUY
24-11-20 14:23,14:23,10727025,13536225,2809200,BUY
24-11-20 14:24,14:24,10784800,13130525,2345725,BUY
24-11-20 14:25,14:25,10676475,13371000,2694525,BUY
24-11-20 14:26,14:26,10855125,13374950,2519825,BUY
24-11-20 14:27,14:27,10865925,13300675,2434750,BUY
24-11-20 14:28,14:28,10553975,13117175,2563200,BUY
24-11-20 14:29,14:29,11011575,13257575,2246000,BUY
24-11-20 14:30,14:30,11042450,13668550,2626100,BUY
24-11-20 14:31,14:31,10999800,13139975,2140175,BUY
24-11-20 14:32,14:32,10532450,13161375,2628925,BUY
24-11-20 14:33,14:33,10727125,13658900,2931775,BUY
24-11-20 14:34,14:34,10721525,13458700,2737175,BUY
24-11-20 14:35,14:35,10990500,13716100,2725600,BUY
24-11-20 14:36,14:36,10250875,13896275,3645400,BUY
24-11-20 14:37,14:37,10094600,13176000,3081400,BUY
24-11-20 14:38,14:38,10123575,13227100,3103525,BUY
24-11-20 14:39,14:39,10041425,12714100,2672675,BUY
24-11-20 14:40,14:40,9930225,13475550,3545325,BUY
24-11-20 14:41,14:41,9884650,13176725,3292075,BUY
24-11-20 14:42,14:42,10024850,13363050,3338200,BUY
24-11-20 14:43,14:43,9826450,13366925,3540475,BUY
24-11-20 14:44,14:44,10298800,13220550,2921750,BUY
24-11-20 14:45,14:45,9842050,13277725,3435675,BUY
24-11-20 14:46,14:46,10336825,13550550,3213725,BUY
24-11-20 14:47,14:47,9909025,13482625,3573600,BUY
24-11-20 14:48,14:48,9758650,13957975,4199325,BUY
24-11-20 14:49,14:49,9730275,13422300,3692025,BUY
24-11-20 14:50,14:50,9769650,13503000,3733350,BUY
24-11-20 14:51,14:51,9813200,13448675,3635475,BUY
24-11-20 14:52,14:52,9846700,13576725,3730025,BUY
24-11-20 14:53,14:53,9744875,13607850,3862975,BUY
24-11-20 14:54,14:54,10022100,13349850,3327750,BUY
24-11-20 14:55,14:55,9676375,13356675,3680300,BUY
24-11-20 14:56,14:56,9728125,13251850,3523725,BUY
24-11-20 14:57,14:57,9740450,13203050,3462600,BUY
24-11-20 14:58,14:58,9669025,13324900,3655875,BUY
24-11-20 14:59,14:59,9759875,13326700,3566825,BUY
24-11-20 15:00,15:00,9598375,13256700,3658325,BUY
24-11-20 15:01,15:01,9264150,13320000,4055850,BUY
24-11-20 15:02,15:02,9583550,12932400,3348850,BUY
24-11-20 15:03,15:03,9479675,13156000,3676325,BUY
24-11-20 15:04,15:04,9464325,13177600,3713275,BUY
24-11-20 15:05,15:05,9355050,13153775,3798725,BUY
24-11-20 15:06,15:06,9477050,12664900,3187850,BUY
24-11-20 15:07,15:07,9399825,12474650,3074825,BUY
24-11-20 15:08,15:08,9318500,12962525,3644025,BUY
24-11-20 15:09,15:09,9142250,13386650,4244400,BUY
24-11-20 15:10,15:10,9441100,13186100,3745000,BUY
24-11-20 15:11,15:11,8915700,13052450,4136750,BUY
24-11-20 15:12,15:12,9152925,12927575,3774650,BUY
24-11-20 15:13,15:13,9351475,13216725,3865250,BUY
24-11-20 15:14,15:14,9525175,13079575,3554400,BUY
24-11-20 15:15,15:15,8914025,12973750,4059725,BUY
24-11-20 15:16,15:16,8995900,13378150,4382250,BUY
24-11-20 15:17,15:17,9283025,13187025,3904000,BUY
24-11-20 15:18,15:18,9089225,13045550,3956325,BUY
24-11-20 15:19,15:19,9116350,12732125,3615775,BUY
24-11-20 15:20,15:20,9434950,13208300,3773350,BUY
24-11-20 15:21,15:21,8936025,12282150,3346125,BUY
24-11-20 15:22,15:22,8697300,12721775,4024475,BUY
24-11-20 15:23,15:23,8518275,12768525,4250250,BUY
24-11-20 15:24,15:24,8653025,12522300,3869275,BUY
24-11-20 15:25,15:25,8762375,12704900,3942525,BUY
24-11-20 15:26,15:26,8297150,12606025,4308875,BUY
24-11-20 15:27,15:27,8595150,12379375,3784225,BUY
24-11-20 15:28,15:28,8305125,12174700,3869575,BUY
24-11-20 15:29,15:29,8274075,12723000,4448925,BUY
25-11-20 9:15,9:15,8219175,10968050,2748875,BUY
25-11-20 9:16,9:16,7987200,11492075,3504875,BUY
25-11-20 9:17,9:17,8453050,11850250,3397200,BUY
25-11-20 9:18,9:18,8199525,12089925,3890400,BUY
25-11-20 9:19,9:19,8388675,11949325,3560650,BUY
25-11-20 9:20,9:20,8907125,12495325,3588200,BUY
25-11-20 9:21,9:21,9065700,12879800,3814100,BUY
25-11-20 9:22,9:22,9043000,12648025,3605025,BUY
25-11-20 9:23,9:23,9402475,13176775,3774300,BUY
25-11-20 9:24,9:24,9190275,13129975,3939700,BUY
25-11-20 9:25,9:25,9484850,13003150,3518300,BUY
25-11-20 9:26,9:26,9787500,13609950,3822450,BUY
25-11-20 9:27,9:27,9445850,13755650,4309800,BUY
25-11-20 9:28,9:28,9789950,13642925,3852975,BUY
25-11-20 9:29,9:29,10114700,13750450,3635750,BUY
25-11-20 9:30,9:30,9995275,13149475,3154200,BUY
25-11-20 9:31,9:31,10156550,13660850,3504300,BUY
25-11-20 9:32,9:32,10144250,13605450,3461200,BUY
25-11-20 9:33,9:33,10500650,13719350,3218700,BUY
25-11-20 9:34,9:34,10422550,13162975,2740425,BUY
25-11-20 9:35,9:35,10419950,13421450,3001500,BUY
25-11-20 9:36,9:36,10551725,13388075,2836350,BUY
25-11-20 9:37,9:37,10532025,13612075,3080050,BUY
25-11-20 9:38,9:38,10730175,13769050,3038875,BUY
25-11-20 9:39,9:39,10368225,14313150,3944925,BUY
25-11-20 9:40,9:40,10593500,13934675,3341175,BUY
25-11-20 9:41,9:41,10666975,13881825,3214850,BUY
25-11-20 9:42,9:42,10630550,14231775,3601225,BUY
25-11-20 9:43,9:43,10554575,13861225,3306650,BUY
25-11-20 9:44,9:44,10922000,14410150,3488150,BUY
25-11-20 9:45,9:45,10832850,14290450,3457600,BUY
25-11-20 9:46,9:46,10732375,14181000,3448625,BUY
25-11-20 9:47,9:47,10261200,14352850,4091650,BUY
25-11-20 9:48,9:48,10401025,14536425,4135400,BUY
25-11-20 9:49,9:49,10422450,14235425,3812975,BUY
25-11-20 9:50,9:50,10236450,14467075,4230625,BUY
25-11-20 9:51,9:51,10644350,14685725,4041375,BUY
25-11-20 9:52,9:52,10699400,15130400,4431000,BUY
25-11-20 9:53,9:53,10691350,14696175,4004825,BUY
25-11-20 9:54,9:54,10615600,14823250,4207650,BUY
25-11-20 9:55,9:55,10518000,14534250,4016250,BUY
25-11-20 9:56,9:56,10722025,14884375,4162350,BUY
25-11-20 9:57,9:57,10395550,14770275,4374725,BUY
25-11-20 9:58,9:58,10428375,14815300,4386925,BUY
25-11-20 9:59,9:59,10769800,14709575,3939775,BUY
25-11-20 10:00,10:00,10750250,15167550,4417300,BUY
25-11-20 10:01,10:01,10587200,14773625,4186425,BUY
25-11-20 10:02,10:02,10673450,15032125,4358675,BUY
25-11-20 10:03,10:03,10661575,14818425,4156850,BUY
25-11-20 10:04,10:04,10786900,14850300,4063400,BUY
25-11-20 10:05,10:05,11063675,15218950,4155275,BUY
25-11-20 10:06,10:06,10804450,15297100,4492650,BUY
25-11-20 10:07,10:07,11165050,14429500,3264450,BUY
25-11-20 10:08,10:08,11302525,15176250,3873725,BUY
25-11-20 10:09,10:09,10914500,15173250,4258750,BUY
25-11-20 10:10,10:10,10908425,14791925,3883500,BUY
25-11-20 10:11,10:11,11459050,15040650,3581600,BUY
25-11-20 10:12,10:12,11027950,14695025,3667075,BUY
25-11-20 10:13,10:13,11224875,15095075,3870200,BUY
25-11-20 10:14,10:14,11201200,15200175,3998975,BUY
25-11-20 10:15,10:15,10927775,14934450,4006675,BUY
25-11-20 10:16,10:16,11080575,15299175,4218600,BUY
25-11-20 10:17,10:17,11060225,15293275,4233050,BUY
25-11-20 10:18,10:18,11028950,14836200,3807250,BUY
25-11-20 10:19,10:19,11060550,14986150,3925600,BUY
25-11-20 10:20,10:20,11386850,14900250,3513400,BUY
25-11-20 10:21,10:21,11335950,15105575,3769625,BUY
25-11-20 10:22,10:22,11448425,14521800,3073375,BUY
25-11-20 10:26,10:26,11828150,15333300,3505150,BUY
25-11-20 10:27,10:27,11707575,15285825,3578250,BUY
25-11-20 10:28,10:28,11934925,15268800,3333875,BUY
25-11-20 10:29,10:29,12513100,14978825,2465725,BUY
25-11-20 10:30,10:30,12288950,14777600,2488650,BUY
25-11-20 10:31,10:31,12035425,14924750,2889325,BUY
25-11-20 10:32,10:32,12065825,14550875,2485050,BUY
25-11-20 10:33,10:33,11955475,14731000,2775525,BUY
25-11-20 10:34,10:34,11941400,14579750,2638350,BUY
25-11-20 10:35,10:35,11696650,14198825,2502175,BUY
25-11-20 10:36,10:36,11812550,14774750,2962200,BUY
25-11-20 10:37,10:37,12001125,14800300,2799175,BUY
25-11-20 10:38,10:38,12361025,14655225,2294200,BUY
25-11-20 10:39,10:39,11884875,14564025,2679150,BUY
25-11-20 10:40,10:40,12421125,14746225,2325100,BUY
25-11-20 10:41,10:41,12040675,14453425,2412750,BUY
25-11-20 10:42,10:42,12354550,14803500,2448950,BUY
25-11-20 10:43,10:43,12569150,14689850,2120700,BUY
25-11-20 10:44,10:44,12443100,14300575,1857475,BUY
25-11-20 10:45,10:45,12977025,14766000,1788975,BUY
25-11-20 10:46,10:46,12576625,14377200,1800575,BUY
25-11-20 10:47,10:47,12308425,14302325,1993900,BUY
25-11-20 10:48,10:48,12183500,14470075,2286575,BUY
25-11-20 10:49,10:49,12264675,14556175,2291500,BUY
25-11-20 10:50,10:50,12411050,14446975,2035925,BUY
25-11-20 10:51,10:51,12284325,14175125,1890800,BUY
25-11-20 10:52,10:52,12385150,14009200,1624050,BUY
25-11-20 10:53,10:53,12496250,14115950,1619700,BUY
25-11-20 10:54,10:54,12574600,14962025,2387425,BUY
25-11-20 10:55,10:55,12537125,14883450,2346325,BUY
25-11-20 10:56,10:56,12681425,14654575,1973150,BUY
25-11-20 10:57,10:57,12401700,14251950,1850250,BUY
25-11-20 10:58,10:58,12332800,14121025,1788225,BUY
25-11-20 10:59,10:59,12591950,14177075,1585125,BUY
25-11-20 11:00,11:00,12838325,14363600,1525275,BUY
25-11-20 11:01,11:01,12899350,14669475,1770125,BUY
25-11-20 11:02,11:02,13342475,14610650,1268175,BUY
25-11-20 11:03,11:03,12810150,14839975,2029825,BUY
25-11-20 11:04,11:04,12829475,14146550,1317075,BUY
25-11-20 11:05,11:05,13043250,14682350,1639100,BUY
25-11-20 11:06,11:06,12922225,14510150,1587925,BUY
25-11-20 11:07,11:07,12705850,14772850,2067000,BUY
25-11-20 11:08,11:08,13069925,14215675,1145750,BUY
25-11-20 11:09,11:09,13120100,14455950,1335850,BUY
25-11-20 11:10,11:10,13128975,14297150,1168175,BUY
25-11-20 11:11,11:11,13612500,14677500,1065000,BUY
25-11-20 11:12,11:12,12954575,15138775,2184200,BUY
25-11-20 11:13,11:13,12798650,14733150,1934500,BUY
25-11-20 11:14,11:14,13167475,14525325,1357850,BUY
25-11-20 11:15,11:15,13224225,14292950,1068725,BUY
25-11-20 11:16,11:16,13415550,14905100,1489550,BUY
25-11-20 11:17,11:17,13411000,14487825,1076825,BUY
25-11-20 11:18,11:18,13026675,14535000,1508325,BUY
25-11-20 11:19,11:19,13177850,14529075,1351225,BUY
25-11-20 11:20,11:20,13123975,14328400,1204425,BUY
25-11-20 11:21,11:21,13352575,14142975,790400,BUY
25-11-20 11:22,11:22,12957225,13816825,859600,BUY
25-11-20 11:23,11:23,13519325,13971975,452650,BUY
25-11-20 11:24,11:24,13768175,14637625,869450,BUY
25-11-20 11:25,11:25,13135575,13700850,565275,BUY
25-11-20 11:26,11:26,13520575,14443875,923300,BUY
25-11-20 11:27,11:27,13173950,13336250,162300,BUY
25-11-20 11:28,11:28,13317175,13968500,651325,BUY
25-11-20 11:29,11:29,13604675,13985175,380500,BUY
25-11-20 11:30,11:30,13506825,14595125,1088300,BUY
25-11-20 11:31,11:31,13688925,14511400,822475,BUY
25-11-20 11:32,11:32,13756100,14010500,254400,BUY
25-11-20 11:33,11:33,13270550,14861250,1590700,BUY
25-11-20 11:34,11:34,13505750,14332200,826450,BUY
25-11-20 11:35,11:35,13507425,13953725,446300,BUY
25-11-20 11:36,11:36,13543400,14218575,675175,BUY
25-11-20 11:37,11:37,13576575,14169375,592800,BUY
25-11-20 11:38,11:38,13533300,14018625,485325,BUY
25-11-20 11:39,11:39,13604325,14302400,698075,BUY
25-11-20 11:40,11:40,13962650,14916775,954125,BUY
25-11-20 11:41,11:41,13647875,14322525,674650,BUY
25-11-20 11:42,11:42,13581650,13962625,380975,BUY
25-11-20 11:43,11:43,13689700,14119250,429550,BUY
25-11-20 11:44,11:44,13641325,13998400,357075,BUY
25-11-20 11:45,11:45,13722250,13796325,74075,BUY
25-11-20 11:46,11:46,13780675,13772700,-7975,SELL
25-11-20 11:47,11:47,13859550,14268425,408875,BUY
25-11-20 11:48,11:48,13797000,13829275,32275,BUY
25-11-20 11:49,11:49,13846825,13939425,92600,BUY
25-11-20 11:50,11:50,14121050,14370475,249425,BUY
25-11-20 11:51,11:51,14005350,14413625,408275,BUY
25-11-20 11:52,11:52,14144350,13627325,-517025,SELL
25-11-20 11:53,11:53,13845150,13737500,-107650,SELL
25-11-20 11:54,11:54,13811475,14245775,434300,BUY
25-11-20 11:55,11:55,14202400,13836525,-365875,SELL
25-11-20 11:56,11:56,14103600,13938650,-164950,SELL
25-11-20 11:57,11:57,13985725,13905025,-80700,SELL
25-11-20 11:58,11:58,13918225,13676450,-241775,SELL
25-11-20 11:59,11:59,14190575,13705050,-485525,SELL
25-11-20 12:00,12:00,14003575,14185325,181750,BUY
25-11-20 12:01,12:01,14492250,13897700,-594550,SELL
25-11-20 12:02,12:02,14001300,13774100,-227200,SELL
25-11-20 12:03,12:03,13868350,14242275,373925,BUY
25-11-20 12:04,12:04,14027125,14388925,361800,BUY
25-11-20 12:05,12:05,14099075,13617000,-482075,SELL
25-11-20 12:06,12:06,14155325,14443950,288625,BUY
25-11-20 12:07,12:07,14117375,13883250,-234125,SELL
25-11-20 12:08,12:08,13727225,13697925,-29300,SELL
25-11-20 12:09,12:09,13702550,13427250,-275300,SELL
25-11-20 12:10,12:10,14297175,14809800,512625,BUY
25-11-20 12:11,12:11,14468475,14112750,-355725,SELL
25-11-20 12:12,12:12,14198675,14584300,385625,BUY
25-11-20 12:13,12:13,14044000,14677875,633875,BUY
25-11-20 12:14,12:14,14319000,14547250,228250,BUY
25-11-20 12:15,12:15,13950425,14416025,465600,BUY
25-11-20 12:16,12:16,14089225,14338600,249375,BUY
25-11-20 12:17,12:17,14549425,14586075,36650,BUY
25-11-20 12:18,12:18,14186075,14592175,406100,BUY
25-11-20 12:19,12:19,14782550,14765425,-17125,SELL
25-11-20 12:20,12:20,14903000,14245575,-657425,SELL
25-11-20 12:21,12:21,14753900,14223725,-530175,SELL
25-11-20 12:22,12:22,14432375,13833825,-598550,SELL
25-11-20 12:23,12:23,14614300,13923375,-690925,SELL
25-11-20 12:24,12:24,14230750,13740150,-490600,SELL
25-11-20 12:25,12:25,14737600,14325700,-411900,SELL
25-11-20 12:26,12:26,14499350,14561725,62375,BUY
25-11-20 12:27,12:27,14280100,14258675,-21425,SELL
25-11-20 12:28,12:28,14368575,14420650,52075,BUY
25-11-20 12:29,12:29,14462475,14141850,-320625,SELL
25-11-20 12:30,12:30,14200350,14350075,149725,BUY
25-11-20 12:31,12:31,14511525,14027350,-484175,SELL
25-11-20 12:32,12:32,14306725,14154850,-151875,SELL
25-11-20 12:33,12:33,14562300,14057900,-504400,SELL
25-11-20 12:34,12:34,14378800,13973375,-405425,SELL
25-11-20 12:35,12:35,14020225,14331750,311525,BUY
25-11-20 12:36,12:36,14569875,14247050,-322825,SELL
25-11-20 12:37,12:37,14394200,14498725,104525,BUY
25-11-20 12:38,12:38,14185950,14044575,-141375,SELL
25-11-20 12:39,12:39,13966900,14158250,191350,BUY
25-11-20 12:40,12:40,14387125,13991625,-395500,SELL
25-11-20 12:41,12:41,14376125,13730675,-645450,SELL
25-11-20 12:42,12:42,14304475,13994650,-309825,SELL
25-11-20 12:43,12:43,14947225,14812025,-135200,SELL
25-11-20 12:44,12:44,14113025,14028575,-84450,SELL
25-11-20 12:45,12:45,14040600,13920750,-119850,SELL
25-11-20 12:46,12:46,14133275,13933675,-199600,SELL
25-11-20 12:47,12:47,14065350,14467550,402200,BUY
25-11-20 12:48,12:48,14212825,14063525,-149300,SELL
25-11-20 12:49,12:49,13965250,14121925,156675,BUY
25-11-20 12:50,12:50,14280850,14176625,-104225,SELL
25-11-20 12:51,12:51,14675275,14248425,-426850,SELL
25-11-20 12:52,12:52,14405450,14226075,-179375,SELL
25-11-20 12:53,12:53,14052275,13449225,-603050,SELL
25-11-20 12:54,12:54,14462425,13735450,-726975,SELL
25-11-20 12:55,12:55,14562400,14365050,-197350,SELL
25-11-20 12:56,12:56,14326225,13782600,-543625,SELL
25-11-20 12:57,12:57,14291475,14231600,-59875,SELL
25-11-20 12:58,12:58,14564375,14173525,-390850,SELL
25-11-20 12:59,12:59,14479100,13527250,-951850,SELL
25-11-20 13:00,13:00,14188525,13720850,-467675,SELL
25-11-20 13:01,13:01,14391425,14147700,-243725,SELL
25-11-20 13:02,13:02,14355925,14616775,260850,BUY
25-11-20 13:03,13:03,14427300,14496225,68925,BUY
25-11-20 13:04,13:04,14605425,14879450,274025,BUY
25-11-20 13:05,13:05,14430075,14703675,273600,BUY
25-11-20 13:06,13:06,14158150,14055850,-102300,SELL
25-11-20 13:07,13:07,14336250,14321150,-15100,SELL
25-11-20 13:08,13:08,14298850,13708375,-590475,SELL
25-11-20 13:09,13:09,14632200,14791950,159750,BUY
25-11-20 13:10,13:10,14530850,14233625,-297225,SELL
25-11-20 13:11,13:11,14643525,14054550,-588975,SELL
25-11-20 13:12,13:12,14492725,14206525,-286200,SELL
25-11-20 13:13,13:13,14516775,14181725,-335050,SELL
25-11-20 13:14,13:14,14165950,13691875,-474075,SELL
25-11-20 13:15,13:15,14472350,14246700,-225650,SELL
25-11-20 13:16,13:16,14419350,14373775,-45575,SELL
25-11-20 13:17,13:17,14703475,13893850,-809625,SELL
25-11-20 13:18,13:18,14865000,14188400,-676600,SELL
25-11-20 13:19,13:19,15179750,14473450,-706300,SELL
25-11-20 13:20,13:20,14895225,14953400,58175,BUY
25-11-20 13:21,13:21,14398550,14211650,-186900,SELL
25-11-20 13:22,13:22,14452225,13922600,-529625,SELL
25-11-20 13:23,13:23,14348875,14079025,-269850,SELL
25-11-20 13:24,13:24,14568700,14241950,-326750,SELL
25-11-20 13:25,13:25,14433475,14324800,-108675,SELL
25-11-20 13:26,13:26,14462350,13789925,-672425,SELL
25-11-20 13:27,13:27,14329300,13674425,-654875,SELL
25-11-20 13:28,13:28,14376100,13784325,-591775,SELL
25-11-20 13:29,13:29,14308000,14476900,168900,BUY
25-11-20 13:30,13:30,14509425,14121375,-388050,SELL
25-11-20 13:31,13:31,14401925,14118000,-283925,SELL
25-11-20 13:32,13:32,14623000,14156075,-466925,SELL
25-11-20 13:33,13:33,14495875,14437125,-58750,SELL
25-11-20 13:34,13:34,14435650,14162925,-272725,SELL
25-11-20 13:35,13:35,14692100,14173450,-518650,SELL
25-11-20 13:36,13:36,14798550,14333425,-465125,SELL
25-11-20 13:37,13:37,14714675,13773925,-940750,SELL
25-11-20 13:38,13:38,14633250,14139250,-494000,SELL
25-11-20 13:39,13:39,14724525,14046375,-678150,SELL
25-11-20 13:40,13:40,14729400,14426400,-303000,SELL
25-11-20 13:41,13:41,14469825,13835475,-634350,SELL
25-11-20 13:42,13:42,14675225,14010100,-665125,SELL
25-11-20 13:43,13:43,14784625,14273100,-511525,SELL
25-11-20 13:44,13:44,14819775,13981950,-837825,SELL
25-11-20 13:45,13:45,14604850,14240450,-364400,SELL
25-11-20 13:46,13:46,14347700,14269000,-78700,SELL
25-11-20 13:47,13:47,14507800,14452550,-55250,SELL
25-11-20 13:48,13:48,14600925,14454350,-146575,SELL
25-11-20 13:49,13:49,14819900,14080650,-739250,SELL
25-11-20 13:50,13:50,14858500,13963200,-895300,SELL
25-11-20 13:51,13:51,15256600,15029400,-227200,SELL
25-11-20 13:52,13:52,15199950,14481825,-718125,SELL
25-11-20 13:53,13:53,15387325,14549975,-837350,SELL
25-11-20 13:54,13:54,15126900,13743075,-1383825,SELL
25-11-20 13:55,13:55,15310500,14209900,-1100600,SELL
25-11-20 13:56,13:56,15085250,14010000,-1075250,SELL
25-11-20 13:57,13:57,15109000,13468175,-1640825,SELL
25-11-20 13:58,13:58,15344750,13993175,-1351575,SELL
25-11-20 13:59,13:59,15208475,13593700,-1614775,SELL
25-11-20 14:00,14:00,15220775,13622300,-1598475,SELL
25-11-20 14:01,14:01,15147625,13234775,-1912850,SELL
25-11-20 14:02,14:02,15121200,13399200,-1722000,SELL
25-11-20 14:03,14:03,15028750,13261625,-1767125,SELL
25-11-20 14:04,14:04,15063950,13459075,-1604875,SELL
25-11-20 14:05,14:05,15358500,13671600,-1686900,SELL
25-11-20 14:06,14:06,15200050,12777600,-2422450,SELL
25-11-20 14:07,14:07,15212275,13711625,-1500650,SELL
25-11-20 14:08,14:08,15113750,13051075,-2062675,SELL
25-11-20 14:09,14:09,15432050,13176575,-2255475,SELL
25-11-20 14:10,14:10,15329550,13401350,-1928200,SELL
25-11-20 14:11,14:11,15137325,12967450,-2169875,SELL
25-11-20 14:12,14:12,15097575,12778000,-2319575,SELL
25-11-20 14:13,14:13,15084925,12946500,-2138425,SELL
25-11-20 14:14,14:14,14979725,13287750,-1691975,SELL
25-11-20 14:15,14:15,15365700,13319900,-2045800,SELL
25-11-20 14:16,14:16,15328950,12531850,-2797100,SELL
25-11-20 14:17,14:17,15623250,12970800,-2652450,SELL
25-11-20 14:18,14:18,15146775,12923450,-2223325,SELL
25-11-20 14:19,14:19,15538975,13230775,-2308200,SELL
25-11-20 14:20,14:20,15427475,13100825,-2326650,SELL
25-11-20 14:21,14:21,15522625,13054775,-2467850,SELL
25-11-20 14:22,14:22,15322200,13247225,-2074975,SELL
25-11-20 14:23,14:23,15353575,13272375,-2081200,SELL
25-11-20 14:24,14:24,15194775,13282825,-1911950,SELL
25-11-20 14:25,14:25,15337075,13129550,-2207525,SELL
25-11-20 14:26,14:26,15304850,13368675,-1936175,SELL
25-11-20 14:27,14:27,15518425,13253525,-2264900,SELL
25-11-20 14:28,14:28,15498050,13293350,-2204700,SELL
25-11-20 14:29,14:29,15279775,12927825,-2351950,SELL
25-11-20 14:30,14:30,15830350,12938325,-2892025,SELL
25-11-20 14:31,14:31,15605775,13218800,-2386975,SELL
25-11-20 14:32,14:32,15192275,13465350,-1726925,SELL
25-11-20 14:33,14:33,15382700,13345125,-2037575,SELL
25-11-20 14:34,14:34,15481575,13572375,-1909200,SELL
25-11-20 14:35,14:35,15248675,12786300,-2462375,SELL
25-11-20 14:36,14:36,15258550,13008925,-2249625,SELL
25-11-20 14:37,14:37,15302575,12617000,-2685575,SELL
25-11-20 14:38,14:38,15001850,13091175,-1910675,SELL
25-11-20 14:39,14:39,15267575,13311175,-1956400,SELL
25-11-20 14:40,14:40,15323200,13478300,-1844900,SELL
25-11-20 14:41,14:41,15599400,12974925,-2624475,SELL
25-11-20 14:42,14:42,14665400,12491600,-2173800,SELL
25-11-20 14:43,14:43,14858200,13180450,-1677750,SELL
25-11-20 14:44,14:44,14915950,12976325,-1939625,SELL
25-11-20 14:45,14:45,14761450,13074100,-1687350,SELL
25-11-20 14:46,14:46,14838800,13099700,-1739100,SELL
25-11-20 14:47,14:47,14765275,13004425,-1760850,SELL
25-11-20 14:48,14:48,14562825,12933225,-1629600,SELL
25-11-20 14:49,14:49,14445350,12483225,-1962125,SELL
25-11-20 14:50,14:50,14408725,12386225,-2022500,SELL
25-11-20 14:51,14:51,14164175,12591225,-1572950,SELL
25-11-20 14:52,14:52,14266200,11987825,-2278375,SELL
25-11-20 14:53,14:53,14224875,12672500,-1552375,SELL
25-11-20 14:54,14:54,14319025,12181400,-2137625,SELL
25-11-20 14:55,14:55,14101575,12193225,-1908350,SELL
25-11-20 14:56,14:56,14248700,12632075,-1616625,SELL
25-11-20 14:57,14:57,14127700,12093825,-2033875,SELL
25-11-20 14:58,14:58,14056950,12131750,-1925200,SELL
25-11-20 14:59,14:59,13964875,12566300,-1398575,SELL
25-11-20 15:00,15:00,14199450,12622500,-1576950,SELL
25-11-20 15:01,15:01,14050875,12369950,-1680925,SELL
25-11-20 15:02,15:02,13875700,12435950,-1439750,SELL
25-11-20 15:03,15:03,14270650,12514850,-1755800,SELL
25-11-20 15:04,15:04,14438000,12565475,-1872525,SELL
25-11-20 15:05,15:05,13865775,12706525,-1159250,SELL
25-11-20 15:06,15:06,14058025,12020500,-2037525,SELL
25-11-20 15:07,15:07,14032950,11981600,-2051350,SELL
25-11-20 15:08,15:08,13883550,11716025,-2167525,SELL
25-11-20 15:09,15:09,13625025,11526925,-2098100,SELL
25-11-20 15:10,15:10,13885425,11549775,-2335650,SELL
25-11-20 15:11,15:11,14061275,11869425,-2191850,SELL
25-11-20 15:12,15:12,13625950,11556525,-2069425,SELL
25-11-20 15:13,15:13,13760075,11838250,-1921825,SELL
25-11-20 15:14,15:14,13757200,11804325,-1952875,SELL
25-11-20 15:15,15:15,13512450,11745525,-1766925,SELL
25-11-20 15:16,15:16,13558550,11567200,-1991350,SELL
25-11-20 15:17,15:17,13784500,11684875,-2099625,SELL
25-11-20 15:18,15:18,13352775,11477700,-1875075,SELL
25-11-20 15:19,15:19,13681200,11189575,-2491625,SELL
25-11-20 15:20,15:20,13709200,11952400,-1756800,SELL
25-11-20 15:21,15:21,13779075,11421175,-2357900,SELL
25-11-20 15:22,15:22,13455700,11189775,-2265925,SELL
25-11-20 15:23,15:23,13127725,11296550,-1831175,SELL
25-11-20 15:24,15:24,13095950,11064500,-2031450,SELL
25-11-20 15:25,15:25,13328650,11219525,-2109125,SELL
25-11-20 15:26,15:26,12929125,11077100,-1852025,SELL
25-11-20 15:27,15:27,12926575,11143475,-1783100,SELL
25-11-20 15:28,15:28,12976475,11087900,-1888575,SELL
25-11-20 15:29,15:29,13095700,11339725,-1755975,SELL
26-11-20 9:15,9:15,12665150,10660175,-2004975,SELL
26-11-20 9:16,9:16,12837500,10255075,-2582425,SELL
26-11-20 9:17,9:17,13790650,11130925,-2659725,SELL
26-11-20 9:18,9:18,13438325,11725425,-1712900,SELL
26-11-20 9:19,9:19,13900300,11782775,-2117525,SELL
26-11-20 9:20,9:20,15262175,12627850,-2634325,SELL
26-11-20 9:21,9:21,15161350,12691775,-2469575,SELL
26-11-20 9:22,9:22,15158075,12608350,-2549725,SELL
26-11-20 9:23,9:23,15496250,13176625,-2319625,SELL
26-11-20 9:24,9:24,15390100,13058200,-2331900,SELL
26-11-20 9:25,9:25,15558025,13177350,-2380675,SELL
26-11-20 9:26,9:26,16353150,13728150,-2625000,SELL
26-11-20 9:27,9:27,16144150,13802900,-2341250,SELL
26-11-20 9:28,9:28,16259650,13594975,-2664675,SELL
26-11-20 9:29,9:29,17315125,14844300,-2470825,SELL
26-11-20 9:30,9:30,17577375,14758775,-2818600,SELL
26-11-20 9:31,9:31,17738850,14737625,-3001225,SELL
26-11-20 9:32,9:32,17351175,15486350,-1864825,SELL
26-11-20 9:33,9:33,17381400,15087875,-2293525,SELL
26-11-20 9:34,9:34,17232350,15360475,-1871875,SELL
26-11-20 9:35,9:35,17776575,15636725,-2139850,SELL
26-11-20 9:36,9:36,17757175,15867525,-1889650,SELL
26-11-20 9:37,9:37,17856975,15727175,-2129800,SELL
26-11-20 9:38,9:38,18149925,15898650,-2251275,SELL
26-11-20 9:39,9:39,18336025,15992425,-2343600,SELL
26-11-20 9:40,9:40,18055325,16132550,-1922775,SELL
26-11-20 9:41,9:41,19188975,16228375,-2960600,SELL
26-11-20 9:42,9:42,18747725,15477350,-3270375,SELL
26-11-20 9:43,9:43,18958750,16356025,-2602725,SELL
26-11-20 9:44,9:44,19287375,16482350,-2805025,SELL
26-11-20 9:45,9:45,19760000,16585075,-3174925,SELL
26-11-20 9:46,9:46,19520200,16238525,-3281675,SELL
26-11-20 9:47,9:47,19611775,16043000,-3568775,SELL
26-11-20 9:48,9:48,20031800,16035725,-3996075,SELL
26-11-20 9:49,9:49,19718775,14849275,-4869500,SELL
26-11-20 9:50,9:50,20276175,16236775,-4039400,SELL
26-11-20 9:51,9:51,20285750,16186000,-4099750,SELL
26-11-20 9:52,9:52,20408700,16047850,-4360850,SELL
26-11-20 9:53,9:53,20450025,16297875,-4152150,SELL
26-11-20 9:54,9:54,20737125,16317050,-4420075,SELL
26-11-20 9:55,9:55,20556275,16174825,-4381450,SELL
26-11-20 9:56,9:56,20724700,16369175,-4355525,SELL
26-11-20 9:57,9:57,20939350,16129850,-4809500,SELL
26-11-20 9:58,9:58,20968575,16150775,-4817800,SELL
26-11-20 9:59,9:59,21242550,16161050,-5081500,SELL
26-11-20 10:00,10:00,21361300,16703075,-4658225,SELL
26-11-20 10:01,10:01,21059025,15876550,-5182475,SELL
26-11-20 10:02,10:02,21222025,16433675,-4788350,SELL
26-11-20 10:03,10:03,21160525,15951975,-5208550,SELL
26-11-20 10:04,10:04,21319075,16545700,-4773375,SELL
26-11-20 10:05,10:05,21242675,17254275,-3988400,SELL
26-11-20 10:06,10:06,21280175,16798375,-4481800,SELL
26-11-20 10:07,10:07,21558400,16148125,-5410275,SELL
26-11-20 10:08,10:08,21649075,17150100,-4498975,SELL
26-11-20 10:09,10:09,21446925,17190550,-4256375,SELL
26-11-20 10:10,10:10,21451225,16500475,-4950750,SELL
26-11-20 10:11,10:11,21558775,17164275,-4394500,SELL
26-11-20 10:12,10:12,21368825,17282825,-4086000,SELL
26-11-20 10:13,10:13,21733475,16298350,-5435125,SELL
26-11-20 10:14,10:14,21637675,17128500,-4509175,SELL
26-11-20 10:15,10:15,21944550,17597775,-4346775,SELL
26-11-20 10:16,10:16,21774775,17146775,-4628000,SELL
26-11-20 10:17,10:17,21693700,17237225,-4456475,SELL
26-11-20 10:18,10:18,22038050,17578350,-4459700,SELL
26-11-20 10:19,10:19,21650075,16642075,-5008000,SELL
26-11-20 10:20,10:20,21342000,17849475,-3492525,SELL
26-11-20 10:21,10:21,20666275,17577000,-3089275,SELL
26-11-20 10:22,10:22,21507750,17728925,-3778825,SELL
26-11-20 10:23,10:23,21789775,18120125,-3669650,SELL
26-11-20 10:24,10:24,21674600,17368875,-4305725,SELL
26-11-20 10:25,10:25,21765000,17205475,-4559525,SELL
26-11-20 10:26,10:26,21801450,17300525,-4500925,SELL
26-11-20 10:27,10:27,21807250,17693275,-4113975,SELL
26-11-20 10:28,10:28,21761225,17802575,-3958650,SELL
26-11-20 10:29,10:29,22381225,18227675,-4153550,SELL
26-11-20 10:30,10:30,22286525,17414250,-4872275,SELL
26-11-20 10:31,10:31,22370625,18015375,-4355250,SELL
26-11-20 10:32,10:32,22393400,17644825,-4748575,SELL
26-11-20 10:33,10:33,22355075,17396350,-4958725,SELL
26-11-20 10:34,10:34,22327475,17467350,-4860125,SELL
26-11-20 10:35,10:35,21886250,16903525,-4982725,SELL
26-11-20 10:36,10:36,22462975,17691650,-4771325,SELL
26-11-20 10:37,10:37,22369850,17594350,-4775500,SELL
26-11-20 10:38,10:38,22367950,18013950,-4354000,SELL
26-11-20 10:39,10:39,22481150,18244250,-4236900,SELL
26-11-20 10:40,10:40,22530125,17491275,-5038850,SELL
26-11-20 10:41,10:41,22695050,18163275,-4531775,SELL
26-11-20 10:42,10:42,21535275,17790325,-3744950,SELL
26-11-20 10:43,10:43,22382950,18099175,-4283775,SELL
26-11-20 10:44,10:44,22510450,18528225,-3982225,SELL
26-11-20 10:45,10:45,22617650,18672675,-3944975,SELL
26-11-20 10:46,10:46,22347350,18047900,-4299450,SELL
26-11-20 10:47,10:47,22735450,18422100,-4313350,SELL
26-11-20 10:48,10:48,22561900,18589475,-3972425,SELL
26-11-20 10:49,10:49,22839800,18250275,-4589525,SELL
26-11-20 10:50,10:50,22460575,18525825,-3934750,SELL
26-11-20 10:51,10:51,22251650,18473900,-3777750,SELL
26-11-20 10:52,10:52,22307425,18621975,-3685450,SELL
26-11-20 10:53,10:53,22587675,18798675,-3789000,SELL
26-11-20 10:54,10:54,22429275,19103875,-3325400,SELL
26-11-20 10:55,10:55,22795125,18954875,-3840250,SELL
26-11-20 10:56,10:56,22510975,18963800,-3547175,SELL
26-11-20 10:57,10:57,21544550,19126875,-2417675,SELL
26-11-20 10:58,10:58,22710400,19294325,-3416075,SELL
26-11-20 10:59,10:59,22483625,18677175,-3806450,SELL
26-11-20 11:00,11:00,22725600,18966975,-3758625,SELL
26-11-20 11:01,11:01,22413400,18582175,-3831225,SELL
26-11-20 11:02,11:02,22741325,19122475,-3618850,SELL
26-11-20 11:03,11:03,22804700,19602825,-3201875,SELL
26-11-20 11:04,11:04,22819825,18841875,-3977950,SELL
26-11-20 11:05,11:05,22845375,18490075,-4355300,SELL
26-11-20 11:06,11:06,22649775,18954875,-3694900,SELL
26-11-20 11:07,11:07,21949225,18383200,-3566025,SELL
26-11-20 11:08,11:08,22726650,19328275,-3398375,SELL
26-11-20 11:09,11:09,22875625,18425075,-4450550,SELL
26-11-20 11:10,11:10,22794975,18835100,-3959875,SELL
26-11-20 11:11,11:11,22897025,19066775,-3830250,SELL
26-11-20 11:12,11:12,22952550,19320775,-3631775,SELL
26-11-20 11:13,11:13,22910050,19184325,-3725725,SELL
26-11-20 11:14,11:14,22550000,18553325,-3996675,SELL
26-11-20 11:15,11:15,23181725,18987650,-4194075,SELL
26-11-20 11:16,11:16,23087625,18825575,-4262050,SELL
26-11-20 11:17,11:17,22894050,18968600,-3925450,SELL
26-11-20 11:18,11:18,22929950,19246400,-3683550,SELL
26-11-20 11:19,11:19,23379800,19555450,-3824350,SELL
26-11-20 11:20,11:20,23033050,19000525,-4032525,SELL
26-11-20 11:21,11:21,23007300,19051725,-3955575,SELL
26-11-20 11:22,11:22,23282175,18754350,-4527825,SELL
26-11-20 11:23,11:23,23308225,19742375,-3565850,SELL
26-11-20 11:24,11:24,23017575,18473950,-4543625,SELL
26-11-20 11:25,11:25,23090325,18462200,-4628125,SELL
26-11-20 11:26,11:26,23208800,19092475,-4116325,SELL
26-11-20 11:27,11:27,23272025,18850025,-4422000,SELL
26-11-20 11:28,11:28,23559550,19122125,-4437425,SELL
26-11-20 11:29,11:29,23188925,18672200,-4516725,SELL
26-11-20 11:30,11:30,23221800,18565425,-4656375,SELL
26-11-20 11:31,11:31,23391200,19134950,-4256250,SELL
26-11-20 11:32,11:32,23909975,18920975,-4989000,SELL
26-11-20 11:33,11:33,23373225,19585525,-3787700,SELL
26-11-20 11:34,11:34,23315025,18982925,-4332100,SELL
26-11-20 11:35,11:35,23568100,19282100,-4286000,SELL
26-11-20 11:36,11:36,23707175,18373325,-5333850,SELL
26-11-20 11:37,11:37,23797650,19991300,-3806350,SELL
26-11-20 11:38,11:38,23644950,18839400,-4805550,SELL
26-11-20 11:39,11:39,23585250,19119150,-4466100,SELL
26-11-20 11:40,11:40,23335150,18708975,-4626175,SELL
26-11-20 11:41,11:41,23528050,18976650,-4551400,SELL
26-11-20 11:42,11:42,23457600,19191025,-4266575,SELL
26-11-20 11:43,11:43,23406175,19372875,-4033300,SELL
26-11-20 11:44,11:44,23467150,18599575,-4867575,SELL
26-11-20 11:45,11:45,23732900,19396100,-4336800,SELL
26-11-20 11:46,11:46,23530825,18122250,-5408575,SELL
26-11-20 11:47,11:47,22849550,19723175,-3126375,SELL
26-11-20 11:48,11:48,23757525,19981500,-3776025,SELL
26-11-20 11:49,11:49,23515575,19636100,-3879475,SELL
26-11-20 11:50,11:50,23765650,19414200,-4351450,SELL
26-11-20 11:51,11:51,23761625,19838950,-3922675,SELL
26-11-20 11:52,11:52,23567125,18933150,-4633975,SELL
26-11-20 11:53,11:53,23989850,19247500,-4742350,SELL
26-11-20 11:54,11:54,23396150,18465100,-4931050,SELL
26-11-20 11:55,11:55,23604725,18816750,-4787975,SELL
26-11-20 11:56,11:56,23613800,19624950,-3988850,SELL
26-11-20 11:57,11:57,24158800,20069525,-4089275,SELL
26-11-20 11:58,11:58,23833825,19455250,-4378575,SELL
26-11-20 11:59,11:59,23755625,17975225,-5780400,SELL
26-11-20 12:00,12:00,23890650,19621100,-4269550,SELL
26-11-20 12:01,12:01,24144500,20151050,-3993450,SELL
26-11-20 12:02,12:02,23938000,19623400,-4314600,SELL
26-11-20 12:03,12:03,23994250,19707025,-4287225,SELL
26-11-20 12:04,12:04,24444350,20390350,-4054000,SELL
26-11-20 12:05,12:05,24381250,19043500,-5337750,SELL
26-11-20 12:06,12:06,24390750,18759600,-5631150,SELL
26-11-20 12:07,12:07,24378975,18800700,-5578275,SELL
26-11-20 12:08,12:08,24199775,18521975,-5677800,SELL
26-11-20 12:09,12:09,24367750,18927250,-5440500,SELL
26-11-20 12:10,12:10,24498250,18922875,-5575375,SELL
26-11-20 12:11,12:11,24188350,18512400,-5675950,SELL
26-11-20 12:12,12:12,24177175,17860875,-6316300,SELL
26-11-20 12:13,12:13,24210650,18842650,-5368000,SELL
26-11-20 12:14,12:14,24615425,18741550,-5873875,SELL
26-11-20 12:15,12:15,24409475,17761250,-6648225,SELL
26-11-20 12:16,12:16,24484800,18669350,-5815450,SELL
26-11-20 12:17,12:17,24518075,18388675,-6129400,SELL
26-11-20 12:18,12:18,24498200,17640825,-6857375,SELL
26-11-20 12:19,12:19,24407100,17424425,-6982675,SELL
26-11-20 12:20,12:20,24515425,18732625,-5782800,SELL
26-11-20 12:21,12:21,24265250,18536325,-5728925,SELL
26-11-20 12:22,12:22,24206050,18287225,-5918825,SELL
26-11-20 12:23,12:23,24249650,18549200,-5700450,SELL
26-11-20 12:24,12:24,24696525,18052700,-6643825,SELL
26-11-20 12:25,12:25,24259925,18526100,-5733825,SELL
26-11-20 12:26,12:26,23665775,19070100,-4595675,SELL
26-11-20 12:27,12:27,24143225,17995725,-6147500,SELL
26-11-20 12:28,12:28,24275150,17657025,-6618125,SELL
26-11-20 12:29,12:29,24662125,18500875,-6161250,SELL
26-11-20 12:30,12:30,24524300,19045875,-5478425,SELL
26-11-20 12:31,12:31,24660325,18924675,-5735650,SELL
26-11-20 12:32,12:32,24791425,18444825,-6346600,SELL
26-11-20 12:33,12:33,24911800,18435200,-6476600,SELL
26-11-20 12:34,12:34,24729325,18836000,-5893325,SELL
26-11-20 12:35,12:35,24799925,18094925,-6705000,SELL
26-11-20 12:36,12:36,24920825,18277325,-6643500,SELL
26-11-20 12:37,12:37,24947025,19567275,-5379750,SELL
26-11-20 12:38,12:38,24722175,18330475,-6391700,SELL
26-11-20 12:39,12:39,24042750,18765800,-5276950,SELL
26-11-20 12:40,12:40,24796850,19405300,-5391550,SELL
26-11-20 12:41,12:41,24417475,18399325,-6018150,SELL
26-11-20 12:42,12:42,23777475,19232000,-4545475,SELL
26-11-20 12:43,12:43,23906725,18427825,-5478900,SELL
26-11-20 12:44,12:44,23388775,19281550,-4107225,SELL
26-11-20 12:45,12:45,23727375,18540600,-5186775,SELL
26-11-20 12:46,12:46,24256625,18452675,-5803950,SELL
26-11-20 12:47,12:47,24203800,19035775,-5168025,SELL
26-11-20 12:48,12:48,24369375,19545700,-4823675,SELL
26-11-20 12:49,12:49,24122150,18967150,-5155000,SELL
26-11-20 12:50,12:50,24363250,19203050,-5160200,SELL
26-11-20 12:51,12:51,22815250,19416175,-3399075,SELL
26-11-20 12:52,12:52,22901625,19178525,-3723100,SELL
26-11-20 12:53,12:53,22754775,19045625,-3709150,SELL
26-11-20 12:54,12:54,22486550,19414150,-3072400,SELL
26-11-20 12:55,12:55,22058450,19563600,-2494850,SELL
26-11-20 12:56,12:56,22216625,19432375,-2784250,SELL
26-11-20 12:57,12:57,22779900,20264950,-2514950,SELL
26-11-20 12:58,12:58,22876700,20406475,-2470225,SELL
26-11-20 12:59,12:59,22902725,19985150,-2917575,SELL
26-11-20 13:00,13:00,22417825,19678050,-2739775,SELL
26-11-20 13:01,13:01,22264925,20019975,-2244950,SELL
26-11-20 13:02,13:02,22258150,19958850,-2299300,SELL
26-11-20 13:03,13:03,22527250,20461875,-2065375,SELL
26-11-20 13:04,13:04,22444475,20367900,-2076575,SELL
26-11-20 13:05,13:05,22398125,20701200,-1696925,SELL
26-11-20 13:06,13:06,21737225,21065300,-671925,SELL
26-11-20 13:07,13:07,22355625,20879850,-1475775,SELL
26-11-20 13:08,13:08,22224100,20673850,-1550250,SELL
26-11-20 13:09,13:09,21922750,21000800,-921950,SELL
26-11-20 13:10,13:10,22149275,21109200,-1040075,SELL
26-11-20 13:11,13:11,22255350,21210400,-1044950,SELL
26-11-20 13:12,13:12,22170150,21266475,-903675,SELL
26-11-20 13:13,13:13,22022550,21456900,-565650,SELL
26-11-20 13:14,13:14,21931325,21385000,-546325,SELL
26-11-20 13:15,13:15,22024250,21005575,-1018675,SELL
26-11-20 13:16,13:16,22021750,21166250,-855500,SELL
26-11-20 13:17,13:17,22011175,21860750,-150425,SELL
26-11-20 13:18,13:18,21743350,21935825,192475,BUY
26-11-20 13:19,13:19,21842750,21847275,4525,BUY
26-11-20 13:20,13:20,21767025,21452425,-314600,SELL
26-11-20 13:21,13:21,20828100,21659625,831525,BUY
26-11-20 13:22,13:22,21133325,21954700,821375,BUY
26-11-20 13:23,13:23,21358925,21808500,449575,BUY
26-11-20 13:24,13:24,21327250,21860150,532900,BUY
26-11-20 13:25,13:25,21431425,21528425,97000,BUY
26-11-20 13:26,13:26,21383550,21758250,374700,BUY
26-11-20 13:27,13:27,21175300,22000375,825075,BUY
26-11-20 13:28,13:28,21262150,21567825,305675,BUY
26-11-20 13:29,13:29,21164150,21670925,506775,BUY
26-11-20 13:30,13:30,21246000,21099350,-146650,SELL
26-11-20 13:31,13:31,21810600,22166000,355400,BUY
26-11-20 13:32,13:32,21277350,21653025,375675,BUY
26-11-20 13:33,13:33,21677975,21760200,82225,BUY
26-11-20 13:34,13:34,21276875,21778600,501725,BUY
26-11-20 13:35,13:35,21423250,21690500,267250,BUY
26-11-20 13:36,13:36,21368125,21468075,99950,BUY
26-11-20 13:37,13:37,21259100,21715600,456500,BUY
26-11-20 13:38,13:38,21397825,21821275,423450,BUY
26-11-20 13:39,13:39,21740475,21640650,-99825,SELL
26-11-20 13:40,13:40,21666150,21799875,133725,BUY
26-11-20 13:41,13:41,21468775,21970375,501600,BUY
26-11-20 13:42,13:42,21482650,20512400,-970250,SELL
26-11-20 13:43,13:43,21717950,21441150,-276800,SELL
26-11-20 13:44,13:44,21693150,21596725,-96425,SELL
26-11-20 13:45,13:45,21869350,21911050,41700,BUY
26-11-20 13:46,13:46,21738725,21790625,51900,BUY
26-11-20 13:47,13:47,21885075,21836475,-48600,SELL
26-11-20 13:48,13:48,22012400,22065225,52825,BUY
26-11-20 13:49,13:49,21999925,21655025,-344900,SELL
26-11-20 13:50,13:50,21886300,21169825,-716475,SELL
26-11-20 13:51,13:51,22147450,20904450,-1243000,SELL
26-11-20 13:52,13:52,22039925,21367125,-672800,SELL
26-11-20 13:53,13:53,22135800,21345525,-790275,SELL
26-11-20 13:54,13:54,22193325,20991175,-1202150,SELL
26-11-20 13:55,13:55,22097075,21558950,-538125,SELL
26-11-20 13:56,13:56,22278225,21601050,-677175,SELL
26-11-20 13:57,13:57,21896400,21452000,-444400,SELL
26-11-20 13:58,13:58,22362050,21745550,-616500,SELL
26-11-20 13:59,13:59,22259750,21373050,-886700,SELL
26-11-20 14:00,14:00,22717050,22206275,-510775,SELL
26-11-20 14:01,14:01,22323900,21551075,-772825,SELL
26-11-20 14:02,14:02,22616875,21477925,-1138950,SELL
26-11-20 14:03,14:03,21975100,21753525,-221575,SELL
26-11-20 14:04,14:04,22330150,21967350,-362800,SELL
26-11-20 14:05,14:05,22256750,21733975,-522775,SELL
26-11-20 14:06,14:06,20773825,20815200,41375,BUY
26-11-20 14:07,14:07,21578700,21766600,187900,BUY
26-11-20 14:08,14:08,21113975,21919775,805800,BUY
26-11-20 14:09,14:09,20917525,21700900,783375,BUY
26-11-20 14:10,14:10,20572050,21521900,949850,BUY
26-11-20 14:11,14:11,21437750,22308100,870350,BUY
26-11-20 14:12,14:12,21254600,22232325,977725,BUY
26-11-20 14:13,14:13,21122150,22536425,1414275,BUY
26-11-20 14:14,14:14,21292100,22333225,1041125,BUY
26-11-20 14:15,14:15,21024575,22702025,1677450,BUY
26-11-20 14:16,14:16,21042150,22289700,1247550,BUY
26-11-20 14:17,14:17,20543025,22227075,1684050,BUY
26-11-20 14:18,14:18,20313375,22899650,2586275,BUY
26-11-20 14:19,14:19,20364600,22833300,2468700,BUY
26-11-20 14:20,14:20,20238075,22660950,2422875,BUY
26-11-20 14:21,14:21,20560725,22898650,2337925,BUY
26-11-20 14:22,14:22,20682525,22932575,2250050,BUY
26-11-20 14:23,14:23,20642100,22858775,2216675,BUY
26-11-20 14:24,14:24,20397450,22743750,2346300,BUY
26-11-20 14:25,14:25,21055325,22699175,1643850,BUY
26-11-20 14:26,14:26,20812975,22503550,1690575,BUY
26-11-20 14:27,14:27,20950750,22569275,1618525,BUY
26-11-20 14:28,14:28,21079900,22757050,1677150,BUY
26-11-20 14:29,14:29,20984100,22305950,1321850,BUY
26-11-20 14:30,14:30,20629700,22789650,2159950,BUY
26-11-20 14:31,14:31,20020175,22962250,2942075,BUY
26-11-20 14:32,14:32,20538750,22255250,1716500,BUY
26-11-20 14:33,14:33,20421050,22081200,1660150,BUY
26-11-20 14:34,14:34,20240475,22123825,1883350,BUY
26-11-20 14:35,14:35,20369425,22301925,1932500,BUY
26-11-20 14:36,14:36,18998075,22038800,3040725,BUY
26-11-20 14:37,14:37,20412400,21952650,1540250,BUY
26-11-20 14:38,14:38,20380825,21911175,1530350,BUY
26-11-20 14:39,14:39,20066100,22333300,2267200,BUY
26-11-20 14:40,14:40,20246150,22464275,2218125,BUY
26-11-20 14:41,14:41,20179125,21844775,1665650,BUY
26-11-20 14:42,14:42,20408100,21875350,1467250,BUY
26-11-20 14:43,14:43,20323425,22234675,1911250,BUY
26-11-20 14:44,14:44,20158325,21431600,1273275,BUY
26-11-20 14:45,14:45,20149925,21434400,1284475,BUY
26-11-20 14:46,14:46,20356425,21839175,1482750,BUY
26-11-20 14:47,14:47,20398900,22212850,1813950,BUY
26-11-20 14:48,14:48,20123675,21353950,1230275,BUY
26-11-20 14:49,14:49,20120725,21173500,1052775,BUY
26-11-20 14:50,14:50,20016075,21305750,1289675,BUY
26-11-20 14:51,14:51,19954850,20738950,784100,BUY
26-11-20 14:52,14:52,19929700,20638775,709075,BUY
26-11-20 14:53,14:53,19958725,20703375,744650,BUY
26-11-20 14:54,14:54,19613925,20903925,1290000,BUY
26-11-20 14:55,14:55,20120650,21863950,1743300,BUY
26-11-20 14:56,14:56,20239000,20954975,715975,BUY
26-11-20 14:57,14:57,19627425,20657450,1030025,BUY
26-11-20 14:58,14:58,20384325,20806050,421725,BUY
26-11-20 14:59,14:59,20348975,19759350,-589625,SELL
26-11-20 15:00,15:00,20156725,19731925,-424800,SELL
26-11-20 15:01,15:01,19934150,19808300,-125850,SELL
26-11-20 15:02,15:02,19978200,19551725,-426475,SELL
26-11-20 15:03,15:03,19688300,19860625,172325,BUY
26-11-20 15:04,15:04,19898025,20069050,171025,BUY
26-11-20 15:05,15:05,19617925,18870000,-747925,SELL
26-11-20 15:06,15:06,19272775,19929600,656825,BUY
26-11-20 15:07,15:07,19194225,19285550,91325,BUY
26-11-20 15:08,15:08,19061675,20315975,1254300,BUY
26-11-20 15:09,15:09,18543400,19951500,1408100,BUY
26-11-20 15:10,15:10,18852525,19022350,169825,BUY
26-11-20 15:11,15:11,18993825,19772425,778600,BUY
26-11-20 15:12,15:12,17848250,18664650,816400,BUY
26-11-20 15:13,15:13,17718500,19314100,1595600,BUY
26-11-20 15:14,15:14,17874825,19296575,1421750,BUY
26-11-20 15:15,15:15,17061075,18471400,1410325,BUY
26-11-20 15:16,15:16,17183725,18936500,1752775,BUY
26-11-20 15:17,15:17,17147600,18853975,1706375,BUY
26-11-20 15:18,15:18,16860975,18475025,1614050,BUY
26-11-20 15:19,15:19,16760575,18039500,1278925,BUY
26-11-20 15:20,15:20,16901975,18310850,1408875,BUY
26-11-20 15:21,15:21,15875725,17365925,1490200,BUY
26-11-20 15:22,15:22,15751900,17275900,1524000,BUY
26-11-20 15:23,15:23,15873725,16715925,842200,BUY
26-11-20 15:24,15:24,15262200,15959025,696825,BUY
26-11-20 15:25,15:25,15250375,15816900,566525,BUY
26-11-20 15:26,15:26,15229450,13952450,-1277000,SELL
26-11-20 15:27,15:27,13692350,13663700,-28650,SELL
26-11-20 15:28,15:28,13575050,13407475,-167575,SELL
26-11-20 15:29,15:29,13219750,13946350,726600,BUY
27-11-20 9:15,9:15,3926775,3091825,-834950,SELL
27-11-20 9:16,9:16,3899350,3091100,-808250,SELL
27-11-20 9:17,9:17,4365300,3457700,-907600,SELL
27-11-20 9:18,9:18,4375100,3457500,-917600,SELL
27-11-20 9:19,9:19,4364725,3456275,-908450,SELL
27-11-20 9:20,9:20,4768275,3902500,-865775,SELL
27-11-20 9:21,9:21,4771525,3902500,-869025,SELL
27-11-20 9:22,9:22,4772875,3904150,-868725,SELL
27-11-20 9:23,9:23,5015075,4184800,-830275,SELL
27-11-20 9:24,9:24,5038150,4194925,-843225,SELL
27-11-20 9:25,9:25,5039675,4198350,-841325,SELL
27-11-20 9:26,9:26,5224075,4359450,-864625,SELL
27-11-20 9:27,9:27,5254850,4359750,-895100,SELL
27-11-20 9:28,9:28,5246325,4362175,-884150,SELL
27-11-20 9:29,9:29,5456800,4564350,-892450,SELL
27-11-20 9:30,9:30,5439800,4563000,-876800,SELL
27-11-20 9:31,9:31,5454900,4563875,-891025,SELL
27-11-20 9:32,9:32,5648200,4720675,-927525,SELL
27-11-20 9:33,9:33,5605500,4718650,-886850,SELL
27-11-20 9:34,9:34,5658425,4720425,-938000,SELL
27-11-20 9:35,9:35,5845725,4740925,-1104800,SELL
27-11-20 9:36,9:36,5843350,4747300,-1096050,SELL
27-11-20 9:37,9:37,5800600,4748775,-1051825,SELL
27-11-20 9:38,9:38,6023500,4817800,-1205700,SELL
27-11-20 9:39,9:39,6023325,4838550,-1184775,SELL
27-11-20 9:40,9:40,6011225,4826550,-1184675,SELL
27-11-20 9:41,9:41,6132025,4852625,-1279400,SELL
27-11-20 9:42,9:42,6153125,4857900,-1295225,SELL
27-11-20 9:43,9:43,6137275,4845125,-1292150,SELL
27-11-20 9:44,9:44,6257450,4841900,-1415550,SELL
27-11-20 9:45,9:45,6241425,4834075,-1407350,SELL
27-11-20 9:46,9:46,6266300,4845525,-1420775,SELL
27-11-20 9:47,9:47,6399600,4925425,-1474175,SELL
27-11-20 9:48,9:48,6409275,4936375,-1472900,SELL
27-11-20 9:49,9:49,6384175,4926850,-1457325,SELL
27-11-20 9:50,9:50,6495700,5004200,-1491500,SELL
27-11-20 9:51,9:51,6508050,5008475,-1499575,SELL
27-11-20 9:52,9:52,6514175,5009475,-1504700,SELL
27-11-20 9:53,9:53,6364600,5025325,-1339275,SELL
27-11-20 9:54,9:54,6353300,5023775,-1329525,SELL
27-11-20 9:55,9:55,6351725,5029525,-1322200,SELL
27-11-20 9:56,9:56,6403950,5085225,-1318725,SELL
27-11-20 9:57,9:57,6359875,5091700,-1268175,SELL
27-11-20 9:58,9:58,6406100,5086825,-1319275,SELL
27-11-20 9:59,9:59,6455850,5158675,-1297175,SELL
27-11-20 10:00,10:00,6455725,5175975,-1279750,SELL
27-11-20 10:01,10:01,6447825,5157900,-1289925,SELL
27-11-20 10:02,10:02,6514450,5223925,-1290525,SELL
27-11-20 10:03,10:03,6505450,5217225,-1288225,SELL
27-11-20 10:04,10:04,6472450,5210325,-1262125,SELL
27-11-20 10:05,10:05,6523250,5284125,-1239125,SELL
27-11-20 10:06,10:06,6540150,5265775,-1274375,SELL
27-11-20 10:07,10:07,6540150,5275700,-1264450,SELL
27-11-20 10:08,10:08,6627100,5368025,-1259075,SELL
27-11-20 10:09,10:09,6628875,5366550,-1262325,SELL
27-11-20 10:10,10:10,6635775,5368025,-1267750,SELL
27-11-20 10:11,10:11,6614825,5371975,-1242850,SELL
27-11-20 10:12,10:12,6658075,5369775,-1288300,SELL
27-11-20 10:13,10:13,6614850,5381950,-1232900,SELL
27-11-20 10:14,10:14,6655425,5418775,-1236650,SELL
27-11-20 10:15,10:15,6714700,5420925,-1293775,SELL
27-11-20 10:16,10:16,6688675,5421750,-1266925,SELL
27-11-20 10:17,10:17,6758650,5483925,-1274725,SELL
27-11-20 10:18,10:18,6715225,5485675,-1229550,SELL
27-11-20 10:19,10:19,6771150,5483825,-1287325,SELL
27-11-20 10:20,10:20,6782100,5516050,-1266050,SELL
27-11-20 10:21,10:21,6763125,5503625,-1259500,SELL
27-11-20 10:22,10:22,6765125,5510875,-1254250,SELL
27-11-20 10:23,10:23,6766250,5560250,-1206000,SELL
27-11-20 10:24,10:24,6812600,5548550,-1264050,SELL
27-11-20 10:25,10:25,6820300,5572575,-1247725,SELL
27-11-20 10:26,10:26,6794725,5585675,-1209050,SELL
27-11-20 10:27,10:27,6830575,5575000,-1255575,SELL
27-11-20 10:28,10:28,6781425,5571850,-1209575,SELL
27-11-20 10:29,10:29,6831175,5628150,-1203025,SELL
27-11-20 10:30,10:30,6819875,5625925,-1193950,SELL
27-11-20 10:31,10:31,6837500,5617775,-1219725,SELL
27-11-20 10:32,10:32,6872275,5619000,-1253275,SELL
27-11-20 10:33,10:33,6906375,5631475,-1274900,SELL
27-11-20 10:34,10:34,6855450,5616825,-1238625,SELL
27-11-20 10:35,10:35,6886425,5618850,-1267575,SELL
27-11-20 10:36,10:36,6915025,5632225,-1282800,SELL
27-11-20 10:37,10:37,6916775,5635700,-1281075,SELL
27-11-20 10:38,10:38,6934975,5626000,-1308975,SELL
27-11-20 10:39,10:39,6944150,5646200,-1297950,SELL
27-11-20 10:40,10:40,6921450,5626100,-1295350,SELL
27-11-20 10:41,10:41,6987575,5654325,-1333250,SELL
27-11-20 10:42,10:42,6976025,5663400,-1312625,SELL
27-11-20 10:43,10:43,7047050,5691275,-1355775,SELL
27-11-20 10:44,10:44,7066700,5684150,-1382550,SELL
27-11-20 10:45,10:45,7108825,5705150,-1403675,SELL
27-11-20 10:46,10:46,7085875,5657975,-1427900,SELL
27-11-20 10:47,10:47,7055600,5749400,-1306200,SELL
27-11-20 10:48,10:48,7035400,5730200,-1305200,SELL
27-11-20 10:49,10:49,7080700,5731425,-1349275,SELL
27-11-20 10:50,10:50,7056100,5774875,-1281225,SELL
27-11-20 10:51,10:51,7079250,5742150,-1337100,SELL
27-11-20 10:52,10:52,7077125,5753200,-1323925,SELL
27-11-20 10:53,10:53,7076325,5752075,-1324250,SELL
27-11-20 10:54,10:54,7129375,5761700,-1367675,SELL
27-11-20 10:55,10:55,7104775,5775125,-1329650,SELL
27-11-20 10:56,10:56,7085650,5768550,-1317100,SELL
27-11-20 10:57,10:57,7090475,5772400,-1318075,SELL
27-11-20 10:58,10:58,7061150,5759475,-1301675,SELL
27-11-20 10:59,10:59,7118025,5779950,-1338075,SELL
27-11-20 11:00,11:00,7095225,5766750,-1328475,SELL
27-11-20 11:01,11:01,7101125,5769225,-1331900,SELL
27-11-20 11:02,11:02,7136975,5830975,-1306000,SELL
27-11-20 11:03,11:03,7124325,5817100,-1307225,SELL
27-11-20 11:04,11:04,7116275,5789800,-1326475,SELL
27-11-20 11:05,11:05,7155100,5841600,-1313500,SELL
27-11-20 11:06,11:06,7200225,5818725,-1381500,SELL
27-11-20 11:07,11:07,7152975,5829575,-1323400,SELL
27-11-20 11:08,11:08,7195400,5853000,-1342400,SELL
27-11-20 11:09,11:09,7174075,5821150,-1352925,SELL
27-11-20 11:10,11:10,7241025,5867875,-1373150,SELL
27-11-20 11:11,11:11,7258025,5804800,-1453225,SELL
27-11-20 11:12,11:12,7225425,5821450,-1403975,SELL
27-11-20 11:13,11:13,7238325,5817800,-1420525,SELL
27-11-20 11:14,11:14,7206600,5819725,-1386875,SELL
27-11-20 11:15,11:15,7233850,5823200,-1410650,SELL
27-11-20 11:16,11:16,7216925,5811750,-1405175,SELL
27-11-20 11:17,11:17,7230825,5837325,-1393500,SELL
27-11-20 11:18,11:18,7170400,5801400,-1369000,SELL
27-11-20 11:19,11:19,7196075,5810300,-1385775,SELL
27-11-20 11:20,11:20,7240475,5834575,-1405900,SELL
27-11-20 11:21,11:21,7236625,5828925,-1407700,SELL
27-11-20 11:22,11:22,7176725,5713800,-1462925,SELL
27-11-20 11:23,11:23,7214650,5834875,-1379775,SELL
27-11-20 11:24,11:24,7267675,5845350,-1422325,SELL
27-11-20 11:25,11:25,7276025,5865925,-1410100,SELL
27-11-20 11:26,11:26,7293175,5828650,-1464525,SELL
27-11-20 11:27,11:27,7294425,5851650,-1442775,SELL
27-11-20 11:28,11:28,7268600,5827300,-1441300,SELL
27-11-20 11:29,11:29,7284800,5872550,-1412250,SELL
27-11-20 11:30,11:30,7280100,5860775,-1419325,SELL
27-11-20 11:31,11:31,7310875,5861850,-1449025,SELL
27-11-20 11:32,11:32,7287550,5890900,-1396650,SELL
27-11-20 11:33,11:33,7329475,5898700,-1430775,SELL
27-11-20 11:34,11:34,7346400,5891750,-1454650,SELL
27-11-20 11:35,11:35,7294150,5899625,-1394525,SELL
27-11-20 11:36,11:36,7301275,5886800,-1414475,SELL
27-11-20 11:37,11:37,7313600,5888150,-1425450,SELL
27-11-20 11:38,11:38,7284275,5931225,-1353050,SELL
27-11-20 11:39,11:39,7261325,5914700,-1346625,SELL
27-11-20 11:40,11:40,7232575,5914450,-1318125,SELL
27-11-20 11:41,11:41,7243925,5867800,-1376125,SELL
27-11-20 11:42,11:42,7185075,5866575,-1318500,SELL
27-11-20 11:43,11:43,7192425,5860350,-1332075,SELL
27-11-20 11:44,11:44,7257875,5858475,-1399400,SELL
27-11-20 11:45,11:45,7305650,5876050,-1429600,SELL
27-11-20 11:46,11:46,7279250,5866825,-1412425,SELL
27-11-20 11:47,11:47,7311275,5927225,-1384050,SELL
27-11-20 11:48,11:48,7287000,5926025,-1360975,SELL
27-11-20 11:49,11:49,7256375,5913525,-1342850,SELL
27-11-20 11:50,11:50,7349925,5901900,-1448025,SELL
27-11-20 11:51,11:51,7343975,5911075,-1432900,SELL
27-11-20 11:52,11:52,7350200,5932425,-1417775,SELL
27-11-20 11:53,11:53,7392950,5955500,-1437450,SELL
27-11-20 11:54,11:54,7392950,5968575,-1424375,SELL
27-11-20 11:55,11:55,7402450,5960300,-1442150,SELL
27-11-20 11:56,11:56,7416325,5971250,-1445075,SELL
27-11-20 11:57,11:57,7430625,5990800,-1439825,SELL
27-11-20 11:58,11:58,7469450,5994650,-1474800,SELL
27-11-20 11:59,11:59,7456550,6043250,-1413300,SELL
27-11-20 12:00,12:00,7504725,6082750,-1421975,SELL
27-11-20 12:01,12:01,7499975,6075450,-1424525,SELL
27-11-20 12:02,12:02,7497500,6100200,-1397300,SELL
27-11-20 12:03,12:03,7484025,6094350,-1389675,SELL
27-11-20 12:04,12:04,7447225,6086500,-1360725,SELL
27-11-20 12:05,12:05,7458475,6114100,-1344375,SELL
27-11-20 12:06,12:06,7476575,6122225,-1354350,SELL
27-11-20 12:07,12:07,7475225,6120325,-1354900,SELL
27-11-20 12:08,12:08,7504150,6149975,-1354175,SELL
27-11-20 12:09,12:09,7501625,6140825,-1360800,SELL
27-11-20 12:10,12:10,7525750,6136800,-1388950,SELL
27-11-20 12:11,12:11,7488800,6154925,-1333875,SELL
27-11-20 12:12,12:12,7516375,6154175,-1362200,SELL
27-11-20 12:13,12:13,7489525,6168050,-1321475,SELL
27-11-20 12:14,12:14,7484550,6171400,-1313150,SELL
27-11-20 12:15,12:15,7512100,6211150,-1300950,SELL
27-11-20 12:16,12:16,7519175,6182800,-1336375,SELL
27-11-20 12:17,12:17,7518050,6212600,-1305450,SELL
27-11-20 12:18,12:18,7536575,6220700,-1315875,SELL
27-11-20 12:19,12:19,7570975,6219325,-1351650,SELL
27-11-20 12:20,12:20,7535600,6206475,-1329125,SELL
27-11-20 12:21,12:21,7482400,6193625,-1288775,SELL
27-11-20 12:22,12:22,7500675,6155200,-1345475,SELL
27-11-20 12:23,12:23,7503675,6257475,-1246200,SELL
27-11-20 12:24,12:24,7527325,6257125,-1270200,SELL
27-11-20 12:25,12:25,7532475,6251250,-1281225,SELL
27-11-20 12:26,12:26,7517725,6267200,-1250525,SELL
27-11-20 12:27,12:27,7487825,6266350,-1221475,SELL
27-11-20 12:28,12:28,7496575,6270450,-1226125,SELL
27-11-20 12:29,12:29,7448475,6251625,-1196850,SELL
27-11-20 12:30,12:30,7448375,6255725,-1192650,SELL
27-11-20 12:31,12:31,7464675,6257450,-1207225,SELL
27-11-20 12:32,12:32,7426875,6285425,-1141450,SELL
27-11-20 12:33,12:33,7428575,6296625,-1131950,SELL
27-11-20 12:34,12:34,7436600,6297375,-1139225,SELL
27-11-20 12:35,12:35,7446775,6348625,-1098150,SELL
27-11-20 12:36,12:36,7444600,6336950,-1107650,SELL
27-11-20 12:37,12:37,7396075,6325675,-1070400,SELL
27-11-20 12:38,12:38,7387300,6340250,-1047050,SELL
27-11-20 12:39,12:39,7453175,6344500,-1108675,SELL
27-11-20 12:40,12:40,7418075,6338050,-1080025,SELL
27-11-20 12:41,12:41,7469075,6348325,-1120750,SELL
27-11-20 12:42,12:42,7471275,6359650,-1111625,SELL
27-11-20 12:43,12:43,7452125,6347525,-1104600,SELL
27-11-20 12:44,12:44,7494200,6342225,-1151975,SELL
27-11-20 12:45,12:45,7492975,6344650,-1148325,SELL
27-11-20 12:46,12:46,7459625,6332250,-1127375,SELL
27-11-20 12:47,12:47,7435300,6333400,-1101900,SELL
27-11-20 12:48,12:48,7453350,6332325,-1121025,SELL
27-11-20 12:49,12:49,7410100,6317750,-1092350,SELL
27-11-20 12:50,12:50,7428975,6347000,-1081975,SELL
27-11-20 12:51,12:51,7485550,6352550,-1133000,SELL
27-11-20 12:52,12:52,7486225,6345250,-1140975,SELL
27-11-20 12:53,12:53,7384900,6269125,-1115775,SELL
27-11-20 12:54,12:54,7408100,6271025,-1137075,SELL
27-11-20 12:55,12:55,7433900,6286225,-1147675,SELL
27-11-20 12:56,12:56,7480050,6277875,-1202175,SELL
27-11-20 12:57,12:57,7452275,6282550,-1169725,SELL
27-11-20 12:58,12:58,7449050,6270925,-1178125,SELL
27-11-20 12:59,12:59,7411175,6280925,-1130250,SELL
27-11-20 13:00,13:00,7421250,6273275,-1147975,SELL
27-11-20 13:01,13:01,7393550,6242050,-1151500,SELL
27-11-20 13:02,13:02,7441875,6266525,-1175350,SELL
27-11-20 13:03,13:03,7470825,6295500,-1175325,SELL
27-11-20 13:04,13:04,7443750,6296375,-1147375,SELL
27-11-20 13:05,13:05,7459450,6235475,-1223975,SELL
27-11-20 13:06,13:06,7435425,6251700,-1183725,SELL
27-11-20 13:07,13:07,7452350,6252225,-1200125,SELL
27-11-20 13:08,13:08,7494100,6238225,-1255875,SELL
27-11-20 13:09,13:09,7470850,6267875,-1202975,SELL
27-11-20 13:10,13:10,7449050,6236800,-1212250,SELL
27-11-20 13:11,13:11,7468150,6246525,-1221625,SELL
27-11-20 13:12,13:12,7444700,6281500,-1163200,SELL
27-11-20 13:13,13:13,7486750,6260950,-1225800,SELL
27-11-20 13:14,13:14,7568675,6245075,-1323600,SELL
27-11-20 13:15,13:15,7569575,6236300,-1333275,SELL
27-11-20 13:16,13:16,7530075,6234375,-1295700,SELL
27-11-20 13:17,13:17,7567900,6180850,-1387050,SELL
27-11-20 13:18,13:18,7576175,6197150,-1379025,SELL
27-11-20 13:19,13:19,7551700,6192800,-1358900,SELL
27-11-20 13:20,13:20,7628300,6187150,-1441150,SELL
27-11-20 13:21,13:21,7646025,6202175,-1443850,SELL
27-11-20 13:22,13:22,7600900,6199975,-1400925,SELL
27-11-20 13:23,13:23,7636250,6188550,-1447700,SELL
27-11-20 13:24,13:24,7627275,6229875,-1397400,SELL
27-11-20 13:25,13:25,7683650,6248275,-1435375,SELL
27-11-20 13:26,13:26,7588750,6221300,-1367450,SELL
27-11-20 13:27,13:27,7695150,6258275,-1436875,SELL
27-11-20 13:28,13:28,7644900,6253650,-1391250,SELL
27-11-20 13:29,13:29,7651625,6249250,-1402375,SELL
27-11-20 13:30,13:30,7702650,6228425,-1474225,SELL
27-11-20 13:31,13:31,7657150,6221875,-1435275,SELL
27-11-20 13:32,13:32,7711150,6237625,-1473525,SELL
27-11-20 13:33,13:33,7759375,6244075,-1515300,SELL
27-11-20 13:34,13:34,7755300,6251950,-1503350,SELL
27-11-20 13:35,13:35,7736350,6237200,-1499150,SELL
27-11-20 13:36,13:36,7794425,6272725,-1521700,SELL
27-11-20 13:37,13:37,7800775,6272425,-1528350,SELL
27-11-20 13:38,13:38,7778150,6270525,-1507625,SELL
27-11-20 13:39,13:39,7694675,6181425,-1513250,SELL
27-11-20 13:40,13:40,7713875,6189350,-1524525,SELL
27-11-20 13:41,13:41,7660800,6189350,-1471450,SELL
27-11-20 13:42,13:42,7662225,6192025,-1470200,SELL
27-11-20 13:43,13:43,7669350,6195675,-1473675,SELL
27-11-20 13:44,13:44,7664775,6183075,-1481700,SELL
27-11-20 13:45,13:45,7670850,6212975,-1457875,SELL
27-11-20 13:46,13:46,7716675,6221675,-1495000,SELL
27-11-20 13:47,13:47,7714875,6219375,-1495500,SELL
27-11-20 13:48,13:48,7696225,6238925,-1457300,SELL
27-11-20 13:49,13:49,7674475,6238025,-1436450,SELL
27-11-20 13:50,13:50,7688775,6243050,-1445725,SELL
27-11-20 13:51,13:51,7639100,6278525,-1360575,SELL
27-11-20 13:52,13:52,7622800,6272275,-1350525,SELL
27-11-20 13:53,13:53,7650550,6255175,-1395375,SELL
27-11-20 13:54,13:54,7708800,6282025,-1426775,SELL
27-11-20 13:55,13:55,7684150,6275775,-1408375,SELL
27-11-20 13:56,13:56,7681925,6275775,-1406150,SELL
27-11-20 13:57,13:57,7662400,6273500,-1388900,SELL
27-11-20 13:58,13:58,7688000,6268250,-1419750,SELL
27-11-20 13:59,13:59,7697650,6250650,-1447000,SELL
27-11-20 14:00,14:00,7670825,6285600,-1385225,SELL
27-11-20 14:01,14:01,7696975,6265600,-1431375,SELL
27-11-20 14:02,14:02,7678075,6307250,-1370825,SELL
27-11-20 14:03,14:03,7714575,6282900,-1431675,SELL
27-11-20 14:04,14:04,7694675,6270625,-1424050,SELL
27-11-20 14:05,14:05,7667075,6270150,-1396925,SELL
27-11-20 14:06,14:06,7710400,6270350,-1440050,SELL
27-11-20 14:07,14:07,7736050,6288450,-1447600,SELL
27-11-20 14:08,14:08,7699000,6279975,-1419025,SELL
27-11-20 14:09,14:09,7703475,6297375,-1406100,SELL
27-11-20 14:10,14:10,7723750,6308775,-1414975,SELL
27-11-20 14:11,14:11,7755050,6291325,-1463725,SELL
27-11-20 14:12,14:12,7724175,6274125,-1450050,SELL
27-11-20 14:13,14:13,7730475,6286450,-1444025,SELL
27-11-20 14:14,14:14,7673425,6282425,-1391000,SELL
27-11-20 14:15,14:15,7726850,6300400,-1426450,SELL
27-11-20 14:16,14:16,7717500,6257825,-1459675,SELL
27-11-20 14:17,14:17,7685275,6276475,-1408800,SELL
27-11-20 14:18,14:18,7671500,6293450,-1378050,SELL
27-11-20 14:19,14:19,7652800,6305850,-1346950,SELL
27-11-20 14:20,14:20,7706750,6318675,-1388075,SELL
27-11-20 14:21,14:21,7660550,6276600,-1383950,SELL
27-11-20 14:22,14:22,7677300,6316850,-1360450,SELL
27-11-20 14:23,14:23,7641125,6279800,-1361325,SELL
27-11-20 14:24,14:24,7583600,6307025,-1276575,SELL
27-11-20 14:25,14:25,7662675,6275850,-1386825,SELL
27-11-20 14:26,14:26,7637550,6289225,-1348325,SELL
27-11-20 14:27,14:27,7540325,6272325,-1268000,SELL
27-11-20 14:28,14:28,7572075,6273275,-1298800,SELL
27-11-20 14:29,14:29,7544200,6273600,-1270600,SELL
27-11-20 14:30,14:30,7451650,6259925,-1191725,SELL
27-11-20 14:31,14:31,7407450,6231875,-1175575,SELL
27-11-20 14:32,14:32,7407450,6254450,-1153000,SELL
27-11-20 14:33,14:33,7455700,6240825,-1214875,SELL
27-11-20 14:34,14:34,7373650,6216100,-1157550,SELL
27-11-20 14:35,14:35,7411500,6219900,-1191600,SELL
27-11-20 14:36,14:36,7436975,6229975,-1207000,SELL
27-11-20 14:37,14:37,7422800,6228625,-1194175,SELL
27-11-20 14:38,14:38,7437675,6244200,-1193475,SELL
27-11-20 14:39,14:39,7412025,6201450,-1210575,SELL
27-11-20 14:40,14:40,7419375,6209450,-1209925,SELL
27-11-20 14:41,14:41,7412250,6209450,-1202800,SELL
27-11-20 14:42,14:42,7386900,6219700,-1167200,SELL
27-11-20 14:43,14:43,7419975,6240625,-1179350,SELL
27-11-20 14:44,14:44,7422025,6243350,-1178675,SELL
27-11-20 14:45,14:45,7458925,6163150,-1295775,SELL
27-11-20 14:46,14:46,7458175,6162900,-1295275,SELL
27-11-20 14:47,14:47,7445925,6161950,-1283975,SELL
27-11-20 14:48,14:48,7320200,5984875,-1335325,SELL
27-11-20 14:49,14:49,7324125,5985450,-1338675,SELL
27-11-20 14:50,14:50,7324750,5981025,-1343725,SELL
27-11-20 14:51,14:51,7167850,5937575,-1230275,SELL
27-11-20 14:52,14:52,7142775,5925450,-1217325,SELL
27-11-20 14:53,14:53,7199175,5939775,-1259400,SELL
27-11-20 14:54,14:54,7164975,5901275,-1263700,SELL
27-11-20 14:55,14:55,7161875,5901275,-1260600,SELL
27-11-20 14:56,14:56,7169700,5907075,-1262625,SELL
27-11-20 14:57,14:57,7069050,5858225,-1210825,SELL
27-11-20 14:58,14:58,7062225,5850850,-1211375,SELL
27-11-20 14:59,14:59,7066850,5884575,-1182275,SELL
27-11-20 15:00,15:00,7007850,5897825,-1110025,SELL
27-11-20 15:01,15:01,7016575,5905575,-1111000,SELL
27-11-20 15:02,15:02,7001050,5875275,-1125775,SELL
27-11-20 15:03,15:03,6873925,5773875,-1100050,SELL
27-11-20 15:04,15:04,6905150,5773875,-1131275,SELL
27-11-20 15:05,15:05,6907275,5772675,-1134600,SELL
27-11-20 15:06,15:06,6749000,5766200,-982800,SELL
27-11-20 15:07,15:07,6775075,5768450,-1006625,SELL
27-11-20 15:08,15:08,6773475,5768450,-1005025,SELL
27-11-20 15:09,15:09,6748000,5790450,-957550,SELL
27-11-20 15:10,15:10,6721675,5787375,-934300,SELL
27-11-20 15:11,15:11,6740250,5786800,-953450,SELL
27-11-20 15:12,15:12,6644075,5730250,-913825,SELL
27-11-20 15:13,15:13,6611875,5706075,-905800,SELL
27-11-20 15:14,15:14,6605025,5706850,-898175,SELL
27-11-20 15:15,15:15,6576450,5622750,-953700,SELL
27-11-20 15:16,15:16,6549875,5646975,-902900,SELL
27-11-20 15:17,15:17,6557825,5642575,-915250,SELL
27-11-20 15:18,15:18,6482125,5584900,-897225,SELL
27-11-20 15:19,15:19,6472875,5584300,-888575,SELL
27-11-20 15:20,15:20,6493900,5589150,-904750,SELL
27-11-20 15:21,15:21,6372325,5477075,-895250,SELL
27-11-20 15:22,15:22,6367525,5470700,-896825,SELL
27-11-20 15:23,15:23,6362350,5476675,-885675,SELL
27-11-20 15:24,15:24,6276550,5353175,-923375,SELL
27-11-20 15:25,15:25,6308625,5357650,-950975,SELL
27-11-20 15:26,15:26,6303950,5332375,-971575,SELL
27-11-20 15:27,15:27,6229125,5258675,-970450,SELL
27-11-20 15:28,15:28,6202475,5254850,-947625,SELL
27-11-20 15:29,15:29,6222500,5258625,-963875,SELL
01-12-20 9:15,9:15,5949925,5204325,-745600,SELL
01-12-20 9:16,9:16,5962850,5210625,-752225,SELL
01-12-20 9:17,9:17,6451650,5700550,-751100,SELL
01-12-20 9:18,9:18,6471900,5701800,-770100,SELL
01-12-20 9:19,9:19,6465625,5699675,-765950,SELL
01-12-20 9:20,9:20,7024225,6292125,-732100,SELL
01-12-20 9:21,9:21,7022725,6292125,-730600,SELL
01-12-20 9:22,9:22,7015975,6297425,-718550,SELL
01-12-20 9:23,9:23,7451925,6580325,-871600,SELL
01-12-20 9:24,9:24,7479750,6576200,-903550,SELL
01-12-20 9:25,9:25,7479700,6580325,-899375,SELL
01-12-20 9:26,9:26,7751725,6759750,-991975,SELL
01-12-20 9:27,9:27,7768275,6761250,-1007025,SELL
01-12-20 9:28,9:28,7753300,6762700,-990600,SELL
01-12-20 9:29,9:29,7885300,6907650,-977650,SELL
01-12-20 9:30,9:30,7937975,6915150,-1022825,SELL
01-12-20 9:31,9:31,7913150,6881625,-1031525,SELL
01-12-20 9:32,9:32,7987000,7025250,-961750,SELL
01-12-20 9:33,9:33,8008025,7029225,-978800,SELL
01-12-20 9:34,9:34,7988350,6990850,-997500,SELL
01-12-20 9:35,9:35,8018600,7059350,-959250,SELL
01-12-20 9:36,9:36,8018600,7039800,-978800,SELL
01-12-20 9:37,9:37,7995325,7061725,-933600,SELL
01-12-20 9:38,9:38,8106075,7171325,-934750,SELL
01-12-20 9:39,9:39,8142200,7191050,-951150,SELL
01-12-20 9:40,9:40,8149400,7193050,-956350,SELL
01-12-20 9:41,9:41,8202450,7346875,-855575,SELL
01-12-20 9:42,9:42,8233850,7318925,-914925,SELL
01-12-20 9:43,9:43,8217325,7330525,-886800,SELL
01-12-20 9:44,9:44,8336400,7468525,-867875,SELL
01-12-20 9:45,9:45,8342250,7468525,-873725,SELL
01-12-20 9:46,9:46,8360500,7441875,-918625,SELL
01-12-20 9:47,9:47,8504475,7582675,-921800,SELL
01-12-20 9:48,9:48,8465050,7588200,-876850,SELL
01-12-20 9:49,9:49,8490600,7576750,-913850,SELL
01-12-20 9:50,9:50,8593150,7703350,-889800,SELL
01-12-20 9:51,9:51,8580525,7690225,-890300,SELL
01-12-20 9:52,9:52,8616825,7703350,-913475,SELL
01-12-20 9:53,9:53,8597925,7744475,-853450,SELL
01-12-20 9:54,9:54,8590825,7730500,-860325,SELL
01-12-20 9:55,9:55,8598400,7748100,-850300,SELL
01-12-20 9:56,9:56,8586600,7836100,-750500,SELL
01-12-20 9:57,9:57,8632225,7852100,-780125,SELL
01-12-20 9:58,9:58,8574050,7849400,-724650,SELL
01-12-20 9:59,9:59,8704500,7955075,-749425,SELL
01-12-20 10:00,10:00,8712350,7967700,-744650,SELL
01-12-20 10:01,10:01,8735050,7929050,-806000,SELL
01-12-20 10:02,10:02,8807575,8060425,-747150,SELL
01-12-20 10:03,10:03,8785775,8055350,-730425,SELL
01-12-20 10:04,10:04,8785775,8027975,-757800,SELL
01-12-20 10:05,10:05,8899775,8117775,-782000,SELL
01-12-20 10:06,10:06,8883500,8098350,-785150,SELL
01-12-20 10:07,10:07,8849325,8069450,-779875,SELL
01-12-20 10:08,10:08,9043650,8146125,-897525,SELL
01-12-20 10:09,10:09,9100950,8155750,-945200,SELL
01-12-20 10:10,10:10,9115275,8152850,-962425,SELL
01-12-20 10:11,10:11,9189875,8233175,-956700,SELL
01-12-20 10:12,10:12,9222675,8236075,-986600,SELL
01-12-20 10:13,10:13,9173600,8245850,-927750,SELL
01-12-20 10:14,10:14,9200025,8205100,-994925,SELL
01-12-20 10:15,10:15,9188550,8245450,-943100,SELL
01-12-20 10:16,10:16,9161400,8240650,-920750,SELL
01-12-20 10:17,10:17,9196775,8320825,-875950,SELL
01-12-20 10:18,10:18,9245800,8328925,-916875,SELL
01-12-20 10:19,10:19,9224000,8310725,-913275,SELL
01-12-20 10:20,10:20,9231475,8344200,-887275,SELL
01-12-20 10:21,10:21,9249800,8327875,-921925,SELL
01-12-20 10:22,10:22,9247675,8368275,-879400,SELL
01-12-20 10:23,10:23,9194750,8379475,-815275,SELL
01-12-20 10:24,10:24,9250850,8408900,-841950,SELL
01-12-20 10:25,10:25,9265700,8408725,-856975,SELL
01-12-20 10:26,10:26,9303350,8400750,-902600,SELL
01-12-20 10:27,10:27,9288850,8441325,-847525,SELL
01-12-20 10:28,10:28,9323050,8443600,-879450,SELL
01-12-20 10:29,10:29,9266100,8487325,-778775,SELL
01-12-20 10:30,10:30,9273875,8487325,-786550,SELL
01-12-20 10:31,10:31,9291400,8487325,-804075,SELL
01-12-20 10:32,10:32,9288825,8585100,-703725,SELL
01-12-20 10:33,10:33,9341750,8588500,-753250,SELL
01-12-20 10:34,10:34,9259500,8583225,-676275,SELL
01-12-20 10:35,10:35,9348575,8637550,-711025,SELL
01-12-20 10:36,10:36,9352500,8642250,-710250,SELL
01-12-20 10:37,10:37,9327050,8638950,-688100,SELL
01-12-20 10:38,10:38,9186825,8556050,-630775,SELL
01-12-20 10:39,10:39,9210250,8604225,-606025,SELL
01-12-20 10:40,10:40,9155275,8599175,-556100,SELL
01-12-20 10:41,10:41,9238150,8686025,-552125,SELL
01-12-20 10:42,10:42,9227850,8675300,-552550,SELL
01-12-20 10:43,10:43,9163350,8684375,-478975,SELL
01-12-20 10:44,10:44,8989650,8768025,-221625,SELL
01-12-20 10:45,10:45,9070700,8769675,-301025,SELL
01-12-20 10:46,10:46,9015350,8733600,-281750,SELL
01-12-20 10:47,10:47,8888375,8765325,-123050,SELL
01-12-20 10:48,10:48,8878000,8783000,-95000,SELL
01-12-20 10:49,10:49,8890200,8773425,-116775,SELL
01-12-20 10:50,10:50,8869050,8800550,-68500,SELL
01-12-20 10:51,10:51,8878175,8834000,-44175,SELL
01-12-20 10:52,10:52,8875225,8843575,-31650,SELL
01-12-20 10:53,10:53,8913700,8974450,60750,BUY
01-12-20 10:54,10:54,8917225,8976250,59025,BUY
01-12-20 10:55,10:55,8905600,8975575,69975,BUY
01-12-20 10:56,10:56,8924850,8995150,70300,BUY
01-12-20 10:57,10:57,8916075,8922200,6125,BUY
01-12-20 10:58,10:58,8921400,8956075,34675,BUY
01-12-20 10:59,10:59,8958750,9081375,122625,BUY
01-12-20 11:00,11:00,8952150,9048200,96050,BUY
01-12-20 11:01,11:01,8935275,9058375,123100,BUY
01-12-20 11:02,11:02,8963075,9140000,176925,BUY
01-12-20 11:03,11:03,9000200,9126350,126150,BUY
01-12-20 11:04,11:04,8981725,9152975,171250,BUY
01-12-20 11:05,11:05,8978150,9138025,159875,BUY
01-12-20 11:06,11:06,9023575,9137075,113500,BUY
01-12-20 11:07,11:07,8990850,9079150,88300,BUY
01-12-20 11:08,11:08,8946450,9120925,174475,BUY
01-12-20 11:09,11:09,8927300,9090250,162950,BUY
01-12-20 11:10,11:10,8993675,9166100,172425,BUY
01-12-20 11:11,11:11,8940025,9155975,215950,BUY
01-12-20 11:12,11:12,9010300,9165800,155500,BUY
01-12-20 11:13,11:13,8910300,9066400,156100,BUY
01-12-20 11:14,11:14,8997000,9218850,221850,BUY
01-12-20 11:15,11:15,8929950,9151800,221850,BUY
01-12-20 11:16,11:16,8945950,9174275,228325,BUY
01-12-20 11:17,11:17,8954525,9151700,197175,BUY
01-12-20 11:18,11:18,8888050,9158175,270125,BUY
01-12-20 11:19,11:19,9019925,9226225,206300,BUY
01-12-20 11:20,11:20,9017750,9198750,181000,BUY
01-12-20 11:21,11:21,9017800,9191700,173900,BUY
01-12-20 11:22,11:22,9026725,9169225,142500,BUY
01-12-20 11:23,11:23,9022625,9211475,188850,BUY
01-12-20 11:24,11:24,9001225,9207850,206625,BUY
01-12-20 11:25,11:25,8966475,9199075,232600,BUY
01-12-20 11:26,11:26,9047850,9140475,92625,BUY
01-12-20 11:27,11:27,9062975,9143050,80075,BUY
01-12-20 11:28,11:28,9020475,9200900,180425,BUY
01-12-20 11:29,11:29,9024175,9211550,187375,BUY
01-12-20 11:30,11:30,9024175,9207800,183625,BUY
01-12-20 11:31,11:31,9013075,9206475,193400,BUY
01-12-20 11:32,11:32,9095775,9209075,113300,BUY
01-12-20 11:33,11:33,9050425,9142850,92425,BUY
01-12-20 11:34,11:34,8782350,9229100,446750,BUY
01-12-20 11:35,11:35,9166775,9148650,-18125,SELL
01-12-20 11:36,11:36,9082700,9200075,117375,BUY
01-12-20 11:37,11:37,9094900,9081150,-13750,SELL
01-12-20 11:38,11:38,9071925,9223725,151800,BUY
01-12-20 11:39,11:39,9106275,9119700,13425,BUY
01-12-20 11:40,11:40,9110475,9192525,82050,BUY
01-12-20 11:41,11:41,9090325,9171150,80825,BUY
01-12-20 11:42,11:42,9056825,9155425,98600,BUY
01-12-20 11:43,11:43,9099975,9247175,147200,BUY
01-12-20 11:44,11:44,9123750,9256225,132475,BUY
01-12-20 11:45,11:45,9063025,9184650,121625,BUY
01-12-20 11:46,11:46,9089400,9219225,129825,BUY
01-12-20 11:47,11:47,9057700,9231600,173900,BUY
01-12-20 11:48,11:48,9047900,9244125,196225,BUY
01-12-20 11:49,11:49,9145500,9282275,136775,BUY
01-12-20 11:50,11:50,9090500,9307250,216750,BUY
01-12-20 11:51,11:51,9064350,9230875,166525,BUY
01-12-20 11:52,11:52,9150825,9298400,147575,BUY
01-12-20 11:53,11:53,9135175,9234300,99125,BUY
01-12-20 11:54,11:54,9173050,9245175,72125,BUY
01-12-20 11:55,11:55,9072950,9343175,270225,BUY
01-12-20 11:56,11:56,9139325,9406025,266700,BUY
01-12-20 11:57,11:57,9099700,9407425,307725,BUY
01-12-20 11:58,11:58,9150100,9355200,205100,BUY
01-12-20 11:59,11:59,9159175,9451450,292275,BUY
01-12-20 12:00,12:00,9176125,9443725,267600,BUY
01-12-20 12:01,12:01,9092100,9398650,306550,BUY
01-12-20 12:02,12:02,9162050,9448800,286750,BUY
01-12-20 12:03,12:03,9189275,9415050,225775,BUY
01-12-20 12:04,12:04,9160925,9395975,235050,BUY
01-12-20 12:05,12:05,9161225,9435925,274700,BUY
01-12-20 12:06,12:06,9120075,9474425,354350,BUY
01-12-20 12:07,12:07,9144800,9513850,369050,BUY
01-12-20 12:08,12:08,9072475,9441350,368875,BUY
01-12-20 12:09,12:09,9153175,9455250,302075,BUY
01-12-20 12:10,12:10,9136250,9443450,307200,BUY
01-12-20 12:11,12:11,9180750,9403475,222725,BUY
01-12-20 12:12,12:12,9146400,9432100,285700,BUY
01-12-20 12:13,12:13,9212850,9463750,250900,BUY
01-12-20 12:14,12:14,9272650,9387000,114350,BUY
01-12-20 12:15,12:15,9186975,9510725,323750,BUY
01-12-20 12:16,12:16,9270775,9459375,188600,BUY
01-12-20 12:17,12:17,9242900,9489500,246600,BUY
01-12-20 12:18,12:18,9185300,9544700,359400,BUY
01-12-20 12:19,12:19,9170575,9508075,337500,BUY
01-12-20 12:20,12:20,9327850,9551250,223400,BUY
01-12-20 12:21,12:21,9280175,9577000,296825,BUY
01-12-20 12:22,12:22,9259700,9597750,338050,BUY
01-12-20 12:23,12:23,9238825,9629275,390450,BUY
01-12-20 12:24,12:24,9067000,9596650,529650,BUY
01-12-20 12:25,12:25,9279975,9618500,338525,BUY
01-12-20 12:26,12:26,9347425,9610050,262625,BUY
01-12-20 12:27,12:27,9330825,9593800,262975,BUY
01-12-20 12:28,12:28,9433400,9668150,234750,BUY
01-12-20 12:29,12:29,9325600,9524550,198950,BUY
01-12-20 12:30,12:30,9310925,9525400,214475,BUY
01-12-20 12:31,12:31,9327425,9527000,199575,BUY
01-12-20 12:32,12:32,9349975,9556250,206275,BUY
01-12-20 12:33,12:33,9351375,9546050,194675,BUY
01-12-20 12:34,12:34,9351375,9469325,117950,BUY
01-12-20 12:35,12:35,9333100,9524850,191750,BUY
01-12-20 12:36,12:36,9396825,9562525,165700,BUY
01-12-20 12:37,12:37,9346800,9497450,150650,BUY
01-12-20 12:38,12:38,9357475,9586425,228950,BUY
01-12-20 12:39,12:39,9354200,9530725,176525,BUY
01-12-20 12:40,12:40,9381550,9603100,221550,BUY
01-12-20 12:41,12:41,9450000,9547675,97675,BUY
01-12-20 12:42,12:42,9437325,9542375,105050,BUY
01-12-20 12:43,12:43,9407775,9542375,134600,BUY
01-12-20 12:44,12:44,9466725,9509975,43250,BUY
01-12-20 12:45,12:45,9496150,9517825,21675,BUY
01-12-20 12:46,12:46,9503250,9499325,-3925,SELL
01-12-20 12:47,12:47,9474150,9481875,7725,BUY
01-12-20 12:48,12:48,9488075,9477000,-11075,SELL
01-12-20 12:49,12:49,9527775,9498675,-29100,SELL
01-12-20 12:50,12:50,9542100,9512225,-29875,SELL
01-12-20 12:51,12:51,9415025,9452925,37900,BUY
01-12-20 12:52,12:52,9525125,9517450,-7675,SELL
01-12-20 12:53,12:53,9505850,9535775,29925,BUY
01-12-20 12:54,12:54,9517700,9513700,-4000,SELL
01-12-20 12:55,12:55,9478525,9429625,-48900,SELL
01-12-20 12:56,12:56,9516125,9534250,18125,BUY
01-12-20 12:57,12:57,9598825,9431800,-167025,SELL
01-12-20 12:58,12:58,9579650,9531625,-48025,SELL
01-12-20 12:59,12:59,9561350,9545500,-15850,SELL
01-12-20 13:00,13:00,9553325,9529575,-23750,SELL
01-12-20 13:01,13:01,9557025,9530900,-26125,SELL
01-12-20 13:02,13:02,9610325,9521275,-89050,SELL
01-12-20 13:03,13:03,9585600,9522300,-63300,SELL
01-12-20 13:04,13:04,9613075,9544325,-68750,SELL
01-12-20 13:05,13:05,9655225,9542925,-112300,SELL
01-12-20 13:06,13:06,9657050,9557625,-99425,SELL
01-12-20 13:07,13:07,9715450,9586475,-128975,SELL
01-12-20 13:08,13:08,9660875,9453775,-207100,SELL
01-12-20 13:09,13:09,9658725,9458225,-200500,SELL
01-12-20 13:10,13:10,9638300,9436650,-201650,SELL
01-12-20 13:11,13:11,9542650,9413375,-129275,SELL
01-12-20 13:12,13:12,9533125,9390475,-142650,SELL
01-12-20 13:13,13:13,9556750,9428275,-128475,SELL
01-12-20 13:14,13:14,9653425,9420975,-232450,SELL
01-12-20 13:15,13:15,9554700,9287125,-267575,SELL
01-12-20 13:16,13:16,9560375,9311600,-248775,SELL
01-12-20 13:17,13:17,9561900,9403475,-158425,SELL
01-12-20 13:18,13:18,9553700,9370075,-183625,SELL
01-12-20 13:19,13:19,9592925,9416350,-176575,SELL
01-12-20 13:20,13:20,9541950,9422050,-119900,SELL
01-12-20 13:21,13:21,9545100,9425825,-119275,SELL
01-12-20 13:22,13:22,9601650,9377225,-224425,SELL
01-12-20 13:23,13:23,9581700,9391975,-189725,SELL
01-12-20 13:24,13:24,9573950,9349825,-224125,SELL
01-12-20 13:25,13:25,9540450,9344600,-195850,SELL
01-12-20 13:26,13:26,9603875,9466175,-137700,SELL
01-12-20 13:27,13:27,9558400,9383875,-174525,SELL
01-12-20 13:28,13:28,9524975,9432975,-92000,SELL
01-12-20 13:29,13:29,9484175,9463975,-20200,SELL
01-12-20 13:30,13:30,9674500,9491525,-182975,SELL
01-12-20 13:31,13:31,9689550,9484250,-205300,SELL
01-12-20 13:32,13:32,9659600,9426100,-233500,SELL
01-12-20 13:33,13:33,9555925,9397475,-158450,SELL
01-12-20 13:34,13:34,9652325,9377425,-274900,SELL
01-12-20 13:35,13:35,9623475,9413975,-209500,SELL
01-12-20 13:36,13:36,9721400,9480950,-240450,SELL
01-12-20 13:37,13:37,9697750,9467550,-230200,SELL
01-12-20 13:38,13:38,9712950,9496650,-216300,SELL
01-12-20 13:39,13:39,9712950,9524675,-188275,SELL
01-12-20 13:40,13:40,9679950,9527275,-152675,SELL
01-12-20 13:41,13:41,9680525,9524925,-155600,SELL
01-12-20 13:42,13:42,9546650,9492450,-54200,SELL
01-12-20 13:43,13:43,9561175,9497725,-63450,SELL
01-12-20 13:44,13:44,9577600,9497625,-79975,SELL
01-12-20 13:45,13:45,9577450,9478950,-98500,SELL
01-12-20 13:46,13:46,9556425,9312175,-244250,SELL
01-12-20 13:47,13:47,9585925,9374025,-211900,SELL
01-12-20 13:48,13:48,9598975,9443775,-155200,SELL
01-12-20 13:49,13:49,9632575,9451175,-181400,SELL
01-12-20 13:50,13:50,9555550,9462825,-92725,SELL
01-12-20 13:51,13:51,9579075,9480925,-98150,SELL
01-12-20 13:52,13:52,9631425,9452325,-179100,SELL
01-12-20 13:53,13:53,9569300,9483925,-85375,SELL
01-12-20 13:54,13:54,9546675,9446050,-100625,SELL
01-12-20 13:55,13:55,9526400,9416775,-109625,SELL
01-12-20 13:56,13:56,9586325,9424850,-161475,SELL
01-12-20 13:57,13:57,9371550,9392750,21200,BUY
01-12-20 13:58,13:58,9477050,9446200,-30850,SELL
01-12-20 13:59,13:59,9393650,9422800,29150,BUY
01-12-20 14:00,14:00,9608975,9466475,-142500,SELL
01-12-20 14:01,14:01,9627825,9453900,-173925,SELL
01-12-20 14:02,14:02,9584175,9463975,-120200,SELL
01-12-20 14:03,14:03,9550800,9385875,-164925,SELL
01-12-20 14:04,14:04,9564300,9383425,-180875,SELL
01-12-20 14:05,14:05,9531525,9429275,-102250,SELL
01-12-20 14:06,14:06,9572625,9461600,-111025,SELL
01-12-20 14:07,14:07,9466450,9481400,14950,BUY
01-12-20 14:08,14:08,9581325,9499900,-81425,SELL
01-12-20 14:09,14:09,9600800,9481125,-119675,SELL
01-12-20 14:10,14:10,9577875,9452450,-125425,SELL
01-12-20 14:11,14:11,9584575,9463550,-121025,SELL
01-12-20 14:12,14:12,9589725,9563625,-26100,SELL
01-12-20 14:13,14:13,9621300,9563525,-57775,SELL
01-12-20 14:14,14:14,9581150,9562225,-18925,SELL
01-12-20 14:15,14:15,9521025,9482325,-38700,SELL
01-12-20 14:16,14:16,9541900,9414975,-126925,SELL
01-12-20 14:17,14:17,9520100,9483550,-36550,SELL
01-12-20 14:18,14:18,9468175,9512225,44050,BUY
01-12-20 14:19,14:19,9474075,9505975,31900,BUY
01-12-20 14:20,14:20,9498675,9491300,-7375,SELL
01-12-20 14:21,14:21,9533375,9525550,-7825,SELL
01-12-20 14:22,14:22,9509600,9525550,15950,BUY
01-12-20 14:23,14:23,9535075,9526825,-8250,SELL
01-12-20 14:24,14:24,9514050,9430000,-84050,SELL
01-12-20 14:25,14:25,9552125,9453175,-98950,SELL
01-12-20 14:26,14:26,9566075,9478650,-87425,SELL
01-12-20 14:27,14:27,9538250,9489150,-49100,SELL
01-12-20 14:28,14:28,9516200,9449775,-66425,SELL
01-12-20 14:29,14:29,9525425,9484675,-40750,SELL
01-12-20 14:30,14:30,9526050,9477925,-48125,SELL
01-12-20 14:31,14:31,9527150,9492650,-34500,SELL
01-12-20 14:32,14:32,9547800,9500250,-47550,SELL
01-12-20 14:33,14:33,9607125,9478250,-128875,SELL
01-12-20 14:34,14:34,9565200,9417450,-147750,SELL
01-12-20 14:35,14:35,9626500,9484050,-142450,SELL
01-12-20 14:36,14:36,9604575,9510250,-94325,SELL
01-12-20 14:37,14:37,9588100,9456275,-131825,SELL
01-12-20 14:38,14:38,9592125,9462175,-129950,SELL
01-12-20 14:39,14:39,9638200,9556825,-81375,SELL
01-12-20 14:40,14:40,9651550,9555400,-96150,SELL
01-12-20 14:41,14:41,9633225,9557175,-76050,SELL
01-12-20 14:42,14:42,9366550,9437425,70875,BUY
01-12-20 14:43,14:43,9388750,9434625,45875,BUY
01-12-20 14:44,14:44,9401700,9437475,35775,BUY
01-12-20 14:45,14:45,9407500,9417325,9825,BUY
01-12-20 14:46,14:46,9356350,9439550,83200,BUY
01-12-20 14:47,14:47,9352100,9433400,81300,BUY
01-12-20 14:48,14:48,9310000,9416675,106675,BUY
01-12-20 14:49,14:49,9356625,9398550,41925,BUY
01-12-20 14:50,14:50,9356625,9394375,37750,BUY
01-12-20 14:51,14:51,9358825,9296400,-62425,SELL
01-12-20 14:52,14:52,9311900,9300125,-11775,SELL
01-12-20 14:53,14:53,9333225,9297775,-35450,SELL
01-12-20 14:54,14:54,9299525,9240225,-59300,SELL
01-12-20 14:55,14:55,9303750,9270775,-32975,SELL
01-12-20 14:56,14:56,9303750,9266800,-36950,SELL
01-12-20 14:57,14:57,9277775,9224450,-53325,SELL
01-12-20 14:58,14:58,9278575,9261325,-17250,SELL
01-12-20 14:59,14:59,9297150,9264325,-32825,SELL
01-12-20 15:00,15:00,8956350,9017000,60650,BUY
01-12-20 15:01,15:01,8952625,9018050,65425,BUY
01-12-20 15:02,15:02,8930850,9011475,80625,BUY
01-12-20 15:03,15:03,8879650,8868075,-11575,SELL
01-12-20 15:04,15:04,8833625,8861925,28300,BUY
01-12-20 15:05,15:05,8892725,8866550,-26175,SELL
01-12-20 15:06,15:06,8854800,8862050,7250,BUY
01-12-20 15:07,15:07,8857100,8863275,6175,BUY
01-12-20 15:08,15:08,8863175,8866400,3225,BUY
01-12-20 15:09,15:09,8799950,8869775,69825,BUY
01-12-20 15:10,15:10,8801625,8872700,71075,BUY
01-12-20 15:11,15:11,8846550,8872950,26400,BUY
01-12-20 15:12,15:12,8787550,8804375,16825,BUY
01-12-20 15:13,15:13,8771275,8802600,31325,BUY
01-12-20 15:14,15:14,8796675,8802025,5350,BUY
01-12-20 15:15,15:15,8742675,8667250,-75425,SELL
01-12-20 15:16,15:16,8697775,8703400,5625,BUY
01-12-20 15:17,15:17,8693825,8703475,9650,BUY
01-12-20 15:18,15:18,8687875,8608475,-79400,SELL
01-12-20 15:19,15:19,8714625,8616850,-97775,SELL
01-12-20 15:20,15:20,8710775,8619100,-91675,SELL
01-12-20 15:21,15:21,8615350,8466300,-149050,SELL
01-12-20 15:22,15:22,8566700,8457525,-109175,SELL
01-12-20 15:23,15:23,8571850,8452625,-119225,SELL
01-12-20 15:24,15:24,8660050,8428250,-231800,SELL
01-12-20 15:25,15:25,8670925,8428875,-242050,SELL
01-12-20 15:26,15:26,8579050,8415975,-163075,SELL
01-12-20 15:27,15:27,8791900,8575000,-216900,SELL
01-12-20 15:28,15:28,8804175,8550025,-254150,SELL
01-12-20 15:29,15:29,8798950,8574450,-224500,SELL
02-12-20 9:15,9:15,8842650,8438575,-404075,SELL
02-12-20 9:16,9:16,8849325,8450325,-399000,SELL
02-12-20 9:17,9:17,9272100,8982800,-289300,SELL
02-12-20 9:18,9:18,9290725,8948350,-342375,SELL
02-12-20 9:19,9:19,9271300,8977725,-293575,SELL
02-12-20 9:20,9:20,9730250,9447550,-282700,SELL
02-12-20 9:21,9:21,9725000,9445250,-279750,SELL
02-12-20 9:22,9:22,9694350,9442500,-251850,SELL
02-12-20 9:23,9:23,9983425,9718700,-264725,SELL
02-12-20 9:24,9:24,9981075,9714025,-267050,SELL
02-12-20 9:25,9:25,10004725,9661500,-343225,SELL
02-12-20 9:26,9:26,10294000,9953775,-340225,SELL
02-12-20 9:27,9:27,10263900,9917200,-346700,SELL
02-12-20 9:28,9:28,10321600,9855425,-466175,SELL
02-12-20 9:29,9:29,10563325,10069025,-494300,SELL
02-12-20 9:30,9:30,10557600,10078250,-479350,SELL
02-12-20 9:31,9:31,10558075,10079250,-478825,SELL
02-12-20 9:32,9:32,10640200,10192550,-447650,SELL
02-12-20 9:33,9:33,10653000,10209625,-443375,SELL
02-12-20 9:34,9:34,10666725,10220125,-446600,SELL
02-12-20 9:35,9:35,10659300,10275525,-383775,SELL
02-12-20 9:36,9:36,10663825,10279125,-384700,SELL
02-12-20 9:37,9:37,10678200,10324400,-353800,SELL
02-12-20 9:38,9:38,10658200,10484500,-173700,SELL
02-12-20 9:39,9:39,10622800,10444175,-178625,SELL
02-12-20 9:40,9:40,10648875,10436875,-212000,SELL
02-12-20 9:41,9:41,10720175,10605625,-114550,SELL
02-12-20 9:42,9:42,10713525,10603950,-109575,SELL
02-12-20 9:43,9:43,10710750,10567850,-142900,SELL
02-12-20 9:44,9:44,10646500,10620225,-26275,SELL
02-12-20 9:45,9:45,10682150,10567900,-114250,SELL
02-12-20 9:46,9:46,10697050,10618950,-78100,SELL
02-12-20 9:47,9:47,10762375,10600400,-161975,SELL
02-12-20 9:48,9:48,10735550,10698850,-36700,SELL
02-12-20 9:49,9:49,10753325,10700475,-52850,SELL
02-12-20 9:50,9:50,10752850,10761325,8475,BUY
02-12-20 9:51,9:51,10760425,10765775,5350,BUY
02-12-20 9:52,9:52,10776500,10766475,-10025,SELL
02-12-20 9:53,9:53,10812300,10706175,-106125,SELL
02-12-20 9:54,9:54,10778625,10771300,-7325,SELL
02-12-20 9:55,9:55,10813975,10806800,-7175,SELL
02-12-20 9:56,9:56,10813100,10768525,-44575,SELL
02-12-20 9:57,9:57,10876725,10869925,-6800,SELL
02-12-20 9:58,9:58,10842900,10865425,22525,BUY
02-12-20 9:59,9:59,10970050,10848575,-121475,SELL
02-12-20 10:00,10:00,10964800,10853275,-111525,SELL
02-12-20 10:01,10:01,10935325,10802800,-132525,SELL
02-12-20 10:02,10:02,11088825,10898700,-190125,SELL
02-12-20 10:03,10:03,11061050,10821500,-239550,SELL
02-12-20 10:04,10:04,11077175,10900375,-176800,SELL
02-12-20 10:05,10:05,11125325,10771625,-353700,SELL
02-12-20 10:06,10:06,11106625,10776300,-330325,SELL
02-12-20 10:07,10:07,11141500,10688050,-453450,SELL
02-12-20 10:08,10:08,11161750,10838150,-323600,SELL
02-12-20 10:09,10:09,11137175,10878725,-258450,SELL
02-12-20 10:10,10:10,11144025,10800300,-343725,SELL
02-12-20 10:11,10:11,11222725,10897150,-325575,SELL
02-12-20 10:12,10:12,11229575,10871975,-357600,SELL
02-12-20 10:13,10:13,11245500,10888475,-357025,SELL
02-12-20 10:14,10:14,11232125,10918825,-313300,SELL
02-12-20 10:15,10:15,11287700,10987800,-299900,SELL
02-12-20 10:16,10:16,11315400,10987750,-327650,SELL
02-12-20 10:17,10:17,11421475,10972675,-448800,SELL
02-12-20 10:18,10:18,11430125,10983200,-446925,SELL
02-12-20 10:19,10:19,11395325,10989050,-406275,SELL
02-12-20 10:20,10:20,11397575,10929450,-468125,SELL
02-12-20 10:21,10:21,11380125,10867000,-513125,SELL
02-12-20 10:22,10:22,11348300,10891050,-457250,SELL
02-12-20 10:23,10:23,11316250,10919525,-396725,SELL
02-12-20 10:24,10:24,11399600,10946825,-452775,SELL
02-12-20 10:25,10:25,11476025,10963450,-512575,SELL
02-12-20 10:26,10:26,11442800,10756025,-686775,SELL
02-12-20 10:27,10:27,11475750,10708800,-766950,SELL
02-12-20 10:28,10:28,11385350,10776800,-608550,SELL
02-12-20 10:29,10:29,11449800,10797925,-651875,SELL
02-12-20 10:30,10:30,11473700,10790150,-683550,SELL
02-12-20 10:31,10:31,11383075,10754750,-628325,SELL
02-12-20 10:32,10:32,11526550,10870650,-655900,SELL
02-12-20 10:33,10:33,11539575,10880850,-658725,SELL
02-12-20 10:34,10:34,11528550,10866025,-662525,SELL
02-12-20 10:35,10:35,11619475,10840375,-779100,SELL
02-12-20 10:36,10:36,11597825,10831025,-766800,SELL
02-12-20 10:37,10:37,11585725,10852525,-733200,SELL
02-12-20 10:38,10:38,11601975,10789800,-812175,SELL
02-12-20 10:39,10:39,11601975,10798075,-803900,SELL
02-12-20 10:40,10:40,11594150,10762800,-831350,SELL
02-12-20 10:41,10:41,11605375,10824475,-780900,SELL
02-12-20 10:42,10:42,11585850,10860850,-725000,SELL
02-12-20 10:43,10:43,11605350,10824475,-780875,SELL
02-12-20 10:44,10:44,11657275,10864050,-793225,SELL
02-12-20 10:45,10:45,11639200,10864750,-774450,SELL
02-12-20 10:46,10:46,11583925,10834525,-749400,SELL
02-12-20 10:47,10:47,11624650,10880550,-744100,SELL
02-12-20 10:48,10:48,11679850,10865300,-814550,SELL
02-12-20 10:49,10:49,11686625,10828125,-858500,SELL
02-12-20 10:50,10:50,11678675,10758550,-920125,SELL
02-12-20 10:51,10:51,11662850,10815575,-847275,SELL
02-12-20 10:52,10:52,11699250,10886325,-812925,SELL
02-12-20 10:53,10:53,11701475,10849675,-851800,SELL
02-12-20 10:54,10:54,11684500,10817025,-867475,SELL
02-12-20 10:55,10:55,11506800,10817025,-689775,SELL
02-12-20 10:56,10:56,11743325,10812725,-930600,SELL
02-12-20 10:57,10:57,11576100,10806575,-769525,SELL
02-12-20 10:58,10:58,11614125,10811300,-802825,SELL
02-12-20 10:59,10:59,11695025,10821700,-873325,SELL
02-12-20 11:00,11:00,11612425,10839900,-772525,SELL
02-12-20 11:01,11:01,11664775,10719350,-945425,SELL
02-12-20 11:02,11:02,11787375,10860975,-926400,SELL
02-12-20 11:03,11:03,11804625,10915300,-889325,SELL
02-12-20 11:04,11:04,11790850,10904850,-886000,SELL
02-12-20 11:05,11:05,11898425,10938450,-959975,SELL
02-12-20 11:06,11:06,11850650,10943100,-907550,SELL
02-12-20 11:07,11:07,11901175,10850600,-1050575,SELL
02-12-20 11:08,11:08,12024775,10959675,-1065100,SELL
02-12-20 11:09,11:09,12038025,11000175,-1037850,SELL
02-12-20 11:10,11:10,12047325,10987975,-1059350,SELL
02-12-20 11:11,11:11,12128800,10967675,-1161125,SELL
02-12-20 11:12,11:12,12101500,10952175,-1149325,SELL
02-12-20 11:13,11:13,12120975,11001975,-1119000,SELL
02-12-20 11:14,11:14,12066000,11045350,-1020650,SELL
02-12-20 11:15,11:15,12203200,11019175,-1184025,SELL
02-12-20 11:16,11:16,12198975,11052525,-1146450,SELL
02-12-20 11:17,11:17,12159325,11053250,-1106075,SELL
02-12-20 11:18,11:18,12245450,10994500,-1250950,SELL
02-12-20 11:19,11:19,12245450,11013700,-1231750,SELL
02-12-20 11:20,11:20,12181150,11029250,-1151900,SELL
02-12-20 11:21,11:21,12200275,11094975,-1105300,SELL
02-12-20 11:22,11:22,12204825,11039675,-1165150,SELL
02-12-20 11:23,11:23,12205325,11077300,-1128025,SELL
02-12-20 11:24,11:24,12205325,11049125,-1156200,SELL
02-12-20 11:25,11:25,12241850,11066675,-1175175,SELL
02-12-20 11:26,11:26,12224425,11075075,-1149350,SELL
02-12-20 11:27,11:27,12325650,11106075,-1219575,SELL
02-12-20 11:28,11:28,12331500,11107850,-1223650,SELL
02-12-20 11:29,11:29,12315175,10871050,-1444125,SELL
02-12-20 11:30,11:30,12331600,10876175,-1455425,SELL
02-12-20 11:31,11:31,12321150,10879400,-1441750,SELL
02-12-20 11:32,11:32,12237475,10696350,-1541125,SELL
02-12-20 11:33,11:33,12235075,10704225,-1530850,SELL
02-12-20 11:34,11:34,12211425,10709175,-1502250,SELL
02-12-20 11:35,11:35,12267975,10709025,-1558950,SELL
02-12-20 11:36,11:36,12089475,10707550,-1381925,SELL
02-12-20 11:37,11:37,12143000,10696050,-1446950,SELL
02-12-20 11:38,11:38,12219250,10649500,-1569750,SELL
02-12-20 11:39,11:39,12262900,10742975,-1519925,SELL
02-12-20 11:40,11:40,12212700,10697875,-1514825,SELL
02-12-20 11:41,11:41,12211800,10709025,-1502775,SELL
02-12-20 11:42,11:42,12286850,10724825,-1562025,SELL
02-12-20 11:43,11:43,12285425,10734050,-1551375,SELL
02-12-20 11:44,11:44,12263550,10645050,-1618500,SELL
02-12-20 11:45,11:45,12320225,10719750,-1600475,SELL
02-12-20 11:46,11:46,12263775,10680275,-1583500,SELL
02-12-20 11:47,11:47,12406275,10737725,-1668550,SELL
02-12-20 11:48,11:48,12400300,10759125,-1641175,SELL
02-12-20 11:49,11:49,12391225,10757625,-1633600,SELL
02-12-20 11:50,11:50,12386300,10721650,-1664650,SELL
02-12-20 11:51,11:51,12317050,10719850,-1597200,SELL
02-12-20 11:52,11:52,12396825,10631550,-1765275,SELL
02-12-20 11:53,11:53,12236125,9861075,-2375050,SELL
02-12-20 11:54,11:54,12286375,10670725,-1615650,SELL
02-12-20 11:55,11:55,12257375,10631800,-1625575,SELL
02-12-20 11:56,11:56,12297275,10656175,-1641100,SELL
02-12-20 11:57,11:57,12390750,10704700,-1686050,SELL
02-12-20 11:58,11:58,12439725,10687925,-1751800,SELL
02-12-20 11:59,11:59,12305625,10723075,-1582550,SELL
02-12-20 12:00,12:00,12286700,10743825,-1542875,SELL
02-12-20 12:01,12:01,12457375,10758850,-1698525,SELL
02-12-20 12:02,12:02,12448150,10762650,-1685500,SELL
02-12-20 12:03,12:03,12492375,10660300,-1832075,SELL
02-12-20 12:04,12:04,12488025,10744450,-1743575,SELL
02-12-20 12:05,12:05,12505225,10701800,-1803425,SELL
02-12-20 12:06,12:06,12560200,10725750,-1834450,SELL
02-12-20 12:07,12:07,12265425,10712250,-1553175,SELL
02-12-20 12:08,12:08,12493500,10783925,-1709575,SELL
02-12-20 12:09,12:09,12561675,10728225,-1833450,SELL
02-12-20 12:10,12:10,12395700,10701100,-1694600,SELL
02-12-20 12:11,12:11,12568975,10740250,-1828725,SELL
02-12-20 12:12,12:12,12627375,10762550,-1864825,SELL
02-12-20 12:13,12:13,12453925,10731350,-1722575,SELL
02-12-20 12:14,12:14,12621800,10766600,-1855200,SELL
02-12-20 12:15,12:15,12676100,10816150,-1859950,SELL
02-12-20 12:16,12:16,12703500,10783800,-1919700,SELL
02-12-20 12:17,12:17,12732300,10849075,-1883225,SELL
02-12-20 12:18,12:18,12639800,10843575,-1796225,SELL
02-12-20 12:19,12:19,12710900,10842300,-1868600,SELL
02-12-20 12:20,12:20,12720750,10836075,-1884675,SELL
02-12-20 12:21,12:21,12619800,10665750,-1954050,SELL
02-12-20 12:22,12:22,12705700,10767450,-1938250,SELL
02-12-20 12:23,12:23,12668425,10739250,-1929175,SELL
02-12-20 12:24,12:24,12783900,10779750,-2004150,SELL
02-12-20 12:25,12:25,12691000,10786975,-1904025,SELL
02-12-20 12:26,12:26,12882350,10835350,-2047000,SELL
02-12-20 12:27,12:27,12660000,10794175,-1865825,SELL
02-12-20 12:28,12:28,12897825,10867275,-2030550,SELL
02-12-20 12:29,12:29,12846975,10851575,-1995400,SELL
02-12-20 12:30,12:30,12896750,10921625,-1975125,SELL
02-12-20 12:31,12:31,12846450,10864825,-1981625,SELL
02-12-20 12:32,12:32,12809850,10815400,-1994450,SELL
02-12-20 12:33,12:33,12737750,10801750,-1936000,SELL
02-12-20 12:34,12:34,12764775,10754750,-2010025,SELL
02-12-20 12:35,12:35,12807750,10877825,-1929925,SELL
02-12-20 12:36,12:36,12672500,10873100,-1799400,SELL
02-12-20 12:37,12:37,12714350,10884150,-1830200,SELL
02-12-20 12:38,12:38,12744425,10803225,-1941200,SELL
02-12-20 12:39,12:39,12809250,10842175,-1967075,SELL
02-12-20 12:40,12:40,12802975,10806125,-1996850,SELL
02-12-20 12:41,12:41,12714275,10831200,-1883075,SELL
02-12-20 12:42,12:42,12778825,10817300,-1961525,SELL
02-12-20 12:43,12:43,12800950,10823900,-1977050,SELL
02-12-20 12:44,12:44,12836750,10871700,-1965050,SELL
02-12-20 12:45,12:45,12885825,10884025,-2001800,SELL
02-12-20 12:46,12:46,12864950,10877625,-1987325,SELL
02-12-20 12:47,12:47,12635375,10848850,-1786525,SELL
02-12-20 12:48,12:48,12788450,10873225,-1915225,SELL
02-12-20 12:49,12:49,12703725,10868425,-1835300,SELL
02-12-20 12:50,12:50,12792300,10842175,-1950125,SELL
02-12-20 12:51,12:51,12854150,10917050,-1937100,SELL
02-12-20 12:52,12:52,12776150,10917050,-1859100,SELL
02-12-20 12:53,12:53,12948700,10924600,-2024100,SELL
02-12-20 12:54,12:54,12956500,10929125,-2027375,SELL
02-12-20 12:55,12:55,12973650,10908150,-2065500,SELL
02-12-20 12:56,12:56,12837175,10643700,-2193475,SELL
02-12-20 12:57,12:57,12848300,10642950,-2205350,SELL
02-12-20 12:58,12:58,12838975,10642700,-2196275,SELL
02-12-20 12:59,12:59,12431650,9628350,-2803300,SELL
02-12-20 13:00,13:00,12448275,9639375,-2808900,SELL
02-12-20 13:01,13:01,12452925,9626825,-2826100,SELL
02-12-20 13:02,13:02,12159225,9338650,-2820575,SELL
02-12-20 13:03,13:03,12160175,9338150,-2822025,SELL
02-12-20 13:04,13:04,12148775,9338150,-2810625,SELL
02-12-20 13:05,13:05,11988350,9418100,-2570250,SELL
02-12-20 13:06,13:06,11982900,9435150,-2547750,SELL
02-12-20 13:07,13:07,11943800,9429000,-2514800,SELL
02-12-20 13:08,13:08,11976000,9451850,-2524150,SELL
02-12-20 13:09,13:09,11959250,9448850,-2510400,SELL
02-12-20 13:10,13:10,11956100,9458475,-2497625,SELL
02-12-20 13:11,13:11,11944750,9393025,-2551725,SELL
02-12-20 13:12,13:12,11937650,9364475,-2573175,SELL
02-12-20 13:13,13:13,11942900,9376725,-2566175,SELL
02-12-20 13:14,13:14,11962100,9321500,-2640600,SELL
02-12-20 13:15,13:15,11944875,9325450,-2619425,SELL
02-12-20 13:16,13:16,11955000,9289250,-2665750,SELL
02-12-20 13:17,13:17,11988475,9267375,-2721100,SELL
02-12-20 13:18,13:18,11955800,9268275,-2687525,SELL
02-12-20 13:19,13:19,11969525,9268275,-2701250,SELL
02-12-20 13:20,13:20,11994675,9309475,-2685200,SELL
02-12-20 13:21,13:21,11984100,9284250,-2699850,SELL
02-12-20 13:22,13:22,11996450,9284150,-2712300,SELL
02-12-20 13:23,13:23,11955425,9313300,-2642125,SELL
02-12-20 13:24,13:24,12011250,9332100,-2679150,SELL
02-12-20 13:25,13:25,12002700,9326275,-2676425,SELL
02-12-20 13:26,13:26,12011700,9308325,-2703375,SELL
02-12-20 13:27,13:27,12057125,9349200,-2707925,SELL
02-12-20 13:28,13:28,12053900,9365650,-2688250,SELL
02-12-20 13:29,13:29,12081800,9352850,-2728950,SELL
02-12-20 13:30,13:30,12063200,9455475,-2607725,SELL
02-12-20 13:31,13:31,12101350,9454850,-2646500,SELL
02-12-20 13:32,13:32,12051150,9457200,-2593950,SELL
02-12-20 13:33,13:33,12193525,9366925,-2826600,SELL
02-12-20 13:34,13:34,12227325,9341000,-2886325,SELL
02-12-20 13:35,13:35,12217525,9355375,-2862150,SELL
02-12-20 13:36,13:36,12264575,9445575,-2819000,SELL
02-12-20 13:37,13:37,12260725,9433275,-2827450,SELL
02-12-20 13:38,13:38,12240750,9433275,-2807475,SELL
02-12-20 13:39,13:39,12199600,9095875,-3103725,SELL
02-12-20 13:40,13:40,12164200,9117300,-3046900,SELL
02-12-20 13:41,13:41,12187750,9098850,-3088900,SELL
02-12-20 13:42,13:42,12189125,9086650,-3102475,SELL
02-12-20 13:43,13:43,12176775,9086650,-3090125,SELL
02-12-20 13:44,13:44,12167050,9067950,-3099100,SELL
02-12-20 13:45,13:45,12061925,9040925,-3021000,SELL
02-12-20 13:46,13:46,12049900,9068150,-2981750,SELL
02-12-20 13:47,13:47,12053925,9046425,-3007500,SELL
02-12-20 13:48,13:48,11972100,8995100,-2977000,SELL
02-12-20 13:49,13:49,11955975,9015700,-2940275,SELL
02-12-20 13:50,13:50,11972125,9012750,-2959375,SELL
02-12-20 13:51,13:51,11979650,8911600,-3068050,SELL
02-12-20 13:52,13:52,11958825,8956275,-3002550,SELL
02-12-20 13:53,13:53,11963225,8965250,-2997975,SELL
02-12-20 13:54,13:54,11966725,8996600,-2970125,SELL
02-12-20 13:55,13:55,11965150,8938900,-3026250,SELL
02-12-20 13:56,13:56,11971125,8974750,-2996375,SELL
02-12-20 13:57,13:57,11957950,8982425,-2975525,SELL
02-12-20 13:58,13:58,11952375,8982425,-2969950,SELL
02-12-20 13:59,13:59,11955225,8955500,-2999725,SELL
02-12-20 14:00,14:00,11916225,8967050,-2949175,SELL
02-12-20 14:01,14:01,11976475,8978250,-2998225,SELL
02-12-20 14:02,14:02,11952475,8917775,-3034700,SELL
02-12-20 14:03,14:03,11950500,9016475,-2934025,SELL
02-12-20 14:04,14:04,11955950,9002350,-2953600,SELL
02-12-20 14:05,14:05,11990575,9031250,-2959325,SELL
02-12-20 14:06,14:06,11917375,8855150,-3062225,SELL
02-12-20 14:07,14:07,11940400,8869250,-3071150,SELL
02-12-20 14:08,14:08,11932875,8871400,-3061475,SELL
02-12-20 14:09,14:09,11694900,8630075,-3064825,SELL
02-12-20 14:10,14:10,11717050,8639175,-3077875,SELL
02-12-20 14:11,14:11,11698100,8645000,-3053100,SELL
02-12-20 14:12,14:12,11645125,8652675,-2992450,SELL
02-12-20 14:13,14:13,11620550,8657600,-2962950,SELL
02-12-20 14:14,14:14,11638475,8652675,-2985800,SELL
02-12-20 14:15,14:15,11521975,8659900,-2862075,SELL
02-12-20 14:16,14:16,11515150,8027175,-3487975,SELL
02-12-20 14:17,14:17,11535725,8650800,-2884925,SELL
02-12-20 14:18,14:18,11638375,8598100,-3040275,SELL
02-12-20 14:19,14:19,11629650,8591175,-3038475,SELL
02-12-20 14:20,14:20,11624900,8583050,-3041850,SELL
02-12-20 14:21,14:21,11480450,8609575,-2870875,SELL
02-12-20 14:22,14:22,11493525,8628325,-2865200,SELL
02-12-20 14:23,14:23,11493625,8590275,-2903350,SELL
02-12-20 14:24,14:24,11308625,8509900,-2798725,SELL
02-12-20 14:25,14:25,11294875,8514250,-2780625,SELL
02-12-20 14:26,14:26,11294875,8504375,-2790500,SELL
02-12-20 14:27,14:27,11321800,8544925,-2776875,SELL
02-12-20 14:28,14:28,11320875,8531475,-2789400,SELL
02-12-20 14:29,14:29,11320875,8573800,-2747075,SELL
02-12-20 14:30,14:30,11297725,8646825,-2650900,SELL
02-12-20 14:31,14:31,11237550,8656825,-2580725,SELL
02-12-20 14:32,14:32,11305725,8656475,-2649250,SELL
02-12-20 14:33,14:33,11358350,8621675,-2736675,SELL
02-12-20 14:34,14:34,11353650,8636950,-2716700,SELL
02-12-20 14:35,14:35,11347950,8584425,-2763525,SELL
02-12-20 14:36,14:36,11291200,8640600,-2650600,SELL
02-12-20 14:37,14:37,11339800,8597200,-2742600,SELL
02-12-20 14:38,14:38,11309850,8670125,-2639725,SELL
02-12-20 14:39,14:39,11380150,8747425,-2632725,SELL
02-12-20 14:40,14:40,11382125,8791850,-2590275,SELL
02-12-20 14:41,14:41,11350675,8811225,-2539450,SELL
02-12-20 14:42,14:42,11346400,8740700,-2605700,SELL
02-12-20 14:43,14:43,11350325,8771250,-2579075,SELL
02-12-20 14:44,14:44,11342350,8796550,-2545800,SELL
02-12-20 14:45,14:45,11203850,8841975,-2361875,SELL
02-12-20 14:46,14:46,11259125,8856225,-2402900,SELL
02-12-20 14:47,14:47,11259125,8858275,-2400850,SELL
02-12-20 14:48,14:48,10985850,8562500,-2423350,SELL
02-12-20 14:49,14:49,10978500,8554475,-2424025,SELL
02-12-20 14:50,14:50,10968600,8550075,-2418525,SELL
02-12-20 14:51,14:51,10882925,8474625,-2408300,SELL
02-12-20 14:52,14:52,10862625,8477375,-2385250,SELL
02-12-20 14:53,14:53,10769200,8477375,-2291825,SELL
02-12-20 14:54,14:54,10830600,8531150,-2299450,SELL
02-12-20 14:55,14:55,10857900,8498325,-2359575,SELL
02-12-20 14:56,14:56,10846675,8533025,-2313650,SELL
02-12-20 14:57,14:57,10769975,8473675,-2296300,SELL
02-12-20 14:58,14:58,10787450,8503725,-2283725,SELL
02-12-20 14:59,14:59,10799200,8495500,-2303700,SELL
02-12-20 15:00,15:00,10570750,8365500,-2205250,SELL
02-12-20 15:01,15:01,10570750,8360750,-2210000,SELL
02-12-20 15:02,15:02,10584075,8351350,-2232725,SELL
02-12-20 15:03,15:03,10357875,8199650,-2158225,SELL
02-12-20 15:04,15:04,10377250,8185350,-2191900,SELL
02-12-20 15:05,15:05,10383800,8191225,-2192575,SELL
02-12-20 15:06,15:06,10438800,8077750,-2361050,SELL
02-12-20 15:07,15:07,10435050,8060025,-2375025,SELL
02-12-20 15:08,15:08,10409950,8078800,-2331150,SELL
02-12-20 15:09,15:09,10560975,8071575,-2489400,SELL
02-12-20 15:10,15:10,10579750,8062175,-2517575,SELL
02-12-20 15:11,15:11,10559325,8077425,-2481900,SELL
02-12-20 15:12,15:12,10627175,8078175,-2549000,SELL
02-12-20 15:13,15:13,10641925,8030875,-2611050,SELL
02-12-20 15:14,15:14,10625675,8037225,-2588450,SELL
02-12-20 15:15,15:15,10674300,7987675,-2686625,SELL
02-12-20 15:16,15:16,10668250,7977275,-2690975,SELL
02-12-20 15:17,15:17,10672925,8010500,-2662425,SELL
02-12-20 15:18,15:18,10655125,8000375,-2654750,SELL
02-12-20 15:19,15:19,10632050,7986325,-2645725,SELL
02-12-20 15:20,15:20,10636675,7993650,-2643025,SELL
02-12-20 15:21,15:21,10648300,7909225,-2739075,SELL
02-12-20 15:22,15:22,10648950,7907725,-2741225,SELL
02-12-20 15:23,15:23,10643500,7899725,-2743775,SELL
02-12-20 15:24,15:24,10452350,7808700,-2643650,SELL
02-12-20 15:25,15:25,10497700,7811725,-2685975,SELL
02-12-20 15:26,15:26,10494125,7798125,-2696000,SELL
02-12-20 15:27,15:27,10416400,7712425,-2703975,SELL
02-12-20 15:28,15:28,10423075,7693600,-2729475,SELL
02-12-20 15:29,15:29,10439250,7722725,-2716525,SELL
03-12-20 9:15,9:15,8309400,7523525,-785875,SELL
03-12-20 9:16,9:16,10273150,7496575,-2776575,SELL
03-12-20 9:17,9:17,10785450,8151100,-2634350,SELL
03-12-20 9:18,9:18,10741600,8162900,-2578700,SELL
03-12-20 9:19,9:19,10770550,8117450,-2653100,SELL
03-12-20 9:20,9:20,11822750,8865150,-2957600,SELL
03-12-20 9:21,9:21,11823075,8852575,-2970500,SELL
03-12-20 9:22,9:22,11772825,8858150,-2914675,SELL
03-12-20 9:23,9:23,12390275,9343100,-3047175,SELL
03-12-20 9:24,9:24,12354150,9291425,-3062725,SELL
03-12-20 9:25,9:25,12341800,9345625,-2996175,SELL
03-12-20 9:26,9:26,12724600,9551925,-3172675,SELL
03-12-20 9:27,9:27,12724975,9611950,-3113025,SELL
03-12-20 9:28,9:28,12790100,9566625,-3223475,SELL
03-12-20 9:29,9:29,12999075,9665250,-3333825,SELL
03-12-20 9:30,9:30,12977925,9634550,-3343375,SELL
03-12-20 9:31,9:31,12967825,9623000,-3344825,SELL
03-12-20 9:32,9:32,13258375,9980525,-3277850,SELL
03-12-20 9:33,9:33,13245550,10065225,-3180325,SELL
03-12-20 9:34,9:34,13159000,10104625,-3054375,SELL
03-12-20 9:35,9:35,13352575,10345475,-3007100,SELL
03-12-20 9:36,9:36,13388350,10299500,-3088850,SELL
03-12-20 9:37,9:37,13394925,10351975,-3042950,SELL
03-12-20 9:38,9:38,13417825,10395650,-3022175,SELL
03-12-20 9:39,9:39,13472325,10347675,-3124650,SELL
03-12-20 9:40,9:40,13308500,10339625,-2968875,SELL
03-12-20 9:41,9:41,13588500,10404550,-3183950,SELL
03-12-20 9:42,9:42,13501800,10477050,-3024750,SELL
03-12-20 9:43,9:43,13632000,10537200,-3094800,SELL
03-12-20 9:44,9:44,13621850,10632850,-2989000,SELL
03-12-20 9:45,9:45,13712950,10695725,-3017225,SELL
03-12-20 9:46,9:46,13706600,10708025,-2998575,SELL
03-12-20 9:47,9:47,13834400,11077200,-2757200,SELL
03-12-20 9:48,9:48,13808250,11075675,-2732575,SELL
03-12-20 9:49,9:49,13786825,11051000,-2735825,SELL
03-12-20 9:50,9:50,13546900,11454575,-2092325,SELL
03-12-20 9:51,9:51,13535125,11331625,-2203500,SELL
03-12-20 9:52,9:52,13568775,11436725,-2132050,SELL
03-12-20 9:53,9:53,13500350,11886950,-1613400,SELL
03-12-20 9:54,9:54,13489700,11910075,-1579625,SELL
03-12-20 9:55,9:55,13497925,11903150,-1594775,SELL
03-12-20 9:56,9:56,13787500,12034725,-1752775,SELL
03-12-20 9:57,9:57,13667200,11997425,-1669775,SELL
03-12-20 9:58,9:58,13813575,12005125,-1808450,SELL
03-12-20 9:59,9:59,13856600,12307825,-1548775,SELL
03-12-20 10:00,10:00,13926500,12262175,-1664325,SELL
03-12-20 10:01,10:01,13987175,12271075,-1716100,SELL
03-12-20 10:02,10:02,13870050,12568825,-1301225,SELL
03-12-20 10:03,10:03,13857450,12543225,-1314225,SELL
03-12-20 10:04,10:04,13874475,12549875,-1324600,SELL
03-12-20 10:05,10:05,13777275,12671675,-1105600,SELL
03-12-20 10:06,10:06,13829800,12657950,-1171850,SELL
03-12-20 10:07,10:07,13773950,12536650,-1237300,SELL
03-12-20 10:08,10:08,13932075,12637925,-1294150,SELL
03-12-20 10:09,10:09,14008375,12749500,-1258875,SELL
03-12-20 10:10,10:10,13822575,12762875,-1059700,SELL
03-12-20 10:11,10:11,14020625,12952100,-1068525,SELL
03-12-20 10:12,10:12,12817025,12898400,81375,BUY
03-12-20 10:13,10:13,14058275,12974700,-1083575,SELL
03-12-20 10:14,10:14,13916500,13237100,-679400,SELL
03-12-20 10:15,10:15,14006275,13246975,-759300,SELL
03-12-20 10:16,10:16,13927700,13235125,-692575,SELL
03-12-20 10:17,10:17,13620025,13510150,-109875,SELL
03-12-20 10:18,10:18,13653900,13461725,-192175,SELL
03-12-20 10:19,10:19,13750950,13484275,-266675,SELL
03-12-20 10:20,10:20,13535125,13699425,164300,BUY
03-12-20 10:21,10:21,13502600,13703025,200425,BUY
03-12-20 10:22,10:22,13371525,13675525,304000,BUY
03-12-20 10:23,10:23,13380675,13915350,534675,BUY
03-12-20 10:24,10:24,13353125,13827200,474075,BUY
03-12-20 10:25,10:25,13417225,13919300,502075,BUY
03-12-20 10:26,10:26,13186050,13978400,792350,BUY
03-12-20 10:27,10:27,13220100,13982400,762300,BUY
03-12-20 10:28,10:28,13094650,13976900,882250,BUY
03-12-20 10:29,10:29,13426175,14131800,705625,BUY
03-12-20 10:30,10:30,13390375,14054550,664175,BUY
03-12-20 10:31,10:31,13417275,13778575,361300,BUY
03-12-20 10:32,10:32,13258625,14333075,1074450,BUY
03-12-20 10:33,10:33,13367625,14284575,916950,BUY
03-12-20 10:34,10:34,13224450,14140950,916500,BUY
03-12-20 10:35,10:35,13507200,14448350,941150,BUY
03-12-20 10:36,10:36,13463750,14455775,992025,BUY
03-12-20 10:37,10:37,13426275,14578175,1151900,BUY
03-12-20 10:38,10:38,13323750,14775275,1451525,BUY
03-12-20 10:39,10:39,13421975,14775625,1353650,BUY
03-12-20 10:40,10:40,13343450,14772875,1429425,BUY
03-12-20 10:41,10:41,13457975,14736325,1278350,BUY
03-12-20 10:42,10:42,13437400,14722375,1284975,BUY
03-12-20 10:43,10:43,13424725,14728900,1304175,BUY
03-12-20 10:44,10:44,13207725,14690275,1482550,BUY
03-12-20 10:45,10:45,13324525,14696475,1371950,BUY
03-12-20 10:46,10:46,13448825,14423875,975050,BUY
03-12-20 10:47,10:47,13523650,14576125,1052475,BUY
03-12-20 10:48,10:48,13512925,14634350,1121425,BUY
03-12-20 10:49,10:49,12928250,14631700,1703450,BUY
03-12-20 10:50,10:50,13547925,14736425,1188500,BUY
03-12-20 10:51,10:51,13578450,14571425,992975,BUY
03-12-20 10:52,10:52,13472800,14659800,1187000,BUY
03-12-20 10:53,10:53,13638450,14664950,1026500,BUY
03-12-20 10:54,10:54,13696525,14433500,736975,BUY
03-12-20 10:55,10:55,13550025,14465575,915550,BUY
03-12-20 10:56,10:56,13735150,14863600,1128450,BUY
03-12-20 10:57,10:57,13757850,14821925,1064075,BUY
03-12-20 10:58,10:58,13717025,14842425,1125400,BUY
03-12-20 10:59,10:59,13914025,14569850,655825,BUY
03-12-20 11:00,11:00,13875425,14611150,735725,BUY
03-12-20 11:01,11:01,13362675,14635725,1273050,BUY
03-12-20 11:02,11:02,14104125,14569450,465325,BUY
03-12-20 11:03,11:03,14098575,14566500,467925,BUY
03-12-20 11:04,11:04,14133075,14559575,426500,BUY
03-12-20 11:05,11:05,14131000,14589875,458875,BUY
03-12-20 11:06,11:06,14139825,14502950,363125,BUY
03-12-20 11:07,11:07,14173625,14597325,423700,BUY
03-12-20 11:08,11:08,14231800,14719300,487500,BUY
03-12-20 11:09,11:09,14021175,14644325,623150,BUY
03-12-20 11:10,11:10,14061075,14675200,614125,BUY
03-12-20 11:11,11:11,14021550,13968725,-52825,SELL
03-12-20 11:12,11:12,14041675,14674000,632325,BUY
03-12-20 11:13,11:13,14032675,14776825,744150,BUY
03-12-20 11:14,11:14,14248700,14856250,607550,BUY
03-12-20 11:15,11:15,14114675,14456550,341875,BUY
03-12-20 11:16,11:16,14183850,14755750,571900,BUY
03-12-20 11:17,11:17,14272950,14016900,-256050,SELL
03-12-20 11:18,11:18,14324625,14879050,554425,BUY
03-12-20 11:19,11:19,14286225,14843375,557150,BUY
03-12-20 11:20,11:20,14104950,14979125,874175,BUY
03-12-20 11:21,11:21,14377075,14875475,498400,BUY
03-12-20 11:22,11:22,14299900,14921050,621150,BUY
03-12-20 11:23,11:23,14578650,14804625,225975,BUY
03-12-20 11:24,11:24,14387350,14836750,449400,BUY
03-12-20 11:25,11:25,14138125,14910175,772050,BUY
03-12-20 11:26,11:26,13862475,14952325,1089850,BUY
03-12-20 11:27,11:27,14518375,14929300,410925,BUY
03-12-20 11:28,11:28,14636225,14850675,214450,BUY
03-12-20 11:29,11:29,14671925,14916475,244550,BUY
03-12-20 11:30,11:30,14439050,14765925,326875,BUY
03-12-20 11:31,11:31,14685925,14882175,196250,BUY
03-12-20 11:32,11:32,14769900,14704450,-65450,SELL
03-12-20 11:33,11:33,14854350,14966900,112550,BUY
03-12-20 11:34,11:34,14825950,14905375,79425,BUY
03-12-20 11:35,11:35,14860950,14575550,-285400,SELL
03-12-20 11:36,11:36,14795525,14586325,-209200,SELL
03-12-20 11:37,11:37,14589250,14605075,15825,BUY
03-12-20 11:38,11:38,14696500,14661575,-34925,SELL
03-12-20 11:39,11:39,14787825,14630300,-157525,SELL
03-12-20 11:40,11:40,14780675,14660175,-120500,SELL
03-12-20 11:41,11:41,14748950,14691850,-57100,SELL
03-12-20 11:42,11:42,14681125,14624975,-56150,SELL
03-12-20 11:43,11:43,14725700,14683650,-42050,SELL
03-12-20 11:44,11:44,14879600,14819450,-60150,SELL
03-12-20 11:45,11:45,14367950,14754650,386700,BUY
03-12-20 11:46,11:46,13764175,14730200,966025,BUY
03-12-20 11:47,11:47,14851525,14005525,-846000,SELL
03-12-20 11:48,11:48,15059725,14868825,-190900,SELL
03-12-20 11:49,11:49,14778925,14239050,-539875,SELL
03-12-20 11:50,11:50,14858350,14916500,58150,BUY
03-12-20 11:51,11:51,15215050,14843950,-371100,SELL
03-12-20 11:52,11:52,15077975,14867025,-210950,SELL
03-12-20 11:53,11:53,15078550,14899500,-179050,SELL
03-12-20 11:54,11:54,15019625,14844125,-175500,SELL
03-12-20 11:55,11:55,15088650,14185100,-903550,SELL
03-12-20 11:56,11:56,15094800,14902050,-192750,SELL
03-12-20 11:57,11:57,14603500,14865775,262275,BUY
03-12-20 11:58,11:58,14908325,14227725,-680600,SELL
03-12-20 11:59,11:59,15255700,15021525,-234175,SELL
03-12-20 12:00,12:00,14525100,14144575,-380525,SELL
03-12-20 12:01,12:01,14551075,14173725,-377350,SELL
03-12-20 12:02,12:02,14718725,14727700,8975,BUY
03-12-20 12:03,12:03,15235250,14888550,-346700,SELL
03-12-20 12:04,12:04,14881375,14826450,-54925,SELL
03-12-20 12:05,12:05,15573875,14819325,-754550,SELL
03-12-20 12:06,12:06,15396900,14826750,-570150,SELL
03-12-20 12:07,12:07,15441725,14832775,-608950,SELL
03-12-20 12:08,12:08,15501600,14770775,-730825,SELL
03-12-20 12:09,12:09,15501725,14808800,-692925,SELL
03-12-20 12:10,12:10,15623175,14705375,-917800,SELL
03-12-20 12:11,12:11,15589075,14703000,-886075,SELL
03-12-20 12:12,12:12,15749625,14801150,-948475,SELL
03-12-20 12:13,12:13,15724750,14784575,-940175,SELL
03-12-20 12:14,12:14,15347025,14880275,-466750,SELL
03-12-20 12:15,12:15,15741925,14925375,-816550,SELL
03-12-20 12:16,12:16,15814625,14880650,-933975,SELL
03-12-20 12:17,12:17,15981900,14874800,-1107100,SELL
03-12-20 12:18,12:18,15990450,14885750,-1104700,SELL
03-12-20 12:19,12:19,15885825,14893875,-991950,SELL
03-12-20 12:20,12:20,16238800,14504525,-1734275,SELL
03-12-20 12:21,12:21,16217075,14527300,-1689775,SELL
03-12-20 12:22,12:22,16266600,14493175,-1773425,SELL
03-12-20 12:23,12:23,16464325,13870675,-2593650,SELL
03-12-20 12:24,12:24,16485825,13929525,-2556300,SELL
03-12-20 12:25,12:25,16457775,13915550,-2542225,SELL
03-12-20 12:26,12:26,16553675,13968150,-2585525,SELL
03-12-20 12:27,12:27,16512900,14014625,-2498275,SELL
03-12-20 12:28,12:28,16549075,13958525,-2590550,SELL
03-12-20 12:29,12:29,16651700,13870425,-2781275,SELL
03-12-20 12:30,12:30,16684150,14157650,-2526500,SELL
03-12-20 12:31,12:31,16684900,14180675,-2504225,SELL
03-12-20 12:32,12:32,16747625,14186050,-2561575,SELL
03-12-20 12:33,12:33,16660275,14119425,-2540850,SELL
03-12-20 12:34,12:34,16728475,13543150,-3185325,SELL
03-12-20 12:35,12:35,16715050,14321375,-2393675,SELL
03-12-20 12:36,12:36,15968175,14302375,-1665800,SELL
03-12-20 12:37,12:37,16533750,14243275,-2290475,SELL
03-12-20 12:38,12:38,16686825,14495075,-2191750,SELL
03-12-20 12:39,12:39,16682625,14475500,-2207125,SELL
03-12-20 12:40,12:40,16645825,14483075,-2162750,SELL
03-12-20 12:41,12:41,16463225,14579850,-1883375,SELL
03-12-20 12:42,12:42,16435450,14569450,-1866000,SELL
03-12-20 12:43,12:43,16614500,14534100,-2080400,SELL
03-12-20 12:44,12:44,16589075,14599475,-1989600,SELL
03-12-20 12:45,12:45,16714100,14615575,-2098525,SELL
03-12-20 12:46,12:46,16464650,14574525,-1890125,SELL
03-12-20 12:47,12:47,16635750,14513300,-2122450,SELL
03-12-20 12:48,12:48,16702150,14475775,-2226375,SELL
03-12-20 12:49,12:49,16424475,14573750,-1850725,SELL
03-12-20 12:50,12:50,16662650,14593000,-2069650,SELL
03-12-20 12:51,12:51,16655925,14650700,-2005225,SELL
03-12-20 12:52,12:52,16535600,14747725,-1787875,SELL
03-12-20 12:53,12:53,16731700,14714075,-2017625,SELL
03-12-20 12:54,12:54,16649775,14729925,-1919850,SELL
03-12-20 12:55,12:55,16776975,14750200,-2026775,SELL
03-12-20 12:56,12:56,17010725,14034275,-2976450,SELL
03-12-20 12:57,12:57,16898250,13983525,-2914725,SELL
03-12-20 12:58,12:58,16902950,13988600,-2914350,SELL
03-12-20 12:59,12:59,17389825,13695900,-3693925,SELL
03-12-20 13:00,13:00,17422550,13742750,-3679800,SELL
03-12-20 13:01,13:01,17370550,13067650,-4302900,SELL
03-12-20 13:02,13:02,17451925,13467425,-3984500,SELL
03-12-20 13:03,13:03,17327425,13482125,-3845300,SELL
03-12-20 13:04,13:04,17448200,13401375,-4046825,SELL
03-12-20 13:05,13:05,17686225,13486150,-4200075,SELL
03-12-20 13:06,13:06,17615475,12767100,-4848375,SELL
03-12-20 13:07,13:07,17537075,13409675,-4127400,SELL
03-12-20 13:08,13:08,17600200,13639525,-3960675,SELL
03-12-20 13:09,13:09,17751575,12895875,-4855700,SELL
03-12-20 13:10,13:10,17696100,13581125,-4114975,SELL
03-12-20 13:11,13:11,17840125,12903775,-4936350,SELL
03-12-20 13:12,13:12,17802250,13526675,-4275575,SELL
03-12-20 13:13,13:13,17740525,13558050,-4182475,SELL
03-12-20 13:14,13:14,17831950,13777450,-4054500,SELL
03-12-20 13:15,13:15,17804675,13708150,-4096525,SELL
03-12-20 13:16,13:16,17772400,13640625,-4131775,SELL
03-12-20 13:17,13:17,17838200,13728900,-4109300,SELL
03-12-20 13:18,13:18,17941050,12905150,-5035900,SELL
03-12-20 13:19,13:19,17809550,13681950,-4127600,SELL
03-12-20 13:20,13:20,18017225,13692100,-4325125,SELL
03-12-20 13:21,13:21,17994450,13808575,-4185875,SELL
03-12-20 13:22,13:22,17965475,13772925,-4192550,SELL
03-12-20 13:23,13:23,17853250,13848625,-4004625,SELL
03-12-20 13:24,13:24,17801125,13966575,-3834550,SELL
03-12-20 13:25,13:25,17797700,13889700,-3908000,SELL
03-12-20 13:26,13:26,17779225,14073000,-3706225,SELL
03-12-20 13:27,13:27,17912150,14115525,-3796625,SELL
03-12-20 13:28,13:28,17885200,14052075,-3833125,SELL
03-12-20 13:29,13:29,17765100,13350700,-4414400,SELL
03-12-20 13:30,13:30,17819875,13954125,-3865750,SELL
03-12-20 13:31,13:31,17808475,13969250,-3839225,SELL
03-12-20 13:32,13:32,17871725,14204250,-3667475,SELL
03-12-20 13:33,13:33,17910825,13570700,-4340125,SELL
03-12-20 13:34,13:34,17997125,14282875,-3714250,SELL
03-12-20 13:35,13:35,17938775,13930150,-4008625,SELL
03-12-20 13:36,13:36,17935175,13846325,-4088850,SELL
03-12-20 13:37,13:37,17836625,13853800,-3982825,SELL
03-12-20 13:38,13:38,17880150,13832000,-4048150,SELL
03-12-20 13:39,13:39,18097375,14091475,-4005900,SELL
03-12-20 13:40,13:40,18062800,13958400,-4104400,SELL
03-12-20 13:41,13:41,17170125,14070500,-3099625,SELL
03-12-20 13:42,13:42,17707700,13358025,-4349675,SELL
03-12-20 13:43,13:43,17704100,14055125,-3648975,SELL
03-12-20 13:44,13:44,17990725,14065025,-3925700,SELL
03-12-20 13:45,13:45,17914750,13931625,-3983125,SELL
03-12-20 13:46,13:46,17647050,13529575,-4117475,SELL
03-12-20 13:47,13:47,17525000,13579125,-3945875,SELL
03-12-20 13:48,13:48,17911725,14374275,-3537450,SELL
03-12-20 13:49,13:49,17943225,14301775,-3641450,SELL
03-12-20 13:50,13:50,17876050,14254275,-3621775,SELL
03-12-20 13:51,13:51,17367325,13975325,-3392000,SELL
03-12-20 13:52,13:52,17289075,14030275,-3258800,SELL
03-12-20 13:53,13:53,17360400,13934700,-3425700,SELL
03-12-20 13:54,13:54,17418675,14034450,-3384225,SELL
03-12-20 13:55,13:55,17460200,14059525,-3400675,SELL
03-12-20 13:56,13:56,17393200,14012000,-3381200,SELL
03-12-20 13:57,13:57,17311525,14100825,-3210700,SELL
03-12-20 13:58,13:58,17306900,14058075,-3248825,SELL
03-12-20 13:59,13:59,17291550,14175925,-3115625,SELL
03-12-20 14:00,14:00,17222475,14061650,-3160825,SELL
03-12-20 14:01,14:01,17210675,14049475,-3161200,SELL
03-12-20 14:02,14:02,17267825,13844450,-3423375,SELL
03-12-20 14:03,14:03,17335300,13978500,-3356800,SELL
03-12-20 14:04,14:04,16896950,13967825,-2929125,SELL
03-12-20 14:05,14:05,16875175,14072050,-2803125,SELL
03-12-20 14:06,14:06,17234100,14190250,-3043850,SELL
03-12-20 14:07,14:07,17233200,12895050,-4338150,SELL
03-12-20 14:08,14:08,16835175,13988200,-2846975,SELL
03-12-20 14:09,14:09,17198925,14243900,-2955025,SELL
03-12-20 14:10,14:10,17188275,14196300,-2991975,SELL
03-12-20 14:11,14:11,17203075,14229200,-2973875,SELL
03-12-20 14:12,14:12,16317150,13482550,-2834600,SELL
03-12-20 14:13,14:13,16843550,14217450,-2626100,SELL
03-12-20 14:14,14:14,16782125,14267125,-2515000,SELL
03-12-20 14:15,14:15,16940700,14269675,-2671025,SELL
03-12-20 14:16,14:16,16828800,13577125,-3251675,SELL
03-12-20 14:17,14:17,16989700,14398625,-2591075,SELL
03-12-20 14:18,14:18,16949425,14121325,-2828100,SELL
03-12-20 14:19,14:19,16965825,14090000,-2875825,SELL
03-12-20 14:20,14:20,17043575,14101275,-2942300,SELL
03-12-20 14:21,14:21,16831825,13408325,-3423500,SELL
03-12-20 14:22,14:22,16860200,13508625,-3351575,SELL
03-12-20 14:23,14:23,16830150,13567025,-3263125,SELL
03-12-20 14:24,14:24,16726475,13564275,-3162200,SELL
03-12-20 14:25,14:25,16894350,13609950,-3284400,SELL
03-12-20 14:26,14:26,16930975,13513800,-3417175,SELL
03-12-20 14:27,14:27,16879975,13615025,-3264950,SELL
03-12-20 14:28,14:28,16926300,13630500,-3295800,SELL
03-12-20 14:29,14:29,16802475,13608100,-3194375,SELL
03-12-20 14:30,14:30,16629150,13763975,-2865175,SELL
03-12-20 14:31,14:31,16830600,13780750,-3049850,SELL
03-12-20 14:32,14:32,16890350,13760650,-3129700,SELL
03-12-20 14:33,14:33,16399100,13857650,-2541450,SELL
03-12-20 14:34,14:34,16613575,13916475,-2697100,SELL
03-12-20 14:35,14:35,16620350,13894550,-2725800,SELL
03-12-20 14:36,14:36,16338325,13665375,-2672950,SELL
03-12-20 14:37,14:37,16361975,13650550,-2711425,SELL
03-12-20 14:38,14:38,15932550,12883125,-3049425,SELL
03-12-20 14:39,14:39,16318600,13685875,-2632725,SELL
03-12-20 14:40,14:40,16494300,13681400,-2812900,SELL
03-12-20 14:41,14:41,15962475,13412900,-2549575,SELL
03-12-20 14:42,14:42,16442875,13588000,-2854875,SELL
03-12-20 14:43,14:43,16484175,13591475,-2892700,SELL
03-12-20 14:44,14:44,16445575,13607325,-2838250,SELL
03-12-20 14:45,14:45,16248950,13599150,-2649800,SELL
03-12-20 14:46,14:46,16332225,13453475,-2878750,SELL
03-12-20 14:47,14:47,16300650,13522150,-2778500,SELL
03-12-20 14:48,14:48,16016725,12739325,-3277400,SELL
03-12-20 14:49,14:49,16118025,13461550,-2656475,SELL
03-12-20 14:50,14:50,16073275,13456200,-2617075,SELL
03-12-20 14:51,14:51,15835325,13020375,-2814950,SELL
03-12-20 14:52,14:52,15956625,13042275,-2914350,SELL
03-12-20 14:53,14:53,15350125,13096025,-2254100,SELL
03-12-20 14:54,14:54,15771625,12929650,-2841975,SELL
03-12-20 14:55,14:55,15743950,12939100,-2804850,SELL
03-12-20 14:56,14:56,15795050,12971050,-2824000,SELL
03-12-20 14:57,14:57,15547375,12671100,-2876275,SELL
03-12-20 14:58,14:58,15596075,12725250,-2870825,SELL
03-12-20 14:59,14:59,15202300,12718475,-2483825,SELL
03-12-20 15:00,15:00,15256600,12731275,-2525325,SELL
03-12-20 15:01,15:01,15224700,12732475,-2492225,SELL
03-12-20 15:02,15:02,15266125,12767350,-2498775,SELL
03-12-20 15:03,15:03,15247100,12537550,-2709550,SELL
03-12-20 15:04,15:04,15291425,12509300,-2782125,SELL
03-12-20 15:05,15:05,15295000,12384800,-2910200,SELL
03-12-20 15:06,15:06,15160100,12295600,-2864500,SELL
03-12-20 15:07,15:07,15161425,12332225,-2829200,SELL
03-12-20 15:08,15:08,15083775,12280500,-2803275,SELL
03-12-20 15:09,15:09,14844275,11982125,-2862150,SELL
03-12-20 15:10,15:10,14913925,12056425,-2857500,SELL
03-12-20 15:11,15:11,14920625,11979275,-2941350,SELL
03-12-20 15:12,15:12,14504525,11599100,-2905425,SELL
03-12-20 15:13,15:13,14642950,11536425,-3106525,SELL
03-12-20 15:14,15:14,14668200,11611675,-3056525,SELL
03-12-20 15:15,15:15,14208575,11463525,-2745050,SELL
03-12-20 15:16,15:16,14218300,11383825,-2834475,SELL
03-12-20 15:17,15:17,14186250,11437950,-2748300,SELL
03-12-20 15:18,15:18,13407950,11033650,-2374300,SELL
03-12-20 15:19,15:19,13363850,10345950,-3017900,SELL
03-12-20 15:20,15:20,13295250,11097250,-2198000,SELL
03-12-20 15:21,15:21,12601475,10367675,-2233800,SELL
03-12-20 15:22,15:22,12575375,9671825,-2903550,SELL
03-12-20 15:23,15:23,12578775,9085750,-3493025,SELL
03-12-20 15:24,15:24,11872925,8399100,-3473825,SELL
03-12-20 15:25,15:25,11824475,8445775,-3378700,SELL
03-12-20 15:26,15:26,11735925,8893100,-2842825,SELL
03-12-20 15:27,15:27,10753300,6430800,-4322500,SELL
03-12-20 15:28,15:28,10897875,8756925,-2140950,SELL
03-12-20 15:29,15:29,10739925,8065425,-2674500,SELL
04-12-20 9:15,9:15,3505300,3309725,-195575,SELL
04-12-20 9:16,9:16,3528975,3311125,-217850,SELL
04-12-20 9:17,9:17,3900175,3623875,-276300,SELL
04-12-20 9:18,9:18,3892100,3624850,-267250,SELL
04-12-20 9:19,9:19,3848800,3617425,-231375,SELL
04-12-20 9:20,9:20,4250950,3921850,-329100,SELL
04-12-20 9:21,9:21,4250750,3920325,-330425,SELL
04-12-20 9:22,9:22,4249225,3908975,-340250,SELL
04-12-20 9:23,9:23,4540300,4081950,-458350,SELL
04-12-20 9:24,9:24,4564225,4090675,-473550,SELL
04-12-20 9:25,9:25,4563625,4091675,-471950,SELL
04-12-20 9:26,9:26,4822150,4251275,-570875,SELL
04-12-20 9:27,9:27,4826150,4226125,-600025,SELL
04-12-20 9:28,9:28,4832125,4233600,-598525,SELL
04-12-20 9:29,9:29,5113275,4413325,-699950,SELL
04-12-20 9:30,9:30,5085550,4422550,-663000,SELL
04-12-20 9:31,9:31,5068350,4403450,-664900,SELL
04-12-20 9:32,9:32,5323725,4584875,-738850,SELL
04-12-20 9:33,9:33,5326925,4565750,-761175,SELL
04-12-20 9:34,9:34,5321375,4575275,-746100,SELL
04-12-20 9:35,9:35,5390550,4687275,-703275,SELL
04-12-20 9:36,9:36,5396925,4663800,-733125,SELL
04-12-20 9:37,9:37,5392200,4680325,-711875,SELL
04-12-20 9:38,9:38,5505000,4729100,-775900,SELL
04-12-20 9:39,9:39,5510975,4735275,-775700,SELL
04-12-20 9:40,9:40,5489100,4754425,-734675,SELL
04-12-20 9:41,9:41,5621300,4835525,-785775,SELL
04-12-20 9:42,9:42,5613750,4832900,-780850,SELL
04-12-20 9:43,9:43,5588825,4834475,-754350,SELL
04-12-20 9:44,9:44,5568750,4920675,-648075,SELL
04-12-20 9:45,9:45,5542400,4919100,-623300,SELL
04-12-20 9:46,9:46,5519375,4920650,-598725,SELL
04-12-20 9:47,9:47,5550175,5049825,-500350,SELL
04-12-20 9:48,9:48,5575550,5037025,-538525,SELL
04-12-20 9:49,9:49,5567850,5049825,-518025,SELL
04-12-20 9:50,9:50,5534650,5163100,-371550,SELL
04-12-20 9:51,9:51,5535400,5165075,-370325,SELL
04-12-20 9:52,9:52,5534650,5166200,-368450,SELL
04-12-20 9:53,9:53,5479425,5234975,-244450,SELL
04-12-20 9:54,9:54,5435775,5234975,-200800,SELL
04-12-20 9:55,9:55,5484200,5223300,-260900,SELL
04-12-20 9:56,9:56,5500250,5305000,-195250,SELL
04-12-20 9:57,9:57,5543425,5315475,-227950,SELL
04-12-20 9:58,9:58,5495050,5324950,-170100,SELL
04-12-20 9:59,9:59,5573400,5406025,-167375,SELL
04-12-20 10:00,10:00,5614075,5408050,-206025,SELL
04-12-20 10:01,10:01,5624500,5408975,-215525,SELL
04-12-20 10:02,10:02,5714225,5536050,-178175,SELL
04-12-20 10:03,10:03,5708125,5535050,-173075,SELL
04-12-20 10:04,10:04,5704250,5533175,-171075,SELL
04-12-20 10:05,10:05,5799650,5683950,-115700,SELL
04-12-20 10:06,10:06,5774925,5707800,-67125,SELL
04-12-20 10:07,10:07,5803975,5704600,-99375,SELL
04-12-20 10:08,10:08,5830200,5848975,18775,BUY
04-12-20 10:09,10:09,5818450,5851050,32600,BUY
04-12-20 10:10,10:10,5833525,5839425,5900,BUY
04-12-20 10:11,10:11,5947100,5923950,-23150,SELL
04-12-20 10:12,10:12,5960100,5923950,-36150,SELL
04-12-20 10:13,10:13,5956125,5925225,-30900,SELL
04-12-20 10:14,10:14,5870775,5986675,115900,BUY
04-12-20 10:15,10:15,5843400,5986850,143450,BUY
04-12-20 10:16,10:16,5873700,5987250,113550,BUY
04-12-20 10:17,10:17,5791750,6099500,307750,BUY
04-12-20 10:18,10:18,5803900,6099175,295275,BUY
04-12-20 10:19,10:19,5829700,6100275,270575,BUY
04-12-20 10:20,10:20,5740375,6188150,447775,BUY
04-12-20 10:21,10:21,5736950,6188725,451775,BUY
04-12-20 10:22,10:22,5712500,6189025,476525,BUY
04-12-20 10:23,10:23,5642400,6328325,685925,BUY
04-12-20 10:24,10:24,5666675,6326675,660000,BUY
04-12-20 10:25,10:25,5692100,6328375,636275,BUY
04-12-20 10:26,10:26,5812425,6435275,622850,BUY
04-12-20 10:27,10:27,5829750,6435275,605525,BUY
04-12-20 10:28,10:28,5804325,6435375,631050,BUY
04-12-20 10:29,10:29,5756575,6576000,819425,BUY
04-12-20 10:30,10:30,5769600,6577625,808025,BUY
04-12-20 10:31,10:31,5766800,6577475,810675,BUY
04-12-20 10:32,10:32,5691225,6760200,1068975,BUY
04-12-20 10:33,10:33,5667975,6760075,1092100,BUY
04-12-20 10:34,10:34,5663125,6760275,1097150,BUY
04-12-20 10:35,10:35,5880350,6971625,1091275,BUY
04-12-20 10:36,10:36,5888925,6970125,1081200,BUY
04-12-20 10:37,10:37,5909750,6971575,1061825,BUY
04-12-20 10:38,10:38,5992175,7087875,1095700,BUY
04-12-20 10:39,10:39,5997900,7087675,1089775,BUY
04-12-20 10:40,10:40,5997900,7084150,1086250,BUY
04-12-20 10:41,10:41,6044575,7178675,1134100,BUY
04-12-20 10:42,10:42,6074000,7180300,1106300,BUY
04-12-20 10:43,10:43,6077425,7180300,1102875,BUY
04-12-20 10:44,10:44,6228450,7185550,957100,BUY
04-12-20 10:45,10:45,6178500,7184650,1006150,BUY
04-12-20 10:46,10:46,6200525,7185375,984850,BUY
04-12-20 10:47,10:47,6318925,7246750,927825,BUY
04-12-20 10:48,10:48,6293450,7246750,953300,BUY
04-12-20 10:49,10:49,6335050,7245400,910350,BUY
04-12-20 10:50,10:50,6460875,7306100,845225,BUY
04-12-20 10:51,10:51,6428250,7302925,874675,BUY
04-12-20 10:52,10:52,6432825,7301225,868400,BUY
04-12-20 10:53,10:53,6510475,7315400,804925,BUY
04-12-20 10:54,10:54,6510700,7280000,769300,BUY
04-12-20 10:55,10:55,6508700,7313550,804850,BUY
04-12-20 10:56,10:56,6664700,7376400,711700,BUY
04-12-20 10:57,10:57,6633625,7371975,738350,BUY
04-12-20 10:58,10:58,6644175,7373700,729525,BUY
04-12-20 10:59,10:59,6706750,7412800,706050,BUY
04-12-20 11:00,11:00,6722850,7416350,693500,BUY
04-12-20 11:01,11:01,6744225,7419275,675050,BUY
04-12-20 11:02,11:02,6786475,7399275,612800,BUY
04-12-20 11:03,11:03,6795575,7402850,607275,BUY
04-12-20 11:04,11:04,6782350,7395100,612750,BUY
04-12-20 11:05,11:05,6812050,7409150,597100,BUY
04-12-20 11:06,11:06,6827900,7443575,615675,BUY
04-12-20 11:07,11:07,6822725,7443775,621050,BUY
04-12-20 11:08,11:08,6866350,7445775,579425,BUY
04-12-20 11:09,11:09,6904700,7488500,583800,BUY
04-12-20 11:10,11:10,6855225,7486200,630975,BUY
04-12-20 11:11,11:11,6943375,7496100,552725,BUY
04-12-20 11:12,11:12,6912275,7498600,586325,BUY
04-12-20 11:13,11:13,6907025,7496825,589800,BUY
04-12-20 11:14,11:14,6974750,7513325,538575,BUY
04-12-20 11:15,11:15,6985950,7511975,526025,BUY
04-12-20 11:16,11:16,7012925,7513200,500275,BUY
04-12-20 11:17,11:17,7020200,7528100,507900,BUY
04-12-20 11:18,11:18,6995425,7507750,512325,BUY
04-12-20 11:19,11:19,7053175,7530875,477700,BUY
04-12-20 11:20,11:20,7095625,7455150,359525,BUY
04-12-20 11:21,11:21,7052475,7454075,401600,BUY
04-12-20 11:22,11:22,7068450,7453350,384900,BUY
04-12-20 11:23,11:23,7150350,7429100,278750,BUY
04-12-20 11:24,11:24,7152325,7460025,307700,BUY
04-12-20 11:25,11:25,7123325,7461325,338000,BUY
04-12-20 11:26,11:26,7170175,7503800,333625,BUY
04-12-20 11:27,11:27,7195500,7507050,311550,BUY
04-12-20 11:28,11:28,7159850,7502325,342475,BUY
04-12-20 11:29,11:29,7201975,7539125,337150,BUY
04-12-20 11:30,11:30,7203475,7540250,336775,BUY
04-12-20 11:31,11:31,7194075,7540250,346175,BUY
04-12-20 11:32,11:32,7229375,7514050,284675,BUY
04-12-20 11:33,11:33,7242525,7519175,276650,BUY
04-12-20 11:34,11:34,7236575,7518500,281925,BUY
04-12-20 11:35,11:35,7254500,7534725,280225,BUY
04-12-20 11:36,11:36,7303400,7535375,231975,BUY
04-12-20 11:37,11:37,7298425,7537125,238700,BUY
04-12-20 11:38,11:38,7282100,7503750,221650,BUY
04-12-20 11:39,11:39,7315350,7504500,189150,BUY
04-12-20 11:40,11:40,7322325,7504500,182175,BUY
04-12-20 11:41,11:41,7329275,7365875,36600,BUY
04-12-20 11:42,11:42,7310850,7364100,53250,BUY
04-12-20 11:43,11:43,7313200,7365975,52775,BUY
04-12-20 11:44,11:44,7363725,7416125,52400,BUY
04-12-20 11:45,11:45,7372100,7412975,40875,BUY
04-12-20 11:46,11:46,7352300,7416125,63825,BUY
04-12-20 11:47,11:47,7362575,7495575,133000,BUY
04-12-20 11:48,11:48,7373325,7495975,122650,BUY
04-12-20 11:49,11:49,7376675,7487375,110700,BUY
04-12-20 11:50,11:50,7345800,7488150,142350,BUY
04-12-20 11:51,11:51,7254425,7460475,206050,BUY
04-12-20 11:52,11:52,7368950,7490675,121725,BUY
04-12-20 11:53,11:53,7347950,7517725,169775,BUY
04-12-20 11:54,11:54,7361950,7486100,124150,BUY
04-12-20 11:55,11:55,7356100,7490175,134075,BUY
04-12-20 11:56,11:56,7359350,7549025,189675,BUY
04-12-20 11:57,11:57,7366550,7515450,148900,BUY
04-12-20 11:58,11:58,7379725,7562600,182875,BUY
04-12-20 11:59,11:59,7353250,7561325,208075,BUY
04-12-20 12:00,12:00,7327650,7521425,193775,BUY
04-12-20 12:01,12:01,7360900,7557000,196100,BUY
04-12-20 12:02,12:02,7319375,7539125,219750,BUY
04-12-20 12:03,12:03,7325050,7545425,220375,BUY
04-12-20 12:04,12:04,7348950,7542100,193150,BUY
04-12-20 12:05,12:05,7371750,7521225,149475,BUY
04-12-20 12:06,12:06,7381050,7558475,177425,BUY
04-12-20 12:07,12:07,7376950,7552650,175700,BUY
04-12-20 12:08,12:08,7421550,7587350,165800,BUY
04-12-20 12:09,12:09,7414100,7589800,175700,BUY
04-12-20 12:10,12:10,7441100,7559050,117950,BUY
04-12-20 12:11,12:11,7421425,7586400,164975,BUY
04-12-20 12:12,12:12,7427150,7584500,157350,BUY
04-12-20 12:13,12:13,7436450,7588500,152050,BUY
04-12-20 12:14,12:14,7351025,7587200,236175,BUY
04-12-20 12:15,12:15,7445575,7592075,146500,BUY
04-12-20 12:16,12:16,7431750,7564275,132525,BUY
04-12-20 12:17,12:17,7476000,7595450,119450,BUY
04-12-20 12:18,12:18,7516725,7635275,118550,BUY
04-12-20 12:19,12:19,7478175,7623475,145300,BUY
04-12-20 12:20,12:20,7517375,7659325,141950,BUY
04-12-20 12:21,12:21,7514125,7659900,145775,BUY
04-12-20 12:22,12:22,7441325,7624250,182925,BUY
04-12-20 12:23,12:23,7539325,7682875,143550,BUY
04-12-20 12:24,12:24,7523200,7682800,159600,BUY
04-12-20 12:25,12:25,7539675,7682800,143125,BUY
04-12-20 12:26,12:26,7543700,7712900,169200,BUY
04-12-20 12:27,12:27,7569075,7708025,138950,BUY
04-12-20 12:28,12:28,7571225,7748300,177075,BUY
04-12-20 12:29,12:29,7555750,7722650,166900,BUY
04-12-20 12:30,12:30,7524275,7710300,186025,BUY
04-12-20 12:31,12:31,7536125,7712475,176350,BUY
04-12-20 12:32,12:32,7583125,7731325,148200,BUY
04-12-20 12:33,12:33,7572075,7729625,157550,BUY
04-12-20 12:34,12:34,7585625,7726425,140800,BUY
04-12-20 12:35,12:35,7563725,7608625,44900,BUY
04-12-20 12:36,12:36,7605925,7615350,9425,BUY
04-12-20 12:37,12:37,7579025,7601125,22100,BUY
04-12-20 12:38,12:38,7613625,7535975,-77650,SELL
04-12-20 12:39,12:39,7607950,7502100,-105850,SELL
04-12-20 12:40,12:40,7628475,7528250,-100225,SELL
04-12-20 12:41,12:41,7606050,7483125,-122925,SELL
04-12-20 12:42,12:42,7558975,7520925,-38050,SELL
04-12-20 12:43,12:43,7557225,7516275,-40950,SELL
04-12-20 12:44,12:44,7604750,7486000,-118750,SELL
04-12-20 12:45,12:45,7631650,7472300,-159350,SELL
04-12-20 12:46,12:46,7620925,7484425,-136500,SELL
04-12-20 12:47,12:47,7613475,7496550,-116925,SELL
04-12-20 12:48,12:48,7643200,7505825,-137375,SELL
04-12-20 12:49,12:49,7647800,7505825,-141975,SELL
04-12-20 12:50,12:50,7624950,7197625,-427325,SELL
04-12-20 12:51,12:51,7620475,7197700,-422775,SELL
04-12-20 12:52,12:52,7614550,7190675,-423875,SELL
04-12-20 12:53,12:53,7631025,7197125,-433900,SELL
04-12-20 12:54,12:54,7628475,7193750,-434725,SELL
04-12-20 12:55,12:55,7668875,7205825,-463050,SELL
04-12-20 12:56,12:56,7673875,6993500,-680375,SELL
04-12-20 12:57,12:57,7670500,6986275,-684225,SELL
04-12-20 12:58,12:58,7676225,6982125,-694100,SELL
04-12-20 12:59,12:59,7680275,6983925,-696350,SELL
04-12-20 13:00,13:00,7683600,6966850,-716750,SELL
04-12-20 13:01,13:01,7657875,6976800,-681075,SELL
04-12-20 13:02,13:02,7674300,7000875,-673425,SELL
04-12-20 13:03,13:03,7678300,7006400,-671900,SELL
04-12-20 13:04,13:04,7692950,7001875,-691075,SELL
04-12-20 13:05,13:05,7649600,6991175,-658425,SELL
04-12-20 13:06,13:06,7620425,6982600,-637825,SELL
04-12-20 13:07,13:07,7611150,6979475,-631675,SELL
04-12-20 13:08,13:08,7629925,6979275,-650650,SELL
04-12-20 13:09,13:09,7619675,6984500,-635175,SELL
04-12-20 13:10,13:10,7597800,6964375,-633425,SELL
04-12-20 13:11,13:11,7572000,7026625,-545375,SELL
04-12-20 13:12,13:12,7620825,7032375,-588450,SELL
04-12-20 13:13,13:13,7592100,7022625,-569475,SELL
04-12-20 13:14,13:14,7588275,6999425,-588850,SELL
04-12-20 13:15,13:15,7610250,7006450,-603800,SELL
04-12-20 13:16,13:16,7599000,6996775,-602225,SELL
04-12-20 13:17,13:17,7610225,7017150,-593075,SELL
04-12-20 13:18,13:18,7608800,6991150,-617650,SELL
04-12-20 13:19,13:19,7608800,7012325,-596475,SELL
04-12-20 13:20,13:20,7661225,7050450,-610775,SELL
04-12-20 13:21,13:21,7629875,7044000,-585875,SELL
04-12-20 13:22,13:22,7662850,7054350,-608500,SELL
04-12-20 13:23,13:23,7551675,7036625,-515050,SELL
04-12-20 13:24,13:24,7544625,7040775,-503850,SELL
04-12-20 13:25,13:25,7593975,7052400,-541575,SELL
04-12-20 13:26,13:26,7557075,7100325,-456750,SELL
04-12-20 13:27,13:27,7555000,7087700,-467300,SELL
04-12-20 13:28,13:28,7536200,7084675,-451525,SELL
04-12-20 13:29,13:29,7551200,7140800,-410400,SELL
04-12-20 13:30,13:30,7582750,7147575,-435175,SELL
04-12-20 13:31,13:31,7538850,7143400,-395450,SELL
04-12-20 13:32,13:32,7577875,7176900,-400975,SELL
04-12-20 13:33,13:33,7557725,7177125,-380600,SELL
04-12-20 13:34,13:34,7550875,7173125,-377750,SELL
04-12-20 13:35,13:35,7550000,7213375,-336625,SELL
04-12-20 13:36,13:36,7529600,7194250,-335350,SELL
04-12-20 13:37,13:37,7546025,7202500,-343525,SELL
04-12-20 13:38,13:38,7583450,7201075,-382375,SELL
04-12-20 13:39,13:39,7574525,7219000,-355525,SELL
04-12-20 13:40,13:40,7561000,7223075,-337925,SELL
04-12-20 13:41,13:41,7584125,7232275,-351850,SELL
04-12-20 13:42,13:42,7609625,7236925,-372700,SELL
04-12-20 13:43,13:43,7604950,7232275,-372675,SELL
04-12-20 13:44,13:44,7505075,7245625,-259450,SELL
04-12-20 13:45,13:45,7530650,7251850,-278800,SELL
04-12-20 13:46,13:46,7511400,7251675,-259725,SELL
04-12-20 13:47,13:47,7573075,7302750,-270325,SELL
04-12-20 13:48,13:48,7548500,7293600,-254900,SELL
04-12-20 13:49,13:49,7587450,7303675,-283775,SELL
04-12-20 13:50,13:50,7554975,7274700,-280275,SELL
04-12-20 13:51,13:51,7461950,7232550,-229400,SELL
04-12-20 13:52,13:52,7464825,7237750,-227075,SELL
04-12-20 13:53,13:53,7462400,7248325,-214075,SELL
04-12-20 13:54,13:54,7475450,7227925,-247525,SELL
04-12-20 13:55,13:55,7475450,7236800,-238650,SELL
04-12-20 13:56,13:56,7467000,7216075,-250925,SELL
04-12-20 13:57,13:57,7465650,7211350,-254300,SELL
04-12-20 13:58,13:58,7469625,7202550,-267075,SELL
04-12-20 13:59,13:59,7472450,7204550,-267900,SELL
04-12-20 14:00,14:00,7528175,7211375,-316800,SELL
04-12-20 14:01,14:01,7567075,7216950,-350125,SELL
04-12-20 14:02,14:02,7513200,7212625,-300575,SELL
04-12-20 14:03,14:03,7564875,7198950,-365925,SELL
04-12-20 14:04,14:04,7564875,7176500,-388375,SELL
04-12-20 14:05,14:05,7542450,7199050,-343400,SELL
04-12-20 14:06,14:06,7591050,7199975,-391075,SELL
04-12-20 14:07,14:07,7588075,7176475,-411600,SELL
04-12-20 14:08,14:08,7585700,7177550,-408150,SELL
04-12-20 14:09,14:09,7589750,7199000,-390750,SELL
04-12-20 14:10,14:10,7589750,7227450,-362300,SELL
04-12-20 14:11,14:11,7618675,7242425,-376250,SELL
04-12-20 14:12,14:12,7597225,7208100,-389125,SELL
04-12-20 14:13,14:13,7617175,7218925,-398250,SELL
04-12-20 14:14,14:14,7619600,7218850,-400750,SELL
04-12-20 14:15,14:15,7602875,7248175,-354700,SELL
04-12-20 14:16,14:16,7596500,7200100,-396400,SELL
04-12-20 14:17,14:17,7625225,7254125,-371100,SELL
04-12-20 14:18,14:18,7620900,7261150,-359750,SELL
04-12-20 14:19,14:19,7614850,7246325,-368525,SELL
04-12-20 14:20,14:20,7620225,7231575,-388650,SELL
04-12-20 14:21,14:21,7662900,7269025,-393875,SELL
04-12-20 14:22,14:22,7641675,7267975,-373700,SELL
04-12-20 14:23,14:23,7634375,7268125,-366250,SELL
04-12-20 14:24,14:24,7611750,7299400,-312350,SELL
04-12-20 14:25,14:25,7658950,7306875,-352075,SELL
04-12-20 14:26,14:26,7639325,7309350,-329975,SELL
04-12-20 14:27,14:27,7622675,7318200,-304475,SELL
04-12-20 14:28,14:28,7636475,7314275,-322200,SELL
04-12-20 14:29,14:29,7639325,7314550,-324775,SELL
04-12-20 14:30,14:30,7454050,7319875,-134175,SELL
04-12-20 14:31,14:31,7463825,7320625,-143200,SELL
04-12-20 14:32,14:32,7480375,7315925,-164450,SELL
04-12-20 14:33,14:33,7391400,7344375,-47025,SELL
04-12-20 14:34,14:34,7385425,7344825,-40600,SELL
04-12-20 14:35,14:35,7412825,7337675,-75150,SELL
04-12-20 14:36,14:36,7317475,7288850,-28625,SELL
04-12-20 14:37,14:37,7348800,7286050,-62750,SELL
04-12-20 14:38,14:38,7320425,7278575,-41850,SELL
04-12-20 14:39,14:39,7276500,7304125,27625,BUY
04-12-20 14:40,14:40,7279175,7305425,26250,BUY
04-12-20 14:41,14:41,7283025,7304875,21850,BUY
04-12-20 14:42,14:42,7115425,7293950,178525,BUY
04-12-20 14:43,14:43,7101575,7294875,193300,BUY
04-12-20 14:44,14:44,7131550,7295875,164325,BUY
04-12-20 14:45,14:45,6981475,7285400,303925,BUY
04-12-20 14:46,14:46,6982025,7285400,303375,BUY
04-12-20 14:47,14:47,6961425,7283125,321700,BUY
04-12-20 14:48,14:48,6899875,7339800,439925,BUY
04-12-20 14:49,14:49,6941050,7340925,399875,BUY
04-12-20 14:50,14:50,6918425,7339650,421225,BUY
04-12-20 14:51,14:51,6822750,7412700,589950,BUY
04-12-20 14:52,14:52,6828075,7413275,585200,BUY
04-12-20 14:53,14:53,6823125,7413925,590800,BUY
04-12-20 14:54,14:54,6767950,7375225,607275,BUY
04-12-20 14:55,14:55,6749325,7375750,626425,BUY
04-12-20 14:56,14:56,6743925,7374175,630250,BUY
04-12-20 14:57,14:57,6693275,7376625,683350,BUY
04-12-20 14:58,14:58,6693275,7379000,685725,BUY
04-12-20 14:59,14:59,6711675,7379250,667575,BUY
04-12-20 15:00,15:00,6639525,7402650,763125,BUY
04-12-20 15:01,15:01,6592800,7403300,810500,BUY
04-12-20 15:02,15:02,6629275,7403875,774600,BUY
04-12-20 15:03,15:03,6546275,7422600,876325,BUY
04-12-20 15:04,15:04,6512975,7412325,899350,BUY
04-12-20 15:05,15:05,6528600,7423750,895150,BUY
04-12-20 15:06,15:06,6506400,7419900,913500,BUY
04-12-20 15:07,15:07,6536300,7422550,886250,BUY
04-12-20 15:08,15:08,6527675,7419250,891575,BUY
04-12-20 15:09,15:09,6489175,7449375,960200,BUY
04-12-20 15:10,15:10,6516600,7450250,933650,BUY
04-12-20 15:11,15:11,6531600,7444900,913300,BUY
04-12-20 15:12,15:12,6490000,7369625,879625,BUY
04-12-20 15:13,15:13,6482225,7367425,885200,BUY
04-12-20 15:14,15:14,6503650,7368675,865025,BUY
04-12-20 15:15,15:15,6395550,7229550,834000,BUY
04-12-20 15:16,15:16,6386675,7229550,842875,BUY
04-12-20 15:17,15:17,6411050,7227300,816250,BUY
04-12-20 15:18,15:18,6289375,7158575,869200,BUY
04-12-20 15:19,15:19,6293025,7167000,873975,BUY
04-12-20 15:20,15:20,6319650,7172325,852675,BUY
04-12-20 15:21,15:21,6139625,6972700,833075,BUY
04-12-20 15:22,15:22,6130975,6969650,838675,BUY
04-12-20 15:23,15:23,6111700,6973375,861675,BUY
04-12-20 15:24,15:24,5968900,6883425,914525,BUY
04-12-20 15:25,15:25,5971500,6883425,911925,BUY
04-12-20 15:26,15:26,5918175,6883425,965250,BUY
04-12-20 15:27,15:27,5878150,6763400,885250,BUY
04-12-20 15:28,15:28,5884825,6763950,879125,BUY
04-12-20 15:29,15:29,5878150,6761500,883350,BUY
07-12-20 9:15,9:15,5618150,6497575,879425,BUY
07-12-20 9:16,9:16,5643550,6497350,853800,BUY
07-12-20 9:17,9:17,5720225,6611150,890925,BUY
07-12-20 9:18,9:18,5700825,6612925,912100,BUY
07-12-20 9:19,9:19,5703000,6614175,911175,BUY
07-12-20 9:20,9:20,5888025,6924275,1036250,BUY
07-12-20 9:21,9:21,5863700,6921425,1057725,BUY
07-12-20 9:22,9:22,5844600,6920925,1076325,BUY
07-12-20 9:23,9:23,6183700,7328825,1145125,BUY
07-12-20 9:24,9:24,6204875,7332250,1127375,BUY
07-12-20 9:25,9:25,6210675,7334925,1124250,BUY
07-12-20 9:26,9:26,6565875,7783600,1217725,BUY
07-12-20 9:27,9:27,6553800,7784875,1231075,BUY
07-12-20 9:28,9:28,6575475,7782425,1206950,BUY
07-12-20 9:29,9:29,6931250,8129675,1198425,BUY
07-12-20 9:30,9:30,7001650,8126250,1124600,BUY
07-12-20 9:31,9:31,6974925,8128775,1153850,BUY
07-12-20 9:32,9:32,7262350,8262075,999725,BUY
07-12-20 9:33,9:33,7272050,8261600,989550,BUY
07-12-20 9:34,9:34,7264100,8260350,996250,BUY
07-12-20 9:35,9:35,7314800,8341950,1027150,BUY
07-12-20 9:36,9:36,7359950,8345450,985500,BUY
07-12-20 9:37,9:37,7354600,8345450,990850,BUY
07-12-20 9:38,9:38,7347225,8725700,1378475,BUY
07-12-20 9:39,9:39,7352325,8725300,1372975,BUY
07-12-20 9:40,9:40,7340050,8722075,1382025,BUY
07-12-20 9:41,9:41,7510025,8943950,1433925,BUY
07-12-20 9:42,9:42,7497975,8946175,1448200,BUY
07-12-20 9:43,9:43,7495250,8945650,1450400,BUY
07-12-20 9:44,9:44,7545900,9136725,1590825,BUY
07-12-20 9:45,9:45,7602750,9137650,1534900,BUY
07-12-20 9:46,9:46,7563550,9128200,1564650,BUY
07-12-20 9:47,9:47,7646150,9244925,1598775,BUY
07-12-20 9:48,9:48,7682500,9247600,1565100,BUY
07-12-20 9:49,9:49,7616400,9246550,1630150,BUY
07-12-20 9:50,9:50,7732775,9357750,1624975,BUY
07-12-20 9:51,9:51,7716700,9330700,1614000,BUY
07-12-20 9:52,9:52,7716925,9345975,1629050,BUY
07-12-20 9:53,9:53,7833875,9468100,1634225,BUY
07-12-20 9:54,9:54,7786725,9466150,1679425,BUY
07-12-20 9:55,9:55,7849850,9470850,1621000,BUY
07-12-20 9:56,9:56,7865625,9555975,1690350,BUY
07-12-20 9:57,9:57,7921000,9559550,1638550,BUY
07-12-20 9:58,9:58,7893975,9553775,1659800,BUY
07-12-20 9:59,9:59,7918425,9498475,1580050,BUY
07-12-20 10:00,10:00,7936700,9500950,1564250,BUY
07-12-20 10:01,10:01,7903675,9496675,1593000,BUY
07-12-20 10:02,10:02,7972250,9476075,1503825,BUY
07-12-20 10:03,10:03,7894325,9476875,1582550,BUY
07-12-20 10:04,10:04,7929275,9453725,1524450,BUY
07-12-20 10:05,10:05,8082300,9516875,1434575,BUY
07-12-20 10:06,10:06,8042050,9484750,1442700,BUY
07-12-20 10:07,10:07,8084875,9511325,1426450,BUY
07-12-20 10:08,10:08,8053025,9576500,1523475,BUY
07-12-20 10:09,10:09,8104125,9597375,1493250,BUY
07-12-20 10:10,10:10,8131250,9594900,1463650,BUY
07-12-20 10:11,10:11,8173950,9612800,1438850,BUY
07-12-20 10:12,10:12,8171750,9597700,1425950,BUY
07-12-20 10:13,10:13,8187675,9622400,1434725,BUY
07-12-20 10:14,10:14,8262525,9673550,1411025,BUY
07-12-20 10:15,10:15,8198925,9669450,1470525,BUY
07-12-20 10:16,10:16,8238275,9673475,1435200,BUY
07-12-20 10:17,10:17,8282375,9647450,1365075,BUY
07-12-20 10:18,10:18,8239225,9653050,1413825,BUY
07-12-20 10:19,10:19,8320000,9653000,1333000,BUY
07-12-20 10:20,10:20,8355225,9608075,1252850,BUY
07-12-20 10:21,10:21,8313425,9602275,1288850,BUY
07-12-20 10:22,10:22,8267500,9592175,1324675,BUY
07-12-20 10:23,10:23,8383750,9619225,1235475,BUY
07-12-20 10:24,10:24,8351775,9615100,1263325,BUY
07-12-20 10:25,10:25,8388200,9622000,1233800,BUY
07-12-20 10:26,10:26,8393075,9650225,1257150,BUY
07-12-20 10:27,10:27,8416225,9632700,1216475,BUY
07-12-20 10:28,10:28,8387025,9648225,1261200,BUY
07-12-20 10:29,10:29,8445975,9662050,1216075,BUY
07-12-20 10:30,10:30,8428525,9659000,1230475,BUY
07-12-20 10:31,10:31,8455300,9668950,1213650,BUY
07-12-20 10:32,10:32,8513250,9662850,1149600,BUY
07-12-20 10:33,10:33,8477775,9659950,1182175,BUY
07-12-20 10:34,10:34,8480500,9664000,1183500,BUY
07-12-20 10:35,10:35,8507675,9726825,1219150,BUY
07-12-20 10:36,10:36,8514800,9724725,1209925,BUY
07-12-20 10:37,10:37,8501400,9714300,1212900,BUY
07-12-20 10:38,10:38,8499700,9705375,1205675,BUY
07-12-20 10:39,10:39,8512450,9705925,1193475,BUY
07-12-20 10:40,10:40,8477325,9727075,1249750,BUY
07-12-20 10:41,10:41,8513000,9737625,1224625,BUY
07-12-20 10:42,10:42,8468125,9726675,1258550,BUY
07-12-20 10:43,10:43,8508125,9710025,1201900,BUY
07-12-20 10:44,10:44,8551625,9759050,1207425,BUY
07-12-20 10:45,10:45,8531075,9773475,1242400,BUY
07-12-20 10:46,10:46,8484875,9776625,1291750,BUY
07-12-20 10:47,10:47,8531150,9824450,1293300,BUY
07-12-20 10:48,10:48,8468550,9797000,1328450,BUY
07-12-20 10:49,10:49,8480075,9815675,1335600,BUY
07-12-20 10:50,10:50,8583825,9853025,1269200,BUY
07-12-20 10:51,10:51,8459775,9824425,1364650,BUY
07-12-20 10:52,10:52,8604500,9856250,1251750,BUY
07-12-20 10:53,10:53,8603075,9874275,1271200,BUY
07-12-20 10:54,10:54,8549125,9867750,1318625,BUY
07-12-20 10:55,10:55,8479875,9842475,1362600,BUY
07-12-20 10:56,10:56,8542225,9955150,1412925,BUY
07-12-20 10:57,10:57,8582225,9971150,1388925,BUY
07-12-20 10:58,10:58,8556375,9948125,1391750,BUY
07-12-20 10:59,10:59,8649925,10024050,1374125,BUY
07-12-20 11:00,11:00,8631825,10024050,1392225,BUY
07-12-20 11:01,11:01,8624725,10024050,1399325,BUY
07-12-20 11:02,11:02,8708350,10078475,1370125,BUY
07-12-20 11:03,11:03,8635525,10043975,1408450,BUY
07-12-20 11:04,11:04,8721525,10075550,1354025,BUY
07-12-20 11:05,11:05,8700100,10098850,1398750,BUY
07-12-20 11:06,11:06,8653600,10077775,1424175,BUY
07-12-20 11:07,11:07,8710825,10110625,1399800,BUY
07-12-20 11:08,11:08,8625550,10116725,1491175,BUY
07-12-20 11:09,11:09,8631700,10110750,1479050,BUY
07-12-20 11:10,11:10,8678900,10135675,1456775,BUY
07-12-20 11:11,11:11,8767000,10153100,1386100,BUY
07-12-20 11:12,11:12,8716025,10128525,1412500,BUY
07-12-20 11:13,11:13,8671125,10135975,1464850,BUY
07-12-20 11:14,11:14,8749350,10073875,1324525,BUY
07-12-20 11:15,11:15,8798175,10153825,1355650,BUY
07-12-20 11:16,11:16,8799850,10100850,1301000,BUY
07-12-20 11:17,11:17,8776250,10161175,1384925,BUY
07-12-20 11:18,11:18,8796275,10180300,1384025,BUY
07-12-20 11:19,11:19,8747750,10036075,1288325,BUY
07-12-20 11:20,11:20,8808075,10209575,1401500,BUY
07-12-20 11:21,11:21,8754325,10213025,1458700,BUY
07-12-20 11:22,11:22,8819225,10209700,1390475,BUY
07-12-20 11:23,11:23,8797950,10187475,1389525,BUY
07-12-20 11:24,11:24,8847525,10206475,1358950,BUY
07-12-20 11:25,11:25,8813000,10159200,1346200,BUY
07-12-20 11:26,11:26,8808850,10166950,1358100,BUY
07-12-20 11:27,11:27,8808850,10217500,1408650,BUY
07-12-20 11:28,11:28,8819800,10133725,1313925,BUY
07-12-20 11:29,11:29,8869000,10254075,1385075,BUY
07-12-20 11:30,11:30,8756925,10229425,1472500,BUY
07-12-20 11:31,11:31,8760725,10174275,1413550,BUY
07-12-20 11:32,11:32,8822175,10180500,1358325,BUY
07-12-20 11:33,11:33,8891800,10244500,1352700,BUY
07-12-20 11:34,11:34,8870325,10259975,1389650,BUY
07-12-20 11:35,11:35,8913275,10236450,1323175,BUY
07-12-20 11:36,11:36,8843100,10232100,1389000,BUY
07-12-20 11:37,11:37,8798000,10207850,1409850,BUY
07-12-20 11:38,11:38,8921150,10282475,1361325,BUY
07-12-20 11:39,11:39,8849200,10280575,1431375,BUY
07-12-20 11:40,11:40,8924300,10290900,1366600,BUY
07-12-20 11:41,11:41,8955800,10257950,1302150,BUY
07-12-20 11:42,11:42,8934775,10173725,1238950,BUY
07-12-20 11:43,11:43,8958000,10255325,1297325,BUY
07-12-20 11:44,11:44,8958075,10313200,1355125,BUY
07-12-20 11:45,11:45,8976875,10284600,1307725,BUY
07-12-20 11:46,11:46,8970050,10308225,1338175,BUY
07-12-20 11:47,11:47,8915150,10272400,1357250,BUY
07-12-20 11:48,11:48,8882350,10247200,1364850,BUY
07-12-20 11:49,11:49,8933500,10299300,1365800,BUY
07-12-20 11:50,11:50,8860175,10293375,1433200,BUY
07-12-20 11:51,11:51,8983600,10296775,1313175,BUY
07-12-20 11:52,11:52,8948775,10280450,1331675,BUY
07-12-20 11:53,11:53,8953150,10310250,1357100,BUY
07-12-20 11:54,11:54,8964625,10276450,1311825,BUY
07-12-20 11:55,11:55,9019375,10369825,1350450,BUY
07-12-20 11:56,11:56,9054700,10374550,1319850,BUY
07-12-20 11:57,11:57,9026300,10288375,1262075,BUY
07-12-20 11:58,11:58,9009875,10296800,1286925,BUY
07-12-20 11:59,11:59,9045150,10251275,1206125,BUY
07-12-20 12:00,12:00,9011150,10322275,1311125,BUY
07-12-20 12:01,12:01,9087300,10360575,1273275,BUY
07-12-20 12:02,12:02,9005800,10369350,1363550,BUY
07-12-20 12:03,12:03,9023475,10367150,1343675,BUY
07-12-20 12:04,12:04,9016475,10367425,1350950,BUY
07-12-20 12:05,12:05,9044950,10374325,1329375,BUY
07-12-20 12:06,12:06,8943300,10327425,1384125,BUY
07-12-20 12:07,12:07,9023425,10355175,1331750,BUY
07-12-20 12:08,12:08,9013025,10425425,1412400,BUY
07-12-20 12:09,12:09,8982700,10424375,1441675,BUY
07-12-20 12:10,12:10,8969000,10425425,1456425,BUY
07-12-20 12:11,12:11,8545050,10380425,1835375,BUY
07-12-20 12:12,12:12,8540775,10382350,1841575,BUY
07-12-20 12:13,12:13,8502625,10376750,1874125,BUY
07-12-20 12:14,12:14,8396300,10469325,2073025,BUY
07-12-20 12:15,12:15,8464675,10471025,2006350,BUY
07-12-20 12:16,12:16,8471400,10467700,1996300,BUY
07-12-20 12:17,12:17,8058325,10521075,2462750,BUY
07-12-20 12:18,12:18,8057975,10529425,2471450,BUY
07-12-20 12:19,12:19,8031125,10529300,2498175,BUY
07-12-20 12:20,12:20,8059575,10604875,2545300,BUY
07-12-20 12:21,12:21,8054400,10602450,2548050,BUY
07-12-20 12:22,12:22,7994450,10549550,2555100,BUY
07-12-20 12:23,12:23,8069525,10621500,2551975,BUY
07-12-20 12:24,12:24,8064650,10614200,2549550,BUY
07-12-20 12:25,12:25,8106350,10619975,2513625,BUY
07-12-20 12:26,12:26,8105325,10626050,2520725,BUY
07-12-20 12:27,12:27,8079150,10618225,2539075,BUY
07-12-20 12:28,12:28,8098900,10621600,2522700,BUY
07-12-20 12:29,12:29,8101475,10667500,2566025,BUY
07-12-20 12:30,12:30,8151550,10670725,2519175,BUY
07-12-20 12:31,12:31,8063125,10664875,2601750,BUY
07-12-20 12:32,12:32,8107725,10609450,2501725,BUY
07-12-20 12:33,12:33,8090450,10600800,2510350,BUY
07-12-20 12:34,12:34,8055425,10624475,2569050,BUY
07-12-20 12:35,12:35,8062625,10649925,2587300,BUY
07-12-20 12:36,12:36,8026025,10646875,2620850,BUY
07-12-20 12:37,12:37,8026025,10646875,2620850,BUY
07-12-20 12:38,12:38,8122975,10648075,2525100,BUY
07-12-20 12:39,12:39,8139550,10702500,2562950,BUY
07-12-20 12:40,12:40,8139150,10699450,2560300,BUY
07-12-20 12:41,12:41,8095525,10710600,2615075,BUY
07-12-20 12:42,12:42,8123350,10686825,2563475,BUY
07-12-20 12:43,12:43,8123350,10695400,2572050,BUY
07-12-20 12:44,12:44,8097800,10658750,2560950,BUY
07-12-20 12:45,12:45,8175750,10710350,2534600,BUY
07-12-20 12:46,12:46,8114075,10704225,2590150,BUY
07-12-20 12:47,12:47,8128750,10708800,2580050,BUY
07-12-20 12:48,12:48,8045850,10690100,2644250,BUY
07-12-20 12:49,12:49,8060425,10731750,2671325,BUY
07-12-20 12:50,12:50,8084725,10729575,2644850,BUY
07-12-20 12:51,12:51,8098100,10726725,2628625,BUY
07-12-20 12:52,12:52,8022600,10730075,2707475,BUY
07-12-20 12:53,12:53,8073700,10726725,2653025,BUY
07-12-20 12:54,12:54,8050350,10747025,2696675,BUY
07-12-20 12:55,12:55,8025975,10744050,2718075,BUY
07-12-20 12:56,12:56,8087625,10748500,2660875,BUY
07-12-20 12:57,12:57,8101125,10750950,2649825,BUY
07-12-20 12:58,12:58,8063100,10747900,2684800,BUY
07-12-20 12:59,12:59,8048950,10748925,2699975,BUY
07-12-20 13:00,13:00,7899250,10721575,2822325,BUY
07-12-20 13:01,13:01,7886925,10720800,2833875,BUY
07-12-20 13:02,13:02,7849350,10713050,2863700,BUY
07-12-20 13:03,13:03,7842300,10734925,2892625,BUY
07-12-20 13:04,13:04,7863450,10694425,2830975,BUY
07-12-20 13:05,13:05,7796475,10733575,2937100,BUY
07-12-20 13:06,13:06,7856700,10756775,2900075,BUY
07-12-20 13:07,13:07,7809825,10749150,2939325,BUY
07-12-20 13:08,13:08,7798900,10748825,2949925,BUY
07-12-20 13:09,13:09,7855900,10700225,2844325,BUY
07-12-20 13:10,13:10,7808400,10756650,2948250,BUY
07-12-20 13:11,13:11,7876575,10756975,2880400,BUY
07-12-20 13:12,13:12,7774525,10760025,2985500,BUY
07-12-20 13:13,13:13,7782050,10764925,2982875,BUY
07-12-20 13:14,13:14,7806625,10766625,2960000,BUY
07-12-20 13:15,13:15,7825225,10780200,2954975,BUY
07-12-20 13:16,13:16,7851700,10742700,2891000,BUY
07-12-20 13:17,13:17,7851700,10660950,2809250,BUY
07-12-20 13:18,13:18,7852150,10751625,2899475,BUY
07-12-20 13:19,13:19,7870675,10790925,2920250,BUY
07-12-20 13:20,13:20,7820000,10747950,2927950,BUY
07-12-20 13:21,13:21,7827700,10839425,3011725,BUY
07-12-20 13:22,13:22,7835550,10839425,3003875,BUY
07-12-20 13:23,13:23,7828550,10835325,3006775,BUY
07-12-20 13:24,13:24,7783725,10824300,3040575,BUY
07-12-20 13:25,13:25,7810200,10815100,3004900,BUY
07-12-20 13:26,13:26,7758000,10817275,3059275,BUY
07-12-20 13:27,13:27,7760000,10818475,3058475,BUY
07-12-20 13:28,13:28,7780175,10846500,3066325,BUY
07-12-20 13:29,13:29,7760000,10846500,3086500,BUY
07-12-20 13:30,13:30,7866350,10846300,2979950,BUY
07-12-20 13:31,13:31,7867225,10844725,2977500,BUY
07-12-20 13:32,13:32,7779525,10843275,3063750,BUY
07-12-20 13:33,13:33,7708125,10691975,2983850,BUY
07-12-20 13:34,13:34,7732875,10694250,2961375,BUY
07-12-20 13:35,13:35,7697375,10694250,2996875,BUY
07-12-20 13:36,13:36,7820425,10681575,2861150,BUY
07-12-20 13:37,13:37,7833950,10678000,2844050,BUY
07-12-20 13:38,13:38,7806200,10676625,2870425,BUY
07-12-20 13:39,13:39,7766625,10635150,2868525,BUY
07-12-20 13:40,13:40,7769250,10673675,2904425,BUY
07-12-20 13:41,13:41,7809125,10679150,2870025,BUY
07-12-20 13:42,13:42,7854275,10616975,2762700,BUY
07-12-20 13:43,13:43,7794075,10612550,2818475,BUY
07-12-20 13:44,13:44,7832475,10561175,2728700,BUY
07-12-20 13:45,13:45,7933175,10617450,2684275,BUY
07-12-20 13:46,13:46,7944100,10616200,2672100,BUY
07-12-20 13:47,13:47,7932675,10620300,2687625,BUY
07-12-20 13:48,13:48,7898425,10662275,2763850,BUY
07-12-20 13:49,13:49,7950925,10613275,2662350,BUY
07-12-20 13:50,13:50,7926550,10656350,2729800,BUY
07-12-20 13:51,13:51,8042900,10674775,2631875,BUY
07-12-20 13:52,13:52,7984625,10671225,2686600,BUY
07-12-20 13:53,13:53,7998000,10636675,2638675,BUY
07-12-20 13:54,13:54,8047425,10690350,2642925,BUY
07-12-20 13:55,13:55,7995600,10693350,2697750,BUY
07-12-20 13:56,13:56,8013450,10693800,2680350,BUY
07-12-20 13:57,13:57,8091600,10718425,2626825,BUY
07-12-20 13:58,13:58,8037125,10715425,2678300,BUY
07-12-20 13:59,13:59,8101275,10715775,2614500,BUY
07-12-20 14:00,14:00,8158250,10665375,2507125,BUY
07-12-20 14:01,14:01,8115500,10659575,2544075,BUY
07-12-20 14:02,14:02,8141275,10662225,2520950,BUY
07-12-20 14:03,14:03,8193400,10540825,2347425,BUY
07-12-20 14:04,14:04,8167650,10485525,2317875,BUY
07-12-20 14:05,14:05,8197675,10544100,2346425,BUY
07-12-20 14:06,14:06,8186175,10565300,2379125,BUY
07-12-20 14:07,14:07,8226575,10567050,2340475,BUY
07-12-20 14:08,14:08,8197050,10566075,2369025,BUY
07-12-20 14:09,14:09,8235725,10579025,2343300,BUY
07-12-20 14:10,14:10,8216225,10581925,2365700,BUY
07-12-20 14:11,14:11,8165875,10555075,2389200,BUY
07-12-20 14:12,14:12,8196975,10628025,2431050,BUY
07-12-20 14:13,14:13,8360375,10657600,2297225,BUY
07-12-20 14:14,14:14,8315525,10650500,2334975,BUY
07-12-20 14:15,14:15,8371475,10593000,2221525,BUY
07-12-20 14:16,14:16,8344950,10589800,2244850,BUY
07-12-20 14:17,14:17,8292325,10589800,2297475,BUY
07-12-20 14:18,14:18,8387050,10625675,2238625,BUY
07-12-20 14:19,14:19,8430450,10624050,2193600,BUY
07-12-20 14:20,14:20,8425825,10625400,2199575,BUY
07-12-20 14:21,14:21,8448300,10632700,2184400,BUY
07-12-20 14:22,14:22,8407875,10628300,2220425,BUY
07-12-20 14:23,14:23,8495225,10628300,2133075,BUY
07-12-20 14:24,14:24,8485675,10629275,2143600,BUY
07-12-20 14:25,14:25,8490325,10638325,2148000,BUY
07-12-20 14:26,14:26,8455400,10606125,2150725,BUY
07-12-20 14:27,14:27,8458775,10667200,2208425,BUY
07-12-20 14:28,14:28,8555350,10678200,2122850,BUY
07-12-20 14:29,14:29,8525575,10672300,2146725,BUY
07-12-20 14:30,14:30,8432950,10583625,2150675,BUY
07-12-20 14:31,14:31,8392025,10580950,2188925,BUY
07-12-20 14:32,14:32,8422225,10582875,2160650,BUY
07-12-20 14:33,14:33,8480025,10620000,2139975,BUY
07-12-20 14:34,14:34,8418200,10623650,2205450,BUY
07-12-20 14:35,14:35,8425425,10618675,2193250,BUY
07-12-20 14:36,14:36,8580850,10668750,2087900,BUY
07-12-20 14:37,14:37,8590125,10668750,2078625,BUY
07-12-20 14:38,14:38,8561750,10670425,2108675,BUY
07-12-20 14:39,14:39,8459425,10610025,2150600,BUY
07-12-20 14:40,14:40,8514575,10608825,2094250,BUY
07-12-20 14:41,14:41,8464700,10607825,2143125,BUY
07-12-20 14:42,14:42,8579225,10628525,2049300,BUY
07-12-20 14:43,14:43,8568250,10601050,2032800,BUY
07-12-20 14:44,14:44,8526975,10623700,2096725,BUY
07-12-20 14:45,14:45,8584450,10637050,2052600,BUY
07-12-20 14:46,14:46,8533475,10575400,2041925,BUY
07-12-20 14:47,14:47,8600075,10644450,2044375,BUY
07-12-20 14:48,14:48,8469625,10514100,2044475,BUY
07-12-20 14:49,14:49,8429600,10509300,2079700,BUY
07-12-20 14:50,14:50,8422175,10513000,2090825,BUY
07-12-20 14:51,14:51,8220750,10365450,2144700,BUY
07-12-20 14:52,14:52,8306950,10340250,2033300,BUY
07-12-20 14:53,14:53,8321250,10369875,2048625,BUY
07-12-20 14:54,14:54,8214525,10346075,2131550,BUY
07-12-20 14:55,14:55,8177750,10303350,2125600,BUY
07-12-20 14:56,14:56,8316175,10369000,2052825,BUY
07-12-20 14:57,14:57,8233300,10294600,2061300,BUY
07-12-20 14:58,14:58,8225050,10292350,2067300,BUY
07-12-20 14:59,14:59,8177450,10286450,2109000,BUY
07-12-20 15:00,15:00,8145700,10210025,2064325,BUY
07-12-20 15:01,15:01,8222175,10240650,2018475,BUY
07-12-20 15:02,15:02,8241600,10246825,2005225,BUY
07-12-20 15:03,15:03,8172500,10151800,1979300,BUY
07-12-20 15:04,15:04,8183225,10151575,1968350,BUY
07-12-20 15:05,15:05,8153575,10151575,1998000,BUY
07-12-20 15:06,15:06,8107250,10215950,2108700,BUY
07-12-20 15:07,15:07,8125500,10215950,2090450,BUY
07-12-20 15:08,15:08,8110575,10215950,2105375,BUY
07-12-20 15:09,15:09,8100800,10283675,2182875,BUY
07-12-20 15:10,15:10,8077950,10292075,2214125,BUY
07-12-20 15:11,15:11,8088850,10288125,2199275,BUY
07-12-20 15:12,15:12,8068225,10160475,2092250,BUY
07-12-20 15:13,15:13,8055350,10184750,2129400,BUY
07-12-20 15:14,15:14,8018625,10179125,2160500,BUY
07-12-20 15:15,15:15,8034850,10047550,2012700,BUY
07-12-20 15:16,15:16,8016825,10051900,2035075,BUY
07-12-20 15:17,15:17,8034850,10048950,2014100,BUY
07-12-20 15:18,15:18,7940825,9877350,1936525,BUY
07-12-20 15:19,15:19,7922225,9877350,1955125,BUY
07-12-20 15:20,15:20,7979325,9881900,1902575,BUY
07-12-20 15:21,15:21,7772525,9637625,1865100,BUY
07-12-20 15:22,15:22,7802375,9631675,1829300,BUY
07-12-20 15:23,15:23,7769275,9635575,1866300,BUY
07-12-20 15:24,15:24,7744550,9455875,1711325,BUY
07-12-20 15:25,15:25,7780425,9455850,1675425,BUY
07-12-20 15:26,15:26,7697575,9455850,1758275,BUY
07-12-20 15:27,15:27,7675975,9307850,1631875,BUY
07-12-20 15:28,15:28,7675000,9306200,1631200,BUY
07-12-20 15:29,15:29,7677525,9304825,1627300,BUY
08-12-20 9:15,9:15,7445725,9110050,1664325,BUY
08-12-20 9:16,9:16,7472525,9105900,1633375,BUY
08-12-20 9:17,9:17,7491025,9159950,1668925,BUY
08-12-20 9:18,9:18,7510600,9164725,1654125,BUY
08-12-20 9:19,9:19,7484675,9155725,1671050,BUY
08-12-20 9:20,9:20,7747775,9437875,1690100,BUY
08-12-20 9:21,9:21,7703050,9436225,1733175,BUY
08-12-20 9:22,9:22,7743625,9437575,1693950,BUY
08-12-20 9:23,9:23,8086025,9724075,1638050,BUY
08-12-20 9:24,9:24,8078575,9778475,1699900,BUY
08-12-20 9:25,9:25,8078575,9779050,1700475,BUY
08-12-20 9:26,9:26,8407550,10206625,1799075,BUY
08-12-20 9:27,9:27,8449725,10158275,1708550,BUY
08-12-20 9:28,9:28,8438825,10206750,1767925,BUY
08-12-20 9:29,9:29,8636250,10581925,1945675,BUY
08-12-20 9:30,9:30,8647225,10581450,1934225,BUY
08-12-20 9:31,9:31,8636250,10583400,1947150,BUY
08-12-20 9:32,9:32,8856625,10753750,1897125,BUY
08-12-20 9:33,9:33,8862225,10806050,1943825,BUY
08-12-20 9:34,9:34,8862225,10804250,1942025,BUY
08-12-20 9:35,9:35,8942475,10940900,1998425,BUY
08-12-20 9:36,9:36,8980075,10888800,1908725,BUY
08-12-20 9:37,9:37,8937025,10906025,1969000,BUY
08-12-20 9:38,9:38,9084975,11048175,1963200,BUY
08-12-20 9:39,9:39,9070175,11045150,1974975,BUY
08-12-20 9:40,9:40,9053525,11045125,1991600,BUY
08-12-20 9:41,9:41,9166800,11135275,1968475,BUY
08-12-20 9:42,9:42,9244800,11139825,1895025,BUY
08-12-20 9:43,9:43,9209025,11139725,1930700,BUY
08-12-20 9:44,9:44,9212400,11227550,2015150,BUY
08-12-20 9:45,9:45,9263900,11253900,1990000,BUY
08-12-20 9:46,9:46,9276325,11201900,1925575,BUY
08-12-20 9:47,9:47,9269550,11369975,2100425,BUY
08-12-20 9:48,9:48,9230175,11372575,2142400,BUY
08-12-20 9:49,9:49,9316275,11372575,2056300,BUY
08-12-20 9:50,9:50,9451650,11477150,2025500,BUY
08-12-20 9:51,9:51,9415450,11475300,2059850,BUY
08-12-20 9:52,9:52,9418375,11477150,2058775,BUY
08-12-20 9:53,9:53,9416375,11520900,2104525,BUY
08-12-20 9:54,9:54,9382775,11521150,2138375,BUY
08-12-20 9:55,9:55,9467650,11499925,2032275,BUY
08-12-20 9:56,9:56,9529350,11607350,2078000,BUY
08-12-20 9:57,9:57,9541975,11603100,2061125,BUY
08-12-20 9:58,9:58,9478875,11602475,2123600,BUY
08-12-20 9:59,9:59,9618300,11699050,2080750,BUY
08-12-20 10:00,10:00,9605450,11699100,2093650,BUY
08-12-20 10:01,10:01,9616275,11669425,2053150,BUY
08-12-20 10:02,10:02,9479025,11760800,2281775,BUY
08-12-20 10:03,10:03,9479775,11752975,2273200,BUY
08-12-20 10:04,10:04,9436175,11665100,2228925,BUY
08-12-20 10:05,10:05,9518625,11779375,2260750,BUY
08-12-20 10:06,10:06,9604775,11774675,2169900,BUY
08-12-20 10:07,10:07,9454225,11801900,2347675,BUY
08-12-20 10:08,10:08,9674800,11798000,2123200,BUY
08-12-20 10:09,10:09,9630400,11802450,2172050,BUY
08-12-20 10:10,10:10,9679950,11773150,2093200,BUY
08-12-20 10:11,10:11,9620150,11688775,2068625,BUY
08-12-20 10:12,10:12,9629700,11662600,2032900,BUY
08-12-20 10:13,10:13,9702450,11771950,2069500,BUY
08-12-20 10:14,10:14,9763750,11743500,1979750,BUY
08-12-20 10:15,10:15,9744900,11716275,1971375,BUY
08-12-20 10:16,10:16,9783475,11766575,1983100,BUY
08-12-20 10:17,10:17,9793825,11759625,1965800,BUY
08-12-20 10:18,10:18,9731575,11704575,1973000,BUY
08-12-20 10:19,10:19,9791225,11737000,1945775,BUY
08-12-20 10:20,10:20,9898800,11836775,1937975,BUY
08-12-20 10:21,10:21,9899000,11777125,1878125,BUY
08-12-20 10:22,10:22,9861825,11712150,1850325,BUY
08-12-20 10:23,10:23,9791100,11739025,1947925,BUY
08-12-20 10:24,10:24,9903575,11755000,1851425,BUY
08-12-20 10:25,10:25,9865375,11828350,1962975,BUY
08-12-20 10:26,10:26,9901175,11663175,1762000,BUY
08-12-20 10:27,10:27,9901075,11774425,1873350,BUY
08-12-20 10:28,10:28,9826200,11742275,1916075,BUY
08-12-20 10:29,10:29,9991275,11828325,1837050,BUY
08-12-20 10:30,10:30,9987575,11828325,1840750,BUY
08-12-20 10:31,10:31,9950250,11746300,1796050,BUY
08-12-20 10:32,10:32,10069600,11818725,1749125,BUY
08-12-20 10:33,10:33,10079825,11866800,1786975,BUY
08-12-20 10:34,10:34,10033025,11867425,1834400,BUY
08-12-20 10:35,10:35,10047900,11832300,1784400,BUY
08-12-20 10:36,10:36,9964225,11796300,1832075,BUY
08-12-20 10:37,10:37,9961950,11817775,1855825,BUY
08-12-20 10:38,10:38,10129750,11867500,1737750,BUY
08-12-20 10:39,10:39,10067800,11866875,1799075,BUY
08-12-20 10:40,10:40,10058825,11822400,1763575,BUY
08-12-20 10:41,10:41,10050025,11898125,1848100,BUY
08-12-20 10:42,10:42,10093100,11892900,1799800,BUY
08-12-20 10:43,10:43,10130425,11885700,1755275,BUY
08-12-20 10:44,10:44,10169625,11939675,1770050,BUY
08-12-20 10:45,10:45,10114200,11907600,1793400,BUY
08-12-20 10:46,10:46,10103425,11812375,1708950,BUY
08-12-20 10:47,10:47,10173000,11922125,1749125,BUY
08-12-20 10:48,10:48,10135475,11892650,1757175,BUY
08-12-20 10:49,10:49,10190250,11876550,1686300,BUY
08-12-20 10:50,10:50,10177400,11875700,1698300,BUY
08-12-20 10:51,10:51,10151675,11904950,1753275,BUY
08-12-20 10:52,10:52,10203775,11917750,1713975,BUY
08-12-20 10:53,10:53,10124025,11971875,1847850,BUY
08-12-20 10:54,10:54,10074900,11977400,1902500,BUY
08-12-20 10:55,10:55,10173250,11977400,1804150,BUY
08-12-20 10:56,10:56,10284300,11921275,1636975,BUY
08-12-20 10:57,10:57,10263875,11864000,1600125,BUY
08-12-20 10:58,10:58,10226650,11881675,1655025,BUY
08-12-20 10:59,10:59,10267825,11942750,1674925,BUY
08-12-20 11:00,11:00,10297000,11891175,1594175,BUY
08-12-20 11:01,11:01,10319225,11942750,1623525,BUY
08-12-20 11:02,11:02,10272400,11828900,1556500,BUY
08-12-20 11:03,11:03,10311025,11907225,1596200,BUY
08-12-20 11:04,11:04,10371000,11911750,1540750,BUY
08-12-20 11:05,11:05,10388400,11835900,1447500,BUY
08-12-20 11:06,11:06,10387600,11832500,1444900,BUY
08-12-20 11:07,11:07,10363575,11798825,1435250,BUY
08-12-20 11:08,11:08,10423450,11831325,1407875,BUY
08-12-20 11:09,11:09,10442625,11864300,1421675,BUY
08-12-20 11:10,11:10,10427350,11817300,1389950,BUY
08-12-20 11:11,11:11,10526425,11748075,1221650,BUY
08-12-20 11:12,11:12,10523400,11747825,1224425,BUY
08-12-20 11:13,11:13,10507275,11745600,1238325,BUY
08-12-20 11:14,11:14,10538725,11805075,1266350,BUY
08-12-20 11:15,11:15,10524300,11805650,1281350,BUY
08-12-20 11:16,11:16,10467075,11797150,1330075,BUY
08-12-20 11:17,11:17,10512925,11765000,1252075,BUY
08-12-20 11:18,11:18,10468600,11774800,1306200,BUY
08-12-20 11:19,11:19,10510325,11717750,1207425,BUY
08-12-20 11:20,11:20,10520100,11745975,1225875,BUY
08-12-20 11:21,11:21,10494650,11797825,1303175,BUY
08-12-20 11:22,11:22,10519225,11750550,1231325,BUY
08-12-20 11:23,11:23,10617850,11762175,1144325,BUY
08-12-20 11:24,11:24,10623675,11760575,1136900,BUY
08-12-20 11:25,11:25,10594375,11757600,1163225,BUY
08-12-20 11:26,11:26,10711425,11637800,926375,BUY
08-12-20 11:27,11:27,10683850,11638925,955075,BUY
08-12-20 11:28,11:28,10619725,11632550,1012825,BUY
08-12-20 11:29,11:29,10725800,11608500,882700,BUY
08-12-20 11:30,11:30,10730125,11613200,883075,BUY
08-12-20 11:31,11:31,10694900,11598900,904000,BUY
08-12-20 11:32,11:32,10733850,11499050,765200,BUY
08-12-20 11:33,11:33,10771075,11497525,726450,BUY
08-12-20 11:34,11:34,10798775,11497525,698750,BUY
08-12-20 11:35,11:35,10813600,11479925,666325,BUY
08-12-20 11:36,11:36,10800550,11510750,710200,BUY
08-12-20 11:37,11:37,10769750,11513950,744200,BUY
08-12-20 11:38,11:38,10799850,11498800,698950,BUY
08-12-20 11:39,11:39,10807375,11530375,723000,BUY
08-12-20 11:40,11:40,10862850,11533775,670925,BUY
08-12-20 11:41,11:41,10835350,11511750,676400,BUY
08-12-20 11:42,11:42,10835350,11477200,641850,BUY
08-12-20 11:43,11:43,10809000,11522675,713675,BUY
08-12-20 11:44,11:44,10906875,11500825,593950,BUY
08-12-20 11:45,11:45,10899200,11556600,657400,BUY
08-12-20 11:46,11:46,10853625,11556600,702975,BUY
08-12-20 11:47,11:47,10916525,11534300,617775,BUY
08-12-20 11:48,11:48,10888675,11503025,614350,BUY
08-12-20 11:49,11:49,10915400,11507925,592525,BUY
08-12-20 11:50,11:50,10943475,11617825,674350,BUY
08-12-20 11:51,11:51,10886550,11533575,647025,BUY
08-12-20 11:52,11:52,10892275,11475625,583350,BUY
08-12-20 11:53,11:53,10886075,11584625,698550,BUY
08-12-20 11:54,11:54,10902450,11631225,728775,BUY
08-12-20 11:55,11:55,11003975,11660975,657000,BUY
08-12-20 11:56,11:56,10944900,11588875,643975,BUY
08-12-20 11:57,11:57,10954675,11647975,693300,BUY
08-12-20 11:58,11:58,10977875,11643475,665600,BUY
08-12-20 11:59,11:59,10935000,11564500,629500,BUY
08-12-20 12:00,12:00,10868725,11628675,759950,BUY
08-12-20 12:01,12:01,10890075,11641025,750950,BUY
08-12-20 12:02,12:02,10955750,11625350,669600,BUY
08-12-20 12:03,12:03,10938675,11680500,741825,BUY
08-12-20 12:04,12:04,10877375,11632875,755500,BUY
08-12-20 12:05,12:05,10939000,11641175,702175,BUY
08-12-20 12:06,12:06,10941250,11607275,666025,BUY
08-12-20 12:07,12:07,10997900,11673800,675900,BUY
08-12-20 12:08,12:08,10946075,11640425,694350,BUY
08-12-20 12:09,12:09,10932525,11602150,669625,BUY
08-12-20 12:10,12:10,10844650,11581100,736450,BUY
08-12-20 12:11,12:11,11002525,11675650,673125,BUY
08-12-20 12:12,12:12,10960350,11594925,634575,BUY
08-12-20 12:13,12:13,10952725,11572650,619925,BUY
08-12-20 12:14,12:14,11030450,11600925,570475,BUY
08-12-20 12:15,12:15,11041750,11621100,579350,BUY
08-12-20 12:16,12:16,10986750,11677275,690525,BUY
08-12-20 12:17,12:17,11020025,11634975,614950,BUY
08-12-20 12:18,12:18,11081800,11672800,591000,BUY
08-12-20 12:19,12:19,11071250,11672800,601550,BUY
08-12-20 12:20,12:20,11011875,11654050,642175,BUY
08-12-20 12:21,12:21,11047975,11662925,614950,BUY
08-12-20 12:22,12:22,11027200,11652725,625525,BUY
08-12-20 12:23,12:23,11015425,11665025,649600,BUY
08-12-20 12:24,12:24,11048375,11688125,639750,BUY
08-12-20 12:25,12:25,11025200,11679875,654675,BUY
08-12-20 12:26,12:26,11116850,11713875,597025,BUY
08-12-20 12:27,12:27,11008800,11705025,696225,BUY
08-12-20 12:28,12:28,10999725,11707950,708225,BUY
08-12-20 12:29,12:29,11000825,11675350,674525,BUY
08-12-20 12:30,12:30,11018825,11681850,663025,BUY
08-12-20 12:31,12:31,10994550,11676525,681975,BUY
08-12-20 12:32,12:32,10980050,11676125,696075,BUY
08-12-20 12:33,12:33,10794500,11673775,879275,BUY
08-12-20 12:34,12:34,10796775,11604575,807800,BUY
08-12-20 12:35,12:35,10820250,11679175,858925,BUY
08-12-20 12:36,12:36,10798325,11678450,880125,BUY
08-12-20 12:37,12:37,10761150,11674775,913625,BUY
08-12-20 12:38,12:38,10804150,11719075,914925,BUY
08-12-20 12:39,12:39,10760200,11721650,961450,BUY
08-12-20 12:40,12:40,10667500,11700900,1033400,BUY
08-12-20 12:41,12:41,10720450,11733200,1012750,BUY
08-12-20 12:42,12:42,10766800,11714400,947600,BUY
08-12-20 12:43,12:43,10687450,11675175,987725,BUY
08-12-20 12:44,12:44,10705625,11652600,946975,BUY
08-12-20 12:45,12:45,10722150,11728850,1006700,BUY
08-12-20 12:46,12:46,10695775,11693225,997450,BUY
08-12-20 12:47,12:47,10708750,11701975,993225,BUY
08-12-20 12:48,12:48,10705075,11618075,913000,BUY
08-12-20 12:49,12:49,10761025,11768375,1007350,BUY
08-12-20 12:50,12:50,10742225,11776350,1034125,BUY
08-12-20 12:51,12:51,10689375,11749200,1059825,BUY
08-12-20 12:52,12:52,10732400,11684550,952150,BUY
08-12-20 12:53,12:53,10695250,11803950,1108700,BUY
08-12-20 12:54,12:54,10775425,11851700,1076275,BUY
08-12-20 12:55,12:55,10734550,11859800,1125250,BUY
08-12-20 12:56,12:56,10795175,11864200,1069025,BUY
08-12-20 12:57,12:57,10738300,11855475,1117175,BUY
08-12-20 12:58,12:58,10694200,11894425,1200225,BUY
08-12-20 12:59,12:59,10725800,11877250,1151450,BUY
08-12-20 13:00,13:00,10703200,11964400,1261200,BUY
08-12-20 13:01,13:01,10631500,11982275,1350775,BUY
08-12-20 13:02,13:02,10687100,11980675,1293575,BUY
08-12-20 13:03,13:03,10579650,11856400,1276750,BUY
08-12-20 13:04,13:04,10574125,11876250,1302125,BUY
08-12-20 13:05,13:05,10629825,11936900,1307075,BUY
08-12-20 13:06,13:06,10511925,11817525,1305600,BUY
08-12-20 13:07,13:07,10477350,11815625,1338275,BUY
08-12-20 13:08,13:08,10450575,11746850,1296275,BUY
08-12-20 13:09,13:09,10362675,11681125,1318450,BUY
08-12-20 13:10,13:10,10405100,11699750,1294650,BUY
08-12-20 13:11,13:11,10381675,11701800,1320125,BUY
08-12-20 13:12,13:12,10352275,11580875,1228600,BUY
08-12-20 13:13,13:13,10315125,11633200,1318075,BUY
08-12-20 13:14,13:14,10315125,11636900,1321775,BUY
08-12-20 13:15,13:15,10374250,11654125,1279875,BUY
08-12-20 13:16,13:16,10393325,11576175,1182850,BUY
08-12-20 13:17,13:17,10363225,11538275,1175050,BUY
08-12-20 13:18,13:18,10225450,11580500,1355050,BUY
08-12-20 13:19,13:19,10290175,11539425,1249250,BUY
08-12-20 13:20,13:20,10342325,11500650,1158325,BUY
08-12-20 13:21,13:21,10277775,11628700,1350925,BUY
08-12-20 13:22,13:22,10393150,11628625,1235475,BUY
08-12-20 13:23,13:23,10350725,11535850,1185125,BUY
08-12-20 13:24,13:24,10319025,11633125,1314100,BUY
08-12-20 13:25,13:25,10340925,11611825,1270900,BUY
08-12-20 13:26,13:26,10349150,11603025,1253875,BUY
08-12-20 13:27,13:27,10428875,11600175,1171300,BUY
08-12-20 13:28,13:28,10318875,11567975,1249100,BUY
08-12-20 13:29,13:29,10424025,11628575,1204550,BUY
08-12-20 13:30,13:30,10450925,11624850,1173925,BUY
08-12-20 13:31,13:31,10375450,11649000,1273550,BUY
08-12-20 13:32,13:32,10467100,11689025,1221925,BUY
08-12-20 13:33,13:33,10456025,11694275,1238250,BUY
08-12-20 13:34,13:34,10436700,11688150,1251450,BUY
08-12-20 13:35,13:35,10431725,11694775,1263050,BUY
08-12-20 13:36,13:36,10337375,11588825,1251450,BUY
08-12-20 13:37,13:37,10337375,11622475,1285100,BUY
08-12-20 13:38,13:38,10337375,11600400,1263025,BUY
08-12-20 13:39,13:39,10326925,11626125,1299200,BUY
08-12-20 13:40,13:40,10239100,11619750,1380650,BUY
08-12-20 13:41,13:41,10290200,11613075,1322875,BUY
08-12-20 13:42,13:42,10334675,11630100,1295425,BUY
08-12-20 13:43,13:43,10331400,11590675,1259275,BUY
08-12-20 13:44,13:44,10382475,11644425,1261950,BUY
08-12-20 13:45,13:45,10362775,11665125,1302350,BUY
08-12-20 13:46,13:46,10287850,11656650,1368800,BUY
08-12-20 13:47,13:47,10357425,11624625,1267200,BUY
08-12-20 13:48,13:48,10379925,11679575,1299650,BUY
08-12-20 13:49,13:49,10361525,11634925,1273400,BUY
08-12-20 13:50,13:50,10278650,11666850,1388200,BUY
08-12-20 13:51,13:51,10430750,11684075,1253325,BUY
08-12-20 13:52,13:52,10436400,11621125,1184725,BUY
08-12-20 13:53,13:53,10380425,11648425,1268000,BUY
08-12-20 13:54,13:54,10349575,11637000,1287425,BUY
08-12-20 13:55,13:55,10349575,11704075,1354500,BUY
08-12-20 13:56,13:56,10382825,11693500,1310675,BUY
08-12-20 13:57,13:57,10368850,11642900,1274050,BUY
08-12-20 13:58,13:58,10456825,11734425,1277600,BUY
08-12-20 13:59,13:59,10385950,11701975,1316025,BUY
08-12-20 14:00,14:00,10284475,11715500,1431025,BUY
08-12-20 14:01,14:01,10358550,11641100,1282550,BUY
08-12-20 14:02,14:02,10277175,11706750,1429575,BUY
08-12-20 14:03,14:03,10176800,11673825,1497025,BUY
08-12-20 14:04,14:04,10338650,11629225,1290575,BUY
08-12-20 14:05,14:05,10320650,11676975,1356325,BUY
08-12-20 14:06,14:06,10377875,11680250,1302375,BUY
08-12-20 14:07,14:07,10341425,11680250,1338825,BUY
08-12-20 14:08,14:08,10347325,11689050,1341725,BUY
08-12-20 14:09,14:09,10421750,11635875,1214125,BUY
08-12-20 14:10,14:10,10448800,11684550,1235750,BUY
08-12-20 14:11,14:11,10298675,11681350,1382675,BUY
08-12-20 14:12,14:12,10333675,11638675,1305000,BUY
08-12-20 14:13,14:13,10235675,11568575,1332900,BUY
08-12-20 14:14,14:14,10325725,11555500,1229775,BUY
08-12-20 14:15,14:15,10383775,11554625,1170850,BUY
08-12-20 14:16,14:16,10359850,11634675,1274825,BUY
08-12-20 14:17,14:17,10331500,11578425,1246925,BUY
08-12-20 14:18,14:18,10309875,10891425,581550,BUY
08-12-20 14:19,14:19,10346075,11669500,1323425,BUY
08-12-20 14:20,14:20,10336525,11678525,1342000,BUY
08-12-20 14:21,14:21,10316725,11576675,1259950,BUY
08-12-20 14:22,14:22,10338300,11625750,1287450,BUY
08-12-20 14:23,14:23,10222075,11620875,1398800,BUY
08-12-20 14:24,14:24,10200575,11638250,1437675,BUY
08-12-20 14:25,14:25,10274800,11634475,1359675,BUY
08-12-20 14:26,14:26,10251075,11568075,1317000,BUY
08-12-20 14:27,14:27,10255025,11627150,1372125,BUY
08-12-20 14:28,14:28,10162850,11599875,1437025,BUY
08-12-20 14:29,14:29,10198225,11602025,1403800,BUY
08-12-20 14:30,14:30,10224575,11582525,1357950,BUY
08-12-20 14:31,14:31,10210400,11581000,1370600,BUY
08-12-20 14:32,14:32,10229375,11577550,1348175,BUY
08-12-20 14:33,14:33,10070500,11485425,1414925,BUY
08-12-20 14:34,14:34,10054850,11492675,1437825,BUY
08-12-20 14:35,14:35,10076425,11491200,1414775,BUY
08-12-20 14:36,14:36,10075250,11369200,1293950,BUY
08-12-20 14:37,14:37,10059875,11368100,1308225,BUY
08-12-20 14:38,14:38,10073625,11373950,1300325,BUY
08-12-20 14:39,14:39,9949200,11310750,1361550,BUY
08-12-20 14:40,14:40,9958000,11299825,1341825,BUY
08-12-20 14:41,14:41,9952750,11301075,1348325,BUY
08-12-20 14:42,14:42,9958825,11188475,1229650,BUY
08-12-20 14:43,14:43,9978300,11214875,1236575,BUY
08-12-20 14:44,14:44,9998900,11278675,1279775,BUY
08-12-20 14:45,14:45,9858100,11289625,1431525,BUY
08-12-20 14:46,14:46,9887825,11266050,1378225,BUY
08-12-20 14:47,14:47,9871975,11267800,1395825,BUY
08-12-20 14:48,14:48,9867350,11218400,1351050,BUY
08-12-20 14:49,14:49,9774700,11204625,1429925,BUY
08-12-20 14:50,14:50,9764225,11217100,1452875,BUY
08-12-20 14:51,14:51,9767325,11164550,1397225,BUY
08-12-20 14:52,14:52,9800800,11157150,1356350,BUY
08-12-20 14:53,14:53,9795150,11167775,1372625,BUY
08-12-20 14:54,14:54,9691350,11084550,1393200,BUY
08-12-20 14:55,14:55,9777375,11114275,1336900,BUY
08-12-20 14:56,14:56,9757650,11127050,1369400,BUY
08-12-20 14:57,14:57,9634550,11038625,1404075,BUY
08-12-20 14:58,14:58,9570350,11037075,1466725,BUY
08-12-20 14:59,14:59,9469700,11036100,1566400,BUY
08-12-20 15:00,15:00,9541100,10973100,1432000,BUY
08-12-20 15:01,15:01,9442525,10895275,1452750,BUY
08-12-20 15:02,15:02,9439700,10968900,1529200,BUY
08-12-20 15:03,15:03,9420250,10903575,1483325,BUY
08-12-20 15:04,15:04,9410100,10914975,1504875,BUY
08-12-20 15:05,15:05,9163650,10913950,1750300,BUY
08-12-20 15:06,15:06,9311100,10847050,1535950,BUY
08-12-20 15:07,15:07,9359875,10880325,1520450,BUY
08-12-20 15:08,15:08,9346925,10870500,1523575,BUY
08-12-20 15:09,15:09,9361500,10723125,1361625,BUY
08-12-20 15:10,15:10,9327475,10722600,1395125,BUY
08-12-20 15:11,15:11,9340475,10675700,1335225,BUY
08-12-20 15:12,15:12,9130275,10512325,1382050,BUY
08-12-20 15:13,15:13,9117300,10515000,1397700,BUY
08-12-20 15:14,15:14,9102575,10459125,1356550,BUY
08-12-20 15:15,15:15,9070300,10458675,1388375,BUY
08-12-20 15:16,15:16,9077925,10455475,1377550,BUY
08-12-20 15:17,15:17,9023950,10453625,1429675,BUY
08-12-20 15:18,15:18,8874225,10348275,1474050,BUY
08-12-20 15:19,15:19,8911675,10345275,1433600,BUY
08-12-20 15:20,15:20,8990900,10349100,1358200,BUY
08-12-20 15:21,15:21,8697925,10153050,1455125,BUY
08-12-20 15:22,15:22,8707800,10196575,1488775,BUY
08-12-20 15:23,15:23,8596450,10194850,1598400,BUY
08-12-20 15:24,15:24,8466175,10055250,1589075,BUY
08-12-20 15:25,15:25,8502950,10057100,1554150,BUY
08-12-20 15:26,15:26,8450325,9990725,1540400,BUY
08-12-20 15:27,15:27,8359350,9942450,1583100,BUY
08-12-20 15:28,15:28,8276450,9943025,1666575,BUY
08-12-20 15:29,15:29,8368975,9947675,1578700,BUY
09-12-20 9:15,9:15,8116050,9730825,1614775,BUY
09-12-20 9:16,9:16,8100125,9731450,1631325,BUY
09-12-20 9:17,9:17,8250225,9892875,1642650,BUY
09-12-20 9:18,9:18,8202175,9931000,1728825,BUY
09-12-20 9:19,9:19,8242150,9931575,1689425,BUY
09-12-20 9:20,9:20,8846375,10698275,1851900,BUY
09-12-20 9:21,9:21,8846300,10697125,1850825,BUY
09-12-20 9:22,9:22,8847875,10638300,1790425,BUY
09-12-20 9:23,9:23,9091875,10822700,1730825,BUY
09-12-20 9:24,9:24,9038225,10923200,1884975,BUY
09-12-20 9:25,9:25,9101275,10922575,1821300,BUY
09-12-20 9:26,9:26,9366275,11068100,1701825,BUY
09-12-20 9:27,9:27,9361850,11047475,1685625,BUY
09-12-20 9:28,9:28,9370775,11003950,1633175,BUY
09-12-20 9:29,9:29,9597650,11135150,1537500,BUY
09-12-20 9:30,9:30,9579400,11071300,1491900,BUY
09-12-20 9:31,9:31,9572650,11136175,1563525,BUY
09-12-20 9:32,9:32,9800250,11285625,1485375,BUY
09-12-20 9:33,9:33,9884100,11240225,1356125,BUY
09-12-20 9:34,9:34,9893975,11224400,1330425,BUY
09-12-20 9:35,9:35,9943525,11352550,1409025,BUY
09-12-20 9:36,9:36,9943525,11377000,1433475,BUY
09-12-20 9:37,9:37,9940650,11397250,1456600,BUY
09-12-20 9:38,9:38,10151725,11425100,1273375,BUY
09-12-20 9:39,9:39,10140100,11439475,1299375,BUY
09-12-20 9:40,9:40,10065650,11463075,1397425,BUY
09-12-20 9:41,9:41,10156150,11552575,1396425,BUY
09-12-20 9:42,9:42,10249200,11469175,1219975,BUY
09-12-20 9:43,9:43,10236725,11550875,1314150,BUY
09-12-20 9:44,9:44,10229700,11777850,1548150,BUY
09-12-20 9:45,9:45,10126025,11716575,1590550,BUY
09-12-20 9:46,9:46,10201450,11796925,1595475,BUY
09-12-20 9:47,9:47,10239950,12040475,1800525,BUY
09-12-20 9:48,9:48,10211725,11959350,1747625,BUY
09-12-20 9:49,9:49,10211725,12040475,1828750,BUY
09-12-20 9:50,9:50,10310525,12060125,1749600,BUY
09-12-20 9:51,9:51,10263175,12057875,1794700,BUY
09-12-20 9:52,9:52,10247050,12103800,1856750,BUY
09-12-20 9:53,9:53,10335200,12210650,1875450,BUY
09-12-20 9:54,9:54,10300275,12120700,1820425,BUY
09-12-20 9:55,9:55,10293325,12088725,1795400,BUY
09-12-20 9:56,9:56,10423925,12160900,1736975,BUY
09-12-20 9:57,9:57,10383600,12204825,1821225,BUY
09-12-20 9:58,9:58,10278150,12308700,2030550,BUY
09-12-20 9:59,9:59,10512275,12406400,1894125,BUY
09-12-20 10:00,10:00,10546850,12406400,1859550,BUY
09-12-20 10:01,10:01,10562500,12408125,1845625,BUY
09-12-20 10:02,10:02,10549650,12362575,1812925,BUY
09-12-20 10:03,10:03,10653225,12312825,1659600,BUY
09-12-20 10:04,10:04,10605900,12315250,1709350,BUY
09-12-20 10:05,10:05,10723575,12423425,1699850,BUY
09-12-20 10:06,10:06,10712350,12439300,1726950,BUY
09-12-20 10:07,10:07,10710650,12346425,1635775,BUY
09-12-20 10:08,10:08,10611150,12425600,1814450,BUY
09-12-20 10:09,10:09,10589125,12479450,1890325,BUY
09-12-20 10:10,10:10,10703425,12433725,1730300,BUY
09-12-20 10:11,10:11,10724700,12540700,1816000,BUY
09-12-20 10:12,10:12,10714425,12519950,1805525,BUY
09-12-20 10:13,10:13,10771450,12542050,1770600,BUY
09-12-20 10:14,10:14,10605400,12475975,1870575,BUY
09-12-20 10:15,10:15,10749850,12552725,1802875,BUY
09-12-20 10:16,10:16,10696900,12551600,1854700,BUY
09-12-20 10:17,10:17,10651300,12603400,1952100,BUY
09-12-20 10:18,10:18,10547300,12625850,2078550,BUY
09-12-20 10:19,10:19,10612850,12575550,1962700,BUY
09-12-20 10:20,10:20,10506450,12605050,2098600,BUY
09-12-20 10:21,10:21,10672850,12625100,1952250,BUY
09-12-20 10:22,10:22,10672850,12603400,1930550,BUY
09-12-20 10:23,10:23,10579700,12670000,2090300,BUY
09-12-20 10:24,10:24,10535700,12669650,2133950,BUY
09-12-20 10:25,10:25,10697225,12670600,1973375,BUY
09-12-20 10:26,10:26,10643550,12752125,2108575,BUY
09-12-20 10:27,10:27,10677100,12752125,2075025,BUY
09-12-20 10:28,10:28,10606800,12641750,2034950,BUY
09-12-20 10:29,10:29,10621875,12686300,2064425,BUY
09-12-20 10:30,10:30,10564225,12766325,2202100,BUY
09-12-20 10:31,10:31,10620500,12744625,2124125,BUY
09-12-20 10:32,10:32,10452975,12746750,2293775,BUY
09-12-20 10:33,10:33,10486500,12728475,2241975,BUY
09-12-20 10:34,10:34,10577125,12726475,2149350,BUY
09-12-20 10:35,10:35,10629900,12700425,2070525,BUY
09-12-20 10:36,10:36,10408100,12698800,2290700,BUY
09-12-20 10:37,10:37,10666775,12698800,2032025,BUY
09-12-20 10:38,10:38,10468850,12562075,2093225,BUY
09-12-20 10:39,10:39,10605400,12750675,2145275,BUY
09-12-20 10:40,10:40,10475800,12651975,2176175,BUY
09-12-20 10:41,10:41,10725075,12548150,1823075,BUY
09-12-20 10:42,10:42,10638000,12836225,2198225,BUY
09-12-20 10:43,10:43,10668650,12735600,2066950,BUY
09-12-20 10:44,10:44,10526800,12794275,2267475,BUY
09-12-20 10:45,10:45,10670525,12798200,2127675,BUY
09-12-20 10:46,10:46,10670525,12734575,2064050,BUY
09-12-20 10:47,10:47,10637975,12737050,2099075,BUY
09-12-20 10:48,10:48,10563925,12817650,2253725,BUY
09-12-20 10:49,10:49,10675200,12758575,2083375,BUY
09-12-20 10:50,10:50,10723700,12783450,2059750,BUY
09-12-20 10:51,10:51,10757650,12820700,2063050,BUY
09-12-20 10:52,10:52,10724325,12874925,2150600,BUY
09-12-20 10:53,10:53,10655950,12877375,2221425,BUY
09-12-20 10:54,10:54,10641175,12808925,2167750,BUY
09-12-20 10:55,10:55,10495250,12828525,2333275,BUY
09-12-20 10:56,10:56,10691525,12794100,2102575,BUY
09-12-20 10:57,10:57,10598100,12839275,2241175,BUY
09-12-20 10:58,10:58,10648950,12815225,2166275,BUY
09-12-20 10:59,10:59,10547925,12865075,2317150,BUY
09-12-20 11:00,11:00,10803700,12918300,2114600,BUY
09-12-20 11:01,11:01,10958475,12926625,1968150,BUY
09-12-20 11:02,11:02,10845750,12772475,1926725,BUY
09-12-20 11:03,11:03,10783700,12898925,2115225,BUY
09-12-20 11:04,11:04,10839725,12842750,2003025,BUY
09-12-20 11:05,11:05,10831750,12936225,2104475,BUY
09-12-20 11:06,11:06,10885450,12956675,2071225,BUY
09-12-20 11:07,11:07,10859475,12979875,2120400,BUY
09-12-20 11:08,11:08,10774175,12891100,2116925,BUY
09-12-20 11:09,11:09,10737100,12808475,2071375,BUY
09-12-20 11:10,11:10,10694175,12967925,2273750,BUY
09-12-20 11:11,11:11,10768125,12928650,2160525,BUY
09-12-20 11:12,11:12,10742300,12885875,2143575,BUY
09-12-20 11:13,11:13,10709475,13003500,2294025,BUY
09-12-20 11:14,11:14,10714325,12929000,2214675,BUY
09-12-20 11:15,11:15,10702375,12958250,2255875,BUY
09-12-20 11:16,11:16,10748800,12981200,2232400,BUY
09-12-20 11:17,11:17,10546500,12996275,2449775,BUY
09-12-20 11:18,11:18,10711675,12866000,2154325,BUY
09-12-20 11:19,11:19,10715000,13023675,2308675,BUY
09-12-20 11:20,11:20,10794850,12978025,2183175,BUY
09-12-20 11:21,11:21,10768350,13061625,2293275,BUY
09-12-20 11:22,11:22,10735025,13011850,2276825,BUY
09-12-20 11:23,11:23,10784125,13090675,2306550,BUY
09-12-20 11:24,11:24,10712125,12991300,2279175,BUY
09-12-20 11:25,11:25,10693175,13034775,2341600,BUY
09-12-20 11:26,11:26,10899500,12947550,2048050,BUY
09-12-20 11:27,11:27,10830500,13064175,2233675,BUY
09-12-20 11:28,11:28,10882775,13047950,2165175,BUY
09-12-20 11:29,11:29,10932550,13020650,2088100,BUY
09-12-20 11:30,11:30,10738825,13134775,2395950,BUY
09-12-20 11:31,11:31,10832675,13016825,2184150,BUY
09-12-20 11:32,11:32,10648175,13054675,2406500,BUY
09-12-20 11:33,11:33,10722200,13039825,2317625,BUY
09-12-20 11:34,11:34,10743975,13067425,2323450,BUY
09-12-20 11:35,11:35,10831200,13124775,2293575,BUY
09-12-20 11:36,11:36,10708200,13103525,2395325,BUY
09-12-20 11:37,11:37,10989075,13198750,2209675,BUY
09-12-20 11:38,11:38,10669400,13125125,2455725,BUY
09-12-20 11:39,11:39,10544400,13125725,2581325,BUY
09-12-20 11:40,11:40,10674975,13108625,2433650,BUY
09-12-20 11:41,11:41,10615025,13097075,2482050,BUY
09-12-20 11:42,11:42,10633175,13268750,2635575,BUY
09-12-20 11:43,11:43,10614575,13050875,2436300,BUY
09-12-20 11:44,11:44,10393500,12533750,2140250,BUY
09-12-20 11:45,11:45,10636750,12568950,1932200,BUY
09-12-20 11:46,11:46,10701150,13222175,2521025,BUY
09-12-20 11:47,11:47,10536625,13285900,2749275,BUY
09-12-20 11:48,11:48,10497350,13305875,2808525,BUY
09-12-20 11:49,11:49,10530350,13308000,2777650,BUY
09-12-20 11:50,11:50,10500050,13232075,2732025,BUY
09-12-20 11:51,11:51,10499800,13220625,2720825,BUY
09-12-20 11:52,11:52,10546250,13275150,2728900,BUY
09-12-20 11:53,11:53,10460650,13376825,2916175,BUY
09-12-20 11:54,11:54,10537100,13287175,2750075,BUY
09-12-20 11:55,11:55,10598150,13375600,2777450,BUY
09-12-20 11:56,11:56,10481000,13290000,2809000,BUY
09-12-20 11:57,11:57,10484525,13287250,2802725,BUY
09-12-20 11:58,11:58,10390475,13252200,2861725,BUY
09-12-20 11:59,11:59,10520775,13241250,2720475,BUY
09-12-20 12:00,12:00,10544750,13193225,2648475,BUY
09-12-20 12:01,12:01,10608300,12445925,1837625,BUY
09-12-20 12:02,12:02,10628125,13222225,2594100,BUY
09-12-20 12:03,12:03,10631925,13254000,2622075,BUY
09-12-20 12:04,12:04,10495125,12585175,2090050,BUY
09-12-20 12:05,12:05,10475925,13140050,2664125,BUY
09-12-20 12:06,12:06,10586900,13196775,2609875,BUY
09-12-20 12:07,12:07,10674575,13367250,2692675,BUY
09-12-20 12:08,12:08,10668975,13123450,2454475,BUY
09-12-20 12:09,12:09,10618250,13162700,2544450,BUY
09-12-20 12:10,12:10,10563350,13231525,2668175,BUY
09-12-20 12:11,12:11,10655475,13048525,2393050,BUY
09-12-20 12:12,12:12,10611975,13271775,2659800,BUY
09-12-20 12:13,12:13,10587125,13303825,2716700,BUY
09-12-20 12:14,12:14,10556625,13345075,2788450,BUY
09-12-20 12:15,12:15,10690900,13452775,2761875,BUY
09-12-20 12:16,12:16,10567275,13359625,2792350,BUY
09-12-20 12:17,12:17,10665725,13127175,2461450,BUY
09-12-20 12:18,12:18,10597450,13245400,2647950,BUY
09-12-20 12:19,12:19,10655450,13331425,2675975,BUY
09-12-20 12:20,12:20,10642550,11814025,1171475,BUY
09-12-20 12:21,12:21,10700100,13350725,2650625,BUY
09-12-20 12:22,12:22,10663775,13379100,2715325,BUY
09-12-20 12:23,12:23,10700100,13336575,2636475,BUY
09-12-20 12:24,12:24,10689500,13383225,2693725,BUY
09-12-20 12:25,12:25,10504375,13283300,2778925,BUY
09-12-20 12:26,12:26,10692775,13356950,2664175,BUY
09-12-20 12:27,12:27,10761325,13452425,2691100,BUY
09-12-20 12:28,12:28,10702575,13388575,2686000,BUY
09-12-20 12:29,12:29,10545850,13335150,2789300,BUY
09-12-20 12:30,12:30,10633275,13414200,2780925,BUY
09-12-20 12:31,12:31,10594975,13431050,2836075,BUY
09-12-20 12:32,12:32,10509225,13278625,2769400,BUY
09-12-20 12:33,12:33,10488250,13243775,2755525,BUY
09-12-20 12:34,12:34,10437600,13245800,2808200,BUY
09-12-20 12:35,12:35,10545250,12798975,2253725,BUY
09-12-20 12:36,12:36,10540975,12782375,2241400,BUY
09-12-20 12:37,12:37,10605675,13436075,2830400,BUY
09-12-20 12:38,12:38,10587850,13468600,2880750,BUY
09-12-20 12:39,12:39,10611900,13509000,2897100,BUY
09-12-20 12:40,12:40,10522225,13330100,2807875,BUY
09-12-20 12:41,12:41,10625175,13486100,2860925,BUY
09-12-20 12:42,12:42,10484325,13298400,2814075,BUY
09-12-20 12:43,12:43,10520400,13465450,2945050,BUY
09-12-20 12:44,12:44,10557300,12775525,2218225,BUY
09-12-20 12:45,12:45,10619275,13445600,2826325,BUY
09-12-20 12:46,12:46,10603100,13446925,2843825,BUY
09-12-20 12:47,12:47,10563450,13469725,2906275,BUY
09-12-20 12:48,12:48,10372125,13464525,3092400,BUY
09-12-20 12:49,12:49,10336050,13628875,3292825,BUY
09-12-20 12:50,12:50,10468250,13560325,3092075,BUY
09-12-20 12:51,12:51,10572250,13481900,2909650,BUY
09-12-20 12:52,12:52,10438300,13516275,3077975,BUY
09-12-20 12:53,12:53,10240825,13410100,3169275,BUY
09-12-20 12:54,12:54,10608775,13433525,2824750,BUY
09-12-20 12:55,12:55,10400550,12880475,2479925,BUY
09-12-20 12:56,12:56,10645000,13403550,2758550,BUY
09-12-20 12:57,12:57,10680475,13600250,2919775,BUY
09-12-20 12:58,12:58,10680475,13524250,2843775,BUY
09-12-20 12:59,12:59,10699325,13537025,2837700,BUY
09-12-20 13:00,13:00,10618525,13667150,3048625,BUY
09-12-20 13:01,13:01,10623675,13592650,2968975,BUY
09-12-20 13:02,13:02,10450600,13653000,3202400,BUY
09-12-20 13:03,13:03,10462675,13622250,3159575,BUY
09-12-20 13:04,13:04,10498750,13485075,2986325,BUY
09-12-20 13:05,13:05,10501250,13624475,3123225,BUY
09-12-20 13:06,13:06,10290300,13533850,3243550,BUY
09-12-20 13:07,13:07,10254225,13613550,3359325,BUY
09-12-20 13:08,13:08,10279175,13686550,3407375,BUY
09-12-20 13:09,13:09,10404800,13644075,3239275,BUY
09-12-20 13:10,13:10,10445000,13632950,3187950,BUY
09-12-20 13:11,13:11,10462100,13685050,3222950,BUY
09-12-20 13:12,13:12,10349450,13657200,3307750,BUY
09-12-20 13:13,13:13,10298200,13580075,3281875,BUY
09-12-20 13:14,13:14,10341375,12910850,2569475,BUY
09-12-20 13:15,13:15,10391800,13570025,3178225,BUY
09-12-20 13:16,13:16,10362250,13715050,3352800,BUY
09-12-20 13:17,13:17,10403500,13701325,3297825,BUY
09-12-20 13:18,13:18,10158825,13807975,3649150,BUY
09-12-20 13:19,13:19,10298400,13842350,3543950,BUY
09-12-20 13:20,13:20,10263125,13120425,2857300,BUY
09-12-20 13:21,13:21,10106900,13784475,3677575,BUY
09-12-20 13:22,13:22,10251175,13603975,3352800,BUY
09-12-20 13:23,13:23,10299425,13767975,3468550,BUY
09-12-20 13:24,13:24,10065825,13661975,3596150,BUY
09-12-20 13:25,13:25,10315300,13737850,3422550,BUY
09-12-20 13:26,13:26,10277025,13707525,3430500,BUY
09-12-20 13:27,13:27,9940750,13679150,3738400,BUY
09-12-20 13:28,13:28,10048500,13654575,3606075,BUY
09-12-20 13:29,13:29,10012450,13671175,3658725,BUY
09-12-20 13:30,13:30,9012725,13571750,4559025,BUY
09-12-20 13:31,13:31,9035800,13549450,4513650,BUY
09-12-20 13:32,13:32,8950225,13574200,4623975,BUY
09-12-20 13:33,13:33,8950350,13608700,4658350,BUY
09-12-20 13:34,13:34,8952525,13590100,4637575,BUY
09-12-20 13:35,13:35,8988700,13682600,4693900,BUY
09-12-20 13:36,13:36,9066375,13588050,4521675,BUY
09-12-20 13:37,13:37,9078375,13582775,4504400,BUY
09-12-20 13:38,13:38,9068375,13640725,4572350,BUY
09-12-20 13:39,13:39,8987500,13675825,4688325,BUY
09-12-20 13:40,13:40,8970000,13705875,4735875,BUY
09-12-20 13:41,13:41,9113175,13694500,4581325,BUY
09-12-20 13:42,13:42,9057250,13697125,4639875,BUY
09-12-20 13:43,13:43,9121025,13724775,4603750,BUY
09-12-20 13:44,13:44,9123125,13759800,4636675,BUY
09-12-20 13:45,13:45,9127850,13730425,4602575,BUY
09-12-20 13:46,13:46,9176150,13685575,4509425,BUY
09-12-20 13:47,13:47,9128650,13681350,4552700,BUY
09-12-20 13:48,13:48,9072350,13603100,4530750,BUY
09-12-20 13:49,13:49,9053525,13573825,4520300,BUY
09-12-20 13:50,13:50,9114625,13675375,4560750,BUY
09-12-20 13:51,13:51,9057550,13577375,4519825,BUY
09-12-20 13:52,13:52,9061675,13583550,4521875,BUY
09-12-20 13:53,13:53,9110525,13480250,4369725,BUY
09-12-20 13:54,13:54,9233200,13589375,4356175,BUY
09-12-20 13:55,13:55,9182675,13595000,4412325,BUY
09-12-20 13:56,13:56,9217825,13602925,4385100,BUY
09-12-20 13:57,13:57,9005000,13588875,4583875,BUY
09-12-20 13:58,13:58,9022375,13579450,4557075,BUY
09-12-20 13:59,13:59,8921125,13452200,4531075,BUY
09-12-20 14:00,14:00,8995250,13530400,4535150,BUY
09-12-20 14:01,14:01,9018025,13546800,4528775,BUY
09-12-20 14:02,14:02,8946850,13472725,4525875,BUY
09-12-20 14:03,14:03,8894825,13530500,4635675,BUY
09-12-20 14:04,14:04,8884900,13481425,4596525,BUY
09-12-20 14:05,14:05,8849925,13537575,4687650,BUY
09-12-20 14:06,14:06,8836600,13534625,4698025,BUY
09-12-20 14:07,14:07,8808250,13531700,4723450,BUY
09-12-20 14:08,14:08,8834500,13487900,4653400,BUY
09-12-20 14:09,14:09,8499525,13419375,4919850,BUY
09-12-20 14:10,14:10,8533700,13463400,4929700,BUY
09-12-20 14:11,14:11,8497925,13460225,4962300,BUY
09-12-20 14:12,14:12,8580700,13557925,4977225,BUY
09-12-20 14:13,14:13,8615425,13576700,4961275,BUY
09-12-20 14:14,14:14,8618175,13523875,4905700,BUY
09-12-20 14:15,14:15,8416875,13563225,5146350,BUY
09-12-20 14:16,14:16,8376875,13566325,5189450,BUY
09-12-20 14:17,14:17,8381075,13593125,5212050,BUY
09-12-20 14:18,14:18,8439750,13470175,5030425,BUY
09-12-20 14:19,14:19,8429875,13571450,5141575,BUY
09-12-20 14:20,14:20,8382175,13536225,5154050,BUY
09-12-20 14:21,14:21,8388300,13553450,5165150,BUY
09-12-20 14:22,14:22,8392700,13500525,5107825,BUY
09-12-20 14:23,14:23,8392700,13538325,5145625,BUY
09-12-20 14:24,14:24,8368025,13592075,5224050,BUY
09-12-20 14:25,14:25,8390750,13605600,5214850,BUY
09-12-20 14:26,14:26,8320275,13620175,5299900,BUY
09-12-20 14:27,14:27,8620550,13625225,5004675,BUY
09-12-20 14:28,14:28,8482725,13565800,5083075,BUY
09-12-20 14:29,14:29,8583675,13625500,5041825,BUY
09-12-20 14:30,14:30,8566675,13674175,5107500,BUY
09-12-20 14:31,14:31,8609500,13675425,5065925,BUY
09-12-20 14:32,14:32,8608950,13675425,5066475,BUY
09-12-20 14:33,14:33,8524050,13637450,5113400,BUY
09-12-20 14:34,14:34,8609025,13693525,5084500,BUY
09-12-20 14:35,14:35,8669575,13684475,5014900,BUY
09-12-20 14:36,14:36,8664875,13654825,4989950,BUY
09-12-20 14:37,14:37,8612125,13693525,5081400,BUY
09-12-20 14:38,14:38,8612125,13695225,5083100,BUY
09-12-20 14:39,14:39,8676600,13740225,5063625,BUY
09-12-20 14:40,14:40,8614650,13786750,5172100,BUY
09-12-20 14:41,14:41,8686425,13791700,5105275,BUY
09-12-20 14:42,14:42,8693575,13829825,5136250,BUY
09-12-20 14:43,14:43,8691275,13845975,5154700,BUY
09-12-20 14:44,14:44,8711300,13786625,5075325,BUY
09-12-20 14:45,14:45,8800225,13827275,5027050,BUY
09-12-20 14:46,14:46,8718950,13822150,5103200,BUY
09-12-20 14:47,14:47,8890100,13823875,4933775,BUY
09-12-20 14:48,14:48,8763350,13700850,4937500,BUY
09-12-20 14:49,14:49,8710475,13856600,5146125,BUY
09-12-20 14:50,14:50,8910725,13861675,4950950,BUY
09-12-20 14:51,14:51,8764050,13646925,4882875,BUY
09-12-20 14:52,14:52,8760675,13633125,4872450,BUY
09-12-20 14:53,14:53,8743600,13659850,4916250,BUY
09-12-20 14:54,14:54,8713275,13407475,4694200,BUY
09-12-20 14:55,14:55,8760700,13476700,4716000,BUY
09-12-20 14:56,14:56,8712575,13442700,4730125,BUY
09-12-20 14:57,14:57,8521725,13464575,4942850,BUY
09-12-20 14:58,14:58,8745750,13453725,4707975,BUY
09-12-20 14:59,14:59,8702325,13381300,4678975,BUY
09-12-20 15:00,15:00,8691950,13176600,4484650,BUY
09-12-20 15:01,15:01,8661225,13157900,4496675,BUY
09-12-20 15:02,15:02,8542975,13145275,4602300,BUY
09-12-20 15:03,15:03,8517125,13103325,4586200,BUY
09-12-20 15:04,15:04,8494950,13077000,4582050,BUY
09-12-20 15:05,15:05,8545350,13075575,4530225,BUY
09-12-20 15:06,15:06,8479075,13015975,4536900,BUY
09-12-20 15:07,15:07,8403575,13018325,4614750,BUY
09-12-20 15:08,15:08,8316625,13011575,4694950,BUY
09-12-20 15:09,15:09,8360725,12925900,4565175,BUY
09-12-20 15:10,15:10,8407925,12969200,4561275,BUY
09-12-20 15:11,15:11,8425150,12972450,4547300,BUY
09-12-20 15:12,15:12,8198750,12786400,4587650,BUY
09-12-20 15:13,15:13,8206300,12797725,4591425,BUY
09-12-20 15:14,15:14,8028750,12805125,4776375,BUY
09-12-20 15:15,15:15,8192100,12539575,4347475,BUY
09-12-20 15:16,15:16,8191400,12525850,4334450,BUY
09-12-20 15:17,15:17,8153725,12485550,4331825,BUY
09-12-20 15:18,15:18,7995025,12159425,4164400,BUY
09-12-20 15:19,15:19,8043450,12244400,4200950,BUY
09-12-20 15:20,15:20,8129625,12233500,4103875,BUY
09-12-20 15:21,15:21,7886525,11764775,3878250,BUY
09-12-20 15:22,15:22,7867025,11769550,3902525,BUY
09-12-20 15:23,15:23,7790825,11764775,3973950,BUY
09-12-20 15:24,15:24,7552600,11376375,3823775,BUY
09-12-20 15:25,15:25,7675075,11409100,3734025,BUY
09-12-20 15:26,15:26,7645100,11406775,3761675,BUY
09-12-20 15:27,15:27,7469225,11155650,3686425,BUY
09-12-20 15:28,15:28,7478850,11135450,3656600,BUY
09-12-20 15:29,15:29,7492375,11161925,3669550,BUY
10-12-20 9:15,9:15,7206250,10109200,2902950,BUY
10-12-20 9:16,9:16,7206250,10828550,3622300,BUY
10-12-20 9:17,9:17,7431025,11100775,3669750,BUY
10-12-20 9:18,9:18,7477875,11100675,3622800,BUY
10-12-20 9:19,9:19,7472650,11083225,3610575,BUY
10-12-20 9:20,9:20,8021950,11715600,3693650,BUY
10-12-20 9:21,9:21,7991825,11712050,3720225,BUY
10-12-20 9:22,9:22,7882225,11689950,3807725,BUY
10-12-20 9:23,9:23,8502175,12299700,3797525,BUY
10-12-20 9:24,9:24,8607275,12327375,3720100,BUY
10-12-20 9:25,9:25,8616700,12315525,3698825,BUY
10-12-20 9:26,9:26,9190175,13076275,3886100,BUY
10-12-20 9:27,9:27,9246350,13051550,3805200,BUY
10-12-20 9:28,9:28,9223800,13082650,3858850,BUY
10-12-20 9:29,9:29,10031850,13516950,3485100,BUY
10-12-20 9:30,9:30,10018900,13501325,3482425,BUY
10-12-20 9:31,9:31,9990075,13477975,3487900,BUY
10-12-20 9:32,9:32,10604525,13844400,3239875,BUY
10-12-20 9:33,9:33,10649650,13832900,3183250,BUY
10-12-20 9:34,9:34,10627425,13840025,3212600,BUY
10-12-20 9:35,9:35,11131850,14231150,3099300,BUY
10-12-20 9:36,9:36,11058050,14228350,3170300,BUY
10-12-20 9:37,9:37,11003900,14252200,3248300,BUY
10-12-20 9:38,9:38,11481300,14196000,2714700,BUY
10-12-20 9:39,9:39,11493475,14193000,2699525,BUY
10-12-20 9:40,9:40,11478000,14189200,2711200,BUY
10-12-20 9:41,9:41,11654400,14162950,2508550,BUY
10-12-20 9:42,9:42,11632875,14183950,2551075,BUY
10-12-20 9:43,9:43,11736575,14174700,2438125,BUY
10-12-20 9:44,9:44,11947875,14647175,2699300,BUY
10-12-20 9:45,9:45,12075150,14653800,2578650,BUY
10-12-20 9:46,9:46,12045350,14666225,2620875,BUY
10-12-20 9:47,9:47,12224125,15030475,2806350,BUY
10-12-20 9:48,9:48,12221675,15043525,2821850,BUY
10-12-20 9:49,9:49,12185125,14996500,2811375,BUY
10-12-20 9:50,9:50,12446650,15132850,2686200,BUY
10-12-20 9:51,9:51,12507150,15176000,2668850,BUY
10-12-20 9:52,9:52,12490350,15194725,2704375,BUY
10-12-20 9:53,9:53,12871575,15683625,2812050,BUY
10-12-20 9:54,9:54,12852875,15604925,2752050,BUY
10-12-20 9:55,9:55,12882750,15695600,2812850,BUY
10-12-20 9:56,9:56,13074775,15887575,2812800,BUY
10-12-20 9:57,9:57,13147550,15892525,2744975,BUY
10-12-20 9:58,9:58,13121075,15865925,2744850,BUY
10-12-20 9:59,9:59,13242400,16164175,2921775,BUY
10-12-20 10:00,10:00,13237525,16179950,2942425,BUY
10-12-20 10:01,10:01,13234700,16180800,2946100,BUY
10-12-20 10:02,10:02,13401225,16243725,2842500,BUY
10-12-20 10:03,10:03,13308475,16233150,2924675,BUY
10-12-20 10:04,10:04,13530200,16270750,2740550,BUY
10-12-20 10:05,10:05,13636850,16366825,2729975,BUY
10-12-20 10:06,10:06,13707050,16390900,2683850,BUY
10-12-20 10:07,10:07,13732000,16337375,2605375,BUY
10-12-20 10:08,10:08,13970825,16143975,2173150,BUY
10-12-20 10:09,10:09,13973325,16206975,2233650,BUY
10-12-20 10:10,10:10,13896650,16270875,2374225,BUY
10-12-20 10:11,10:11,14168200,16380925,2212725,BUY
10-12-20 10:12,10:12,14005700,16417750,2412050,BUY
10-12-20 10:13,10:13,14019225,16436825,2417600,BUY
10-12-20 10:14,10:14,14296950,16620250,2323300,BUY
10-12-20 10:15,10:15,14335150,16590275,2255125,BUY
10-12-20 10:16,10:16,14311850,16627150,2315300,BUY
10-12-20 10:17,10:17,14576725,16736000,2159275,BUY
10-12-20 10:18,10:18,14486075,16751700,2265625,BUY
10-12-20 10:19,10:19,14508400,16845325,2336925,BUY
10-12-20 10:20,10:20,14632225,16741775,2109550,BUY
10-12-20 10:21,10:21,14659200,16792500,2133300,BUY
10-12-20 10:22,10:22,14692200,16715050,2022850,BUY
10-12-20 10:23,10:23,14628325,16810375,2182050,BUY
10-12-20 10:24,10:24,14376925,16809675,2432750,BUY
10-12-20 10:25,10:25,14617600,16715125,2097525,BUY
10-12-20 10:26,10:26,14681475,16594025,1912550,BUY
10-12-20 10:27,10:27,14612650,16695175,2082525,BUY
10-12-20 10:28,10:28,14669200,16095800,1426600,BUY
10-12-20 10:29,10:29,14676800,16632600,1955800,BUY
10-12-20 10:30,10:30,14679875,16651225,1971350,BUY
10-12-20 10:31,10:31,14693150,16636800,1943650,BUY
10-12-20 10:32,10:32,14906900,16707150,1800250,BUY
10-12-20 10:33,10:33,14734100,16689900,1955800,BUY
10-12-20 10:34,10:34,14922325,16108825,1186500,BUY
10-12-20 10:35,10:35,14926175,16723200,1797025,BUY
10-12-20 10:36,10:36,14902100,16755225,1853125,BUY
10-12-20 10:37,10:37,14949550,16671150,1721600,BUY
10-12-20 10:38,10:38,15044350,16113025,1068675,BUY
10-12-20 10:39,10:39,15016575,16142000,1125425,BUY
10-12-20 10:40,10:40,15042700,16718200,1675500,BUY
10-12-20 10:41,10:41,15183950,16563050,1379100,BUY
10-12-20 10:42,10:42,15183925,16516875,1332950,BUY
10-12-20 10:43,10:43,15166725,16638125,1471400,BUY
10-12-20 10:44,10:44,15066275,16773075,1706800,BUY
10-12-20 10:45,10:45,15103525,16879675,1776150,BUY
10-12-20 10:46,10:46,14940025,16684975,1744950,BUY
10-12-20 10:47,10:47,15000475,16528950,1528475,BUY
10-12-20 10:48,10:48,15165375,16717825,1552450,BUY
10-12-20 10:49,10:49,15087150,16747600,1660450,BUY
10-12-20 10:50,10:50,15026650,16182550,1155900,BUY
10-12-20 10:51,10:51,15130975,16731275,1600300,BUY
10-12-20 10:52,10:52,15061250,16806700,1745450,BUY
10-12-20 10:53,10:53,15130575,16875650,1745075,BUY
10-12-20 10:54,10:54,15029225,16896375,1867150,BUY
10-12-20 10:55,10:55,15257975,16956650,1698675,BUY
10-12-20 10:56,10:56,15068650,16774700,1706050,BUY
10-12-20 10:57,10:57,15172525,16831625,1659100,BUY
10-12-20 10:58,10:58,15132400,16765025,1632625,BUY
10-12-20 10:59,10:59,15269275,16729800,1460525,BUY
10-12-20 11:00,11:00,15239850,16670000,1430150,BUY
10-12-20 11:01,11:01,15251775,16758975,1507200,BUY
10-12-20 11:02,11:02,15195050,16827575,1632525,BUY
10-12-20 11:03,11:03,15199075,16863950,1664875,BUY
10-12-20 11:04,11:04,15218800,16868125,1649325,BUY
10-12-20 11:05,11:05,15224650,16734275,1509625,BUY
10-12-20 11:06,11:06,15282075,16838875,1556800,BUY
10-12-20 11:07,11:07,15280925,16841400,1560475,BUY
10-12-20 11:08,11:08,15255775,16219925,964150,BUY
10-12-20 11:09,11:09,15274500,16775900,1501400,BUY
10-12-20 11:10,11:10,15229225,16733950,1504725,BUY
10-12-20 11:11,11:11,15366500,16898500,1532000,BUY
10-12-20 11:12,11:12,15321400,16880450,1559050,BUY
10-12-20 11:13,11:13,15406250,16901175,1494925,BUY
10-12-20 11:14,11:14,15418225,17163650,1745425,BUY
10-12-20 11:15,11:15,15320775,17181975,1861200,BUY
10-12-20 11:16,11:16,15402125,17129375,1727250,BUY
10-12-20 11:17,11:17,15612075,17190325,1578250,BUY
10-12-20 11:18,11:18,15498075,17243075,1745000,BUY
10-12-20 11:19,11:19,15526225,17088950,1562725,BUY
10-12-20 11:20,11:20,15772450,17293900,1521450,BUY
10-12-20 11:21,11:21,15704550,17336150,1631600,BUY
10-12-20 11:22,11:22,15682575,17223825,1541250,BUY
10-12-20 11:23,11:23,15800850,17396875,1596025,BUY
10-12-20 11:24,11:24,15781000,17477900,1696900,BUY
10-12-20 11:25,11:25,15859000,16584550,725550,BUY
10-12-20 11:26,11:26,15976400,17110475,1134075,BUY
10-12-20 11:27,11:27,15763050,17542200,1779150,BUY
10-12-20 11:28,11:28,16014225,17665200,1650975,BUY
10-12-20 11:29,11:29,16042175,17704625,1662450,BUY
10-12-20 11:30,11:30,16047100,17099125,1052025,BUY
10-12-20 11:31,11:31,15990100,17701025,1710925,BUY
10-12-20 11:32,11:32,16119300,17783000,1663700,BUY
10-12-20 11:33,11:33,16083500,17635475,1551975,BUY
10-12-20 11:34,11:34,16130575,17667675,1537100,BUY
10-12-20 11:35,11:35,16203225,17812650,1609425,BUY
10-12-20 11:36,11:36,16158275,16471425,313150,BUY
10-12-20 11:37,11:37,16223475,17878600,1655125,BUY
10-12-20 11:38,11:38,16146250,17322650,1176400,BUY
10-12-20 11:39,11:39,16108125,17888900,1780775,BUY
10-12-20 11:40,11:40,16202175,17296175,1094000,BUY
10-12-20 11:41,11:41,16245850,17669000,1423150,BUY
10-12-20 11:42,11:42,16416075,18018950,1602875,BUY
10-12-20 11:43,11:43,16278500,17866550,1588050,BUY
10-12-20 11:44,11:44,15813100,17800875,1987775,BUY
10-12-20 11:45,11:45,16290875,17723425,1432550,BUY
10-12-20 11:46,11:46,16241450,17647575,1406125,BUY
10-12-20 11:47,11:47,16253850,17053225,799375,BUY
10-12-20 11:48,11:48,16249125,17595725,1346600,BUY
10-12-20 11:49,11:49,16231950,17619800,1387850,BUY
10-12-20 11:50,11:50,16268950,17236300,967350,BUY
10-12-20 11:51,11:51,16344400,17497175,1152775,BUY
10-12-20 11:52,11:52,16442200,17601350,1159150,BUY
10-12-20 11:53,11:53,16496825,17277625,780800,BUY
10-12-20 11:54,11:54,16458500,17274100,815600,BUY
10-12-20 11:55,11:55,16493075,17132850,639775,BUY
10-12-20 11:56,11:56,16605425,17035825,430400,BUY
10-12-20 11:57,11:57,16432575,17067200,634625,BUY
10-12-20 11:58,11:58,16416025,17003225,587200,BUY
10-12-20 11:59,11:59,16357775,17035025,677250,BUY
10-12-20 12:00,12:00,16570700,17116200,545500,BUY
10-12-20 12:01,12:01,16608800,16960625,351825,BUY
10-12-20 12:02,12:02,16608800,16987800,379000,BUY
10-12-20 12:03,12:03,16627100,16372775,-254325,SELL
10-12-20 12:04,12:04,16694775,17068225,373450,BUY
10-12-20 12:05,12:05,16371725,17061250,689525,BUY
10-12-20 12:06,12:06,16742525,17231375,488850,BUY
10-12-20 12:07,12:07,16752125,17191400,439275,BUY
10-12-20 12:08,12:08,16643675,16654775,11100,BUY
10-12-20 12:09,12:09,16696950,17037975,341025,BUY
10-12-20 12:10,12:10,16680850,16455375,-225475,SELL
10-12-20 12:11,12:11,16759500,17025300,265800,BUY
10-12-20 12:12,12:12,16740000,16392225,-347775,SELL
10-12-20 12:13,12:13,16610150,16444950,-165200,SELL
10-12-20 12:14,12:14,16850375,16952200,101825,BUY
10-12-20 12:15,12:15,16885700,16907200,21500,BUY
10-12-20 12:16,12:16,16921675,16364000,-557675,SELL
10-12-20 12:17,12:17,16921675,16334250,-587425,SELL
10-12-20 12:18,12:18,16786775,16580675,-206100,SELL
10-12-20 12:19,12:19,16766750,16578150,-188600,SELL
10-12-20 12:20,12:20,16809025,16598150,-210875,SELL
10-12-20 12:21,12:21,16771500,16607975,-163525,SELL
10-12-20 12:22,12:22,16758300,16634675,-123625,SELL
10-12-20 12:23,12:23,16755000,16716625,-38375,SELL
10-12-20 12:24,12:24,16788050,16768250,-19800,SELL
10-12-20 12:25,12:25,16772025,16119625,-652400,SELL
10-12-20 12:26,12:26,16779700,16673100,-106600,SELL
10-12-20 12:27,12:27,16802925,16607325,-195600,SELL
10-12-20 12:28,12:28,16788200,16643875,-144325,SELL
10-12-20 12:29,12:29,16673900,16752300,78400,BUY
10-12-20 12:30,12:30,16863100,16840975,-22125,SELL
10-12-20 12:31,12:31,16884650,16796825,-87825,SELL
10-12-20 12:32,12:32,16896100,16787550,-108550,SELL
10-12-20 12:33,12:33,16814200,16229300,-584900,SELL
10-12-20 12:34,12:34,16881475,16794425,-87050,SELL
10-12-20 12:35,12:35,16922350,16767550,-154800,SELL
10-12-20 12:36,12:36,16971550,16959850,-11700,SELL
10-12-20 12:37,12:37,16964175,17014850,50675,BUY
10-12-20 12:38,12:38,17006050,17021250,15200,BUY
10-12-20 12:39,12:39,17060750,17081350,20600,BUY
10-12-20 12:40,12:40,17010325,16964775,-45550,SELL
10-12-20 12:41,12:41,16973600,17114300,140700,BUY
10-12-20 12:42,12:42,17009300,17088775,79475,BUY
10-12-20 12:43,12:43,16989500,17081650,92150,BUY
10-12-20 12:44,12:44,16845450,17031950,186500,BUY
10-12-20 12:45,12:45,17087150,17229250,142100,BUY
10-12-20 12:46,12:46,16932525,17182200,249675,BUY
10-12-20 12:47,12:47,16875550,16997025,121475,BUY
10-12-20 12:48,12:48,17098725,17146600,47875,BUY
10-12-20 12:49,12:49,17133150,17224975,91825,BUY
10-12-20 12:50,12:50,16916775,17252225,335450,BUY
10-12-20 12:51,12:51,16773600,17260500,486900,BUY
10-12-20 12:52,12:52,16986425,17145825,159400,BUY
10-12-20 12:53,12:53,16879500,17197650,318150,BUY
10-12-20 12:54,12:54,16919150,17175900,256750,BUY
10-12-20 12:55,12:55,16980575,17248300,267725,BUY
10-12-20 12:56,12:56,16990625,17167700,177075,BUY
10-12-20 12:57,12:57,17112425,17230900,118475,BUY
10-12-20 12:58,12:58,17014675,17006375,-8300,SELL
10-12-20 12:59,12:59,17020150,17205875,185725,BUY
10-12-20 13:00,13:00,16974575,17322875,348300,BUY
10-12-20 13:01,13:01,16984600,16340975,-643625,SELL
10-12-20 13:02,13:02,16904900,17340150,435250,BUY
10-12-20 13:03,13:03,17040250,17364550,324300,BUY
10-12-20 13:04,13:04,17021925,17237400,215475,BUY
10-12-20 13:05,13:05,17056500,17235050,178550,BUY
10-12-20 13:06,13:06,16935600,17374725,439125,BUY
10-12-20 13:07,13:07,16969500,17271650,302150,BUY
10-12-20 13:08,13:08,16899750,17303975,404225,BUY
10-12-20 13:09,13:09,16905775,17308600,402825,BUY
10-12-20 13:10,13:10,17040950,17273825,232875,BUY
10-12-20 13:11,13:11,17057350,17344275,286925,BUY
10-12-20 13:12,13:12,16935800,16882350,-53450,SELL
10-12-20 13:13,13:13,17014025,16817950,-196075,SELL
10-12-20 13:14,13:14,16999750,17367775,368025,BUY
10-12-20 13:15,13:15,17002650,17342950,340300,BUY
10-12-20 13:16,13:16,16942075,17360425,418350,BUY
10-12-20 13:17,13:17,16865950,17340550,474600,BUY
10-12-20 13:18,13:18,16898250,17233175,334925,BUY
10-12-20 13:19,13:19,16894650,17269350,374700,BUY
10-12-20 13:20,13:20,16930375,17246650,316275,BUY
10-12-20 13:21,13:21,16856725,17498225,641500,BUY
10-12-20 13:22,13:22,16905250,17499125,593875,BUY
10-12-20 13:23,13:23,16908750,17424375,515625,BUY
10-12-20 13:24,13:24,16846475,17479200,632725,BUY
10-12-20 13:25,13:25,16797125,17412500,615375,BUY
10-12-20 13:26,13:26,16797125,17416050,618925,BUY
10-12-20 13:27,13:27,16765450,17549350,783900,BUY
10-12-20 13:28,13:28,16750900,17525600,774700,BUY
10-12-20 13:29,13:29,16769875,17489850,719975,BUY
10-12-20 13:30,13:30,16870125,17775050,904925,BUY
10-12-20 13:31,13:31,16972200,17782600,810400,BUY
10-12-20 13:32,13:32,16988950,17782600,793650,BUY
10-12-20 13:33,13:33,16820475,17549625,729150,BUY
10-12-20 13:34,13:34,16827150,17549550,722400,BUY
10-12-20 13:35,13:35,16824100,17514175,690075,BUY
10-12-20 13:36,13:36,16419975,17115525,695550,BUY
10-12-20 13:37,13:37,16390625,17035550,644925,BUY
10-12-20 13:38,13:38,16364325,17121550,757225,BUY
10-12-20 13:39,13:39,16496000,16731675,235675,BUY
10-12-20 13:40,13:40,16505200,16741250,236050,BUY
10-12-20 13:41,13:41,16466750,16741300,274550,BUY
10-12-20 13:42,13:42,16400700,16679175,278475,BUY
10-12-20 13:43,13:43,16415625,16690000,274375,BUY
10-12-20 13:44,13:44,16416100,16596725,180625,BUY
10-12-20 13:45,13:45,16263100,16344500,81400,BUY
10-12-20 13:46,13:46,16246925,16228400,-18525,SELL
10-12-20 13:47,13:47,16251850,16328800,76950,BUY
10-12-20 13:48,13:48,16304350,16531125,226775,BUY
10-12-20 13:49,13:49,16299200,16605600,306400,BUY
10-12-20 13:50,13:50,16328200,16592175,263975,BUY
10-12-20 13:51,13:51,16441100,16919825,478725,BUY
10-12-20 13:52,13:52,16303725,16851700,547975,BUY
10-12-20 13:53,13:53,16413100,16668875,255775,BUY
10-12-20 13:54,13:54,16550750,16924025,373275,BUY
10-12-20 13:55,13:55,16527700,16388525,-139175,SELL
10-12-20 13:56,13:56,16552400,16868600,316200,BUY
10-12-20 13:57,13:57,16435000,16836600,401600,BUY
10-12-20 13:58,13:58,16422175,16739125,316950,BUY
10-12-20 13:59,13:59,16408725,16769925,361200,BUY
10-12-20 14:00,14:00,16365300,16423225,57925,BUY
10-12-20 14:01,14:01,16329775,16309850,-19925,SELL
10-12-20 14:02,14:02,16365200,16331550,-33650,SELL
10-12-20 14:03,14:03,15898650,17009050,1110400,BUY
10-12-20 14:04,14:04,16122525,16991850,869325,BUY
10-12-20 14:05,14:05,16122525,17118325,995800,BUY
10-12-20 14:06,14:06,16010850,17198650,1187800,BUY
10-12-20 14:07,14:07,16099225,17224450,1125225,BUY
10-12-20 14:08,14:08,16102650,17281600,1178950,BUY
10-12-20 14:09,14:09,16181050,17135925,954875,BUY
10-12-20 14:10,14:10,16163825,17305500,1141675,BUY
10-12-20 14:11,14:11,16176550,17248100,1071550,BUY
10-12-20 14:12,14:12,16145975,16997300,851325,BUY
10-12-20 14:13,14:13,16181875,17041525,859650,BUY
10-12-20 14:14,14:14,16174450,17113800,939350,BUY
10-12-20 14:15,14:15,16207900,17125950,918050,BUY
10-12-20 14:16,14:16,16203325,16490200,286875,BUY
10-12-20 14:17,14:17,16190600,17168625,978025,BUY
10-12-20 14:18,14:18,16141725,16955575,813850,BUY
10-12-20 14:19,14:19,16177325,16986000,808675,BUY
10-12-20 14:20,14:20,16199725,16964250,764525,BUY
10-12-20 14:21,14:21,16176900,17081375,904475,BUY
10-12-20 14:22,14:22,16189450,17067175,877725,BUY
10-12-20 14:23,14:23,16145700,17050250,904550,BUY
10-12-20 14:24,14:24,16167125,16610575,443450,BUY
10-12-20 14:25,14:25,16183000,17081150,898150,BUY
10-12-20 14:26,14:26,16203500,17131275,927775,BUY
10-12-20 14:27,14:27,15986275,17332800,1346525,BUY
10-12-20 14:28,14:28,15973175,17315425,1342250,BUY
10-12-20 14:29,14:29,16033825,17293050,1259225,BUY
10-12-20 14:30,14:30,15357450,17354450,1997000,BUY
10-12-20 14:31,14:31,15380275,17373600,1993325,BUY
10-12-20 14:32,14:32,15362850,17370850,2008000,BUY
10-12-20 14:33,14:33,15022350,17489525,2467175,BUY
10-12-20 14:34,14:34,14658425,17481000,2822575,BUY
10-12-20 14:35,14:35,14970025,17438050,2468025,BUY
10-12-20 14:36,14:36,14901825,17277750,2375925,BUY
10-12-20 14:37,14:37,14750175,17366725,2616550,BUY
10-12-20 14:38,14:38,14917425,17315450,2398025,BUY
10-12-20 14:39,14:39,14889700,17385950,2496250,BUY
10-12-20 14:40,14:40,14901825,17463975,2562150,BUY
10-12-20 14:41,14:41,14883125,17402750,2519625,BUY
10-12-20 14:42,14:42,15037125,17507475,2470350,BUY
10-12-20 14:43,14:43,15036225,17617050,2580825,BUY
10-12-20 14:44,14:44,15029400,17585575,2556175,BUY
10-12-20 14:45,14:45,14479125,17482050,3002925,BUY
10-12-20 14:46,14:46,14487300,16956250,2468950,BUY
10-12-20 14:47,14:47,14495575,17417775,2922200,BUY
10-12-20 14:48,14:48,14210175,17306500,3096325,BUY
10-12-20 14:49,14:49,14232700,17335875,3103175,BUY
10-12-20 14:50,14:50,14226500,17306425,3079925,BUY
10-12-20 14:51,14:51,14142950,17286775,3143825,BUY
10-12-20 14:52,14:52,14185875,17306325,3120450,BUY
10-12-20 14:53,14:53,14174875,17306475,3131600,BUY
10-12-20 14:54,14:54,14362300,17258225,2895925,BUY
10-12-20 14:55,14:55,14374025,16685700,2311675,BUY
10-12-20 14:56,14:56,14390500,17259625,2869125,BUY
10-12-20 14:57,14:57,13451075,17165825,3714750,BUY
10-12-20 14:58,14:58,13481675,17163675,3682000,BUY
10-12-20 14:59,14:59,13392125,17185800,3793675,BUY
10-12-20 15:00,15:00,13089075,17071600,3982525,BUY
10-12-20 15:01,15:01,13140900,17048625,3907725,BUY
10-12-20 15:02,15:02,13118300,17046150,3927850,BUY
10-12-20 15:03,15:03,13088725,16299100,3210375,BUY
10-12-20 15:04,15:04,13053075,16745250,3692175,BUY
10-12-20 15:05,15:05,13057200,16902575,3845375,BUY
10-12-20 15:06,15:06,13229675,16984600,3754925,BUY
10-12-20 15:07,15:07,13262825,16980150,3717325,BUY
10-12-20 15:08,15:08,13298450,16980150,3681700,BUY
10-12-20 15:09,15:09,12993800,16883750,3889950,BUY
10-12-20 15:10,15:10,12994300,16910100,3915800,BUY
10-12-20 15:11,15:11,12949350,16908625,3959275,BUY
10-12-20 15:12,15:12,12899275,16709300,3810025,BUY
10-12-20 15:13,15:13,12876975,16611850,3734875,BUY
10-12-20 15:14,15:14,12885675,16619150,3733475,BUY
10-12-20 15:15,15:15,12263125,15957875,3694750,BUY
10-12-20 15:16,15:16,12264725,16061050,3796325,BUY
10-12-20 15:17,15:17,12139575,15663425,3523850,BUY
10-12-20 15:18,15:18,11094475,15222800,4128325,BUY
10-12-20 15:19,15:19,11082550,14618925,3536375,BUY
10-12-20 15:20,15:20,11096450,14723950,3627500,BUY
10-12-20 15:21,15:21,9887575,14060150,4172575,BUY
10-12-20 15:22,15:22,9714000,13925050,4211050,BUY
10-12-20 15:23,15:23,9820175,14045675,4225500,BUY
10-12-20 15:24,15:24,8678450,12915050,4236600,BUY
10-12-20 15:25,15:25,9074450,12873300,3798850,BUY
10-12-20 15:26,15:26,8952900,13376475,4423575,BUY
10-12-20 15:27,15:27,8289825,12537775,4247950,BUY
10-12-20 15:28,15:28,8485450,12499850,4014400,BUY
10-12-20 15:29,15:29,8511925,12044375,3532450,BUY
11-12-20 9:15,9:15,3572675,2979650,-593025,SELL
11-12-20 9:16,9:16,3573825,2975500,-598325,SELL
11-12-20 9:17,9:17,3721225,3134575,-586650,SELL
11-12-20 9:18,9:18,3721150,3142050,-579100,SELL
11-12-20 9:19,9:19,3724175,3122925,-601250,SELL
11-12-20 9:20,9:20,4180875,3605700,-575175,SELL
11-12-20 9:21,9:21,4184400,3616450,-567950,SELL
11-12-20 9:22,9:22,4177275,3612100,-565175,SELL
11-12-20 9:23,9:23,4364400,3954100,-410300,SELL
11-12-20 9:24,9:24,4367950,3947450,-420500,SELL
11-12-20 9:25,9:25,4370050,3958650,-411400,SELL
11-12-20 9:26,9:26,4470925,4188650,-282275,SELL
11-12-20 9:27,9:27,4464825,4186975,-277850,SELL
11-12-20 9:28,9:28,4469575,4186525,-283050,SELL
11-12-20 9:29,9:29,4493450,4411775,-81675,SELL
11-12-20 9:30,9:30,4471950,4415175,-56775,SELL
11-12-20 9:31,9:31,4494550,4412125,-82425,SELL
11-12-20 9:32,9:32,4480700,4715900,235200,BUY
11-12-20 9:33,9:33,4475950,4715175,239225,BUY
11-12-20 9:34,9:34,4479125,4711650,232525,BUY
11-12-20 9:35,9:35,4561200,4996750,435550,BUY
11-12-20 9:36,9:36,4572275,4997550,425275,BUY
11-12-20 9:37,9:37,4559950,4991850,431900,BUY
11-12-20 9:38,9:38,4661425,5192400,530975,BUY
11-12-20 9:39,9:39,4638300,5157000,518700,BUY
11-12-20 9:40,9:40,4647875,5206175,558300,BUY
11-12-20 9:41,9:41,4697650,5263250,565600,BUY
11-12-20 9:42,9:42,4676425,5250150,573725,BUY
11-12-20 9:43,9:43,4696725,5241275,544550,BUY
11-12-20 9:44,9:44,4764100,5310200,546100,BUY
11-12-20 9:45,9:45,4771875,5328400,556525,BUY
11-12-20 9:46,9:46,4795925,5326150,530225,BUY
11-12-20 9:47,9:47,4844275,5356150,511875,BUY
11-12-20 9:48,9:48,4844375,5328775,484400,BUY
11-12-20 9:49,9:49,4853300,5384850,531550,BUY
11-12-20 9:50,9:50,4948200,5443975,495775,BUY
11-12-20 9:51,9:51,4927050,5449600,522550,BUY
11-12-20 9:52,9:52,4905300,5414950,509650,BUY
11-12-20 9:53,9:53,4958125,5530625,572500,BUY
11-12-20 9:54,9:54,4973875,5532225,558350,BUY
11-12-20 9:55,9:55,4950675,5501975,551300,BUY
11-12-20 9:56,9:56,5035775,5549900,514125,BUY
11-12-20 9:57,9:57,5031600,5541675,510075,BUY
11-12-20 9:58,9:58,5035025,5600075,565050,BUY
11-12-20 9:59,9:59,5106150,5645625,539475,BUY
11-12-20 10:00,10:00,5084025,5617525,533500,BUY
11-12-20 10:01,10:01,5134800,5658400,523600,BUY
11-12-20 10:02,10:02,5243050,5667650,424600,BUY
11-12-20 10:03,10:03,5269425,5683900,414475,BUY
11-12-20 10:04,10:04,5239750,5666750,427000,BUY
11-12-20 10:05,10:05,5357625,5724650,367025,BUY
11-12-20 10:06,10:06,5339700,5741850,402150,BUY
11-12-20 10:07,10:07,5374000,5714975,340975,BUY
11-12-20 10:08,10:08,5434400,5779650,345250,BUY
11-12-20 10:09,10:09,5436825,5763500,326675,BUY
11-12-20 10:10,10:10,5460075,5772050,311975,BUY
11-12-20 10:11,10:11,5574625,5878100,303475,BUY
11-12-20 10:12,10:12,5527150,5896975,369825,BUY
11-12-20 10:13,10:13,5527150,5905950,378800,BUY
11-12-20 10:14,10:14,5679050,5922900,243850,BUY
11-12-20 10:15,10:15,5696850,5950000,253150,BUY
11-12-20 10:16,10:16,5667525,5920575,253050,BUY
11-12-20 10:17,10:17,5713800,5981400,267600,BUY
11-12-20 10:18,10:18,5750800,5980925,230125,BUY
11-12-20 10:19,10:19,5749100,5964625,215525,BUY
11-12-20 10:20,10:20,5820175,5970950,150775,BUY
11-12-20 10:21,10:21,5836225,6006500,170275,BUY
11-12-20 10:22,10:22,5834375,5957400,123025,BUY
11-12-20 10:23,10:23,5845650,6042625,196975,BUY
11-12-20 10:24,10:24,5822600,6058075,235475,BUY
11-12-20 10:25,10:25,5819675,6083150,263475,BUY
11-12-20 10:26,10:26,5866050,6081875,215825,BUY
11-12-20 10:27,10:27,5806650,6079625,272975,BUY
11-12-20 10:28,10:28,5860100,6108375,248275,BUY
11-12-20 10:29,10:29,5920300,6147400,227100,BUY
11-12-20 10:30,10:30,5891675,6165775,274100,BUY
11-12-20 10:31,10:31,5944200,6141625,197425,BUY
11-12-20 10:32,10:32,5962175,6262400,300225,BUY
11-12-20 10:33,10:33,5959000,6249375,290375,BUY
11-12-20 10:34,10:34,5982925,6248375,265450,BUY
11-12-20 10:35,10:35,6053675,6303750,250075,BUY
11-12-20 10:36,10:36,6067700,6251725,184025,BUY
11-12-20 10:37,10:37,6073675,6288175,214500,BUY
11-12-20 10:38,10:38,6152675,6368375,215700,BUY
11-12-20 10:39,10:39,6144325,6356525,212200,BUY
11-12-20 10:40,10:40,6158000,6324250,166250,BUY
11-12-20 10:41,10:41,6262475,6406550,144075,BUY
11-12-20 10:42,10:42,6245975,6399300,153325,BUY
11-12-20 10:43,10:43,6258875,6377600,118725,BUY
11-12-20 10:44,10:44,6345400,6439350,93950,BUY
11-12-20 10:45,10:45,6372500,6445075,72575,BUY
11-12-20 10:46,10:46,6348175,6426350,78175,BUY
11-12-20 10:47,10:47,6423200,6397525,-25675,SELL
11-12-20 10:48,10:48,6399275,6433825,34550,BUY
11-12-20 10:49,10:49,6416225,6389150,-27075,SELL
11-12-20 10:50,10:50,6498000,6461325,-36675,SELL
11-12-20 10:51,10:51,6468550,6464575,-3975,SELL
11-12-20 10:52,10:52,6506700,6484275,-22425,SELL
11-12-20 10:53,10:53,6555275,6505550,-49725,SELL
11-12-20 10:54,10:54,6529025,6517550,-11475,SELL
11-12-20 10:55,10:55,6571650,6546400,-25250,SELL
11-12-20 10:56,10:56,6605100,6551000,-54100,SELL
11-12-20 10:57,10:57,6600475,6490175,-110300,SELL
11-12-20 10:58,10:58,6600475,6548825,-51650,SELL
11-12-20 10:59,10:59,6602650,6586375,-16275,SELL
11-12-20 11:00,11:00,6618350,6556300,-62050,SELL
11-12-20 11:01,11:01,6637875,6577275,-60600,SELL
11-12-20 11:02,11:02,6640875,6570000,-70875,SELL
11-12-20 11:03,11:03,6645875,6596325,-49550,SELL
11-12-20 11:04,11:04,6638300,6557525,-80775,SELL
11-12-20 11:05,11:05,6662600,6657975,-4625,SELL
11-12-20 11:06,11:06,6647875,6654550,6675,BUY
11-12-20 11:07,11:07,6628300,6667300,39000,BUY
11-12-20 11:08,11:08,6731175,6600350,-130825,SELL
11-12-20 11:09,11:09,6744025,6619350,-124675,SELL
11-12-20 11:10,11:10,6681800,6626225,-55575,SELL
11-12-20 11:11,11:11,6788500,6635200,-153300,SELL
11-12-20 11:12,11:12,6795425,6710650,-84775,SELL
11-12-20 11:13,11:13,6783575,6681000,-102575,SELL
11-12-20 11:14,11:14,6836900,6757700,-79200,SELL
11-12-20 11:15,11:15,6865950,6764250,-101700,SELL
11-12-20 11:16,11:16,6868100,6737350,-130750,SELL
11-12-20 11:17,11:17,6896500,6763900,-132600,SELL
11-12-20 11:18,11:18,6855925,6769200,-86725,SELL
11-12-20 11:19,11:19,6881175,6728325,-152850,SELL
11-12-20 11:20,11:20,7027225,6750825,-276400,SELL
11-12-20 11:21,11:21,7018550,6672750,-345800,SELL
11-12-20 11:22,11:22,6984225,6712925,-271300,SELL
11-12-20 11:23,11:23,7080950,6772000,-308950,SELL
11-12-20 11:24,11:24,6992600,6730800,-261800,SELL
11-12-20 11:25,11:25,7032525,6776950,-255575,SELL
11-12-20 11:26,11:26,7112200,6768400,-343800,SELL
11-12-20 11:27,11:27,7102250,6778050,-324200,SELL
11-12-20 11:28,11:28,7113575,6747325,-366250,SELL
11-12-20 11:29,11:29,7253900,6656125,-597775,SELL
11-12-20 11:30,11:30,7257650,6657075,-600575,SELL
11-12-20 11:31,11:31,7241475,6637675,-603800,SELL
11-12-20 11:32,11:32,7393475,6664875,-728600,SELL
11-12-20 11:33,11:33,7411900,6656475,-755425,SELL
11-12-20 11:34,11:34,7376575,6656475,-720100,SELL
11-12-20 11:35,11:35,7580850,6688550,-892300,SELL
11-12-20 11:36,11:36,7587175,6700575,-886600,SELL
11-12-20 11:37,11:37,7586650,6707450,-879200,SELL
11-12-20 11:38,11:38,7654050,6800475,-853575,SELL
11-12-20 11:39,11:39,7646525,6777300,-869225,SELL
11-12-20 11:40,11:40,7683075,6797650,-885425,SELL
11-12-20 11:41,11:41,7791525,6822250,-969275,SELL
11-12-20 11:42,11:42,7767100,6819775,-947325,SELL
11-12-20 11:43,11:43,7790475,6817400,-973075,SELL
11-12-20 11:44,11:44,7789250,6871125,-918125,SELL
11-12-20 11:45,11:45,7790100,6862600,-927500,SELL
11-12-20 11:46,11:46,7816350,6876425,-939925,SELL
11-12-20 11:47,11:47,7870450,6913750,-956700,SELL
11-12-20 11:48,11:48,7864875,6903800,-961075,SELL
11-12-20 11:49,11:49,7841625,6921925,-919700,SELL
11-12-20 11:50,11:50,7908950,6977900,-931050,SELL
11-12-20 11:51,11:51,7929975,6985725,-944250,SELL
11-12-20 11:52,11:52,7900150,6982625,-917525,SELL
11-12-20 11:53,11:53,7985025,7001550,-983475,SELL
11-12-20 11:54,11:54,7974725,7045475,-929250,SELL
11-12-20 11:55,11:55,7980450,7068150,-912300,SELL
11-12-20 11:56,11:56,7972775,7023450,-949325,SELL
11-12-20 11:57,11:57,7958750,7058275,-900475,SELL
11-12-20 11:58,11:58,7946450,7053575,-892875,SELL
11-12-20 11:59,11:59,7870675,7025175,-845500,SELL
11-12-20 12:00,12:00,7885625,7028475,-857150,SELL
11-12-20 12:01,12:01,7862450,7003250,-859200,SELL
11-12-20 12:02,12:02,7910425,7092050,-818375,SELL
11-12-20 12:03,12:03,7899400,7010275,-889125,SELL
11-12-20 12:04,12:04,7900200,7093125,-807075,SELL
11-12-20 12:05,12:05,7925725,7037700,-888025,SELL
11-12-20 12:06,12:06,7927400,7096125,-831275,SELL
11-12-20 12:07,12:07,7921675,7094500,-827175,SELL
11-12-20 12:08,12:08,7939525,7092625,-846900,SELL
11-12-20 12:09,12:09,7978050,7087150,-890900,SELL
11-12-20 12:10,12:10,7955075,7114425,-840650,SELL
11-12-20 12:11,12:11,7938750,7073400,-865350,SELL
11-12-20 12:12,12:12,7942375,7095100,-847275,SELL
11-12-20 12:13,12:13,7961200,7097750,-863450,SELL
11-12-20 12:14,12:14,7966400,7126925,-839475,SELL
11-12-20 12:15,12:15,8009875,7158725,-851150,SELL
11-12-20 12:16,12:16,7953350,7156725,-796625,SELL
11-12-20 12:17,12:17,7941000,7170600,-770400,SELL
11-12-20 12:18,12:18,7967775,7133900,-833875,SELL
11-12-20 12:19,12:19,7943500,7143050,-800450,SELL
11-12-20 12:20,12:20,7992300,7138800,-853500,SELL
11-12-20 12:21,12:21,7992975,7125525,-867450,SELL
11-12-20 12:22,12:22,7984600,6876700,-1107900,SELL
11-12-20 12:23,12:23,8026150,7166825,-859325,SELL
11-12-20 12:24,12:24,8020125,7098800,-921325,SELL
11-12-20 12:25,12:25,8064200,7194025,-870175,SELL
11-12-20 12:26,12:26,8030800,7243675,-787125,SELL
11-12-20 12:27,12:27,8018550,7143250,-875300,SELL
11-12-20 12:28,12:28,8033525,7148225,-885300,SELL
11-12-20 12:29,12:29,8031975,7125200,-906775,SELL
11-12-20 12:30,12:30,8050775,7168300,-882475,SELL
11-12-20 12:31,12:31,8033375,7142550,-890825,SELL
11-12-20 12:32,12:32,8037675,7295475,-742200,SELL
11-12-20 12:33,12:33,7985375,7279200,-706175,SELL
11-12-20 12:34,12:34,7976275,7241025,-735250,SELL
11-12-20 12:35,12:35,8011025,7244700,-766325,SELL
11-12-20 12:36,12:36,7973675,7176800,-796875,SELL
11-12-20 12:37,12:37,7987200,7151325,-835875,SELL
11-12-20 12:38,12:38,7979550,7175400,-804150,SELL
11-12-20 12:39,12:39,7966650,7165975,-800675,SELL
11-12-20 12:40,12:40,8034075,7262425,-771650,SELL
11-12-20 12:41,12:41,8002300,7281025,-721275,SELL
11-12-20 12:42,12:42,7947800,7254725,-693075,SELL
11-12-20 12:43,12:43,7974375,7272975,-701400,SELL
11-12-20 12:44,12:44,7947900,7274850,-673050,SELL
11-12-20 12:45,12:45,7923800,7236850,-686950,SELL
11-12-20 12:46,12:46,7954850,7234800,-720050,SELL
11-12-20 12:47,12:47,7923800,7245975,-677825,SELL
11-12-20 12:48,12:48,7862525,7165075,-697450,SELL
11-12-20 12:49,12:49,7910100,7169875,-740225,SELL
11-12-20 12:50,12:50,7887850,7112175,-775675,SELL
11-12-20 12:51,12:51,7838325,7052900,-785425,SELL
11-12-20 12:52,12:52,7833875,7076175,-757700,SELL
11-12-20 12:53,12:53,7833875,7048575,-785300,SELL
11-12-20 12:54,12:54,7873325,7064050,-809275,SELL
11-12-20 12:55,12:55,7887900,7090000,-797900,SELL
11-12-20 12:56,12:56,7879100,7087100,-792000,SELL
11-12-20 12:57,12:57,7856950,7172525,-684425,SELL
11-12-20 12:58,12:58,7839500,7093200,-746300,SELL
11-12-20 12:59,12:59,7832225,7126200,-706025,SELL
11-12-20 13:00,13:00,7843025,7157350,-685675,SELL
11-12-20 13:01,13:01,7831550,7130750,-700800,SELL
11-12-20 13:02,13:02,7824200,7172800,-651400,SELL
11-12-20 13:03,13:03,7845175,7146500,-698675,SELL
11-12-20 13:04,13:04,7820300,7116000,-704300,SELL
11-12-20 13:05,13:05,7848175,7151325,-696850,SELL
11-12-20 13:06,13:06,7887150,7115150,-772000,SELL
11-12-20 13:07,13:07,7822925,7095625,-727300,SELL
11-12-20 13:08,13:08,7879025,7123525,-755500,SELL
11-12-20 13:09,13:09,7912350,7223750,-688600,SELL
11-12-20 13:10,13:10,7868050,7220450,-647600,SELL
11-12-20 13:11,13:11,7892750,7200625,-692125,SELL
11-12-20 13:12,13:12,7907550,7215675,-691875,SELL
11-12-20 13:13,13:13,7938700,7219100,-719600,SELL
11-12-20 13:14,13:14,7887575,7211500,-676075,SELL
11-12-20 13:15,13:15,8010875,7279950,-730925,SELL
11-12-20 13:16,13:16,7973875,7271850,-702025,SELL
11-12-20 13:17,13:17,7992550,7263325,-729225,SELL
11-12-20 13:18,13:18,8007700,7245450,-762250,SELL
11-12-20 13:19,13:19,7984650,7228450,-756200,SELL
11-12-20 13:20,13:20,8011975,7281950,-730025,SELL
11-12-20 13:21,13:21,8020350,7308725,-711625,SELL
11-12-20 13:22,13:22,8020350,7278825,-741525,SELL
11-12-20 13:23,13:23,8020675,7267125,-753550,SELL
11-12-20 13:24,13:24,8083925,7283525,-800400,SELL
11-12-20 13:25,13:25,8065950,7249650,-816300,SELL
11-12-20 13:26,13:26,8102625,7342900,-759725,SELL
11-12-20 13:27,13:27,8212800,7389625,-823175,SELL
11-12-20 13:28,13:28,8207000,7390275,-816725,SELL
11-12-20 13:29,13:29,8213575,7373650,-839925,SELL
11-12-20 13:30,13:30,8234000,7300400,-933600,SELL
11-12-20 13:31,13:31,8206975,7284150,-922825,SELL
11-12-20 13:32,13:32,8203750,7275000,-928750,SELL
11-12-20 13:33,13:33,8229425,7289725,-939700,SELL
11-12-20 13:34,13:34,8229675,7279350,-950325,SELL
11-12-20 13:35,13:35,8222825,7270475,-952350,SELL
11-12-20 13:36,13:36,8280475,7344950,-935525,SELL
11-12-20 13:37,13:37,8278250,7309850,-968400,SELL
11-12-20 13:38,13:38,8252575,7311625,-940950,SELL
11-12-20 13:39,13:39,8239675,7334775,-904900,SELL
11-12-20 13:40,13:40,8306425,7315375,-991050,SELL
11-12-20 13:41,13:41,8283375,7270950,-1012425,SELL
11-12-20 13:42,13:42,8326150,7344375,-981775,SELL
11-12-20 13:43,13:43,8309925,7347500,-962425,SELL
11-12-20 13:44,13:44,8300600,7356200,-944400,SELL
11-12-20 13:45,13:45,8380900,7417225,-963675,SELL
11-12-20 13:46,13:46,8350725,7417200,-933525,SELL
11-12-20 13:47,13:47,8365500,7431925,-933575,SELL
11-12-20 13:48,13:48,8369775,7430150,-939625,SELL
11-12-20 13:49,13:49,8363400,7438850,-924550,SELL
11-12-20 13:50,13:50,8363400,7453825,-909575,SELL
11-12-20 13:51,13:51,8435775,7500725,-935050,SELL
11-12-20 13:52,13:52,8400050,7498575,-901475,SELL
11-12-20 13:53,13:53,8408750,7500250,-908500,SELL
11-12-20 13:54,13:54,8500700,7500500,-1000200,SELL
11-12-20 13:55,13:55,8530025,7512475,-1017550,SELL
11-12-20 13:56,13:56,8504525,7513675,-990850,SELL
11-12-20 13:57,13:57,8577050,7516850,-1060200,SELL
11-12-20 13:58,13:58,8581900,7518725,-1063175,SELL
11-12-20 13:59,13:59,8572800,7511150,-1061650,SELL
11-12-20 14:00,14:00,8600600,7325250,-1275350,SELL
11-12-20 14:01,14:01,8591500,7324650,-1266850,SELL
11-12-20 14:02,14:02,8596400,7310100,-1286300,SELL
11-12-20 14:03,14:03,8666500,7153850,-1512650,SELL
11-12-20 14:04,14:04,8661750,7159925,-1501825,SELL
11-12-20 14:05,14:05,8645125,7160625,-1484500,SELL
11-12-20 14:06,14:06,8780700,7155975,-1624725,SELL
11-12-20 14:07,14:07,8779050,7152400,-1626650,SELL
11-12-20 14:08,14:08,8755200,7165425,-1589775,SELL
11-12-20 14:09,14:09,8849600,7185000,-1664600,SELL
11-12-20 14:10,14:10,8839825,7165900,-1673925,SELL
11-12-20 14:11,14:11,8849725,7180725,-1669000,SELL
11-12-20 14:12,14:12,8974350,7185625,-1788725,SELL
11-12-20 14:13,14:13,8976600,7193250,-1783350,SELL
11-12-20 14:14,14:14,8938050,7182125,-1755925,SELL
11-12-20 14:15,14:15,8806500,7088200,-1718300,SELL
11-12-20 14:16,14:16,8784075,7078000,-1706075,SELL
11-12-20 14:17,14:17,8779900,7059800,-1720100,SELL
11-12-20 14:18,14:18,8713525,7021200,-1692325,SELL
11-12-20 14:19,14:19,8734675,7027350,-1707325,SELL
11-12-20 14:20,14:20,8725375,7025775,-1699600,SELL
11-12-20 14:21,14:21,8725125,6999675,-1725450,SELL
11-12-20 14:22,14:22,8701750,6953475,-1748275,SELL
11-12-20 14:23,14:23,8725675,7009800,-1715875,SELL
11-12-20 14:24,14:24,8689525,6948175,-1741350,SELL
11-12-20 14:25,14:25,8711150,6970250,-1740900,SELL
11-12-20 14:26,14:26,8703250,6982275,-1720975,SELL
11-12-20 14:27,14:27,8727325,6993450,-1733875,SELL
11-12-20 14:28,14:28,8734550,6997825,-1736725,SELL
11-12-20 14:29,14:29,8696275,6975525,-1720750,SELL
11-12-20 14:30,14:30,8795200,7016825,-1778375,SELL
11-12-20 14:31,14:31,8785700,7017525,-1768175,SELL
11-12-20 14:32,14:32,8794875,6998225,-1796650,SELL
11-12-20 14:33,14:33,8780300,7002675,-1777625,SELL
11-12-20 14:34,14:34,8781125,6980675,-1800450,SELL
11-12-20 14:35,14:35,8789850,7021925,-1767925,SELL
11-12-20 14:36,14:36,8645650,7009150,-1636500,SELL
11-12-20 14:37,14:37,8641175,7013525,-1627650,SELL
11-12-20 14:38,14:38,8631700,6999225,-1632475,SELL
11-12-20 14:39,14:39,8645150,7002800,-1642350,SELL
11-12-20 14:40,14:40,8645325,6992550,-1652775,SELL
11-12-20 14:41,14:41,8645150,7005375,-1639775,SELL
11-12-20 14:42,14:42,8659750,7040575,-1619175,SELL
11-12-20 14:43,14:43,8677350,7029950,-1647400,SELL
11-12-20 14:44,14:44,8659750,7021550,-1638200,SELL
11-12-20 14:45,14:45,8666575,7037150,-1629425,SELL
11-12-20 14:46,14:46,8649150,7016100,-1633050,SELL
11-12-20 14:47,14:47,8672525,7062000,-1610525,SELL
11-12-20 14:48,14:48,8619400,7054375,-1565025,SELL
11-12-20 14:49,14:49,8620675,7064250,-1556425,SELL
11-12-20 14:50,14:50,8652100,7072750,-1579350,SELL
11-12-20 14:51,14:51,8600225,7028100,-1572125,SELL
11-12-20 14:52,14:52,8616725,7025275,-1591450,SELL
11-12-20 14:53,14:53,8605000,7002300,-1602700,SELL
11-12-20 14:54,14:54,8577875,7023250,-1554625,SELL
11-12-20 14:55,14:55,8595475,7011600,-1583875,SELL
11-12-20 14:56,14:56,8579975,6996600,-1583375,SELL
11-12-20 14:57,14:57,8598975,6972975,-1626000,SELL
11-12-20 14:58,14:58,8599025,6992925,-1606100,SELL
11-12-20 14:59,14:59,8592025,6973075,-1618950,SELL
11-12-20 15:00,15:00,8569125,6966050,-1603075,SELL
11-12-20 15:01,15:01,8542150,6978925,-1563225,SELL
11-12-20 15:02,15:02,8563975,6967325,-1596650,SELL
11-12-20 15:03,15:03,8521550,6963125,-1558425,SELL
11-12-20 15:04,15:04,8526275,6975550,-1550725,SELL
11-12-20 15:05,15:05,8526275,6954300,-1571975,SELL
11-12-20 15:06,15:06,8405425,6917750,-1487675,SELL
11-12-20 15:07,15:07,8435050,6894450,-1540600,SELL
11-12-20 15:08,15:08,8409550,6891350,-1518200,SELL
11-12-20 15:09,15:09,8402175,6908550,-1493625,SELL
11-12-20 15:10,15:10,8395500,6914225,-1481275,SELL
11-12-20 15:11,15:11,8389175,6899975,-1489200,SELL
11-12-20 15:12,15:12,8216150,6938100,-1278050,SELL
11-12-20 15:13,15:13,8250775,6954275,-1296500,SELL
11-12-20 15:14,15:14,8235500,6949725,-1285775,SELL
11-12-20 15:15,15:15,7968675,7083350,-885325,SELL
11-12-20 15:16,15:16,7977225,7083175,-894050,SELL
11-12-20 15:17,15:17,7982100,7091525,-890575,SELL
11-12-20 15:18,15:18,7836800,7079150,-757650,SELL
11-12-20 15:19,15:19,7847525,7083525,-764000,SELL
11-12-20 15:20,15:20,7834250,7096350,-737900,SELL
11-12-20 15:21,15:21,7621475,7126925,-494550,SELL
11-12-20 15:22,15:22,7636375,7115725,-520650,SELL
11-12-20 15:23,15:23,7622800,7116800,-506000,SELL
11-12-20 15:24,15:24,7518875,7118375,-400500,SELL
11-12-20 15:25,15:25,7551575,7145075,-406500,SELL
11-12-20 15:26,15:26,7496400,7134525,-361875,SELL
11-12-20 15:27,15:27,7382150,7099600,-282550,SELL
11-12-20 15:28,15:28,7386575,7094675,-291900,SELL
11-12-20 15:29,15:29,7402275,7105550,-296725,SELL
14-12-20 9:15,9:15,7011725,6965950,-45775,SELL
14-12-20 9:16,9:16,7022600,6964450,-58150,SELL
14-12-20 9:17,9:17,7146225,7045400,-100825,SELL
14-12-20 9:18,9:18,7119900,7042850,-77050,SELL
14-12-20 9:19,9:19,7150075,7063025,-87050,SELL
14-12-20 9:20,9:20,7544100,7526625,-17475,SELL
14-12-20 9:21,9:21,7552650,7535100,-17550,SELL
14-12-20 9:22,9:22,7529825,7533850,4025,BUY
14-12-20 9:23,9:23,7776650,7834350,57700,BUY
14-12-20 9:24,9:24,7782600,7843100,60500,BUY
14-12-20 9:25,9:25,7782600,7832175,49575,BUY
14-12-20 9:26,9:26,7930725,7986750,56025,BUY
14-12-20 9:27,9:27,7921200,7980900,59700,BUY
14-12-20 9:28,9:28,7907950,7955825,47875,BUY
14-12-20 9:29,9:29,7985225,8000750,15525,BUY
14-12-20 9:30,9:30,7981450,8000975,19525,BUY
14-12-20 9:31,9:31,7971050,7997575,26525,BUY
14-12-20 9:32,9:32,8152525,8058925,-93600,SELL
14-12-20 9:33,9:33,8158400,8070675,-87725,SELL
14-12-20 9:34,9:34,8136550,8066100,-70450,SELL
14-12-20 9:35,9:35,8241575,8067975,-173600,SELL
14-12-20 9:36,9:36,8248375,8112325,-136050,SELL
14-12-20 9:37,9:37,8242750,8110425,-132325,SELL
14-12-20 9:38,9:38,8242375,8170375,-72000,SELL
14-12-20 9:39,9:39,8264625,8182275,-82350,SELL
14-12-20 9:40,9:40,8235100,8172650,-62450,SELL
14-12-20 9:41,9:41,8197600,8296350,98750,BUY
14-12-20 9:42,9:42,8192725,8305725,113000,BUY
14-12-20 9:43,9:43,8187925,8286625,98700,BUY
14-12-20 9:44,9:44,8237525,8417775,180250,BUY
14-12-20 9:45,9:45,8246350,8421800,175450,BUY
14-12-20 9:46,9:46,8268775,8405125,136350,BUY
14-12-20 9:47,9:47,8287250,8493450,206200,BUY
14-12-20 9:48,9:48,8216725,8461700,244975,BUY
14-12-20 9:49,9:49,8295200,8494925,199725,BUY
14-12-20 9:50,9:50,8418475,8478150,59675,BUY
14-12-20 9:51,9:51,8381100,8447775,66675,BUY
14-12-20 9:52,9:52,8394750,8517200,122450,BUY
14-12-20 9:53,9:53,8388950,8557950,169000,BUY
14-12-20 9:54,9:54,8412500,8549725,137225,BUY
14-12-20 9:55,9:55,8422325,8563975,141650,BUY
14-12-20 9:56,9:56,8529225,8602225,73000,BUY
14-12-20 9:57,9:57,8558075,8536175,-21900,SELL
14-12-20 9:58,9:58,8553900,8598650,44750,BUY
14-12-20 9:59,9:59,8623250,8651650,28400,BUY
14-12-20 10:00,10:00,8662775,8626575,-36200,SELL
14-12-20 10:01,10:01,8642275,8597675,-44600,SELL
14-12-20 10:02,10:02,8693550,8665600,-27950,SELL
14-12-20 10:03,10:03,8692875,8687550,-5325,SELL
14-12-20 10:04,10:04,8726900,8686850,-40050,SELL
14-12-20 10:05,10:05,8758425,8701050,-57375,SELL
14-12-20 10:06,10:06,8788625,8751475,-37150,SELL
14-12-20 10:07,10:07,8762075,8730975,-31100,SELL
14-12-20 10:08,10:08,8824700,8766900,-57800,SELL
14-12-20 10:09,10:09,8821325,8706850,-114475,SELL
14-12-20 10:10,10:10,8802075,8779100,-22975,SELL
14-12-20 10:11,10:11,8854950,8763125,-91825,SELL
14-12-20 10:12,10:12,8904675,8837925,-66750,SELL
14-12-20 10:13,10:13,8646400,8854375,207975,BUY
14-12-20 10:14,10:14,8924950,8838325,-86625,SELL
14-12-20 10:15,10:15,8891300,8836725,-54575,SELL
14-12-20 10:16,10:16,8911225,8778875,-132350,SELL
14-12-20 10:17,10:17,8949425,8893550,-55875,SELL
14-12-20 10:18,10:18,8994875,8883050,-111825,SELL
14-12-20 10:19,10:19,8950525,8849925,-100600,SELL
14-12-20 10:20,10:20,9071600,8912925,-158675,SELL
14-12-20 10:21,10:21,9085200,8909350,-175850,SELL
14-12-20 10:22,10:22,9086125,8926825,-159300,SELL
14-12-20 10:23,10:23,9022975,8971775,-51200,SELL
14-12-20 10:24,10:24,9018575,8971725,-46850,SELL
14-12-20 10:25,10:25,9004350,8945150,-59200,SELL
14-12-20 10:26,10:26,9004000,8988950,-15050,SELL
14-12-20 10:27,10:27,8964350,9022925,58575,BUY
14-12-20 10:28,10:28,8938200,9044300,106100,BUY
14-12-20 10:29,10:29,9010325,9117425,107100,BUY
14-12-20 10:30,10:30,9001275,9096650,95375,BUY
14-12-20 10:31,10:31,8979425,9099050,119625,BUY
14-12-20 10:32,10:32,9039925,9123650,83725,BUY
14-12-20 10:33,10:33,9065050,9118175,53125,BUY
14-12-20 10:34,10:34,9056725,9143750,87025,BUY
14-12-20 10:35,10:35,9063075,9210425,147350,BUY
14-12-20 10:36,10:36,9070925,9239675,168750,BUY
14-12-20 10:37,10:37,9075375,9205125,129750,BUY
14-12-20 10:38,10:38,9103000,9239200,136200,BUY
14-12-20 10:39,10:39,9095625,9270925,175300,BUY
14-12-20 10:40,10:40,9130750,9274775,144025,BUY
14-12-20 10:41,10:41,9145600,9338825,193225,BUY
14-12-20 10:42,10:42,9147025,9020375,-126650,SELL
14-12-20 10:43,10:43,9026400,8946500,-79900,SELL
14-12-20 10:44,10:44,9119500,9304600,185100,BUY
14-12-20 10:45,10:45,9157525,9345100,187575,BUY
14-12-20 10:46,10:46,9139875,9272825,132950,BUY
14-12-20 10:47,10:47,9140075,9342450,202375,BUY
14-12-20 10:48,10:48,9144625,9275350,130725,BUY
14-12-20 10:49,10:49,9139950,9336275,196325,BUY
14-12-20 10:50,10:50,9221600,9356850,135250,BUY
14-12-20 10:51,10:51,9186675,9268550,81875,BUY
14-12-20 10:52,10:52,9187225,9303700,116475,BUY
14-12-20 10:53,10:53,9222675,9344500,121825,BUY
14-12-20 10:54,10:54,9236575,9330400,93825,BUY
14-12-20 10:55,10:55,9231725,9414550,182825,BUY
14-12-20 10:56,10:56,9218225,9331400,113175,BUY
14-12-20 10:57,10:57,9246675,9327950,81275,BUY
14-12-20 10:58,10:58,9240175,9309300,69125,BUY
14-12-20 10:59,10:59,9326600,9476825,150225,BUY
14-12-20 11:00,11:00,9281925,9331350,49425,BUY
14-12-20 11:01,11:01,9312325,9362250,49925,BUY
14-12-20 11:02,11:02,9418500,9463950,45450,BUY
14-12-20 11:03,11:03,9409275,9405875,-3400,SELL
14-12-20 11:04,11:04,9420450,9484250,63800,BUY
14-12-20 11:05,11:05,9542550,9463150,-79400,SELL
14-12-20 11:06,11:06,9551250,9421875,-129375,SELL
14-12-20 11:07,11:07,9510725,9449050,-61675,SELL
14-12-20 11:08,11:08,9561650,9450375,-111275,SELL
14-12-20 11:09,11:09,9571350,9434850,-136500,SELL
14-12-20 11:10,11:10,9572325,9437375,-134950,SELL
14-12-20 11:11,11:11,9666100,9492575,-173525,SELL
14-12-20 11:12,11:12,9670925,9521175,-149750,SELL
14-12-20 11:13,11:13,9664900,9399875,-265025,SELL
14-12-20 11:14,11:14,9732150,9427400,-304750,SELL
14-12-20 11:15,11:15,9750625,9487125,-263500,SELL
14-12-20 11:16,11:16,9741125,9463325,-277800,SELL
14-12-20 11:17,11:17,9766000,9376525,-389475,SELL
14-12-20 11:18,11:18,9757200,9457925,-299275,SELL
14-12-20 11:19,11:19,9749075,9415225,-333850,SELL
14-12-20 11:20,11:20,9794050,9500325,-293725,SELL
14-12-20 11:21,11:21,9821850,9536875,-284975,SELL
14-12-20 11:22,11:22,9754200,9458325,-295875,SELL
14-12-20 11:23,11:23,9815900,9500450,-315450,SELL
14-12-20 11:24,11:24,9849650,9458000,-391650,SELL
14-12-20 11:25,11:25,9824975,9567075,-257900,SELL
14-12-20 11:26,11:26,9834525,9570500,-264025,SELL
14-12-20 11:27,11:27,9819500,9592075,-227425,SELL
14-12-20 11:28,11:28,9603100,9538675,-64425,SELL
14-12-20 11:29,11:29,9878000,9543525,-334475,SELL
14-12-20 11:30,11:30,9863400,9560575,-302825,SELL
14-12-20 11:31,11:31,9929650,9538025,-391625,SELL
14-12-20 11:32,11:32,9899575,9553275,-346300,SELL
14-12-20 11:33,11:33,9954100,9654450,-299650,SELL
14-12-20 11:34,11:34,9896125,9633625,-262500,SELL
14-12-20 11:35,11:35,9855625,9636100,-219525,SELL
14-12-20 11:36,11:36,9861775,9590800,-270975,SELL
14-12-20 11:37,11:37,9865325,9562125,-303200,SELL
14-12-20 11:38,11:38,9863675,9620150,-243525,SELL
14-12-20 11:39,11:39,9857675,9612725,-244950,SELL
14-12-20 11:40,11:40,9872000,9579250,-292750,SELL
14-12-20 11:41,11:41,9846725,9535800,-310925,SELL
14-12-20 11:42,11:42,9847425,9544425,-303000,SELL
14-12-20 11:43,11:43,9905325,9658250,-247075,SELL
14-12-20 11:44,11:44,9854425,9550250,-304175,SELL
14-12-20 11:45,11:45,9899425,9672225,-227200,SELL
14-12-20 11:46,11:46,9891425,9655100,-236325,SELL
14-12-20 11:47,11:47,9926900,9613900,-313000,SELL
14-12-20 11:48,11:48,9900450,9564650,-335800,SELL
14-12-20 11:49,11:49,9919850,9740425,-179425,SELL
14-12-20 11:50,11:50,9945650,9566950,-378700,SELL
14-12-20 11:51,11:51,9952975,9686050,-266925,SELL
14-12-20 11:52,11:52,9945700,9662875,-282825,SELL
14-12-20 11:53,11:53,9950425,9645825,-304600,SELL
14-12-20 11:54,11:54,10030075,9668750,-361325,SELL
14-12-20 11:55,11:55,10008250,9745850,-262400,SELL
14-12-20 11:56,11:56,10000575,9634900,-365675,SELL
14-12-20 11:57,11:57,9965775,9668300,-297475,SELL
14-12-20 11:58,11:58,9973825,9687900,-285925,SELL
14-12-20 11:59,11:59,9939575,9596750,-342825,SELL
14-12-20 12:00,12:00,10041000,9366200,-674800,SELL
14-12-20 12:01,12:01,10027700,9751250,-276450,SELL
14-12-20 12:02,12:02,9968425,9722850,-245575,SELL
14-12-20 12:03,12:03,10036200,9727875,-308325,SELL
14-12-20 12:04,12:04,10062700,9784150,-278550,SELL
14-12-20 12:05,12:05,9994375,9727875,-266500,SELL
14-12-20 12:06,12:06,10059400,9462550,-596850,SELL
14-12-20 12:07,12:07,10061100,9758525,-302575,SELL
14-12-20 12:08,12:08,10098275,9818650,-279625,SELL
14-12-20 12:09,12:09,10022675,9825375,-197300,SELL
14-12-20 12:10,12:10,10065375,9775000,-290375,SELL
14-12-20 12:11,12:11,10073550,9851725,-221825,SELL
14-12-20 12:12,12:12,10059100,9943025,-116075,SELL
14-12-20 12:13,12:13,10006125,9927375,-78750,SELL
14-12-20 12:14,12:14,10011875,9908975,-102900,SELL
14-12-20 12:15,12:15,10097275,9946750,-150525,SELL
14-12-20 12:16,12:16,10036250,9896300,-139950,SELL
14-12-20 12:17,12:17,10036950,9935250,-101700,SELL
14-12-20 12:18,12:18,10067575,9984925,-82650,SELL
14-12-20 12:19,12:19,10060900,10022500,-38400,SELL
14-12-20 12:20,12:20,10067900,9952725,-115175,SELL
14-12-20 12:21,12:21,10062225,10027650,-34575,SELL
14-12-20 12:22,12:22,10046425,10008100,-38325,SELL
14-12-20 12:23,12:23,10066550,10039575,-26975,SELL
14-12-20 12:24,12:24,10063800,9990100,-73700,SELL
14-12-20 12:25,12:25,10058650,9992225,-66425,SELL
14-12-20 12:26,12:26,10053925,10038725,-15200,SELL
14-12-20 12:27,12:27,10073400,10037450,-35950,SELL
14-12-20 12:28,12:28,10059175,10007225,-51950,SELL
14-12-20 12:29,12:29,10086950,10017900,-69050,SELL
14-12-20 12:30,12:30,10097975,10075600,-22375,SELL
14-12-20 12:31,12:31,10124375,10103475,-20900,SELL
14-12-20 12:32,12:32,10111050,10036000,-75050,SELL
14-12-20 12:33,12:33,10080675,10090000,9325,BUY
14-12-20 12:34,12:34,10071600,10100575,28975,BUY
14-12-20 12:35,12:35,10081075,10104725,23650,BUY
14-12-20 12:36,12:36,10135350,10113550,-21800,SELL
14-12-20 12:37,12:37,10081450,10022475,-58975,SELL
14-12-20 12:38,12:38,10075000,10035750,-39250,SELL
14-12-20 12:39,12:39,10048950,10023475,-25475,SELL
14-12-20 12:40,12:40,10053825,10003950,-49875,SELL
14-12-20 12:41,12:41,10050650,9849775,-200875,SELL
14-12-20 12:42,12:42,10055850,9950375,-105475,SELL
14-12-20 12:43,12:43,10034325,9917975,-116350,SELL
14-12-20 12:44,12:44,10073575,10027250,-46325,SELL
14-12-20 12:45,12:45,10059950,9998600,-61350,SELL
14-12-20 12:46,12:46,10077650,9621600,-456050,SELL
14-12-20 12:47,12:47,10072550,10076850,4300,BUY
14-12-20 12:48,12:48,10082975,10112925,29950,BUY
14-12-20 12:49,12:49,10056175,10098025,41850,BUY
14-12-20 12:50,12:50,9901200,9890075,-11125,SELL
14-12-20 12:51,12:51,10089250,10134550,45300,BUY
14-12-20 12:52,12:52,10140850,10117100,-23750,SELL
14-12-20 12:53,12:53,10105175,10106325,1150,BUY
14-12-20 12:54,12:54,10153975,10133150,-20825,SELL
14-12-20 12:55,12:55,10210125,10182425,-27700,SELL
14-12-20 12:56,12:56,10184575,10180225,-4350,SELL
14-12-20 12:57,12:57,10128050,9925625,-202425,SELL
14-12-20 12:58,12:58,10142825,9921800,-221025,SELL
14-12-20 12:59,12:59,10154200,9857400,-296800,SELL
14-12-20 13:00,13:00,10180425,9965550,-214875,SELL
14-12-20 13:01,13:01,10165425,9904025,-261400,SELL
14-12-20 13:02,13:02,10186725,9896700,-290025,SELL
14-12-20 13:03,13:03,10181450,9971100,-210350,SELL
14-12-20 13:04,13:04,10177775,9867100,-310675,SELL
14-12-20 13:05,13:05,10170825,10018750,-152075,SELL
14-12-20 13:06,13:06,10225675,10016175,-209500,SELL
14-12-20 13:07,13:07,10199650,9962400,-237250,SELL
14-12-20 13:08,13:08,10234975,10023550,-211425,SELL
14-12-20 13:09,13:09,10024025,10020475,-3550,SELL
14-12-20 13:10,13:10,10041700,9975775,-65925,SELL
14-12-20 13:11,13:11,10046450,9977775,-68675,SELL
14-12-20 13:12,13:12,9993100,10003625,10525,BUY
14-12-20 13:13,13:13,10018650,10045825,27175,BUY
14-12-20 13:14,13:14,10046825,10054175,7350,BUY
14-12-20 13:15,13:15,9924150,10098600,174450,BUY
14-12-20 13:16,13:16,9890150,10075550,185400,BUY
14-12-20 13:17,13:17,9911525,10050000,138475,BUY
14-12-20 13:18,13:18,9912150,10024400,112250,BUY
14-12-20 13:19,13:19,9877675,10067450,189775,BUY
14-12-20 13:20,13:20,9876700,10085200,208500,BUY
14-12-20 13:21,13:21,9899250,10102600,203350,BUY
14-12-20 13:22,13:22,9919075,10115675,196600,BUY
14-12-20 13:23,13:23,9906075,10050650,144575,BUY
14-12-20 13:24,13:24,9944300,10084225,139925,BUY
14-12-20 13:25,13:25,9947400,10098275,150875,BUY
14-12-20 13:26,13:26,9888950,10080550,191600,BUY
14-12-20 13:27,13:27,9937175,10145000,207825,BUY
14-12-20 13:28,13:28,9934225,9775975,-158250,SELL
14-12-20 13:29,13:29,9932000,10067325,135325,BUY
14-12-20 13:30,13:30,10000200,10171675,171475,BUY
14-12-20 13:31,13:31,10027100,10239275,212175,BUY
14-12-20 13:32,13:32,10006225,10126650,120425,BUY
14-12-20 13:33,13:33,9880825,10084000,203175,BUY
14-12-20 13:34,13:34,9908675,10146800,238125,BUY
14-12-20 13:35,13:35,9895400,10074375,178975,BUY
14-12-20 13:36,13:36,9893675,10088975,195300,BUY
14-12-20 13:37,13:37,9863450,10025775,162325,BUY
14-12-20 13:38,13:38,9865075,9950000,84925,BUY
14-12-20 13:39,13:39,9808400,9939575,131175,BUY
14-12-20 13:40,13:40,9821100,10145575,324475,BUY
14-12-20 13:41,13:41,9812875,9842175,29300,BUY
14-12-20 13:42,13:42,9847725,10132075,284350,BUY
14-12-20 13:43,13:43,9821500,10099650,278150,BUY
14-12-20 13:44,13:44,9812350,10148775,336425,BUY
14-12-20 13:45,13:45,9856000,9935650,79650,BUY
14-12-20 13:46,13:46,9878400,10200300,321900,BUY
14-12-20 13:47,13:47,9852225,10079950,227725,BUY
14-12-20 13:48,13:48,9869875,9943725,73850,BUY
14-12-20 13:49,13:49,9891200,10164700,273500,BUY
14-12-20 13:50,13:50,9860975,9909725,48750,BUY
14-12-20 13:51,13:51,9899875,10066775,166900,BUY
14-12-20 13:52,13:52,9895275,10216850,321575,BUY
14-12-20 13:53,13:53,9868900,10156000,287100,BUY
14-12-20 13:54,13:54,9877925,9855650,-22275,SELL
14-12-20 13:55,13:55,9914125,10186050,271925,BUY
14-12-20 13:56,13:56,9939925,10226875,286950,BUY
14-12-20 13:57,13:57,9940125,10195250,255125,BUY
14-12-20 13:58,13:58,9931225,10110075,178850,BUY
14-12-20 13:59,13:59,9970375,9867550,-102825,SELL
14-12-20 14:00,14:00,9921275,10118525,197250,BUY
14-12-20 14:01,14:01,9951675,10208075,256400,BUY
14-12-20 14:02,14:02,9951675,10237525,285850,BUY
14-12-20 14:03,14:03,9942350,10190175,247825,BUY
14-12-20 14:04,14:04,9968250,10193275,225025,BUY
14-12-20 14:05,14:05,9960775,10201100,240325,BUY
14-12-20 14:06,14:06,10013175,10175875,162700,BUY
14-12-20 14:07,14:07,9977900,10066750,88850,BUY
14-12-20 14:08,14:08,9986850,10120850,134000,BUY
14-12-20 14:09,14:09,10024775,9846050,-178725,SELL
14-12-20 14:10,14:10,10016675,10159900,143225,BUY
14-12-20 14:11,14:11,10051500,10170025,118525,BUY
14-12-20 14:12,14:12,10082825,10168450,85625,BUY
14-12-20 14:13,14:13,10051625,10175000,123375,BUY
14-12-20 14:14,14:14,10113575,10203600,90025,BUY
14-12-20 14:15,14:15,10108125,10174800,66675,BUY
14-12-20 14:16,14:16,10068400,10147325,78925,BUY
14-12-20 14:17,14:17,10090150,10105325,15175,BUY
14-12-20 14:18,14:18,10086475,10142500,56025,BUY
14-12-20 14:19,14:19,10108875,10143175,34300,BUY
14-12-20 14:20,14:20,10117125,10160700,43575,BUY
14-12-20 14:21,14:21,10113425,10144300,30875,BUY
14-12-20 14:22,14:22,10079400,10180400,101000,BUY
14-12-20 14:23,14:23,10060825,10227775,166950,BUY
14-12-20 14:24,14:24,10093725,10138250,44525,BUY
14-12-20 14:25,14:25,10129625,10201825,72200,BUY
14-12-20 14:26,14:26,10090575,10129050,38475,BUY
14-12-20 14:27,14:27,10093000,10058400,-34600,SELL
14-12-20 14:28,14:28,10083650,10128450,44800,BUY
14-12-20 14:29,14:29,10083925,10144000,60075,BUY
14-12-20 14:30,14:30,10096375,10251450,155075,BUY
14-12-20 14:31,14:31,10140800,10283025,142225,BUY
14-12-20 14:32,14:32,10083425,10234750,151325,BUY
14-12-20 14:33,14:33,10075725,10205100,129375,BUY
14-12-20 14:34,14:34,10135575,10248725,113150,BUY
14-12-20 14:35,14:35,10088375,10161050,72675,BUY
14-12-20 14:36,14:36,10087250,10148550,61300,BUY
14-12-20 14:37,14:37,10073650,10226425,152775,BUY
14-12-20 14:38,14:38,10078175,10108900,30725,BUY
14-12-20 14:39,14:39,10097900,10241750,143850,BUY
14-12-20 14:40,14:40,10108075,10059600,-48475,SELL
14-12-20 14:41,14:41,10127200,10228175,100975,BUY
14-12-20 14:42,14:42,10045850,10237950,192100,BUY
14-12-20 14:43,14:43,10080850,10229325,148475,BUY
14-12-20 14:44,14:44,10041375,10160225,118850,BUY
14-12-20 14:45,14:45,10010850,10204000,193150,BUY
14-12-20 14:46,14:46,10020000,10192125,172125,BUY
14-12-20 14:47,14:47,10050150,10246675,196525,BUY
14-12-20 14:48,14:48,10048875,10296225,247350,BUY
14-12-20 14:49,14:49,9991625,10278125,286500,BUY
14-12-20 14:50,14:50,10035575,10252600,217025,BUY
14-12-20 14:51,14:51,10035725,10199700,163975,BUY
14-12-20 14:52,14:52,10027625,10199400,171775,BUY
14-12-20 14:53,14:53,9978950,10180525,201575,BUY
14-12-20 14:54,14:54,9968325,10178625,210300,BUY
14-12-20 14:55,14:55,10006775,10177275,170500,BUY
14-12-20 14:56,14:56,9932150,10176175,244025,BUY
14-12-20 14:57,14:57,9960875,10073275,112400,BUY
14-12-20 14:58,14:58,9972725,10057750,85025,BUY
14-12-20 14:59,14:59,9957450,10092350,134900,BUY
14-12-20 15:00,15:00,9994300,10046950,52650,BUY
14-12-20 15:01,15:01,9963675,10043625,79950,BUY
14-12-20 15:02,15:02,9913850,10042775,128925,BUY
14-12-20 15:03,15:03,9953825,9960575,6750,BUY
14-12-20 15:04,15:04,9923750,9998450,74700,BUY
14-12-20 15:05,15:05,9953725,9968525,14800,BUY
14-12-20 15:06,15:06,9912575,9944850,32275,BUY
14-12-20 15:07,15:07,9877475,9940600,63125,BUY
14-12-20 15:08,15:08,9912375,9950900,38525,BUY
14-12-20 15:09,15:09,9831975,9832375,400,BUY
14-12-20 15:10,15:10,9825225,9844325,19100,BUY
14-12-20 15:11,15:11,9834575,9856525,21950,BUY
14-12-20 15:12,15:12,9673650,9720225,46575,BUY
14-12-20 15:13,15:13,9673175,9742850,69675,BUY
14-12-20 15:14,15:14,9695350,9702250,6900,BUY
14-12-20 15:15,15:15,9586075,9639575,53500,BUY
14-12-20 15:16,15:16,9584475,9604875,20400,BUY
14-12-20 15:17,15:17,9609375,9619775,10400,BUY
14-12-20 15:18,15:18,9432150,9447700,15550,BUY
14-12-20 15:19,15:19,9461875,9422150,-39725,SELL
14-12-20 15:20,15:20,9466950,9463950,-3000,SELL
14-12-20 15:21,15:21,9262875,9241800,-21075,SELL
14-12-20 15:22,15:22,9267275,9251500,-15775,SELL
14-12-20 15:23,15:23,9265850,9247500,-18350,SELL
14-12-20 15:24,15:24,9089325,9060425,-28900,SELL
14-12-20 15:25,15:25,9150500,9072975,-77525,SELL
14-12-20 15:26,15:26,9119625,9047575,-72050,SELL
14-12-20 15:27,15:27,8958625,8915425,-43200,SELL
14-12-20 15:28,15:28,8956825,8904700,-52125,SELL
14-12-20 15:29,15:29,8974325,8917325,-57000,SELL
15-12-20 9:15,9:15,8839950,8747850,-92100,SELL
15-12-20 9:16,9:16,8786675,8746000,-40675,SELL
15-12-20 9:17,9:17,8962325,8884525,-77800,SELL
15-12-20 9:18,9:18,8938075,8906175,-31900,SELL
15-12-20 9:19,9:19,8933700,8880175,-53525,SELL
15-12-20 9:20,9:20,9329550,9358900,29350,BUY
15-12-20 9:21,9:21,9348875,9301875,-47000,SELL
15-12-20 9:22,9:22,9339150,9295075,-44075,SELL
15-12-20 9:23,9:23,9886575,9685950,-200625,SELL
15-12-20 9:24,9:24,9918275,9709650,-208625,SELL
15-12-20 9:25,9:25,9893425,9689400,-204025,SELL
15-12-20 9:26,9:26,10039000,9890975,-148025,SELL
15-12-20 9:27,9:27,10021875,9880350,-141525,SELL
15-12-20 9:28,9:28,10016025,9867700,-148325,SELL
15-12-20 9:29,9:29,10150075,10040075,-110000,SELL
15-12-20 9:30,9:30,10169000,10044625,-124375,SELL
15-12-20 9:31,9:31,10149100,9922150,-226950,SELL
15-12-20 9:32,9:32,10372400,10121350,-251050,SELL
15-12-20 9:33,9:33,10407025,10123475,-283550,SELL
15-12-20 9:34,9:34,10370650,10110900,-259750,SELL
15-12-20 9:35,9:35,10487850,10006250,-481600,SELL
15-12-20 9:36,9:36,10497550,10019525,-478025,SELL
15-12-20 9:37,9:37,10516375,10006225,-510150,SELL
15-12-20 9:38,9:38,10633600,10015375,-618225,SELL
15-12-20 9:39,9:39,10591550,10018175,-573375,SELL
15-12-20 9:40,9:40,10611150,10034200,-576950,SELL
15-12-20 9:41,9:41,10661350,10031025,-630325,SELL
15-12-20 9:42,9:42,10668200,9951650,-716550,SELL
15-12-20 9:43,9:43,10656625,10088475,-568150,SELL
15-12-20 9:44,9:44,10687275,10213275,-474000,SELL
15-12-20 9:45,9:45,10676375,10204175,-472200,SELL
15-12-20 9:46,9:46,10695925,10215425,-480500,SELL
15-12-20 9:47,9:47,10789850,10263925,-525925,SELL
15-12-20 9:48,9:48,10771450,10303500,-467950,SELL
15-12-20 9:49,9:49,10812350,10304575,-507775,SELL
15-12-20 9:50,9:50,10879825,10291425,-588400,SELL
15-12-20 9:51,9:51,10903000,10288250,-614750,SELL
15-12-20 9:52,9:52,10907600,10286650,-620950,SELL
15-12-20 9:53,9:53,11013900,10223000,-790900,SELL
15-12-20 9:54,9:54,10991150,10249275,-741875,SELL
15-12-20 9:55,9:55,11042925,10316800,-726125,SELL
15-12-20 9:56,9:56,11116650,10141175,-975475,SELL
15-12-20 9:57,9:57,11101750,10133250,-968500,SELL
15-12-20 9:58,9:58,11106525,10156050,-950475,SELL
15-12-20 9:59,9:59,11114675,10301300,-813375,SELL
15-12-20 10:00,10:00,11119825,10309650,-810175,SELL
15-12-20 10:01,10:01,11141325,10269350,-871975,SELL
15-12-20 10:02,10:02,11255475,10379750,-875725,SELL
15-12-20 10:03,10:03,11249450,10367925,-881525,SELL
15-12-20 10:04,10:04,11270725,10383800,-886925,SELL
15-12-20 10:05,10:05,11401450,10204625,-1196825,SELL
15-12-20 10:06,10:06,11373425,10209250,-1164175,SELL
15-12-20 10:07,10:07,11377825,10188925,-1188900,SELL
15-12-20 10:08,10:08,11449325,9969425,-1479900,SELL
15-12-20 10:09,10:09,11471850,9960700,-1511150,SELL
15-12-20 10:10,10:10,11471850,9960575,-1511275,SELL
15-12-20 10:11,10:11,11520300,9728825,-1791475,SELL
15-12-20 10:12,10:12,11544025,9756025,-1788000,SELL
15-12-20 10:13,10:13,11547350,9757300,-1790050,SELL
15-12-20 10:14,10:14,11683600,9787175,-1896425,SELL
15-12-20 10:15,10:15,11695550,9870475,-1825075,SELL
15-12-20 10:16,10:16,11648425,9830750,-1817675,SELL
15-12-20 10:17,10:17,11796300,9874650,-1921650,SELL
15-12-20 10:18,10:18,11763625,9875550,-1888075,SELL
15-12-20 10:19,10:19,11777400,9845500,-1931900,SELL
15-12-20 10:20,10:20,11888900,9943975,-1944925,SELL
15-12-20 10:21,10:21,11906875,9959675,-1947200,SELL
15-12-20 10:22,10:22,11889350,9967425,-1921925,SELL
15-12-20 10:23,10:23,12018150,9967150,-2051000,SELL
15-12-20 10:24,10:24,11995475,9932150,-2063325,SELL
15-12-20 10:25,10:25,12006700,9934700,-2072000,SELL
15-12-20 10:26,10:26,12086675,9980225,-2106450,SELL
15-12-20 10:27,10:27,12092200,10023750,-2068450,SELL
15-12-20 10:28,10:28,12062750,10005125,-2057625,SELL
15-12-20 10:29,10:29,12102125,10037125,-2065000,SELL
15-12-20 10:30,10:30,12080900,10149500,-1931400,SELL
15-12-20 10:31,10:31,12099375,10118325,-1981050,SELL
15-12-20 10:36,10:36,12287825,10218975,-2068850,SELL
15-12-20 10:37,10:37,12298300,10215925,-2082375,SELL
15-12-20 10:38,10:38,12337725,10246225,-2091500,SELL
15-12-20 10:39,10:39,12332800,10207700,-2125100,SELL
15-12-20 10:40,10:40,12317550,10204750,-2112800,SELL
15-12-20 10:41,10:41,12365700,10226675,-2139025,SELL
15-12-20 10:42,10:42,12366325,10198775,-2167550,SELL
15-12-20 10:43,10:43,12345750,10128825,-2216925,SELL
15-12-20 10:44,10:44,12350975,9941725,-2409250,SELL
15-12-20 10:45,10:45,12353775,10206825,-2146950,SELL
15-12-20 10:46,10:46,12290350,10176525,-2113825,SELL
15-12-20 10:47,10:47,12393125,10259500,-2133625,SELL
15-12-20 10:48,10:48,12369675,10228000,-2141675,SELL
15-12-20 10:49,10:49,12402225,10280850,-2121375,SELL
15-12-20 10:50,10:50,12381825,10324950,-2056875,SELL
15-12-20 10:51,10:51,12381550,10345425,-2036125,SELL
15-12-20 10:52,10:52,12414825,10275875,-2138950,SELL
15-12-20 10:53,10:53,12505050,10324425,-2180625,SELL
15-12-20 10:54,10:54,12470050,10379000,-2091050,SELL
15-12-20 10:55,10:55,12526775,10415850,-2110925,SELL
15-12-20 10:56,10:56,12511625,10232325,-2279300,SELL
15-12-20 10:57,10:57,12513850,10271500,-2242350,SELL
15-12-20 10:58,10:58,12516775,10270750,-2246025,SELL
15-12-20 10:59,10:59,12475750,10279400,-2196350,SELL
15-12-20 11:00,11:00,12449450,10317625,-2131825,SELL
15-12-20 11:01,11:01,12496775,10384850,-2111925,SELL
15-12-20 11:02,11:02,12468550,10420825,-2047725,SELL
15-12-20 11:03,11:03,12444275,10360300,-2083975,SELL
15-12-20 11:04,11:04,12444275,10400750,-2043525,SELL
15-12-20 11:05,11:05,12504875,10415825,-2089050,SELL
15-12-20 11:06,11:06,12475600,10445825,-2029775,SELL
15-12-20 11:07,11:07,12476400,10403025,-2073375,SELL
15-12-20 11:08,11:08,12616725,10488625,-2128100,SELL
15-12-20 11:09,11:09,12602250,10379750,-2222500,SELL
15-12-20 11:10,11:10,12644500,10480875,-2163625,SELL
15-12-20 11:11,11:11,12659525,10458000,-2201525,SELL
15-12-20 11:12,11:12,12655250,10437500,-2217750,SELL
15-12-20 11:13,11:13,12690000,10478300,-2211700,SELL
15-12-20 11:14,11:14,12736200,10414650,-2321550,SELL
15-12-20 11:15,11:15,12694975,10482600,-2212375,SELL
15-12-20 11:16,11:16,12726475,10495975,-2230500,SELL
15-12-20 11:17,11:17,12806325,10581900,-2224425,SELL
15-12-20 11:18,11:18,12759875,10543650,-2216225,SELL
15-12-20 11:19,11:19,12759875,9861100,-2898775,SELL
15-12-20 11:20,11:20,12823325,10613775,-2209550,SELL
15-12-20 11:21,11:21,12803300,10606250,-2197050,SELL
15-12-20 11:22,11:22,12779200,10651000,-2128200,SELL
15-12-20 11:23,11:23,12857275,10717250,-2140025,SELL
15-12-20 11:24,11:24,12827675,10658275,-2169400,SELL
15-12-20 11:25,11:25,12857275,10748250,-2109025,SELL
15-12-20 11:26,11:26,12768425,10756300,-2012125,SELL
15-12-20 11:27,11:27,12774175,10757400,-2016775,SELL
15-12-20 11:28,11:28,12764275,10762350,-2001925,SELL
15-12-20 11:29,11:29,12738700,10543000,-2195700,SELL
15-12-20 11:30,11:30,12772325,10783575,-1988750,SELL
15-12-20 11:31,11:31,12769300,10792150,-1977150,SELL
15-12-20 11:32,11:32,12770325,10843800,-1926525,SELL
15-12-20 11:33,11:33,12772000,10853225,-1918775,SELL
15-12-20 11:34,11:34,12753225,10854500,-1898725,SELL
15-12-20 11:35,11:35,12730050,10855050,-1875000,SELL
15-12-20 11:36,11:36,12766700,10760050,-2006650,SELL
15-12-20 11:37,11:37,12793050,10626150,-2166900,SELL
15-12-20 11:38,11:38,12737950,10918125,-1819825,SELL
15-12-20 11:39,11:39,12750500,10799100,-1951400,SELL
15-12-20 11:40,11:40,12737925,10610800,-2127125,SELL
15-12-20 11:41,11:41,12795875,10912475,-1883400,SELL
15-12-20 11:46,11:46,12782575,10988700,-1793875,SELL
15-12-20 11:47,11:47,12788050,10649475,-2138575,SELL
15-12-20 11:48,11:48,12807850,10973025,-1834825,SELL
15-12-20 11:49,11:49,12816225,10897650,-1918575,SELL
15-12-20 11:50,11:50,12864700,10940475,-1924225,SELL
15-12-20 11:51,11:51,12916300,11005950,-1910350,SELL
15-12-20 11:52,11:52,12838725,10867950,-1970775,SELL
15-12-20 11:53,11:53,12866675,10833650,-2033025,SELL
15-12-20 11:54,11:54,12817800,10734375,-2083425,SELL
15-12-20 11:55,11:55,12859475,10862450,-1997025,SELL
15-12-20 11:56,11:56,12922475,10961875,-1960600,SELL
15-12-20 11:57,11:57,12902050,10838850,-2063200,SELL
15-12-20 11:58,11:58,12944400,10625825,-2318575,SELL
15-12-20 11:59,11:59,12898050,10897550,-2000500,SELL
15-12-20 12:00,12:00,12899625,10899000,-2000625,SELL
15-12-20 12:01,12:01,12848325,10704200,-2144125,SELL
15-12-20 12:02,12:02,12935000,10915675,-2019325,SELL
15-12-20 12:03,12:03,12878275,10156100,-2722175,SELL
15-12-20 12:04,12:04,12900275,10870175,-2030100,SELL
15-12-20 12:05,12:05,12916025,10878350,-2037675,SELL
15-12-20 12:06,12:06,12866700,10824500,-2042200,SELL
15-12-20 12:07,12:07,12932175,11008425,-1923750,SELL
15-12-20 12:08,12:08,12903425,10939400,-1964025,SELL
15-12-20 12:09,12:09,12910400,10987200,-1923200,SELL
15-12-20 12:10,12:10,12917525,11024900,-1892625,SELL
15-12-20 12:11,12:11,12888150,10985975,-1902175,SELL
15-12-20 12:12,12:12,12935625,11046650,-1888975,SELL
15-12-20 12:13,12:13,12906750,10970950,-1935800,SELL
15-12-20 12:14,12:14,12942675,11022275,-1920400,SELL
15-12-20 12:15,12:15,12932625,11033000,-1899625,SELL
15-12-20 12:16,12:16,12988400,11093050,-1895350,SELL
15-12-20 12:17,12:17,12959200,11077000,-1882200,SELL
15-12-20 12:18,12:18,12907825,10920275,-1987550,SELL
15-12-20 12:19,12:19,12926850,11028075,-1898775,SELL
15-12-20 12:20,12:20,12893150,11031100,-1862050,SELL
15-12-20 12:21,12:21,12926250,11086225,-1840025,SELL
15-12-20 12:22,12:22,12933875,11015225,-1918650,SELL
15-12-20 12:23,12:23,12918475,11041100,-1877375,SELL
15-12-20 12:24,12:24,12978550,11042175,-1936375,SELL
15-12-20 12:25,12:25,13001825,11096350,-1905475,SELL
15-12-20 12:26,12:26,12990425,11097025,-1893400,SELL
15-12-20 12:27,12:27,12956300,10992675,-1963625,SELL
15-12-20 12:28,12:28,12972350,10970650,-2001700,SELL
15-12-20 12:29,12:29,12939925,10937325,-2002600,SELL
15-12-20 12:30,12:30,13004675,10952675,-2052000,SELL
15-12-20 12:31,12:31,13017475,10994700,-2022775,SELL
15-12-20 12:32,12:32,13028050,11021800,-2006250,SELL
15-12-20 12:33,12:33,12994675,10974200,-2020475,SELL
15-12-20 12:34,12:34,12999075,11019400,-1979675,SELL
15-12-20 12:35,12:35,13020425,10943550,-2076875,SELL
15-12-20 12:36,12:36,13053100,10984625,-2068475,SELL
15-12-20 12:37,12:37,13011300,10912675,-2098625,SELL
15-12-20 12:38,12:38,13016150,10780025,-2236125,SELL
15-12-20 12:39,12:39,12993050,10948550,-2044500,SELL
15-12-20 12:40,12:40,12993050,10878075,-2114975,SELL
15-12-20 12:41,12:41,13006875,10932075,-2074800,SELL
15-12-20 12:42,12:42,12943600,10930425,-2013175,SELL
15-12-20 12:43,12:43,12941925,10926225,-2015700,SELL
15-12-20 12:44,12:44,13036725,11007350,-2029375,SELL
15-12-20 12:45,12:45,13015325,10840725,-2174600,SELL
15-12-20 12:46,12:46,12989400,10895575,-2093825,SELL
15-12-20 12:47,12:47,12998900,10900925,-2097975,SELL
15-12-20 12:48,12:48,12934775,10944175,-1990600,SELL
15-12-20 12:49,12:49,12935400,10819525,-2115875,SELL
15-12-20 12:50,12:50,12955625,10849150,-2106475,SELL
15-12-20 12:51,12:51,12935575,10990700,-1944875,SELL
15-12-20 12:52,12:52,12931800,11024650,-1907150,SELL
15-12-20 12:53,12:53,12921275,11041050,-1880225,SELL
15-12-20 12:54,12:54,12701100,10938450,-1762650,SELL
15-12-20 12:55,12:55,12704075,10943475,-1760600,SELL
15-12-20 12:56,12:56,12715500,10706375,-2009125,SELL
15-12-20 12:57,12:57,12582725,10863300,-1719425,SELL
15-12-20 12:58,12:58,12573675,10638600,-1935075,SELL
15-12-20 12:59,12:59,12550450,10848650,-1701800,SELL
15-12-20 13:00,13:00,12611525,10904225,-1707300,SELL
15-12-20 13:01,13:01,12550250,10880375,-1669875,SELL
15-12-20 13:02,13:02,12588225,10869500,-1718725,SELL
15-12-20 13:03,13:03,12549075,10688075,-1861000,SELL
15-12-20 13:04,13:04,12565150,10843200,-1721950,SELL
15-12-20 13:05,13:05,12546375,10705425,-1840950,SELL
15-12-20 13:06,13:06,12585175,10882150,-1703025,SELL
15-12-20 13:07,13:07,12624225,10962025,-1662200,SELL
15-12-20 13:08,13:08,12555100,10955375,-1599725,SELL
15-12-20 13:09,13:09,12389225,10866050,-1523175,SELL
15-12-20 13:10,13:10,12421025,10907075,-1513950,SELL
15-12-20 13:11,13:11,12389225,10902750,-1486475,SELL
15-12-20 13:12,13:12,12447800,10927625,-1520175,SELL
15-12-20 13:13,13:13,12404650,10687225,-1717425,SELL
15-12-20 13:14,13:14,12262675,10889675,-1373000,SELL
15-12-20 13:15,13:15,12383825,10976900,-1406925,SELL
15-12-20 13:16,13:16,12396600,10989325,-1407275,SELL
15-12-20 13:17,13:17,12384250,11035325,-1348925,SELL
15-12-20 13:18,13:18,12310675,10867575,-1443100,SELL
15-12-20 13:19,13:19,12299850,10773675,-1526175,SELL
15-12-20 13:20,13:20,12308675,10761350,-1547325,SELL
15-12-20 13:21,13:21,12279275,10816900,-1462375,SELL
15-12-20 13:22,13:22,12235850,10891275,-1344575,SELL
15-12-20 13:23,13:23,12342900,10854625,-1488275,SELL
15-12-20 13:24,13:24,12313425,10864225,-1449200,SELL
15-12-20 13:25,13:25,12295000,10474275,-1820725,SELL
15-12-20 13:26,13:26,12301650,10624525,-1677125,SELL
15-12-20 13:27,13:27,12257750,10781125,-1476625,SELL
15-12-20 13:28,13:28,12242700,10587900,-1654800,SELL
15-12-20 13:29,13:29,12274750,10854900,-1419850,SELL
15-12-20 13:30,13:30,12233500,10845525,-1387975,SELL
15-12-20 13:31,13:31,12232025,10870925,-1361100,SELL
15-12-20 13:32,13:32,12218150,10869600,-1348550,SELL
15-12-20 13:33,13:33,12254650,10851250,-1403400,SELL
15-12-20 13:34,13:34,12254650,10748325,-1506325,SELL
15-12-20 13:35,13:35,12184100,10777925,-1406175,SELL
15-12-20 13:36,13:36,12198800,10877700,-1321100,SELL
15-12-20 13:37,13:37,12162450,10872625,-1289825,SELL
15-12-20 13:38,13:38,12208500,10839150,-1369350,SELL
15-12-20 13:39,13:39,12216850,10874175,-1342675,SELL
15-12-20 13:40,13:40,12182375,10911100,-1271275,SELL
15-12-20 13:41,13:41,12224025,10864725,-1359300,SELL
15-12-20 13:42,13:42,12146775,10884700,-1262075,SELL
15-12-20 13:43,13:43,12139575,10616825,-1522750,SELL
15-12-20 13:44,13:44,12261825,10856650,-1405175,SELL
15-12-20 13:45,13:45,12269775,10775025,-1494750,SELL
15-12-20 13:46,13:46,12290650,10719925,-1570725,SELL
15-12-20 13:47,13:47,12301700,10595325,-1706375,SELL
15-12-20 13:48,13:48,12370050,10781675,-1588375,SELL
15-12-20 13:49,13:49,12307650,9842175,-2465475,SELL
15-12-20 13:50,13:50,12359350,10512400,-1846950,SELL
15-12-20 13:51,13:51,12305275,10509725,-1795550,SELL
15-12-20 13:52,13:52,12332325,10493875,-1838450,SELL
15-12-20 13:53,13:53,12305275,10773125,-1532150,SELL
15-12-20 13:54,13:54,12315725,10873875,-1441850,SELL
15-12-20 13:55,13:55,12301225,10685575,-1615650,SELL
15-12-20 13:56,13:56,12290725,10880450,-1410275,SELL
15-12-20 13:57,13:57,12106600,10691850,-1414750,SELL
15-12-20 13:58,13:58,12100000,10735425,-1364575,SELL
15-12-20 13:59,13:59,12058350,10697875,-1360475,SELL
15-12-20 14:00,14:00,12086425,10772875,-1313550,SELL
15-12-20 14:01,14:01,12082675,10763875,-1318800,SELL
15-12-20 14:02,14:02,12072875,10714650,-1358225,SELL
15-12-20 14:03,14:03,11457125,10517800,-939325,SELL
15-12-20 14:04,14:04,11479825,10554175,-925650,SELL
15-12-20 14:05,14:05,11452850,10534850,-918000,SELL
15-12-20 14:06,14:06,11282175,10394275,-887900,SELL
15-12-20 14:07,14:07,11276350,10346400,-929950,SELL
15-12-20 14:08,14:08,11286925,10326025,-960900,SELL
15-12-20 14:09,14:09,11259400,10404550,-854850,SELL
15-12-20 14:10,14:10,11254275,10414875,-839400,SELL
15-12-20 14:11,14:11,11230175,10401225,-828950,SELL
15-12-20 14:12,14:12,11279350,10281575,-997775,SELL
15-12-20 14:13,14:13,11297900,10325650,-972250,SELL
15-12-20 14:14,14:14,11305950,10319725,-986225,SELL
15-12-20 14:15,14:15,11412475,10370025,-1042450,SELL
15-12-20 14:16,14:16,11427025,10344250,-1082775,SELL
15-12-20 14:17,14:17,11399275,10341600,-1057675,SELL
15-12-20 14:18,14:18,11539125,10389325,-1149800,SELL
15-12-20 14:19,14:19,11514775,10377725,-1137050,SELL
15-12-20 14:20,14:20,11525550,10375625,-1149925,SELL
15-12-20 14:21,14:21,11438300,10424675,-1013625,SELL
15-12-20 14:22,14:22,11384025,10418775,-965250,SELL
15-12-20 14:23,14:23,11407275,10195675,-1211600,SELL
15-12-20 14:24,14:24,11388700,10335825,-1052875,SELL
15-12-20 14:25,14:25,11348275,10258175,-1090100,SELL
15-12-20 14:26,14:26,11343450,10302100,-1041350,SELL
15-12-20 14:27,14:27,11453775,10314075,-1139700,SELL
15-12-20 14:28,14:28,11440650,10135800,-1304850,SELL
15-12-20 14:29,14:29,11418650,10338575,-1080075,SELL
15-12-20 14:30,14:30,11457325,10402875,-1054450,SELL
15-12-20 14:31,14:31,11438900,10337125,-1101775,SELL
15-12-20 14:32,14:32,11434625,10356025,-1078600,SELL
15-12-20 14:33,14:33,11577525,10298125,-1279400,SELL
15-12-20 14:34,14:34,11592525,10326325,-1266200,SELL
15-12-20 14:35,14:35,11583750,10305625,-1278125,SELL
15-12-20 14:36,14:36,11578750,10319600,-1259150,SELL
15-12-20 14:37,14:37,11546225,10112250,-1433975,SELL
15-12-20 14:38,14:38,11552900,10333700,-1219200,SELL
15-12-20 14:39,14:39,11580750,10277550,-1303200,SELL
15-12-20 14:40,14:40,11628950,10370375,-1258575,SELL
15-12-20 14:41,14:41,11617250,10343600,-1273650,SELL
15-12-20 14:42,14:42,11601050,10301700,-1299350,SELL
15-12-20 14:43,14:43,11632075,10262375,-1369700,SELL
15-12-20 14:44,14:44,11621400,10323800,-1297600,SELL
15-12-20 14:45,14:45,11576300,10298300,-1278000,SELL
15-12-20 14:46,14:46,11576725,10270625,-1306100,SELL
15-12-20 14:47,14:47,11575975,10291250,-1284725,SELL
15-12-20 14:48,14:48,11551750,10304775,-1246975,SELL
15-12-20 14:49,14:49,11556125,10297625,-1258500,SELL
15-12-20 14:50,14:50,11561975,10299375,-1262600,SELL
15-12-20 14:51,14:51,11582250,10295300,-1286950,SELL
15-12-20 14:52,14:52,11550150,10293825,-1256325,SELL
15-12-20 14:53,14:53,11560650,10212875,-1347775,SELL
15-12-20 14:54,14:54,11437225,10081450,-1355775,SELL
15-12-20 14:55,14:55,11437225,10173850,-1263375,SELL
15-12-20 14:56,14:56,11444800,10184575,-1260225,SELL
15-12-20 14:57,14:57,11437425,10179700,-1257725,SELL
15-12-20 14:58,14:58,11449900,10135025,-1314875,SELL
15-12-20 14:59,14:59,11409950,10151225,-1258725,SELL
15-12-20 15:00,15:00,11378150,10049725,-1328425,SELL
15-12-20 15:01,15:01,11349175,10033775,-1315400,SELL
15-12-20 15:02,15:02,11371375,10052025,-1319350,SELL
15-12-20 15:03,15:03,11290475,9949600,-1340875,SELL
15-12-20 15:04,15:04,11236825,9947375,-1289450,SELL
15-12-20 15:05,15:05,11286775,9966025,-1320750,SELL
15-12-20 15:06,15:06,11197300,9795375,-1401925,SELL
15-12-20 15:07,15:07,11183475,9817100,-1366375,SELL
15-12-20 15:08,15:08,11180300,9800425,-1379875,SELL
15-12-20 15:09,15:09,11092850,9714850,-1378000,SELL
15-12-20 15:10,15:10,11131400,9715900,-1415500,SELL
15-12-20 15:11,15:11,11098425,9713375,-1385050,SELL
15-12-20 15:12,15:12,10874250,9528325,-1345925,SELL
15-12-20 15:13,15:13,10869250,9526425,-1342825,SELL
15-12-20 15:14,15:14,10860575,9455400,-1405175,SELL
15-12-20 15:15,15:15,10752475,9352500,-1399975,SELL
15-12-20 15:16,15:16,10760275,9358525,-1401750,SELL
15-12-20 15:17,15:17,10752450,9362425,-1390025,SELL
15-12-20 15:18,15:18,10579600,9197425,-1382175,SELL
15-12-20 15:19,15:19,10596675,9182700,-1413975,SELL
15-12-20 15:20,15:20,10639700,9195400,-1444300,SELL
15-12-20 15:21,15:21,10459900,8975300,-1484600,SELL
15-12-20 15:22,15:22,10435650,8977800,-1457850,SELL
15-12-20 15:23,15:23,10425325,8979300,-1446025,SELL
15-12-20 15:24,15:24,10235725,8852575,-1383150,SELL
15-12-20 15:25,15:25,10304700,8859625,-1445075,SELL
15-12-20 15:26,15:26,10251025,8846525,-1404500,SELL
15-12-20 15:27,15:27,10164600,8732625,-1431975,SELL
15-12-20 15:28,15:28,10163725,8711650,-1452075,SELL
15-12-20 15:29,15:29,10190025,8735000,-1455025,SELL
16-12-20 9:15,9:15,9951875,8519375,-1432500,SELL
16-12-20 9:16,9:16,9966425,8505400,-1461025,SELL
16-12-20 9:17,9:17,10108950,8819675,-1289275,SELL
16-12-20 9:18,9:18,10103600,8838150,-1265450,SELL
16-12-20 9:19,9:19,10088000,8821175,-1266825,SELL
16-12-20 9:20,9:20,10884900,9555050,-1329850,SELL
16-12-20 9:21,9:21,10922475,9555825,-1366650,SELL
16-12-20 9:22,9:22,10869350,9560225,-1309125,SELL
16-12-20 9:23,9:23,11158050,9746775,-1411275,SELL
16-12-20 9:24,9:24,11169050,9806775,-1362275,SELL
16-12-20 9:25,9:25,11183400,9837275,-1346125,SELL
16-12-20 9:26,9:26,11392225,10144125,-1248100,SELL
16-12-20 9:27,9:27,11400775,10124800,-1275975,SELL
16-12-20 9:28,9:28,11371675,10131375,-1240300,SELL
16-12-20 9:29,9:29,11581575,10281625,-1299950,SELL
16-12-20 9:30,9:30,11548850,10282025,-1266825,SELL
16-12-20 9:31,9:31,11573025,10273950,-1299075,SELL
16-12-20 9:32,9:32,11642150,10489900,-1152250,SELL
16-12-20 9:33,9:33,11623925,10535450,-1088475,SELL
16-12-20 9:34,9:34,11668275,10486900,-1181375,SELL
16-12-20 9:35,9:35,11818600,10685550,-1133050,SELL
16-12-20 9:36,9:36,11769000,10683175,-1085825,SELL
16-12-20 9:37,9:37,11773325,10688850,-1084475,SELL
16-12-20 9:38,9:38,11757275,10888725,-868550,SELL
16-12-20 9:39,9:39,11779850,10904475,-875375,SELL
16-12-20 9:40,9:40,11749450,10909900,-839550,SELL
16-12-20 9:41,9:41,11962375,11039875,-922500,SELL
16-12-20 9:42,9:42,11954600,11076475,-878125,SELL
16-12-20 9:43,9:43,11948350,11000950,-947400,SELL
16-12-20 9:44,9:44,11939225,11195575,-743650,SELL
16-12-20 9:45,9:45,11977200,11144600,-832600,SELL
16-12-20 9:46,9:46,11991250,11180625,-810625,SELL
16-12-20 9:47,9:47,12039600,11270200,-769400,SELL
16-12-20 9:48,9:48,12042050,11293450,-748600,SELL
16-12-20 9:49,9:49,12023225,11268975,-754250,SELL
16-12-20 9:50,9:50,12019850,11455600,-564250,SELL
16-12-20 9:51,9:51,12001950,11414975,-586975,SELL
16-12-20 9:52,9:52,11991050,11441525,-549525,SELL
16-12-20 9:53,9:53,11933775,11518375,-415400,SELL
16-12-20 9:54,9:54,11921175,11491225,-429950,SELL
16-12-20 9:55,9:55,11955075,11545125,-409950,SELL
16-12-20 9:56,9:56,12063800,11540975,-522825,SELL
16-12-20 9:57,9:57,12055275,11529325,-525950,SELL
16-12-20 9:58,9:58,12021325,11476175,-545150,SELL
16-12-20 9:59,9:59,12113525,11477775,-635750,SELL
16-12-20 10:00,10:00,12134275,11536700,-597575,SELL
16-12-20 10:01,10:01,12129675,11481850,-647825,SELL
16-12-20 10:02,10:02,12221275,11527875,-693400,SELL
16-12-20 10:03,10:03,12177350,11542250,-635100,SELL
16-12-20 10:04,10:04,12164200,11483950,-680250,SELL
16-12-20 10:05,10:05,12341750,11636200,-705550,SELL
16-12-20 10:06,10:06,12319175,11612400,-706775,SELL
16-12-20 10:07,10:07,12361175,11651450,-709725,SELL
16-12-20 10:08,10:08,12393525,11397750,-995775,SELL
16-12-20 10:09,10:09,12351075,11370850,-980225,SELL
16-12-20 10:10,10:10,12394675,11349425,-1045250,SELL
16-12-20 10:11,10:11,12548300,11507175,-1041125,SELL
16-12-20 10:12,10:12,12528400,11511925,-1016475,SELL
16-12-20 10:13,10:13,12549350,11487950,-1061400,SELL
16-12-20 10:14,10:14,12660675,11600800,-1059875,SELL
16-12-20 10:15,10:15,12644725,11587400,-1057325,SELL
16-12-20 10:16,10:16,12661925,11555250,-1106675,SELL
16-12-20 10:17,10:17,12757075,11682625,-1074450,SELL
16-12-20 10:18,10:18,12740425,11668025,-1072400,SELL
16-12-20 10:19,10:19,12727750,11665900,-1061850,SELL
16-12-20 10:20,10:20,12761275,11724050,-1037225,SELL
16-12-20 10:21,10:21,12672775,11714400,-958375,SELL
16-12-20 10:22,10:22,12771725,11641600,-1130125,SELL
16-12-20 10:23,10:23,12788775,11800350,-988425,SELL
16-12-20 10:24,10:24,12838275,11832425,-1005850,SELL
16-12-20 10:25,10:25,12789025,11849575,-939450,SELL
16-12-20 10:26,10:26,12849850,11895750,-954100,SELL
16-12-20 10:27,10:27,12776300,11066075,-1710225,SELL
16-12-20 10:28,10:28,12857075,11843425,-1013650,SELL
16-12-20 10:29,10:29,12980325,11914500,-1065825,SELL
16-12-20 10:30,10:30,12975000,11909825,-1065175,SELL
16-12-20 10:31,10:31,12971575,11965300,-1006275,SELL
16-12-20 10:32,10:32,13090100,11972025,-1118075,SELL
16-12-20 10:33,10:33,13079100,11856550,-1222550,SELL
16-12-20 10:34,10:34,13079850,11669850,-1410000,SELL
16-12-20 10:35,10:35,13168700,11996850,-1171850,SELL
16-12-20 10:36,10:36,13197900,12072500,-1125400,SELL
16-12-20 10:37,10:37,13167075,12033350,-1133725,SELL
16-12-20 10:38,10:38,13135700,12053175,-1082525,SELL
16-12-20 10:39,10:39,13225800,12025900,-1199900,SELL
16-12-20 10:40,10:40,13227525,12033975,-1193550,SELL
16-12-20 10:41,10:41,13271350,12143850,-1127500,SELL
16-12-20 10:42,10:42,13284225,12134850,-1149375,SELL
16-12-20 10:43,10:43,13266125,12139225,-1126900,SELL
16-12-20 10:44,10:44,13276525,12152700,-1123825,SELL
16-12-20 10:45,10:45,13348425,12179075,-1169350,SELL
16-12-20 10:46,10:46,13302750,12172000,-1130750,SELL
16-12-20 10:47,10:47,13276675,12180525,-1096150,SELL
16-12-20 10:48,10:48,13327200,12156275,-1170925,SELL
16-12-20 10:49,10:49,13322025,12182025,-1140000,SELL
16-12-20 10:50,10:50,13467875,12250475,-1217400,SELL
16-12-20 10:51,10:51,13426250,12254475,-1171775,SELL
16-12-20 10:52,10:52,13383250,12227925,-1155325,SELL
16-12-20 10:53,10:53,13446100,12321925,-1124175,SELL
16-12-20 10:54,10:54,13280975,12252150,-1028825,SELL
16-12-20 10:55,10:55,13353575,12209575,-1144000,SELL
16-12-20 10:56,10:56,13460925,12275575,-1185350,SELL
16-12-20 10:57,10:57,13439250,12300950,-1138300,SELL
16-12-20 10:58,10:58,13390150,12283550,-1106600,SELL
16-12-20 10:59,10:59,13490500,12271450,-1219050,SELL
16-12-20 11:00,11:00,13495500,12295500,-1200000,SELL
16-12-20 11:01,11:01,13454225,12282250,-1171975,SELL
16-12-20 11:02,11:02,13468225,12192450,-1275775,SELL
16-12-20 11:03,11:03,13468225,12174950,-1293275,SELL
16-12-20 11:04,11:04,13463275,12214700,-1248575,SELL
16-12-20 11:05,11:05,13470000,12214700,-1255300,SELL
16-12-20 11:06,11:06,13470350,12219525,-1250825,SELL
16-12-20 11:07,11:07,13324825,12155850,-1168975,SELL
16-12-20 11:08,11:08,13391300,11369800,-2021500,SELL
16-12-20 11:09,11:09,13509425,12232875,-1276550,SELL
16-12-20 11:10,11:10,13520500,11977850,-1542650,SELL
16-12-20 11:11,11:11,13532275,12047200,-1485075,SELL
16-12-20 11:12,11:12,13546750,12277725,-1269025,SELL
16-12-20 11:13,11:13,13546750,12269875,-1276875,SELL
16-12-20 11:14,11:14,13547800,12126675,-1421125,SELL
16-12-20 11:15,11:15,13539775,12247500,-1292275,SELL
16-12-20 11:16,11:16,13537100,12261725,-1275375,SELL
16-12-20 11:17,11:17,13612125,12283575,-1328550,SELL
16-12-20 11:18,11:18,13592800,12245725,-1347075,SELL
16-12-20 11:19,11:19,13589375,12195400,-1393975,SELL
16-12-20 11:20,11:20,13628275,12257100,-1371175,SELL
16-12-20 11:21,11:21,13653225,12264050,-1389175,SELL
16-12-20 11:22,11:22,13642625,12217875,-1424750,SELL
16-12-20 11:23,11:23,13658125,12235225,-1422900,SELL
16-12-20 11:24,11:24,13668200,12257875,-1410325,SELL
16-12-20 11:25,11:25,13684925,12058350,-1626575,SELL
16-12-20 11:26,11:26,13708925,12322225,-1386700,SELL
16-12-20 11:27,11:27,13461050,12274325,-1186725,SELL
16-12-20 11:28,11:28,13630300,12296925,-1333375,SELL
16-12-20 11:29,11:29,13666225,12221100,-1445125,SELL
16-12-20 11:30,11:30,13740725,12296725,-1444000,SELL
16-12-20 11:31,11:31,13686875,12355750,-1331125,SELL
16-12-20 11:32,11:32,13716925,12356225,-1360700,SELL
16-12-20 11:33,11:33,13692850,12362475,-1330375,SELL
16-12-20 11:34,11:34,13704375,12360625,-1343750,SELL
16-12-20 11:35,11:35,13778400,12164025,-1614375,SELL
16-12-20 11:36,11:36,12993775,12318350,-675425,SELL
16-12-20 11:37,11:37,13745800,12341975,-1403825,SELL
16-12-20 11:38,11:38,13730775,12299250,-1431525,SELL
16-12-20 11:39,11:39,13739625,12320500,-1419125,SELL
16-12-20 11:40,11:40,13776950,12343825,-1433125,SELL
16-12-20 11:41,11:41,13736850,12372850,-1364000,SELL
16-12-20 11:42,11:42,13706400,12196325,-1510075,SELL
16-12-20 11:43,11:43,13598425,12324175,-1274250,SELL
16-12-20 11:44,11:44,13688375,12301075,-1387300,SELL
16-12-20 11:45,11:45,13772975,12305450,-1467525,SELL
16-12-20 11:46,11:46,13767725,12297825,-1469900,SELL
16-12-20 11:47,11:47,13792000,12166125,-1625875,SELL
16-12-20 11:48,11:48,13828700,12262500,-1566200,SELL
16-12-20 11:49,11:49,13825075,12296175,-1528900,SELL
16-12-20 11:50,11:50,13723100,12275175,-1447925,SELL
16-12-20 11:51,11:51,13782425,11609650,-2172775,SELL
16-12-20 11:52,11:52,13782300,12253075,-1529225,SELL
16-12-20 11:53,11:53,13811525,12343450,-1468075,SELL
16-12-20 11:54,11:54,13794100,12334125,-1459975,SELL
16-12-20 11:55,11:55,13719825,12390950,-1328875,SELL
16-12-20 11:56,11:56,13820075,12350975,-1469100,SELL
16-12-20 11:57,11:57,13851700,12295350,-1556350,SELL
16-12-20 11:58,11:58,13675325,12355550,-1319775,SELL
16-12-20 11:59,11:59,13648175,12308950,-1339225,SELL
16-12-20 12:00,12:00,13962650,12391350,-1571300,SELL
16-12-20 12:01,12:01,13962075,12406975,-1555100,SELL
16-12-20 12:02,12:02,13962075,12423925,-1538150,SELL
16-12-20 12:03,12:03,13946150,12407925,-1538225,SELL
16-12-20 12:04,12:04,13871425,12378250,-1493175,SELL
16-12-20 12:05,12:05,13910400,12336100,-1574300,SELL
16-12-20 12:06,12:06,13878475,12377725,-1500750,SELL
16-12-20 12:07,12:07,13915275,12362925,-1552350,SELL
16-12-20 12:08,12:08,13883750,12235475,-1648275,SELL
16-12-20 12:09,12:09,13893150,12261400,-1631750,SELL
16-12-20 12:10,12:10,13921350,12345150,-1576200,SELL
16-12-20 12:11,12:11,13923600,12324650,-1598950,SELL
16-12-20 12:12,12:12,13977925,12336575,-1641350,SELL
16-12-20 12:13,12:13,13894475,12111775,-1782700,SELL
16-12-20 12:14,12:14,13806925,12323325,-1483600,SELL
16-12-20 12:15,12:15,13978275,12332150,-1646125,SELL
16-12-20 12:16,12:16,13878575,12237525,-1641050,SELL
16-12-20 12:17,12:17,13969675,11690125,-2279550,SELL
16-12-20 12:18,12:18,13777425,12245800,-1531625,SELL
16-12-20 12:19,12:19,13935000,12366450,-1568550,SELL
16-12-20 12:20,12:20,13949225,12326400,-1622825,SELL
16-12-20 12:21,12:21,14000225,12392900,-1607325,SELL
16-12-20 12:22,12:22,13978675,12437625,-1541050,SELL
16-12-20 12:23,12:23,13878225,12376925,-1501300,SELL
16-12-20 12:24,12:24,13955600,12327650,-1627950,SELL
16-12-20 12:25,12:25,14044275,12391625,-1652650,SELL
16-12-20 12:26,12:26,14069975,12388200,-1681775,SELL
16-12-20 12:27,12:27,14044675,12292100,-1752575,SELL
16-12-20 12:28,12:28,14051575,12337650,-1713925,SELL
16-12-20 12:29,12:29,14068150,12231175,-1836975,SELL
16-12-20 12:30,12:30,14154950,12400350,-1754600,SELL
16-12-20 12:31,12:31,14118650,12442275,-1676375,SELL
16-12-20 12:32,12:32,14116675,12444825,-1671850,SELL
16-12-20 12:33,12:33,13971250,11480350,-2490900,SELL
16-12-20 12:34,12:34,13980075,11476250,-2503825,SELL
16-12-20 12:35,12:35,13959125,11487775,-2471350,SELL
16-12-20 12:36,12:36,14239600,11474525,-2765075,SELL
16-12-20 12:37,12:37,14246100,11408800,-2837300,SELL
16-12-20 12:38,12:38,14224100,11407800,-2816300,SELL
16-12-20 12:39,12:39,14347425,11577125,-2770300,SELL
16-12-20 12:40,12:40,14362425,11552125,-2810300,SELL
16-12-20 12:41,12:41,14339675,11561600,-2778075,SELL
16-12-20 12:42,12:42,14474050,11614050,-2860000,SELL
16-12-20 12:43,12:43,14448225,11654475,-2793750,SELL
16-12-20 12:44,12:44,14444800,11629575,-2815225,SELL
16-12-20 12:45,12:45,14606950,11628500,-2978450,SELL
16-12-20 12:46,12:46,14578700,11634600,-2944100,SELL
16-12-20 12:47,12:47,14591875,11635150,-2956725,SELL
16-12-20 12:48,12:48,14662525,11636075,-3026450,SELL
16-12-20 12:49,12:49,14645075,11534625,-3110450,SELL
16-12-20 12:50,12:50,14645075,11599000,-3046075,SELL
16-12-20 12:51,12:51,14725175,11574000,-3151175,SELL
16-12-20 12:52,12:52,14751150,11633575,-3117575,SELL
16-12-20 12:53,12:53,14703725,11572200,-3131525,SELL
16-12-20 12:54,12:54,14779375,11146575,-3632800,SELL
16-12-20 12:55,12:55,14760975,11160725,-3600250,SELL
16-12-20 12:56,12:56,14752950,11178950,-3574000,SELL
16-12-20 12:57,12:57,14833325,11274425,-3558900,SELL
16-12-20 12:58,12:58,14819375,11298075,-3521300,SELL
16-12-20 12:59,12:59,14827300,11286350,-3540950,SELL
16-12-20 13:00,13:00,14886050,11364850,-3521200,SELL
16-12-20 13:01,13:01,14898925,11440075,-3458850,SELL
16-12-20 13:02,13:02,14886950,11406775,-3480175,SELL
16-12-20 13:03,13:03,14824150,11436675,-3387475,SELL
16-12-20 13:04,13:04,14842700,11411500,-3431200,SELL
16-12-20 13:05,13:05,14798975,11419475,-3379500,SELL
16-12-20 13:06,13:06,14790425,11393175,-3397250,SELL
16-12-20 13:07,13:07,14802950,11379600,-3423350,SELL
16-12-20 13:08,13:08,14789000,11334550,-3454450,SELL
16-12-20 13:09,13:09,14812850,11524125,-3288725,SELL
16-12-20 13:10,13:10,14819000,11450250,-3368750,SELL
16-12-20 13:11,13:11,14810325,11476875,-3333450,SELL
16-12-20 13:12,13:12,14826375,11335675,-3490700,SELL
16-12-20 13:13,13:13,14808875,11313000,-3495875,SELL
16-12-20 13:14,13:14,14826375,11400175,-3426200,SELL
16-12-20 13:15,13:15,14883925,10835325,-4048600,SELL
16-12-20 13:16,13:16,14846675,11485575,-3361100,SELL
16-12-20 13:17,13:17,14767250,11366700,-3400550,SELL
16-12-20 13:18,13:18,14922475,11512575,-3409900,SELL
16-12-20 13:19,13:19,14918575,11424375,-3494200,SELL
16-12-20 13:20,13:20,14913075,11474350,-3438725,SELL
16-12-20 13:21,13:21,14859650,11449600,-3410050,SELL
16-12-20 13:22,13:22,14769925,11160475,-3609450,SELL
16-12-20 13:23,13:23,14850075,11541750,-3308325,SELL
16-12-20 13:24,13:24,14903975,11546750,-3357225,SELL
16-12-20 13:25,13:25,14884650,11613475,-3271175,SELL
16-12-20 13:26,13:26,14867300,11572025,-3295275,SELL
16-12-20 13:27,13:27,14853100,11374300,-3478800,SELL
16-12-20 13:28,13:28,14727675,11497450,-3230225,SELL
16-12-20 13:29,13:29,14842100,11540750,-3301350,SELL
16-12-20 13:30,13:30,14902950,11574225,-3328725,SELL
16-12-20 13:31,13:31,14899325,11532400,-3366925,SELL
16-12-20 13:32,13:32,14899325,11522650,-3376675,SELL
16-12-20 13:33,13:33,14808275,11208750,-3599525,SELL
16-12-20 13:34,13:34,14874600,11540200,-3334400,SELL
16-12-20 13:35,13:35,14871975,11570425,-3301550,SELL
16-12-20 13:36,13:36,14867150,11537775,-3329375,SELL
16-12-20 13:37,13:37,14869800,11532700,-3337100,SELL
16-12-20 13:38,13:38,14911525,11658400,-3253125,SELL
16-12-20 13:39,13:39,14911325,11648425,-3262900,SELL
16-12-20 13:40,13:40,14900100,11582550,-3317550,SELL
16-12-20 13:41,13:41,14877500,11649150,-3228350,SELL
16-12-20 13:42,13:42,14945675,11529575,-3416100,SELL
16-12-20 13:43,13:43,14939525,11555700,-3383825,SELL
16-12-20 13:44,13:44,14806950,11639025,-3167925,SELL
16-12-20 13:45,13:45,14885650,11769300,-3116350,SELL
16-12-20 13:46,13:46,14847200,11722625,-3124575,SELL
16-12-20 13:47,13:47,14847575,11708225,-3139350,SELL
16-12-20 13:48,13:48,14793825,11579100,-3214725,SELL
16-12-20 13:49,13:49,14727250,11687250,-3040000,SELL
16-12-20 13:50,13:50,14788525,11661400,-3127125,SELL
16-12-20 13:51,13:51,14821925,11739600,-3082325,SELL
16-12-20 13:52,13:52,14815225,11684850,-3130375,SELL
16-12-20 13:53,13:53,14805000,11724700,-3080300,SELL
16-12-20 13:54,13:54,14650475,11646650,-3003825,SELL
16-12-20 13:55,13:55,14667050,11624525,-3042525,SELL
16-12-20 13:56,13:56,14663225,11667300,-2995925,SELL
16-12-20 13:57,13:57,14670925,11695675,-2975250,SELL
16-12-20 13:58,13:58,14661125,11683775,-2977350,SELL
16-12-20 13:59,13:59,14655700,11669000,-2986700,SELL
16-12-20 14:00,14:00,14446375,11589275,-2857100,SELL
16-12-20 14:01,14:01,14437600,11619775,-2817825,SELL
16-12-20 14:02,14:02,14428925,11510375,-2918550,SELL
16-12-20 14:03,14:03,14397525,11494175,-2903350,SELL
16-12-20 14:04,14:04,14418325,11507875,-2910450,SELL
16-12-20 14:05,14:05,14403875,11501025,-2902850,SELL
16-12-20 14:06,14:06,14375075,11551425,-2823650,SELL
16-12-20 14:07,14:07,14366325,11499325,-2867000,SELL
16-12-20 14:08,14:08,14399600,11537550,-2862050,SELL
16-12-20 14:09,14:09,14268300,11507975,-2760325,SELL
16-12-20 14:10,14:10,14273950,10310550,-3963400,SELL
16-12-20 14:11,14:11,14270800,11487300,-2783500,SELL
16-12-20 14:12,14:12,14255850,11545000,-2710850,SELL
16-12-20 14:13,14:13,14275700,11383450,-2892250,SELL
16-12-20 14:14,14:14,14313125,11585650,-2727475,SELL
16-12-20 14:15,14:15,14305300,11569975,-2735325,SELL
16-12-20 14:16,14:16,14286550,11614825,-2671725,SELL
16-12-20 14:17,14:17,14285050,11629100,-2655950,SELL
16-12-20 14:18,14:18,14337325,11629525,-2707800,SELL
16-12-20 14:19,14:19,14338625,11647975,-2690650,SELL
16-12-20 14:20,14:20,14317525,11544975,-2772550,SELL
16-12-20 14:21,14:21,14362700,11555025,-2807675,SELL
16-12-20 14:22,14:22,14327700,11539150,-2788550,SELL
16-12-20 14:23,14:23,14327700,11325775,-3001925,SELL
16-12-20 14:24,14:24,14310000,11534825,-2775175,SELL
16-12-20 14:25,14:25,14303600,11582425,-2721175,SELL
16-12-20 14:26,14:26,14285525,11573325,-2712200,SELL
16-12-20 14:27,14:27,14308400,11661525,-2646875,SELL
16-12-20 14:28,14:28,14192875,11624425,-2568450,SELL
16-12-20 14:29,14:29,14296175,11536275,-2759900,SELL
16-12-20 14:30,14:30,14348925,11663800,-2685125,SELL
16-12-20 14:31,14:31,14317100,11622550,-2694550,SELL
16-12-20 14:32,14:32,14304875,11644375,-2660500,SELL
16-12-20 14:33,14:33,14078925,11182850,-2896075,SELL
16-12-20 14:34,14:34,14066425,11441700,-2624725,SELL
16-12-20 14:35,14:35,14066425,11391075,-2675350,SELL
16-12-20 14:36,14:36,14077750,11428000,-2649750,SELL
16-12-20 14:37,14:37,14070125,11496300,-2573825,SELL
16-12-20 14:38,14:38,14072475,11425400,-2647075,SELL
16-12-20 14:39,14:39,13942325,11410900,-2531425,SELL
16-12-20 14:40,14:40,13968450,11390950,-2577500,SELL
16-12-20 14:41,14:41,13962900,11195725,-2767175,SELL
16-12-20 14:42,14:42,13874100,11408450,-2465650,SELL
16-12-20 14:43,14:43,13869725,11340925,-2528800,SELL
16-12-20 14:44,14:44,13866225,11327250,-2538975,SELL
16-12-20 14:45,14:45,13914650,11209150,-2705500,SELL
16-12-20 14:46,14:46,13914625,11376325,-2538300,SELL
16-12-20 14:47,14:47,13906275,11335275,-2571000,SELL
16-12-20 14:48,14:48,13942325,11379675,-2562650,SELL
16-12-20 14:49,14:49,13929275,11346825,-2582450,SELL
16-12-20 14:50,14:50,13918275,11342875,-2575400,SELL
16-12-20 14:51,14:51,13892325,11317425,-2574900,SELL
16-12-20 14:52,14:52,13747800,11308400,-2439400,SELL
16-12-20 14:53,14:53,13888350,11327250,-2561100,SELL
16-12-20 14:54,14:54,13848525,11234275,-2614250,SELL
16-12-20 14:55,14:55,13864950,11203350,-2661600,SELL
16-12-20 14:56,14:56,13835125,11059125,-2776000,SELL
16-12-20 14:57,14:57,13702350,11066300,-2636050,SELL
16-12-20 14:58,14:58,13709950,10900625,-2809325,SELL
16-12-20 14:59,14:59,13686450,11115275,-2571175,SELL
16-12-20 15:00,15:00,13489425,11012325,-2477100,SELL
16-12-20 15:01,15:01,13459950,11037150,-2422800,SELL
16-12-20 15:02,15:02,13439775,11032300,-2407475,SELL
16-12-20 15:03,15:03,13336125,10925250,-2410875,SELL
16-12-20 15:04,15:04,13353975,10982900,-2371075,SELL
16-12-20 15:05,15:05,13330500,10981125,-2349375,SELL
16-12-20 15:06,15:06,13272175,10799500,-2472675,SELL
16-12-20 15:07,15:07,13301425,10901200,-2400225,SELL
16-12-20 15:08,15:08,13284075,10866250,-2417825,SELL
16-12-20 15:09,15:09,13151050,10671375,-2479675,SELL
16-12-20 15:10,15:10,13189150,10700125,-2489025,SELL
16-12-20 15:11,15:11,13161075,10677050,-2484025,SELL
16-12-20 15:12,15:12,13060050,10616725,-2443325,SELL
16-12-20 15:13,15:13,13024550,10642400,-2382150,SELL
16-12-20 15:14,15:14,13058875,10639725,-2419150,SELL
16-12-20 15:15,15:15,12904275,10400950,-2503325,SELL
16-12-20 15:16,15:16,12882225,10401600,-2480625,SELL
16-12-20 15:17,15:17,12900375,10417450,-2482925,SELL
16-12-20 15:18,15:18,12674550,10032425,-2642125,SELL
16-12-20 15:19,15:19,12647450,10060600,-2586850,SELL
16-12-20 15:20,15:20,12689650,10064175,-2625475,SELL
16-12-20 15:21,15:21,12413525,9846575,-2566950,SELL
16-12-20 15:22,15:22,12404050,9844200,-2559850,SELL
16-12-20 15:23,15:23,12400325,9851575,-2548750,SELL
16-12-20 15:24,15:24,12206725,9589300,-2617425,SELL
16-12-20 15:25,15:25,12239675,9627525,-2612150,SELL
16-12-20 15:26,15:26,12206575,9585175,-2621400,SELL
16-12-20 15:27,15:27,11993475,9275575,-2717900,SELL
16-12-20 15:28,15:28,12006775,9244775,-2762000,SELL
16-12-20 15:29,15:29,12017450,9268450,-2749000,SELL
17-12-20 9:15,9:15,11738775,8901625,-2837150,SELL
17-12-20 9:16,9:16,11714775,8885000,-2829775,SELL
17-12-20 9:17,9:17,11899900,9174300,-2725600,SELL
17-12-20 9:18,9:18,11879950,9164975,-2714975,SELL
17-12-20 9:19,9:19,11894925,9152075,-2742850,SELL
17-12-20 9:20,9:20,12372325,9750100,-2622225,SELL
17-12-20 9:21,9:21,12329250,9748850,-2580400,SELL
17-12-20 9:22,9:22,12321600,9749450,-2572150,SELL
17-12-20 9:23,9:23,12923900,10790525,-2133375,SELL
17-12-20 9:24,9:24,12928075,10772350,-2155725,SELL
17-12-20 9:25,9:25,12925275,10789050,-2136225,SELL
17-12-20 9:26,9:26,13746100,11675275,-2070825,SELL
17-12-20 9:27,9:27,13759400,11689875,-2069525,SELL
17-12-20 9:28,9:28,13772100,11702825,-2069275,SELL
17-12-20 9:29,9:29,14518100,12150250,-2367850,SELL
17-12-20 9:30,9:30,14535750,12145325,-2390425,SELL
17-12-20 9:31,9:31,14517300,12175100,-2342200,SELL
17-12-20 9:32,9:32,14934275,12639500,-2294775,SELL
17-12-20 9:33,9:33,14953325,12679250,-2274075,SELL
17-12-20 9:34,9:34,14969725,12603825,-2365900,SELL
17-12-20 9:35,9:35,15320400,13023325,-2297075,SELL
17-12-20 9:36,9:36,15339950,13019000,-2320950,SELL
17-12-20 9:37,9:37,15320175,13032175,-2288000,SELL
17-12-20 9:38,9:38,15615625,13394650,-2220975,SELL
17-12-20 9:39,9:39,15598375,13376025,-2222350,SELL
17-12-20 9:40,9:40,15584950,13241275,-2343675,SELL
17-12-20 9:41,9:41,15817375,13688750,-2128625,SELL
17-12-20 9:42,9:42,15790475,13672200,-2118275,SELL
17-12-20 9:43,9:43,15789675,13548275,-2241400,SELL
17-12-20 9:44,9:44,16008100,13856300,-2151800,SELL
17-12-20 9:45,9:45,16040200,13957425,-2082775,SELL
17-12-20 9:46,9:46,15762325,13957950,-1804375,SELL
17-12-20 9:47,9:47,15549750,14334325,-1215425,SELL
17-12-20 9:48,9:48,15399975,14187525,-1212450,SELL
17-12-20 9:49,9:49,15550325,14326250,-1224075,SELL
17-12-20 9:50,9:50,15537950,14555250,-982700,SELL
17-12-20 9:51,9:51,15589525,14564700,-1024825,SELL
17-12-20 9:52,9:52,15574225,14508800,-1065425,SELL
17-12-20 9:53,9:53,15749800,14751200,-998600,SELL
17-12-20 9:54,9:54,15750475,14791225,-959250,SELL
17-12-20 9:55,9:55,15743300,14741000,-1002300,SELL
17-12-20 9:56,9:56,15796425,14613575,-1182850,SELL
17-12-20 9:57,9:57,15682700,15003125,-679575,SELL
17-12-20 9:58,9:58,15788350,14975475,-812875,SELL
17-12-20 9:59,9:59,15876350,15077475,-798875,SELL
17-12-20 10:00,10:00,15898850,15222800,-676050,SELL
17-12-20 10:01,10:01,15918900,15065275,-853625,SELL
17-12-20 10:02,10:02,15824825,15473450,-351375,SELL
17-12-20 10:03,10:03,15842525,15439000,-403525,SELL
17-12-20 10:04,10:04,15821450,15276900,-544550,SELL
17-12-20 10:05,10:05,15959875,15485675,-474200,SELL
17-12-20 10:06,10:06,15950350,15504575,-445775,SELL
17-12-20 10:07,10:07,15945600,15416700,-528900,SELL
17-12-20 10:08,10:08,15710675,15358150,-352525,SELL
17-12-20 10:09,10:09,15949600,15625725,-323875,SELL
17-12-20 10:10,10:10,15799200,15675775,-123425,SELL
17-12-20 10:11,10:11,15999475,15812475,-187000,SELL
17-12-20 10:12,10:12,16025725,15672625,-353100,SELL
17-12-20 10:13,10:13,16027525,14955400,-1072125,SELL
17-12-20 10:14,10:14,16072125,15872000,-200125,SELL
17-12-20 10:15,10:15,16097700,15918975,-178725,SELL
17-12-20 10:16,10:16,16010325,15841050,-169275,SELL
17-12-20 10:17,10:17,16160325,15734550,-425775,SELL
17-12-20 10:18,10:18,16084300,15501550,-582750,SELL
17-12-20 10:19,10:19,16148975,15410975,-738000,SELL
17-12-20 10:20,10:20,16139400,15742375,-397025,SELL
17-12-20 10:21,10:21,16164900,15913975,-250925,SELL
17-12-20 10:22,10:22,16196325,15817150,-379175,SELL
17-12-20 10:23,10:23,16244475,15923800,-320675,SELL
17-12-20 10:24,10:24,16118125,15920700,-197425,SELL
17-12-20 10:25,10:25,16245525,16096825,-148700,SELL
17-12-20 10:26,10:26,16284250,16121975,-162275,SELL
17-12-20 10:27,10:27,16027900,15958300,-69600,SELL
17-12-20 10:28,10:28,16220600,15981175,-239425,SELL
17-12-20 10:29,10:29,16268275,15657700,-610575,SELL
17-12-20 10:30,10:30,16286450,16100550,-185900,SELL
17-12-20 10:31,10:31,16321400,16013625,-307775,SELL
17-12-20 10:32,10:32,16182700,16288850,106150,BUY
17-12-20 10:33,10:33,16444025,16326425,-117600,SELL
17-12-20 10:34,10:34,15112725,16311900,1199175,BUY
17-12-20 10:35,10:35,16388425,16309375,-79050,SELL
17-12-20 10:36,10:36,16560850,16242375,-318475,SELL
17-12-20 10:37,10:37,16494900,16302000,-192900,SELL
17-12-20 10:38,10:38,16717225,16360275,-356950,SELL
17-12-20 10:39,10:39,16427650,16081250,-346400,SELL
17-12-20 10:40,10:40,16532950,16268650,-264300,SELL
17-12-20 10:41,10:41,16652475,16145450,-507025,SELL
17-12-20 10:42,10:42,16686500,16161275,-525225,SELL
17-12-20 10:43,10:43,16686500,16151825,-534675,SELL
17-12-20 10:44,10:44,16786075,16146650,-639425,SELL
17-12-20 10:45,10:45,16839375,15577425,-1261950,SELL
17-12-20 10:46,10:46,16844350,16109025,-735325,SELL
17-12-20 10:47,10:47,16897500,16215500,-682000,SELL
17-12-20 10:48,10:48,16723575,16247950,-475625,SELL
17-12-20 10:49,10:49,16774550,15675925,-1098625,SELL
17-12-20 10:50,10:50,16707500,16499275,-208225,SELL
17-12-20 10:51,10:51,16871125,16553650,-317475,SELL
17-12-20 10:52,10:52,16705400,16276650,-428750,SELL
17-12-20 10:53,10:53,16886150,16444875,-441275,SELL
17-12-20 10:54,10:54,16877725,16555375,-322350,SELL
17-12-20 10:55,10:55,16944750,16425500,-519250,SELL
17-12-20 10:56,10:56,16668525,16880000,211475,BUY
17-12-20 10:57,10:57,16920750,16766000,-154750,SELL
17-12-20 10:58,10:58,16947675,16933625,-14050,SELL
17-12-20 10:59,10:59,16723650,16945025,221375,BUY
17-12-20 11:00,11:00,16681075,16938650,257575,BUY
17-12-20 11:01,11:01,16726625,16930350,203725,BUY
17-12-20 11:02,11:02,16802875,16703975,-98900,SELL
17-12-20 11:03,11:03,16787475,16980525,193050,BUY
17-12-20 11:04,11:04,16782725,16979125,196400,BUY
17-12-20 11:05,11:05,16738200,17169100,430900,BUY
17-12-20 11:06,11:06,16667100,17104750,437650,BUY
17-12-20 11:07,11:07,16681100,16986375,305275,BUY
17-12-20 11:08,11:08,16922850,17096300,173450,BUY
17-12-20 11:09,11:09,16660300,17101950,441650,BUY
17-12-20 11:10,11:10,16667550,17140075,472525,BUY
17-12-20 11:11,11:11,16687800,17228800,541000,BUY
17-12-20 11:12,11:12,16692950,17129525,436575,BUY
17-12-20 11:13,11:13,16811550,17063900,252350,BUY
17-12-20 11:14,11:14,16980475,17170000,189525,BUY
17-12-20 11:15,11:15,17036200,17285475,249275,BUY
17-12-20 11:16,11:16,16852850,17161000,308150,BUY
17-12-20 11:17,11:17,16838400,17329425,491025,BUY
17-12-20 11:18,11:18,16662400,17299400,637000,BUY
17-12-20 11:19,11:19,16808000,17188175,380175,BUY
17-12-20 11:20,11:20,16870100,17361850,491750,BUY
17-12-20 11:21,11:21,16910700,17076925,166225,BUY
17-12-20 11:22,11:22,16957625,17250450,292825,BUY
17-12-20 11:23,11:23,16829250,17084475,255225,BUY
17-12-20 11:24,11:24,16910325,16915975,5650,BUY
17-12-20 11:25,11:25,16960025,16857000,-103025,SELL
17-12-20 11:26,11:26,16891800,17324575,432775,BUY
17-12-20 11:27,11:27,17025425,17512550,487125,BUY
17-12-20 11:28,11:28,17009050,17477075,468025,BUY
17-12-20 11:29,11:29,16960200,17452875,492675,BUY
17-12-20 11:30,11:30,17036400,17490700,454300,BUY
17-12-20 11:31,11:31,16732775,17328250,595475,BUY
17-12-20 11:32,11:32,17048550,17487850,439300,BUY
17-12-20 11:33,11:33,16919500,17435725,516225,BUY
17-12-20 11:34,11:34,16741025,16108825,-632200,SELL
17-12-20 11:35,11:35,16800500,17423250,622750,BUY
17-12-20 11:36,11:36,16943675,17311625,367950,BUY
17-12-20 11:37,11:37,17022300,17164875,142575,BUY
17-12-20 11:38,11:38,17066325,17540375,474050,BUY
17-12-20 11:39,11:39,17033075,17261875,228800,BUY
17-12-20 11:40,11:40,16801400,17128100,326700,BUY
17-12-20 11:41,11:41,17076775,17005950,-70825,SELL
17-12-20 11:42,11:42,17107500,17668000,560500,BUY
17-12-20 11:43,11:43,16959950,17648075,688125,BUY
17-12-20 11:44,11:44,16959675,17599150,639475,BUY
17-12-20 11:45,11:45,17077450,17621775,544325,BUY
17-12-20 11:46,11:46,17079450,17616275,536825,BUY
17-12-20 11:47,11:47,17208825,17741100,532275,BUY
17-12-20 11:48,11:48,17054400,17753650,699250,BUY
17-12-20 11:49,11:49,17010875,17522975,512100,BUY
17-12-20 11:50,11:50,17203125,17838875,635750,BUY
17-12-20 11:51,11:51,16896800,17823175,926375,BUY
17-12-20 11:52,11:52,17193000,17376775,183775,BUY
17-12-20 11:53,11:53,17308600,17674000,365400,BUY
17-12-20 11:54,11:54,17257075,17755525,498450,BUY
17-12-20 11:55,11:55,17298350,17712925,414575,BUY
17-12-20 11:56,11:56,17037975,17856550,818575,BUY
17-12-20 11:57,11:57,17278600,17722825,444225,BUY
17-12-20 11:58,11:58,17084175,17856750,772575,BUY
17-12-20 11:59,11:59,17322025,17834550,512525,BUY
17-12-20 12:00,12:00,17261650,17841175,579525,BUY
17-12-20 12:01,12:01,17196725,17852175,655450,BUY
17-12-20 12:02,12:02,17061975,17597025,535050,BUY
17-12-20 12:03,12:03,17201650,17796925,595275,BUY
17-12-20 12:04,12:04,17268200,17855225,587025,BUY
17-12-20 12:05,12:05,17272100,17806400,534300,BUY
17-12-20 12:06,12:06,16868750,17850550,981800,BUY
17-12-20 12:07,12:07,16876275,17857150,980875,BUY
17-12-20 12:08,12:08,16921025,17774825,853800,BUY
17-12-20 12:09,12:09,16776325,17868725,1092400,BUY
17-12-20 12:14,12:14,15278950,17680500,2401550,BUY
17-12-20 12:15,12:15,15091025,17643775,2552750,BUY
17-12-20 12:16,12:16,15091050,17634800,2543750,BUY
17-12-20 12:17,12:17,15068050,17624450,2556400,BUY
17-12-20 12:18,12:18,14996375,17720775,2724400,BUY
17-12-20 12:19,12:19,14989400,17852800,2863400,BUY
17-12-20 12:20,12:20,15010725,17935300,2924575,BUY
17-12-20 12:21,12:21,15135775,18025625,2889850,BUY
17-12-20 12:22,12:22,15125375,18005400,2880025,BUY
17-12-20 12:23,12:23,15114375,17839175,2724800,BUY
17-12-20 12:24,12:24,15217625,17996550,2778925,BUY
17-12-20 12:25,12:25,15300375,18234825,2934450,BUY
17-12-20 12:26,12:26,15280975,18186050,2905075,BUY
17-12-20 12:27,12:27,15220075,18489875,3269800,BUY
17-12-20 12:28,12:28,15223175,18302800,3079625,BUY
17-12-20 12:29,12:29,15227350,18523550,3296200,BUY
17-12-20 12:30,12:30,15139650,18710000,3570350,BUY
17-12-20 12:31,12:31,15139225,18699200,3559975,BUY
17-12-20 12:32,12:32,15131700,18674425,3542725,BUY
17-12-20 12:33,12:33,15361225,18691700,3330475,BUY
17-12-20 12:34,12:34,15378125,18748475,3370350,BUY
17-12-20 12:35,12:35,15387500,18773800,3386300,BUY
17-12-20 12:36,12:36,15730100,18826775,3096675,BUY
17-12-20 12:37,12:37,15738200,18792675,3054475,BUY
17-12-20 12:38,12:38,15731000,18772850,3041850,BUY
17-12-20 12:39,12:39,15822925,18898725,3075800,BUY
17-12-20 12:40,12:40,15831700,18939000,3107300,BUY
17-12-20 12:41,12:41,15850475,18335625,2485150,BUY
17-12-20 12:42,12:42,15862975,19078850,3215875,BUY
17-12-20 12:43,12:43,15908025,19025350,3117325,BUY
17-12-20 12:44,12:44,15805150,18926275,3121125,BUY
17-12-20 12:45,12:45,16208275,18923025,2714750,BUY
17-12-20 12:46,12:46,16197175,18861300,2664125,BUY
17-12-20 12:47,12:47,16033750,18241075,2207325,BUY
17-12-20 12:48,12:48,16145700,18862450,2716750,BUY
17-12-20 12:49,12:49,16174625,18824700,2650075,BUY
17-12-20 12:50,12:50,16175225,18718675,2543450,BUY
17-12-20 12:51,12:51,16304900,19036900,2732000,BUY
17-12-20 12:52,12:52,16213450,18439950,2226500,BUY
17-12-20 12:53,12:53,16274575,18876775,2602200,BUY
17-12-20 12:54,12:54,16425225,18826100,2400875,BUY
17-12-20 12:55,12:55,16400750,18979925,2579175,BUY
17-12-20 12:56,12:56,16402300,18936525,2534225,BUY
17-12-20 12:57,12:57,15952425,18650150,2697725,BUY
17-12-20 12:58,12:58,15916800,18681375,2764575,BUY
17-12-20 12:59,12:59,15818325,18684625,2866300,BUY
17-12-20 13:00,13:00,16055900,18803950,2748050,BUY
17-12-20 13:01,13:01,16045325,18574250,2528925,BUY
17-12-20 13:02,13:02,15941075,18274350,2333275,BUY
17-12-20 13:03,13:03,16168650,18925475,2756825,BUY
17-12-20 13:04,13:04,16165500,18854950,2689450,BUY
17-12-20 13:05,13:05,16202150,18931275,2729125,BUY
17-12-20 13:06,13:06,16230225,18572425,2342200,BUY
17-12-20 13:07,13:07,16220075,18602275,2382200,BUY
17-12-20 13:08,13:08,16234775,18654025,2419250,BUY
17-12-20 13:09,13:09,16374400,18723900,2349500,BUY
17-12-20 13:10,13:10,16409450,18823775,2414325,BUY
17-12-20 13:11,13:11,16269700,18622325,2352625,BUY
17-12-20 13:12,13:12,16445050,18641275,2196225,BUY
17-12-20 13:13,13:13,16115900,18711850,2595950,BUY
17-12-20 13:14,13:14,16461525,18501525,2040000,BUY
17-12-20 13:15,13:15,16409800,18698600,2288800,BUY
17-12-20 13:16,13:16,16380600,18149750,1769150,BUY
17-12-20 13:17,13:17,16395375,18782975,2387600,BUY
17-12-20 13:18,13:18,16312300,18756950,2444650,BUY
17-12-20 13:19,13:19,16335475,18815025,2479550,BUY
17-12-20 13:20,13:20,16389600,18786500,2396900,BUY
17-12-20 13:21,13:21,16547575,18801400,2253825,BUY
17-12-20 13:22,13:22,16571600,18798025,2226425,BUY
17-12-20 13:23,13:23,16539275,18802100,2262825,BUY
17-12-20 13:24,13:24,16652875,18686275,2033400,BUY
17-12-20 13:25,13:25,16675900,18805050,2129150,BUY
17-12-20 13:26,13:26,16555975,18786075,2230100,BUY
17-12-20 13:27,13:27,16618050,18629500,2011450,BUY
17-12-20 13:28,13:28,16716425,18746600,2030175,BUY
17-12-20 13:29,13:29,16716500,18669500,1953000,BUY
17-12-20 13:30,13:30,16726325,18373450,1647125,BUY
17-12-20 13:31,13:31,16695000,18374600,1679600,BUY
17-12-20 13:32,13:32,16711175,18287825,1576650,BUY
17-12-20 13:33,13:33,16737625,18286025,1548400,BUY
17-12-20 13:34,13:34,16713750,18248225,1534475,BUY
17-12-20 13:35,13:35,16718525,18275100,1556575,BUY
17-12-20 13:36,13:36,16668275,17961625,1293350,BUY
17-12-20 13:37,13:37,16602750,18086800,1484050,BUY
17-12-20 13:38,13:38,16650025,17872150,1222125,BUY
17-12-20 13:39,13:39,16673600,17975600,1302000,BUY
17-12-20 13:40,13:40,16736725,17839750,1103025,BUY
17-12-20 13:41,13:41,16682800,18016425,1333625,BUY
17-12-20 13:42,13:42,16745200,18027075,1281875,BUY
17-12-20 13:43,13:43,16953550,18097400,1143850,BUY
17-12-20 13:44,13:44,16918725,17999475,1080750,BUY
17-12-20 13:45,13:45,16882400,17766775,884375,BUY
17-12-20 13:46,13:46,16898750,18000675,1101925,BUY
17-12-20 13:47,13:47,16897275,17918650,1021375,BUY
17-12-20 13:48,13:48,16983575,17992500,1008925,BUY
17-12-20 13:49,13:49,16971300,17846050,874750,BUY
17-12-20 13:50,13:50,16924075,17950125,1026050,BUY
17-12-20 13:51,13:51,16892325,17978175,1085850,BUY
17-12-20 13:52,13:52,16924025,18092500,1168475,BUY
17-12-20 13:53,13:53,16912300,18177400,1265100,BUY
17-12-20 13:54,13:54,16932400,18268100,1335700,BUY
17-12-20 13:55,13:55,16972000,17958200,986200,BUY
17-12-20 13:56,13:56,16874025,18217425,1343400,BUY
17-12-20 13:57,13:57,16939850,18026750,1086900,BUY
17-12-20 13:58,13:58,17045250,18205850,1160600,BUY
17-12-20 13:59,13:59,17070900,18169600,1098700,BUY
17-12-20 14:00,14:00,17000325,18295625,1295300,BUY
17-12-20 14:01,14:01,16938125,18186125,1248000,BUY
17-12-20 14:02,14:02,17001875,17430525,428650,BUY
17-12-20 14:03,14:03,16900925,18145125,1244200,BUY
17-12-20 14:04,14:04,16893375,17398300,504925,BUY
17-12-20 14:05,14:05,16871275,17951725,1080450,BUY
17-12-20 14:06,14:06,16925900,18034400,1108500,BUY
17-12-20 14:07,14:07,16862050,18180525,1318475,BUY
17-12-20 14:08,14:08,16813600,18154275,1340675,BUY
17-12-20 14:09,14:09,16960700,17317900,357200,BUY
17-12-20 14:10,14:10,16957575,17937700,980125,BUY
17-12-20 14:11,14:11,16948750,17777825,829075,BUY
17-12-20 14:12,14:12,17034400,17812300,777900,BUY
17-12-20 14:13,14:13,17111575,17728325,616750,BUY
17-12-20 14:14,14:14,17121100,17791375,670275,BUY
17-12-20 14:15,14:15,16996150,17754400,758250,BUY
17-12-20 14:16,14:16,17037725,17970250,932525,BUY
17-12-20 14:17,14:17,17044175,17661375,617200,BUY
17-12-20 14:18,14:18,17091725,17721500,629775,BUY
17-12-20 14:19,14:19,17033175,17506750,473575,BUY
17-12-20 14:20,14:20,17047925,17551700,503775,BUY
17-12-20 14:21,14:21,16916600,17084375,167775,BUY
17-12-20 14:22,14:22,16874700,17278025,403325,BUY
17-12-20 14:23,14:23,16903400,17328250,424850,BUY
17-12-20 14:24,14:24,16386350,16800250,413900,BUY
17-12-20 14:25,14:25,16375600,16802300,426700,BUY
17-12-20 14:26,14:26,16385075,16789725,404650,BUY
17-12-20 14:27,14:27,16370675,16943475,572800,BUY
17-12-20 14:28,14:28,16357225,16821150,463925,BUY
17-12-20 14:29,14:29,16357950,16942425,584475,BUY
17-12-20 14:30,14:30,16419900,16937300,517400,BUY
17-12-20 14:31,14:31,16413850,17011575,597725,BUY
17-12-20 14:32,14:32,16423525,16937300,513775,BUY
17-12-20 14:33,14:33,16168600,16782600,614000,BUY
17-12-20 14:34,14:34,16202225,16312425,110200,BUY
17-12-20 14:35,14:35,16219175,16827200,608025,BUY
17-12-20 14:36,14:36,16267150,17150925,883775,BUY
17-12-20 14:37,14:37,16242450,17116075,873625,BUY
17-12-20 14:38,14:38,16190125,17145650,955525,BUY
17-12-20 14:39,14:39,16092050,17072725,980675,BUY
17-12-20 14:40,14:40,16125250,17143650,1018400,BUY
17-12-20 14:41,14:41,16108025,17088950,980925,BUY
17-12-20 14:42,14:42,15937850,17305150,1367300,BUY
17-12-20 14:43,14:43,15909925,17234800,1324875,BUY
17-12-20 14:44,14:44,15943550,16891800,948250,BUY
17-12-20 14:45,14:45,15684050,17021900,1337850,BUY
17-12-20 14:46,14:46,15728325,17091675,1363350,BUY
17-12-20 14:47,14:47,15622350,17061675,1439325,BUY
17-12-20 14:48,14:48,15610100,17216100,1606000,BUY
17-12-20 14:49,14:49,15598825,17194250,1595425,BUY
17-12-20 14:50,14:50,15608400,17164775,1556375,BUY
17-12-20 14:51,14:51,15440275,16691400,1251125,BUY
17-12-20 14:52,14:52,15422925,16739025,1316100,BUY
17-12-20 14:53,14:53,15440600,16724900,1284300,BUY
17-12-20 14:54,14:54,15199750,16398600,1198850,BUY
17-12-20 14:55,14:55,15186325,16391475,1205150,BUY
17-12-20 14:56,14:56,15187000,16429525,1242525,BUY
17-12-20 14:57,14:57,15006625,15985000,978375,BUY
17-12-20 14:58,14:58,15045950,15836700,790750,BUY
17-12-20 14:59,14:59,15013375,15296075,282700,BUY
17-12-20 15:00,15:00,14703475,15862625,1159150,BUY
17-12-20 15:01,15:01,14845850,15796075,950225,BUY
17-12-20 15:02,15:02,14831775,15674450,842675,BUY
17-12-20 15:03,15:03,14511275,15111325,600050,BUY
17-12-20 15:04,15:04,14507450,15242525,735075,BUY
17-12-20 15:05,15:05,14511325,15305125,793800,BUY
17-12-20 15:06,15:06,13988000,14753100,765100,BUY
17-12-20 15:07,15:07,13984225,14881625,897400,BUY
17-12-20 15:08,15:08,13980600,14851300,870700,BUY
17-12-20 15:09,15:09,13432000,14206700,774700,BUY
17-12-20 15:10,15:10,13418850,14272825,853975,BUY
17-12-20 15:11,15:11,13371225,14334200,962975,BUY
17-12-20 15:12,15:12,12825375,13690225,864850,BUY
17-12-20 15:13,15:13,12763175,13721550,958375,BUY
17-12-20 15:14,15:14,12819900,13688225,868325,BUY
17-12-20 15:15,15:15,12268300,13235200,966900,BUY
17-12-20 15:16,15:16,12217825,13185550,967725,BUY
17-12-20 15:17,15:17,12168675,13168550,999875,BUY
17-12-20 15:18,15:18,11459550,12670775,1211225,BUY
17-12-20 15:19,15:19,11439325,12647675,1208350,BUY
17-12-20 15:20,15:20,11454825,12577350,1122525,BUY
17-12-20 15:21,15:21,10656850,11786425,1129575,BUY
17-12-20 15:22,15:22,10686950,11684300,997350,BUY
17-12-20 15:23,15:23,10673650,11041275,367625,BUY
17-12-20 15:24,15:24,9927650,10990350,1062700,BUY
17-12-20 15:25,15:25,9920875,11452900,1532025,BUY
17-12-20 15:26,15:26,10017975,11505025,1487050,BUY
17-12-20 15:27,15:27,9396625,9893700,497075,BUY
17-12-20 15:28,15:28,9385950,9922425,536475,BUY
17-12-20 15:29,15:29,9379500,10001200,621700,BUY
18-12-20 9:15,9:15,2562625,3714650,1152025,BUY
18-12-20 9:16,9:16,2539850,3714500,1174650,BUY
18-12-20 9:17,9:17,2754275,3896650,1142375,BUY
18-12-20 9:18,9:18,2767550,3894550,1127000,BUY
18-12-20 9:19,9:19,2772875,3904850,1131975,BUY
18-12-20 9:20,9:20,3184675,4318875,1134200,BUY
18-12-20 9:21,9:21,3203800,4326625,1122825,BUY
18-12-20 9:22,9:22,3180925,4316575,1135650,BUY
18-12-20 9:23,9:23,3418000,4507825,1089825,BUY
18-12-20 9:24,9:24,3444450,4505225,1060775,BUY
18-12-20 9:25,9:25,3414475,4508775,1094300,BUY
18-12-20 9:26,9:26,3670300,4666875,996575,BUY
18-12-20 9:27,9:27,3648050,4652700,1004650,BUY
18-12-20 9:28,9:28,3661950,4665125,1003175,BUY
18-12-20 9:29,9:29,3866350,4767650,901300,BUY
18-12-20 9:30,9:30,3861625,4764700,903075,BUY
18-12-20 9:31,9:31,3866225,4770875,904650,BUY
18-12-20 9:32,9:32,4118175,4799100,680925,BUY
18-12-20 9:33,9:33,4110575,4801525,690950,BUY
18-12-20 9:34,9:34,4107550,4789375,681825,BUY
18-12-20 9:35,9:35,4390825,4829000,438175,BUY
18-12-20 9:36,9:36,4386400,4826650,440250,BUY
18-12-20 9:37,9:37,4386150,4805025,418875,BUY
18-12-20 9:38,9:38,4573975,4899300,325325,BUY
18-12-20 9:39,9:39,4591150,4910675,319525,BUY
18-12-20 9:40,9:40,4586625,4909125,322500,BUY
18-12-20 9:41,9:41,4853600,4910175,56575,BUY
18-12-20 9:42,9:42,4857525,4916100,58575,BUY
18-12-20 9:43,9:43,4862500,4910175,47675,BUY
18-12-20 9:44,9:44,4978600,5061750,83150,BUY
18-12-20 9:45,9:45,4984425,5065550,81125,BUY
18-12-20 9:46,9:46,4970650,5051625,80975,BUY
18-12-20 9:47,9:47,5122875,5333475,210600,BUY
18-12-20 9:48,9:48,5091500,5331925,240425,BUY
18-12-20 9:49,9:49,5111850,5313900,202050,BUY
18-12-20 9:50,9:50,5277750,5443500,165750,BUY
18-12-20 9:51,9:51,5266875,5448175,181300,BUY
18-12-20 9:52,9:52,5270775,5462375,191600,BUY
18-12-20 9:53,9:53,5380350,5534600,154250,BUY
18-12-20 9:54,9:54,5382950,5538150,155200,BUY
18-12-20 9:55,9:55,5364350,5531625,167275,BUY
18-12-20 9:56,9:56,5599975,5461400,-138575,SELL
18-12-20 9:57,9:57,5602225,5467500,-134725,SELL
18-12-20 9:58,9:58,5597625,5457150,-140475,SELL
18-12-20 9:59,9:59,5826900,5421875,-405025,SELL
18-12-20 10:00,10:00,5831800,5428875,-402925,SELL
18-12-20 10:01,10:01,5834975,5428875,-406100,SELL
18-12-20 10:02,10:02,5969775,5491575,-478200,SELL
18-12-20 10:03,10:03,5948175,5488550,-459625,SELL
18-12-20 10:04,10:04,5957200,5492825,-464375,SELL
18-12-20 10:05,10:05,6053000,5687000,-366000,SELL
18-12-20 10:06,10:06,6079450,5700400,-379050,SELL
18-12-20 10:07,10:07,6078375,5690775,-387600,SELL
18-12-20 10:08,10:08,6094975,5815725,-279250,SELL
18-12-20 10:09,10:09,6091100,5809200,-281900,SELL
18-12-20 10:10,10:10,6088750,5810375,-278375,SELL
18-12-20 10:11,10:11,6204125,5967275,-236850,SELL
18-12-20 10:12,10:12,6195425,5934275,-261150,SELL
18-12-20 10:13,10:13,6195425,5959700,-235725,SELL
18-12-20 10:14,10:14,6235475,6061575,-173900,SELL
18-12-20 10:15,10:15,6239475,6050025,-189450,SELL
18-12-20 10:16,10:16,6233850,6062675,-171175,SELL
18-12-20 10:17,10:17,6291875,6116900,-174975,SELL
18-12-20 10:18,10:18,6292475,6115025,-177450,SELL
18-12-20 10:19,10:19,6290850,6102100,-188750,SELL
18-12-20 10:20,10:20,6337400,6169750,-167650,SELL
18-12-20 10:21,10:21,6317275,6184775,-132500,SELL
18-12-20 10:22,10:22,6331575,6203750,-127825,SELL
18-12-20 10:23,10:23,6395725,6285800,-109925,SELL
18-12-20 10:24,10:24,6381175,6281525,-99650,SELL
18-12-20 10:25,10:25,6383925,6230225,-153700,SELL
18-12-20 10:26,10:26,6460875,6366425,-94450,SELL
18-12-20 10:27,10:27,6456875,6347150,-109725,SELL
18-12-20 10:28,10:28,6446775,6337200,-109575,SELL
18-12-20 10:29,10:29,6530250,6353800,-176450,SELL
18-12-20 10:30,10:30,6539800,6393600,-146200,SELL
18-12-20 10:31,10:31,6517625,6356650,-160975,SELL
18-12-20 10:32,10:32,6589575,6419425,-170150,SELL
18-12-20 10:33,10:33,6581050,6428900,-152150,SELL
18-12-20 10:34,10:34,6574275,6431100,-143175,SELL
18-12-20 10:35,10:35,6580850,6473450,-107400,SELL
18-12-20 10:36,10:36,6601275,6471700,-129575,SELL
18-12-20 10:37,10:37,6584850,6488075,-96775,SELL
18-12-20 10:38,10:38,6617925,6565425,-52500,SELL
18-12-20 10:39,10:39,6630550,6548975,-81575,SELL
18-12-20 10:40,10:40,6630550,6543575,-86975,SELL
18-12-20 10:41,10:41,6650875,6588900,-61975,SELL
18-12-20 10:42,10:42,6661225,6591875,-69350,SELL
18-12-20 10:43,10:43,6642950,6574075,-68875,SELL
18-12-20 10:44,10:44,6701325,6618250,-83075,SELL
18-12-20 10:45,10:45,6687100,6618425,-68675,SELL
18-12-20 10:46,10:46,6691825,6593750,-98075,SELL
18-12-20 10:47,10:47,6725050,6662900,-62150,SELL
18-12-20 10:48,10:48,6735600,6637250,-98350,SELL
18-12-20 10:49,10:49,6744825,6669400,-75425,SELL
18-12-20 10:50,10:50,6761725,6716475,-45250,SELL
18-12-20 10:51,10:51,6763975,6686900,-77075,SELL
18-12-20 10:52,10:52,6748700,6703375,-45325,SELL
18-12-20 10:53,10:53,6741500,6764250,22750,BUY
18-12-20 10:54,10:54,6736475,6801975,65500,BUY
18-12-20 10:55,10:55,6748725,6780750,32025,BUY
18-12-20 10:56,10:56,6770625,6815350,44725,BUY
18-12-20 10:57,10:57,6749775,6763800,14025,BUY
18-12-20 10:58,10:58,6766325,6784025,17700,BUY
18-12-20 10:59,10:59,6783125,6788625,5500,BUY
18-12-20 11:00,11:00,6768475,6804575,36100,BUY
18-12-20 11:01,11:01,6773175,6790000,16825,BUY
18-12-20 11:02,11:02,6801275,6874925,73650,BUY
18-12-20 11:03,11:03,6805250,6848925,43675,BUY
18-12-20 11:04,11:04,6792100,6868075,75975,BUY
18-12-20 11:05,11:05,6762450,6866150,103700,BUY
18-12-20 11:06,11:06,6758500,6890775,132275,BUY
18-12-20 11:07,11:07,6769275,6919825,150550,BUY
18-12-20 11:08,11:08,6792875,6847900,55025,BUY
18-12-20 11:09,11:09,6797600,6920600,123000,BUY
18-12-20 11:10,11:10,6791125,6928525,137400,BUY
18-12-20 11:11,11:11,6829525,6895625,66100,BUY
18-12-20 11:12,11:12,6819825,6926025,106200,BUY
18-12-20 11:13,11:13,6827525,6895850,68325,BUY
18-12-20 11:14,11:14,6743775,6919250,175475,BUY
18-12-20 11:15,11:15,6813850,6910425,96575,BUY
18-12-20 11:16,11:16,6815850,6938650,122800,BUY
18-12-20 11:17,11:17,6819750,6892075,72325,BUY
18-12-20 11:18,11:18,6820800,6916175,95375,BUY
18-12-20 11:19,11:19,6825275,6936400,111125,BUY
18-12-20 11:20,11:20,6819575,6920375,100800,BUY
18-12-20 11:21,11:21,6829475,6964950,135475,BUY
18-12-20 11:22,11:22,6823900,6896875,72975,BUY
18-12-20 11:23,11:23,6846825,6954775,107950,BUY
18-12-20 11:24,11:24,6834325,6947550,113225,BUY
18-12-20 11:25,11:25,6850925,7010700,159775,BUY
18-12-20 11:26,11:26,6806700,7048700,242000,BUY
18-12-20 11:27,11:27,6797075,7012925,215850,BUY
18-12-20 11:28,11:28,6788025,6974450,186425,BUY
18-12-20 11:29,11:29,6730100,6997975,267875,BUY
18-12-20 11:30,11:30,6722050,7008575,286525,BUY
18-12-20 11:31,11:31,6721050,7008075,287025,BUY
18-12-20 11:32,11:32,6731375,7003125,271750,BUY
18-12-20 11:33,11:33,6732850,7021950,289100,BUY
18-12-20 11:34,11:34,6734975,6972575,237600,BUY
18-12-20 11:35,11:35,6728700,7029975,301275,BUY
18-12-20 11:36,11:36,6725825,6952750,226925,BUY
18-12-20 11:37,11:37,6721675,6937400,215725,BUY
18-12-20 11:38,11:38,6724475,6793475,69000,BUY
18-12-20 11:39,11:39,6722750,6971475,248725,BUY
18-12-20 11:40,11:40,6741875,6989950,248075,BUY
18-12-20 11:41,11:41,6775575,7047525,271950,BUY
18-12-20 11:42,11:42,6757075,6996900,239825,BUY
18-12-20 11:43,11:43,6773500,6947450,173950,BUY
18-12-20 11:44,11:44,6758700,7038400,279700,BUY
18-12-20 11:45,11:45,6748250,6998075,249825,BUY
18-12-20 11:46,11:46,6741450,7008075,266625,BUY
18-12-20 11:47,11:47,6743175,6996900,253725,BUY
18-12-20 11:48,11:48,6759575,6978375,218800,BUY
18-12-20 11:49,11:49,6742775,6977450,234675,BUY
18-12-20 11:50,11:50,6685400,6990925,305525,BUY
18-12-20 11:51,11:51,6762600,7008700,246100,BUY
18-12-20 11:52,11:52,6775050,6999125,224075,BUY
18-12-20 11:53,11:53,6766150,7013200,247050,BUY
18-12-20 11:54,11:54,6798125,7101375,303250,BUY
18-12-20 11:55,11:55,6775825,6801125,25300,BUY
18-12-20 11:56,11:56,6826350,7081925,255575,BUY
18-12-20 11:57,11:57,6809425,7054675,245250,BUY
18-12-20 11:58,11:58,6811275,7014650,203375,BUY
18-12-20 11:59,11:59,6803125,6978425,175300,BUY
18-12-20 12:00,12:00,6821825,7038450,216625,BUY
18-12-20 12:01,12:01,6813200,7027150,213950,BUY
18-12-20 12:02,12:02,6816300,7102575,286275,BUY
18-12-20 12:03,12:03,6816450,7079175,262725,BUY
18-12-20 12:04,12:04,6807625,7020500,212875,BUY
18-12-20 12:05,12:05,6813150,7044650,231500,BUY
18-12-20 12:06,12:06,6772675,6951475,178800,BUY
18-12-20 12:07,12:07,6796200,7090025,293825,BUY
18-12-20 12:08,12:08,6789600,7107450,317850,BUY
18-12-20 12:09,12:09,6785550,7103075,317525,BUY
18-12-20 12:10,12:10,6805425,7081800,276375,BUY
18-12-20 12:11,12:11,6792900,6833550,40650,BUY
18-12-20 12:12,12:12,6824200,7126625,302425,BUY
18-12-20 12:13,12:13,6791650,7097225,305575,BUY
18-12-20 12:14,12:14,6778425,6862500,84075,BUY
18-12-20 12:15,12:15,6788100,7160200,372100,BUY
18-12-20 12:16,12:16,6783750,6856225,72475,BUY
18-12-20 12:17,12:17,6794700,7122100,327400,BUY
18-12-20 12:18,12:18,6801475,7090050,288575,BUY
18-12-20 12:19,12:19,6822700,6833950,11250,BUY
18-12-20 12:20,12:20,6844250,7131200,286950,BUY
18-12-20 12:21,12:21,6861500,7113675,252175,BUY
18-12-20 12:22,12:22,6868500,6899150,30650,BUY
18-12-20 12:23,12:23,6749025,7091100,342075,BUY
18-12-20 12:24,12:24,6849950,7118900,268950,BUY
18-12-20 12:25,12:25,6853750,7135075,281325,BUY
18-12-20 12:26,12:26,6857325,7161275,303950,BUY
18-12-20 12:27,12:27,6879775,7166975,287200,BUY
18-12-20 12:28,12:28,6868825,7157550,288725,BUY
18-12-20 12:29,12:29,6893375,7176350,282975,BUY
18-12-20 12:30,12:30,6862000,7137725,275725,BUY
18-12-20 12:31,12:31,6867700,7177700,310000,BUY
18-12-20 12:32,12:32,6829175,7196525,367350,BUY
18-12-20 12:33,12:33,6889825,7221050,331225,BUY
18-12-20 12:34,12:34,6896250,7222500,326250,BUY
18-12-20 12:35,12:35,6885600,7216925,331325,BUY
18-12-20 12:36,12:36,6927025,7250300,323275,BUY
18-12-20 12:37,12:37,6918775,7237475,318700,BUY
18-12-20 12:38,12:38,6931800,7235550,303750,BUY
18-12-20 12:39,12:39,6942750,7213025,270275,BUY
18-12-20 12:40,12:40,6948775,7192875,244100,BUY
18-12-20 12:41,12:41,6944975,7162700,217725,BUY
18-12-20 12:42,12:42,6971650,7198700,227050,BUY
18-12-20 12:43,12:43,6978975,7198200,219225,BUY
18-12-20 12:44,12:44,6977650,7164800,187150,BUY
18-12-20 12:45,12:45,6990850,7241150,250300,BUY
18-12-20 12:46,12:46,6995675,7238075,242400,BUY
18-12-20 12:47,12:47,6993950,7230350,236400,BUY
18-12-20 12:48,12:48,6985675,7238125,252450,BUY
18-12-20 12:49,12:49,6970075,7191450,221375,BUY
18-12-20 12:50,12:50,6974800,7184875,210075,BUY
18-12-20 12:51,12:51,6985225,7262775,277550,BUY
18-12-20 12:52,12:52,6991250,7195250,204000,BUY
18-12-20 12:53,12:53,6973400,7219825,246425,BUY
18-12-20 12:54,12:54,6999250,7198750,199500,BUY
18-12-20 12:55,12:55,6983625,7196675,213050,BUY
18-12-20 12:56,12:56,6990275,7211450,221175,BUY
18-12-20 12:57,12:57,7012200,7167900,155700,BUY
18-12-20 12:58,12:58,6977750,7177075,199325,BUY
18-12-20 12:59,12:59,6974550,7160850,186300,BUY
18-12-20 13:00,13:00,6993075,7231375,238300,BUY
18-12-20 13:01,13:01,7008175,7274975,266800,BUY
18-12-20 13:02,13:02,6992550,7238950,246400,BUY
18-12-20 13:03,13:03,7015850,7270725,254875,BUY
18-12-20 13:04,13:04,7035650,7280475,244825,BUY
18-12-20 13:05,13:05,7031250,7284375,253125,BUY
18-12-20 13:06,13:06,7035400,7278950,243550,BUY
18-12-20 13:07,13:07,7062250,7282000,219750,BUY
18-12-20 13:08,13:08,7039800,7268175,228375,BUY
18-12-20 13:09,13:09,7045875,7202000,156125,BUY
18-12-20 13:10,13:10,7072075,7255825,183750,BUY
18-12-20 13:11,13:11,7068300,7284850,216550,BUY
18-12-20 13:12,13:12,7026125,7228925,202800,BUY
18-12-20 13:13,13:13,7030575,7176900,146325,BUY
18-12-20 13:14,13:14,7030575,7211250,180675,BUY
18-12-20 13:15,13:15,7041525,7246625,205100,BUY
18-12-20 13:16,13:16,7041225,7256225,215000,BUY
18-12-20 13:17,13:17,7047075,7235575,188500,BUY
18-12-20 13:18,13:18,7059300,7248500,189200,BUY
18-12-20 13:19,13:19,7057800,7222275,164475,BUY
18-12-20 13:20,13:20,7061125,7218300,157175,BUY
18-12-20 13:21,13:21,7039900,6967875,-72025,SELL
18-12-20 13:22,13:22,7063750,7234900,171150,BUY
18-12-20 13:23,13:23,7061325,7215275,153950,BUY
18-12-20 13:24,13:24,7051350,7257125,205775,BUY
18-12-20 13:25,13:25,7071325,7286550,215225,BUY
18-12-20 13:26,13:26,7087125,7329050,241925,BUY
18-12-20 13:27,13:27,7052875,7309575,256700,BUY
18-12-20 13:28,13:28,7023925,7291350,267425,BUY
18-12-20 13:29,13:29,7019125,7298475,279350,BUY
18-12-20 13:30,13:30,6753150,7138925,385775,BUY
18-12-20 13:31,13:31,6745500,7107050,361550,BUY
18-12-20 13:32,13:32,6745500,7120900,375400,BUY
18-12-20 13:33,13:33,6719300,7140475,421175,BUY
18-12-20 13:34,13:34,6704850,7165450,460600,BUY
18-12-20 13:35,13:35,6715800,7163425,447625,BUY
18-12-20 13:36,13:36,6737775,7117725,379950,BUY
18-12-20 13:37,13:37,6712750,7125675,412925,BUY
18-12-20 13:38,13:38,6735700,7155850,420150,BUY
18-12-20 13:39,13:39,6720975,7143600,422625,BUY
18-12-20 13:40,13:40,6723700,7168100,444400,BUY
18-12-20 13:41,13:41,6742400,7154925,412525,BUY
18-12-20 13:42,13:42,6732400,7101800,369400,BUY
18-12-20 13:43,13:43,6738350,7156200,417850,BUY
18-12-20 13:44,13:44,6738350,7166400,428050,BUY
18-12-20 13:45,13:45,6755100,7161875,406775,BUY
18-12-20 13:46,13:46,6755100,7164850,409750,BUY
18-12-20 13:47,13:47,6755100,7128875,373775,BUY
18-12-20 13:48,13:48,6791800,7139000,347200,BUY
18-12-20 13:49,13:49,6791800,7155225,363425,BUY
18-12-20 13:50,13:50,6791800,7162100,370300,BUY
18-12-20 13:51,13:51,6806050,7162250,356200,BUY
18-12-20 13:52,13:52,6803275,6968350,165075,BUY
18-12-20 13:53,13:53,6813625,7178450,364825,BUY
18-12-20 13:54,13:54,6869000,7011725,142725,BUY
18-12-20 13:55,13:55,6865325,7267100,401775,BUY
18-12-20 13:56,13:56,6871775,7241675,369900,BUY
18-12-20 13:57,13:57,6854625,7232800,378175,BUY
18-12-20 13:58,13:58,6840300,7237875,397575,BUY
18-12-20 13:59,13:59,6835100,7225725,390625,BUY
18-12-20 14:00,14:00,6898325,7221975,323650,BUY
18-12-20 14:01,14:01,6901375,7230950,329575,BUY
18-12-20 14:02,14:02,6918050,7206800,288750,BUY
18-12-20 14:03,14:03,6924375,7252625,328250,BUY
18-12-20 14:04,14:04,6951100,7254100,303000,BUY
18-12-20 14:05,14:05,6920575,7249500,328925,BUY
18-12-20 14:06,14:06,6909175,7172800,263625,BUY
18-12-20 14:07,14:07,6909175,7185225,276050,BUY
18-12-20 14:08,14:08,6941925,7263100,321175,BUY
18-12-20 14:09,14:09,6804300,7185600,381300,BUY
18-12-20 14:10,14:10,6823000,7213050,390050,BUY
18-12-20 14:11,14:11,6794250,7180575,386325,BUY
18-12-20 14:12,14:12,6644575,7164050,519475,BUY
18-12-20 14:13,14:13,6652975,7163000,510025,BUY
18-12-20 14:14,14:14,6645100,7152775,507675,BUY
18-12-20 14:15,14:15,6490700,7184125,693425,BUY
18-12-20 14:16,14:16,6481000,7183750,702750,BUY
18-12-20 14:17,14:17,6481000,7146750,665750,BUY
18-12-20 14:18,14:18,6426225,7107775,681550,BUY
18-12-20 14:19,14:19,6426225,7175500,749275,BUY
18-12-20 14:20,14:20,6436500,7163175,726675,BUY
18-12-20 14:21,14:21,6479000,7198300,719300,BUY
18-12-20 14:22,14:22,6472550,7146600,674050,BUY
18-12-20 14:23,14:23,6478075,7168125,690050,BUY
18-12-20 14:24,14:24,6419300,7164675,745375,BUY
18-12-20 14:25,14:25,6405150,7209700,804550,BUY
18-12-20 14:26,14:26,6409475,7223600,814125,BUY
18-12-20 14:27,14:27,6414350,7191525,777175,BUY
18-12-20 14:28,14:28,6426550,7176675,750125,BUY
18-12-20 14:29,14:29,6415275,7181075,765800,BUY
18-12-20 14:30,14:30,6424950,7192725,767775,BUY
18-12-20 14:31,14:31,6430400,7199125,768725,BUY
18-12-20 14:32,14:32,6432950,7192950,760000,BUY
18-12-20 14:33,14:33,6346275,7240125,893850,BUY
18-12-20 14:34,14:34,6356600,7221025,864425,BUY
18-12-20 14:35,14:35,6368325,7250200,881875,BUY
18-12-20 14:36,14:36,6243175,7209675,966500,BUY
18-12-20 14:37,14:37,6230125,7208725,978600,BUY
18-12-20 14:38,14:38,6216350,7204775,988425,BUY
18-12-20 14:39,14:39,6089375,7127025,1037650,BUY
18-12-20 14:40,14:40,6089300,7101525,1012225,BUY
18-12-20 14:41,14:41,6058100,7129600,1071500,BUY
18-12-20 14:42,14:42,6007675,7158000,1150325,BUY
18-12-20 14:43,14:43,6019675,7187025,1167350,BUY
18-12-20 14:44,14:44,5993900,7151225,1157325,BUY
18-12-20 14:45,14:45,5895550,7138125,1242575,BUY
18-12-20 14:46,14:46,5900325,7154225,1253900,BUY
18-12-20 14:47,14:47,5904525,7142725,1238200,BUY
18-12-20 14:48,14:48,5870925,7123000,1252075,BUY
18-12-20 14:49,14:49,5847375,7115750,1268375,BUY
18-12-20 14:50,14:50,5854325,7131500,1277175,BUY
18-12-20 14:51,14:51,5835275,7100275,1265000,BUY
18-12-20 14:52,14:52,5833800,7099400,1265600,BUY
18-12-20 14:53,14:53,5824275,7048375,1224100,BUY
18-12-20 14:54,14:54,5699800,7036125,1336325,BUY
18-12-20 14:55,14:55,5695175,6970525,1275350,BUY
18-12-20 14:56,14:56,5702000,7017100,1315100,BUY
18-12-20 14:57,14:57,5633825,6920725,1286900,BUY
18-12-20 14:58,14:58,5637050,6948000,1310950,BUY
18-12-20 14:59,14:59,5632425,6946150,1313725,BUY
18-12-20 15:00,15:00,5529350,6864500,1335150,BUY
18-12-20 15:01,15:01,5531775,6839125,1307350,BUY
18-12-20 15:02,15:02,5523900,6843725,1319825,BUY
18-12-20 15:03,15:03,5489200,6786750,1297550,BUY
18-12-20 15:04,15:04,5515600,6803625,1288025,BUY
18-12-20 15:05,15:05,5497025,6792300,1295275,BUY
18-12-20 15:06,15:06,5434750,6666375,1231625,BUY
18-12-20 15:07,15:07,5459250,6692050,1232800,BUY
18-12-20 15:08,15:08,5455875,6663725,1207850,BUY
18-12-20 15:09,15:09,5465575,6652550,1186975,BUY
18-12-20 15:10,15:10,5482650,6675400,1192750,BUY
18-12-20 15:11,15:11,5470450,6675400,1204950,BUY
18-12-20 15:12,15:12,5419750,6625625,1205875,BUY
18-12-20 15:13,15:13,5432825,6635100,1202275,BUY
18-12-20 15:14,15:14,5429800,6643525,1213725,BUY
18-12-20 15:15,15:15,5361375,6588350,1226975,BUY
18-12-20 15:16,15:16,5361425,6584075,1222650,BUY
18-12-20 15:17,15:17,5373200,6593650,1220450,BUY
18-12-20 15:18,15:18,5316450,6597400,1280950,BUY
18-12-20 15:19,15:19,5325000,6580050,1255050,BUY
18-12-20 15:20,15:20,5329700,6581900,1252200,BUY
18-12-20 15:21,15:21,5222875,6420825,1197950,BUY
18-12-20 15:22,15:22,5212550,6387575,1175025,BUY
18-12-20 15:23,15:23,5209200,6416650,1207450,BUY
18-12-20 15:24,15:24,5116350,6313125,1196775,BUY
18-12-20 15:25,15:25,5134525,6315325,1180800,BUY
18-12-20 15:26,15:26,5125175,6305325,1180150,BUY
18-12-20 15:27,15:27,5077750,6193750,1116000,BUY
18-12-20 15:28,15:28,5082725,6195775,1113050,BUY
18-12-20 15:29,15:29,5079925,6210050,1130125,BUY
21-12-20 9:15,9:15,5028625,6099675,1071050,BUY
21-12-20 9:16,9:16,5019425,6095275,1075850,BUY
21-12-20 9:17,9:17,5143175,6176100,1032925,BUY
21-12-20 9:18,9:18,5146975,6164600,1017625,BUY
21-12-20 9:19,9:19,5138425,6175675,1037250,BUY
21-12-20 9:20,9:20,5665575,6326525,660950,BUY
21-12-20 9:21,9:21,5659700,6314400,654700,BUY
21-12-20 9:22,9:22,5660400,6321975,661575,BUY
21-12-20 9:23,9:23,6374725,6727225,352500,BUY
21-12-20 9:24,9:24,6379075,6720450,341375,BUY
21-12-20 9:25,9:25,6385025,6722900,337875,BUY
21-12-20 9:26,9:26,6539550,6853175,313625,BUY
21-12-20 9:27,9:27,6547500,6855100,307600,BUY
21-12-20 9:28,9:28,6537625,6842375,304750,BUY
21-12-20 9:29,9:29,6761925,6977600,215675,BUY
21-12-20 9:30,9:30,6762350,6983050,220700,BUY
21-12-20 9:31,9:31,6757525,6968125,210600,BUY
21-12-20 9:32,9:32,6893250,7103850,210600,BUY
21-12-20 9:33,9:33,6886450,7107450,221000,BUY
21-12-20 9:34,9:34,6875400,7105975,230575,BUY
21-12-20 9:35,9:35,6928900,7236425,307525,BUY
21-12-20 9:36,9:36,6928900,7222925,294025,BUY
21-12-20 9:37,9:37,6933925,7214175,280250,BUY
21-12-20 9:38,9:38,6979125,7346475,367350,BUY
21-12-20 9:39,9:39,6973100,7326575,353475,BUY
21-12-20 9:40,9:40,6970950,7305450,334500,BUY
21-12-20 9:41,9:41,7057675,7470525,412850,BUY
21-12-20 9:42,9:42,7062475,7483300,420825,BUY
21-12-20 9:43,9:43,7061100,7483300,422200,BUY
21-12-20 9:44,9:44,7135975,7763200,627225,BUY
21-12-20 9:45,9:45,7133025,7805075,672050,BUY
21-12-20 9:46,9:46,7118850,7759200,640350,BUY
21-12-20 9:47,9:47,7294025,7961000,666975,BUY
21-12-20 9:48,9:48,7294025,7961100,667075,BUY
21-12-20 9:49,9:49,7287975,7939775,651800,BUY
21-12-20 9:50,9:50,7271100,7951250,680150,BUY
21-12-20 9:51,9:51,7264825,7888300,623475,BUY
21-12-20 9:52,9:52,7273725,7933750,660025,BUY
21-12-20 9:53,9:53,7344050,8054825,710775,BUY
21-12-20 9:54,9:54,7355525,8070625,715100,BUY
21-12-20 9:55,9:55,7344050,8042625,698575,BUY
21-12-20 9:56,9:56,7458500,8134375,675875,BUY
21-12-20 9:57,9:57,7458575,8104100,645525,BUY
21-12-20 9:58,9:58,7441825,8089800,647975,BUY
21-12-20 9:59,9:59,7562775,8157400,594625,BUY
21-12-20 10:00,10:00,7565450,8157550,592100,BUY
21-12-20 10:01,10:01,7580350,8155150,574800,BUY
21-12-20 10:02,10:02,7669950,8230350,560400,BUY
21-12-20 10:03,10:03,7700900,8292550,591650,BUY
21-12-20 10:04,10:04,7713050,8283150,570100,BUY
21-12-20 10:05,10:05,7740800,8317700,576900,BUY
21-12-20 10:06,10:06,7741300,8335325,594025,BUY
21-12-20 10:07,10:07,7734350,8323650,589300,BUY
21-12-20 10:08,10:08,7686000,8311600,625600,BUY
21-12-20 10:09,10:09,7723825,8363175,639350,BUY
21-12-20 10:10,10:10,7722150,8371100,648950,BUY
21-12-20 10:11,10:11,7763450,8510825,747375,BUY
21-12-20 10:12,10:12,7730200,8503925,773725,BUY
21-12-20 10:13,10:13,7740625,8476200,735575,BUY
21-12-20 10:14,10:14,7821775,8526100,704325,BUY
21-12-20 10:15,10:15,7850900,8534100,683200,BUY
21-12-20 10:16,10:16,7846050,8523600,677550,BUY
21-12-20 10:17,10:17,7872575,8565300,692725,BUY
21-12-20 10:18,10:18,7872575,8558625,686050,BUY
21-12-20 10:19,10:19,7872575,8509325,636750,BUY
21-12-20 10:20,10:20,7927075,8619050,691975,BUY
21-12-20 10:21,10:21,7927000,8584775,657775,BUY
21-12-20 10:22,10:22,7896675,8624550,727875,BUY
21-12-20 10:23,10:23,7900450,8705400,804950,BUY
21-12-20 10:24,10:24,7930725,8688300,757575,BUY
21-12-20 10:25,10:25,7928975,8680500,751525,BUY
21-12-20 10:26,10:26,7998275,8743150,744875,BUY
21-12-20 10:27,10:27,8009400,8713550,704150,BUY
21-12-20 10:28,10:28,8015750,8755350,739600,BUY
21-12-20 10:29,10:29,7990250,8755800,765550,BUY
21-12-20 10:30,10:30,8008425,8739800,731375,BUY
21-12-20 10:31,10:31,8012550,8744750,732200,BUY
21-12-20 10:32,10:32,8036625,8780850,744225,BUY
21-12-20 10:33,10:33,8036850,8781450,744600,BUY
21-12-20 10:34,10:34,8025950,8795775,769825,BUY
21-12-20 10:35,10:35,8057625,8779925,722300,BUY
21-12-20 10:36,10:36,8057625,8837675,780050,BUY
21-12-20 10:37,10:37,8104850,8893550,788700,BUY
21-12-20 10:38,10:38,7754850,8784500,1029650,BUY
21-12-20 10:39,10:39,7757375,8781200,1023825,BUY
21-12-20 10:40,10:40,7759350,8799525,1040175,BUY
21-12-20 10:41,10:41,7492550,8690325,1197775,BUY
21-12-20 10:42,10:42,7494125,8762775,1268650,BUY
21-12-20 10:43,10:43,7485675,8748700,1263025,BUY
21-12-20 10:44,10:44,7554650,8674575,1119925,BUY
21-12-20 10:45,10:45,7536350,8703350,1167000,BUY
21-12-20 10:46,10:46,7553550,8681075,1127525,BUY
21-12-20 10:47,10:47,7610800,8704450,1093650,BUY
21-12-20 10:48,10:48,7607550,8717475,1109925,BUY
21-12-20 10:49,10:49,7611375,8662675,1051300,BUY
21-12-20 10:50,10:50,7699450,8683375,983925,BUY
21-12-20 10:51,10:51,7686800,8783975,1097175,BUY
21-12-20 10:52,10:52,7709750,8787450,1077700,BUY
21-12-20 10:53,10:53,7738650,8965925,1227275,BUY
21-12-20 10:54,10:54,7761475,8962700,1201225,BUY
21-12-20 10:55,10:55,7761475,8943900,1182425,BUY
21-12-20 10:56,10:56,7805500,9008000,1202500,BUY
21-12-20 10:57,10:57,7764050,8898325,1134275,BUY
21-12-20 10:58,10:58,7764050,8971975,1207925,BUY
21-12-20 10:59,10:59,7871075,9032575,1161500,BUY
21-12-20 11:00,11:00,7873900,9042500,1168600,BUY
21-12-20 11:01,11:01,7858500,8990075,1131575,BUY
21-12-20 11:02,11:02,7893700,8847375,953675,BUY
21-12-20 11:03,11:03,7876600,9053675,1177075,BUY
21-12-20 11:04,11:04,7888075,9056350,1168275,BUY
21-12-20 11:05,11:05,7916250,9046650,1130400,BUY
21-12-20 11:06,11:06,7904125,8902150,998025,BUY
21-12-20 11:07,11:07,7916250,9031250,1115000,BUY
21-12-20 11:08,11:08,7940475,8980725,1040250,BUY
21-12-20 11:09,11:09,7957625,9069150,1111525,BUY
21-12-20 11:10,11:10,7963525,8835750,872225,BUY
21-12-20 11:11,11:11,7989575,9035950,1046375,BUY
21-12-20 11:12,11:12,7976875,9134125,1157250,BUY
21-12-20 11:13,11:13,8008075,9126075,1118000,BUY
21-12-20 11:14,11:14,8102000,9151275,1049275,BUY
21-12-20 11:15,11:15,8103600,9124175,1020575,BUY
21-12-20 11:16,11:16,8091125,9103925,1012800,BUY
21-12-20 11:17,11:17,8119675,9093750,974075,BUY
21-12-20 11:18,11:18,8107550,9086900,979350,BUY
21-12-20 11:19,11:19,8107550,9126525,1018975,BUY
21-12-20 11:20,11:20,8156300,9051125,894825,BUY
21-12-20 11:21,11:21,8197125,9177625,980500,BUY
21-12-20 11:22,11:22,8156925,9117725,960800,BUY
21-12-20 11:23,11:23,8183175,9139375,956200,BUY
21-12-20 11:24,11:24,8172875,9184225,1011350,BUY
21-12-20 11:25,11:25,8183200,9141000,957800,BUY
21-12-20 11:26,11:26,8181700,9168850,987150,BUY
21-12-20 11:27,11:27,8187550,9135075,947525,BUY
21-12-20 11:28,11:28,8165250,9107500,942250,BUY
21-12-20 11:29,11:29,8213525,8987750,774225,BUY
21-12-20 11:30,11:30,8222150,9219125,996975,BUY
21-12-20 11:31,11:31,8232875,9179975,947100,BUY
21-12-20 11:32,11:32,8248275,8981600,733325,BUY
21-12-20 11:33,11:33,8273750,8978800,705050,BUY
21-12-20 11:34,11:34,8267350,8986875,719525,BUY
21-12-20 11:35,11:35,8268625,9244750,976125,BUY
21-12-20 11:36,11:36,8275100,9222225,947125,BUY
21-12-20 11:37,11:37,8275100,9292400,1017300,BUY
21-12-20 11:38,11:38,8278925,9235125,956200,BUY
21-12-20 11:39,11:39,8284200,8909700,625500,BUY
21-12-20 11:40,11:40,8280325,9224150,943825,BUY
21-12-20 11:41,11:41,8321725,9235275,913550,BUY
21-12-20 11:42,11:42,8297600,9200925,903325,BUY
21-12-20 11:43,11:43,8297575,9219850,922275,BUY
21-12-20 11:44,11:44,8348475,9196750,848275,BUY
21-12-20 11:45,11:45,8352075,9223350,871275,BUY
21-12-20 11:46,11:46,8353325,9222350,869025,BUY
21-12-20 11:47,11:47,8346775,9209325,862550,BUY
21-12-20 11:48,11:48,8345725,9226450,880725,BUY
21-12-20 11:49,11:49,8345725,9251500,905775,BUY
21-12-20 11:50,11:50,8405575,9278000,872425,BUY
21-12-20 11:51,11:51,8417325,9284500,867175,BUY
21-12-20 11:52,11:52,8413025,9272725,859700,BUY
21-12-20 11:53,11:53,8386025,9250300,864275,BUY
21-12-20 11:54,11:54,8397325,9245325,848000,BUY
21-12-20 11:55,11:55,8428650,9248550,819900,BUY
21-12-20 11:56,11:56,8512850,9301325,788475,BUY
21-12-20 11:57,11:57,8532475,9275475,743000,BUY
21-12-20 11:58,11:58,8527300,9285400,758100,BUY
21-12-20 11:59,11:59,8596425,9463275,866850,BUY
21-12-20 12:00,12:00,8616975,9442500,825525,BUY
21-12-20 12:01,12:01,8614900,9416975,802075,BUY
21-12-20 12:02,12:02,8608975,9473750,864775,BUY
21-12-20 12:03,12:03,8667900,9517925,850025,BUY
21-12-20 12:04,12:04,8655150,9496975,841825,BUY
21-12-20 12:05,12:05,8658200,9437950,779750,BUY
21-12-20 12:06,12:06,8716900,9429275,712375,BUY
21-12-20 12:07,12:07,8722875,9558475,835600,BUY
21-12-20 12:08,12:08,8749275,9541450,792175,BUY
21-12-20 12:09,12:09,8784250,9560800,776550,BUY
21-12-20 12:10,12:10,8785225,9617425,832200,BUY
21-12-20 12:11,12:11,8764650,9593475,828825,BUY
21-12-20 12:12,12:12,8844950,9572625,727675,BUY
21-12-20 12:13,12:13,8865475,9615100,749625,BUY
21-12-20 12:14,12:14,8862175,9572475,710300,BUY
21-12-20 12:15,12:15,8945050,9532775,587725,BUY
21-12-20 12:16,12:16,8916875,9540275,623400,BUY
21-12-20 12:17,12:17,8926900,9496675,569775,BUY
21-12-20 12:18,12:18,8962775,9496950,534175,BUY
21-12-20 12:19,12:19,8971425,9484375,512950,BUY
21-12-20 12:20,12:20,8971425,9576650,605225,BUY
21-12-20 12:21,12:21,9008575,9514975,506400,BUY
21-12-20 12:22,12:22,8999650,9539075,539425,BUY
21-12-20 12:23,12:23,8993625,9495850,502225,BUY
21-12-20 12:24,12:24,9037600,9488025,450425,BUY
21-12-20 12:25,12:25,9053225,9578375,525150,BUY
21-12-20 12:26,12:26,9026875,9526725,499850,BUY
21-12-20 12:27,12:27,9058500,9564850,506350,BUY
21-12-20 12:28,12:28,9050725,9565000,514275,BUY
21-12-20 12:29,12:29,9067075,9579775,512700,BUY
21-12-20 12:30,12:30,9264600,9689100,424500,BUY
21-12-20 12:31,12:31,9254625,9617000,362375,BUY
21-12-20 12:32,12:32,9254625,9652825,398200,BUY
21-12-20 12:33,12:33,9286300,9557925,271625,BUY
21-12-20 12:34,12:34,9295800,9575075,279275,BUY
21-12-20 12:35,12:35,9300525,9536350,235825,BUY
21-12-20 12:36,12:36,9378050,9618125,240075,BUY
21-12-20 12:37,12:37,9383050,9602500,219450,BUY
21-12-20 12:38,12:38,9393650,9659000,265350,BUY
21-12-20 12:39,12:39,9504800,9627550,122750,BUY
21-12-20 12:40,12:40,9487425,9660750,173325,BUY
21-12-20 12:41,12:41,9492850,9590150,97300,BUY
21-12-20 12:42,12:42,9553550,9530950,-22600,SELL
21-12-20 12:43,12:43,9514025,9535975,21950,BUY
21-12-20 12:44,12:44,9528700,9533725,5025,BUY
21-12-20 12:45,12:45,9569150,9530975,-38175,SELL
21-12-20 12:46,12:46,9550625,9464075,-86550,SELL
21-12-20 12:47,12:47,9569150,9540975,-28175,SELL
21-12-20 12:48,12:48,9583475,9593925,10450,BUY
21-12-20 12:49,12:49,9600925,9594525,-6400,SELL
21-12-20 12:50,12:50,9618225,9623750,5525,BUY
21-12-20 12:51,12:51,9696250,9463950,-232300,SELL
21-12-20 12:52,12:52,9694375,9456250,-238125,SELL
21-12-20 12:53,12:53,9691350,9443300,-248050,SELL
21-12-20 12:54,12:54,9793600,9423025,-370575,SELL
21-12-20 12:55,12:55,9805575,9434175,-371400,SELL
21-12-20 12:56,12:56,9774625,9452850,-321775,SELL
21-12-20 12:57,12:57,9845450,9273450,-572000,SELL
21-12-20 12:58,12:58,9829900,9260675,-569225,SELL
21-12-20 12:59,12:59,9853200,9289400,-563800,SELL
21-12-20 13:00,13:00,9898750,9186300,-712450,SELL
21-12-20 13:01,13:01,9893925,9180300,-713625,SELL
21-12-20 13:02,13:02,9900225,9193225,-707000,SELL
21-12-20 13:03,13:03,9945775,8568825,-1376950,SELL
21-12-20 13:04,13:04,9959550,8552675,-1406875,SELL
21-12-20 13:05,13:05,9956925,8563025,-1393900,SELL
21-12-20 13:06,13:06,9898400,8546675,-1351725,SELL
21-12-20 13:07,13:07,9891175,8550000,-1341175,SELL
21-12-20 13:08,13:08,9900100,8539425,-1360675,SELL
21-12-20 13:09,13:09,9981375,8417450,-1563925,SELL
21-12-20 13:10,13:10,9980700,8409525,-1571175,SELL
21-12-20 13:11,13:11,9980725,8371375,-1609350,SELL
21-12-20 13:12,13:12,10129975,8406850,-1723125,SELL
21-12-20 13:13,13:13,10125250,8422925,-1702325,SELL
21-12-20 13:14,13:14,10122100,8394325,-1727775,SELL
21-12-20 13:15,13:15,10192650,8477375,-1715275,SELL
21-12-20 13:16,13:16,10192650,8447600,-1745050,SELL
21-12-20 13:17,13:17,10184700,8452275,-1732425,SELL
21-12-20 13:18,13:18,10304325,8521250,-1783075,SELL
21-12-20 13:19,13:19,10303525,8516925,-1786600,SELL
21-12-20 13:20,13:20,10303525,8515775,-1787750,SELL
21-12-20 13:21,13:21,10309575,8538125,-1771450,SELL
21-12-20 13:22,13:22,10286350,8538125,-1748225,SELL
21-12-20 13:23,13:23,10306300,8483700,-1822600,SELL
21-12-20 13:24,13:24,10348550,8574100,-1774450,SELL
21-12-20 13:25,13:25,10334050,8598325,-1735725,SELL
21-12-20 13:26,13:26,10342500,8585525,-1756975,SELL
21-12-20 13:27,13:27,10375550,8596225,-1779325,SELL
21-12-20 13:28,13:28,10365550,8543125,-1822425,SELL
21-12-20 13:29,13:29,10386600,8568850,-1817750,SELL
21-12-20 13:30,13:30,10473000,8621325,-1851675,SELL
21-12-20 13:31,13:31,10470075,8603275,-1866800,SELL
21-12-20 13:32,13:32,10456875,8603225,-1853650,SELL
21-12-20 13:33,13:33,10576725,8575250,-2001475,SELL
21-12-20 13:34,13:34,10574125,8629350,-1944775,SELL
21-12-20 13:35,13:35,10586200,8641975,-1944225,SELL
21-12-20 13:36,13:36,10619325,8401575,-2217750,SELL
21-12-20 13:37,13:37,10616725,8416700,-2200025,SELL
21-12-20 13:38,13:38,10619250,8406850,-2212400,SELL
21-12-20 13:39,13:39,10657625,8124225,-2533400,SELL
21-12-20 13:40,13:40,10642575,8142275,-2500300,SELL
21-12-20 13:41,13:41,10651100,8115325,-2535775,SELL
21-12-20 13:42,13:42,10807500,8135850,-2671650,SELL
21-12-20 13:43,13:43,10814600,8128475,-2686125,SELL
21-12-20 13:44,13:44,10812750,8118325,-2694425,SELL
21-12-20 13:45,13:45,10943650,8294175,-2649475,SELL
21-12-20 13:46,13:46,10943900,8318000,-2625900,SELL
21-12-20 13:47,13:47,10950425,8294175,-2656250,SELL
21-12-20 13:48,13:48,11035875,8368050,-2667825,SELL
21-12-20 13:49,13:49,11032975,8372000,-2660975,SELL
21-12-20 13:50,13:50,11035850,8366375,-2669475,SELL
21-12-20 13:51,13:51,11042700,8424875,-2617825,SELL
21-12-20 13:52,13:52,11042875,8408925,-2633950,SELL
21-12-20 13:53,13:53,11042875,8437150,-2605725,SELL
21-12-20 13:54,13:54,11094925,8483875,-2611050,SELL
21-12-20 13:55,13:55,11091975,8492825,-2599150,SELL
21-12-20 13:56,13:56,11094975,8482600,-2612375,SELL
21-12-20 13:57,13:57,11069925,8451525,-2618400,SELL
21-12-20 13:58,13:58,11065675,8441300,-2624375,SELL
21-12-20 13:59,13:59,11076000,8462825,-2613175,SELL
21-12-20 14:00,14:00,11046975,8406500,-2640475,SELL
21-12-20 14:01,14:01,11044050,8383100,-2660950,SELL
21-12-20 14:02,14:02,11044825,8378800,-2666025,SELL
21-12-20 14:03,14:03,11080475,8369575,-2710900,SELL
21-12-20 14:04,14:04,11083800,8369575,-2714225,SELL
21-12-20 14:05,14:05,11077900,8385625,-2692275,SELL
21-12-20 14:06,14:06,11019350,8440025,-2579325,SELL
21-12-20 14:07,14:07,11023225,8424500,-2598725,SELL
21-12-20 14:08,14:08,11013550,8433500,-2580050,SELL
21-12-20 14:09,14:09,11082300,8440500,-2641800,SELL
21-12-20 14:10,14:10,11091200,8436100,-2655100,SELL
21-12-20 14:11,14:11,11077000,8446900,-2630100,SELL
21-12-20 14:12,14:12,11148400,8380425,-2767975,SELL
21-12-20 14:13,14:13,11163600,8383825,-2779775,SELL
21-12-20 14:14,14:14,11161450,8390200,-2771250,SELL
21-12-20 14:15,14:15,11178825,8358225,-2820600,SELL
21-12-20 14:16,14:16,11178875,8336900,-2841975,SELL
21-12-20 14:17,14:17,11178175,8365550,-2812625,SELL
21-12-20 14:18,14:18,11229475,8256125,-2973350,SELL
21-12-20 14:19,14:19,11227050,8268150,-2958900,SELL
21-12-20 14:20,14:20,11229625,8239625,-2990000,SELL
21-12-20 14:21,14:21,11197650,8048475,-3149175,SELL
21-12-20 14:22,14:22,11199350,8045725,-3153625,SELL
21-12-20 14:23,14:23,11200375,8043175,-3157200,SELL
21-12-20 14:24,14:24,11206100,7959900,-3246200,SELL
21-12-20 14:25,14:25,11207700,7946650,-3261050,SELL
21-12-20 14:26,14:26,11203975,7952925,-3251050,SELL
21-12-20 14:27,14:27,11200800,7932950,-3267850,SELL
21-12-20 14:28,14:28,11204350,7949450,-3254900,SELL
21-12-20 14:29,14:29,11204675,7956000,-3248675,SELL
21-12-20 14:30,14:30,11255175,7964375,-3290800,SELL
21-12-20 14:31,14:31,11259325,7954600,-3304725,SELL
21-12-20 14:32,14:32,11258525,7950700,-3307825,SELL
21-12-20 14:33,14:33,11244200,7960400,-3283800,SELL
21-12-20 14:34,14:34,11252900,7999550,-3253350,SELL
21-12-20 14:35,14:35,11246975,7991550,-3255425,SELL
21-12-20 14:36,14:36,11246100,7986875,-3259225,SELL
21-12-20 14:37,14:37,11249325,8007800,-3241525,SELL
21-12-20 14:38,14:38,11246125,7999300,-3246825,SELL
21-12-20 14:39,14:39,11241000,8001250,-3239750,SELL
21-12-20 14:40,14:40,11241625,8012750,-3228875,SELL
21-12-20 14:41,14:41,11240900,8022450,-3218450,SELL
21-12-20 14:42,14:42,11258850,7936375,-3322475,SELL
21-12-20 14:43,14:43,11258925,7930500,-3328425,SELL
21-12-20 14:44,14:44,11259625,7944600,-3315025,SELL
21-12-20 14:45,14:45,11262825,7796275,-3466550,SELL
21-12-20 14:46,14:46,11262425,7804050,-3458375,SELL
21-12-20 14:47,14:47,11265325,7796850,-3468475,SELL
21-12-20 14:48,14:48,11235775,7753050,-3482725,SELL
21-12-20 14:49,14:49,11235450,7736200,-3499250,SELL
21-12-20 14:50,14:50,11235825,7749625,-3486200,SELL
21-12-20 14:51,14:51,11265350,7731375,-3533975,SELL
21-12-20 14:52,14:52,11266100,7707200,-3558900,SELL
21-12-20 14:53,14:53,11266100,7719725,-3546375,SELL
21-12-20 14:54,14:54,11264575,7647325,-3617250,SELL
21-12-20 14:55,14:55,11269675,7640525,-3629150,SELL
21-12-20 14:56,14:56,11264600,7588950,-3675650,SELL
21-12-20 14:57,14:57,11170350,7551825,-3618525,SELL
21-12-20 14:58,14:58,11169500,7560050,-3609450,SELL
21-12-20 14:59,14:59,11170325,7491975,-3678350,SELL
21-12-20 15:00,15:00,11083850,7381625,-3702225,SELL
21-12-20 15:01,15:01,11083850,7334775,-3749075,SELL
21-12-20 15:02,15:02,11088175,7369625,-3718550,SELL
21-12-20 15:03,15:03,10953750,7138025,-3815725,SELL
21-12-20 15:04,15:04,10950525,7133025,-3817500,SELL
21-12-20 15:05,15:05,10958150,7133700,-3824450,SELL
21-12-20 15:06,15:06,10893000,6995150,-3897850,SELL
21-12-20 15:07,15:07,10892900,7010525,-3882375,SELL
21-12-20 15:08,15:08,10892925,7010525,-3882400,SELL
21-12-20 15:09,15:09,10954050,7056250,-3897800,SELL
21-12-20 15:10,15:10,10959100,7086850,-3872250,SELL
21-12-20 15:11,15:11,10953700,7064550,-3889150,SELL
21-12-20 15:12,15:12,10975625,7015675,-3959950,SELL
21-12-20 15:13,15:13,10974600,7010575,-3964025,SELL
21-12-20 15:14,15:14,10975425,7012775,-3962650,SELL
21-12-20 15:15,15:15,10999125,7025750,-3973375,SELL
21-12-20 15:16,15:16,10997600,7015275,-3982325,SELL
21-12-20 15:17,15:17,10997825,7032550,-3965275,SELL
21-12-20 15:18,15:18,11031525,6993500,-4038025,SELL
21-12-20 15:19,15:19,11030600,6992250,-4038350,SELL
21-12-20 15:20,15:20,11038275,6971425,-4066850,SELL
21-12-20 15:21,15:21,11016200,6947375,-4068825,SELL
21-12-20 15:22,15:22,11016675,6948975,-4067700,SELL
21-12-20 15:23,15:23,11010050,6945700,-4064350,SELL
21-12-20 15:24,15:24,10985050,6926075,-4058975,SELL
21-12-20 15:25,15:25,10992675,6926550,-4066125,SELL
21-12-20 15:26,15:26,10987375,6916225,-4071150,SELL
21-12-20 15:27,15:27,11008600,6894700,-4113900,SELL
21-12-20 15:28,15:28,11004450,6888500,-4115950,SELL
21-12-20 15:29,15:29,11007000,6894700,-4112300,SELL
22-12-20 9:15,9:15,10179475,5560125,-4619350,SELL
22-12-20 9:16,9:16,10174975,5568400,-4606575,SELL
22-12-20 9:17,9:17,10276775,5656050,-4620725,SELL
22-12-20 9:18,9:18,10279575,5649100,-4630475,SELL
22-12-20 9:19,9:19,10275700,5649100,-4626600,SELL
22-12-20 9:20,9:20,10340475,5671700,-4668775,SELL
22-12-20 9:21,9:21,10344325,5679975,-4664350,SELL
22-12-20 9:22,9:22,10341275,5632475,-4708800,SELL
22-12-20 9:23,9:23,10362250,5670675,-4691575,SELL
22-12-20 9:24,9:24,10368025,5721700,-4646325,SELL
22-12-20 9:25,9:25,10373525,5714750,-4658775,SELL
22-12-20 9:26,9:26,10418425,5791050,-4627375,SELL
22-12-20 9:27,9:27,10418425,5826475,-4591950,SELL
22-12-20 9:28,9:28,10415325,5838275,-4577050,SELL
22-12-20 9:29,9:29,10497350,5899950,-4597400,SELL
22-12-20 9:30,9:30,10493950,5902900,-4591050,SELL
22-12-20 9:31,9:31,10493625,5791850,-4701775,SELL
22-12-20 9:32,9:32,10607200,5934675,-4672525,SELL
22-12-20 9:33,9:33,10609800,5979100,-4630700,SELL
22-12-20 9:34,9:34,10606450,5965700,-4640750,SELL
22-12-20 9:35,9:35,10747400,5995600,-4751800,SELL
22-12-20 9:36,9:36,10741350,6034800,-4706550,SELL
22-12-20 9:37,9:37,10741350,5897875,-4843475,SELL
22-12-20 9:38,9:38,10836500,6211550,-4624950,SELL
22-12-20 9:39,9:39,10840200,6231525,-4608675,SELL
22-12-20 9:40,9:40,10836500,6172400,-4664100,SELL
22-12-20 9:41,9:41,10847900,6293775,-4554125,SELL
22-12-20 9:42,9:42,10848250,6305575,-4542675,SELL
22-12-20 9:43,9:43,10844900,6253375,-4591525,SELL
22-12-20 9:44,9:44,10924825,6322325,-4602500,SELL
22-12-20 9:45,9:45,10927500,6387825,-4539675,SELL
22-12-20 9:46,9:46,10927325,6364325,-4563000,SELL
22-12-20 9:47,9:47,11099450,6493875,-4605575,SELL
22-12-20 9:48,9:48,11099650,6481750,-4617900,SELL
22-12-20 9:49,9:49,11098950,6486975,-4611975,SELL
22-12-20 9:50,9:50,11104850,6410900,-4693950,SELL
22-12-20 9:51,9:51,11105650,6453375,-4652275,SELL
22-12-20 9:52,9:52,11101700,6424850,-4676850,SELL
22-12-20 9:53,9:53,11149400,6440850,-4708550,SELL
22-12-20 9:54,9:54,11150175,6351125,-4799050,SELL
22-12-20 9:55,9:55,11142650,6434325,-4708325,SELL
22-12-20 9:56,9:56,11093050,6403350,-4689700,SELL
22-12-20 9:57,9:57,11097150,6396000,-4701150,SELL
22-12-20 9:58,9:58,11096725,6349875,-4746850,SELL
22-12-20 9:59,9:59,11086675,6348025,-4738650,SELL
22-12-20 10:00,10:00,11086925,6401525,-4685400,SELL
22-12-20 10:01,10:01,11087450,6291875,-4795575,SELL
22-12-20 10:02,10:02,11087900,6355225,-4732675,SELL
22-12-20 10:03,10:03,11093675,6492250,-4601425,SELL
22-12-20 10:04,10:04,11097900,6286100,-4811800,SELL
22-12-20 10:05,10:05,11134525,6420500,-4714025,SELL
22-12-20 10:06,10:06,11127000,6465075,-4661925,SELL
22-12-20 10:07,10:07,11138625,6455550,-4683075,SELL
22-12-20 10:08,10:08,11208675,6577850,-4630825,SELL
22-12-20 10:09,10:09,11208450,6558675,-4649775,SELL
22-12-20 10:10,10:10,11207600,6538700,-4668900,SELL
22-12-20 10:11,10:11,11174025,6550700,-4623325,SELL
22-12-20 10:12,10:12,11173675,6499850,-4673825,SELL
22-12-20 10:13,10:13,11169675,6539025,-4630650,SELL
22-12-20 10:14,10:14,11174375,6694800,-4479575,SELL
22-12-20 10:15,10:15,11258325,6641400,-4616925,SELL
22-12-20 10:16,10:16,11251300,6546700,-4704600,SELL
22-12-20 10:17,10:17,11313025,6763150,-4549875,SELL
22-12-20 10:18,10:18,11314375,6668500,-4645875,SELL
22-12-20 10:19,10:19,11306725,6763150,-4543575,SELL
22-12-20 10:20,10:20,11347775,6692475,-4655300,SELL
22-12-20 10:21,10:21,11325875,6692200,-4633675,SELL
22-12-20 10:22,10:22,11334225,6572350,-4761875,SELL
22-12-20 10:23,10:23,11282775,6614250,-4668525,SELL
22-12-20 10:24,10:24,11291975,6668675,-4623300,SELL
22-12-20 10:25,10:25,11280250,6579350,-4700900,SELL
22-12-20 10:26,10:26,11294075,6663225,-4630850,SELL
22-12-20 10:27,10:27,11313350,6663100,-4650250,SELL
22-12-20 10:28,10:28,11307500,6705800,-4601700,SELL
22-12-20 10:29,10:29,11394125,6711975,-4682150,SELL
22-12-20 10:30,10:30,11380875,6704250,-4676625,SELL
22-12-20 10:31,10:31,11394075,6704250,-4689825,SELL
22-12-20 10:32,10:32,11400225,6518650,-4881575,SELL
22-12-20 10:33,10:33,11396525,6708775,-4687750,SELL
22-12-20 10:34,10:34,11401750,6708775,-4692975,SELL
22-12-20 10:35,10:35,11465600,6691800,-4773800,SELL
22-12-20 10:36,10:36,11461875,6719425,-4742450,SELL
22-12-20 10:37,10:37,11456000,6714625,-4741375,SELL
22-12-20 10:38,10:38,11461625,6675875,-4785750,SELL
22-12-20 10:39,10:39,11461650,6795525,-4666125,SELL
22-12-20 10:40,10:40,11461650,6640825,-4820825,SELL
22-12-20 10:41,10:41,11438425,6800425,-4638000,SELL
22-12-20 10:42,10:42,11504225,6668850,-4835375,SELL
22-12-20 10:43,10:43,11504225,6911925,-4592300,SELL
22-12-20 10:44,10:44,11507475,6923475,-4584000,SELL
22-12-20 10:45,10:45,11442050,6980675,-4461375,SELL
22-12-20 10:46,10:46,11510825,6987750,-4523075,SELL
22-12-20 10:47,10:47,11570200,6924075,-4646125,SELL
22-12-20 10:48,10:48,11572000,6930900,-4641100,SELL
22-12-20 10:49,10:49,11566150,7016400,-4549750,SELL
22-12-20 10:50,10:50,11620125,6928900,-4691225,SELL
22-12-20 10:51,10:51,11696650,6982050,-4714600,SELL
22-12-20 10:52,10:52,11693800,7128875,-4564925,SELL
22-12-20 10:53,10:53,11609525,6765250,-4844275,SELL
22-12-20 10:54,10:54,11593250,6799475,-4793775,SELL
22-12-20 10:55,10:55,11593250,6988525,-4604725,SELL
22-12-20 10:56,10:56,11696425,6696900,-4999525,SELL
22-12-20 10:57,10:57,11690750,7039550,-4651200,SELL
22-12-20 10:58,10:58,11694350,6723925,-4970425,SELL
22-12-20 10:59,10:59,11759650,6914925,-4844725,SELL
22-12-20 11:00,11:00,11764600,7143725,-4620875,SELL
22-12-20 11:01,11:01,11759975,6914825,-4845150,SELL
22-12-20 11:02,11:02,11817700,6940550,-4877150,SELL
22-12-20 11:03,11:03,11812900,6997700,-4815200,SELL
22-12-20 11:04,11:04,11823150,7052375,-4770775,SELL
22-12-20 11:05,11:05,11816200,6863500,-4952700,SELL
22-12-20 11:06,11:06,11786650,7054450,-4732200,SELL
22-12-20 11:07,11:07,11816500,7045825,-4770675,SELL
22-12-20 11:08,11:08,11792800,7037375,-4755425,SELL
22-12-20 11:09,11:09,11796125,7042125,-4754000,SELL
22-12-20 11:10,11:10,11794250,6942125,-4852125,SELL
22-12-20 11:11,11:11,11815175,7098075,-4717100,SELL
22-12-20 11:12,11:12,11808550,7012575,-4795975,SELL
22-12-20 11:13,11:13,11814475,7039575,-4774900,SELL
22-12-20 11:14,11:14,11760500,7132225,-4628275,SELL
22-12-20 11:15,11:15,11758575,7204675,-4553900,SELL
22-12-20 11:16,11:16,11760525,7204675,-4555850,SELL
22-12-20 11:17,11:17,11762950,7150225,-4612725,SELL
22-12-20 11:18,11:18,11764800,7162025,-4602775,SELL
22-12-20 11:19,11:19,11768225,7213100,-4555125,SELL
22-12-20 11:20,11:20,11742125,7190500,-4551625,SELL
22-12-20 11:21,11:21,11742075,7188250,-4553825,SELL
22-12-20 11:22,11:22,11682125,7188250,-4493875,SELL
22-12-20 11:23,11:23,11790800,7117625,-4673175,SELL
22-12-20 11:24,11:24,11778200,7119625,-4658575,SELL
22-12-20 11:25,11:25,11786600,6983650,-4802950,SELL
22-12-20 11:26,11:26,11775300,7177200,-4598100,SELL
22-12-20 11:27,11:27,11791175,7195100,-4596075,SELL
22-12-20 11:28,11:28,11837025,7127775,-4709250,SELL
22-12-20 11:29,11:29,11946525,7139875,-4806650,SELL
22-12-20 11:30,11:30,11947850,7355375,-4592475,SELL
22-12-20 11:31,11:31,11933700,7352100,-4581600,SELL
22-12-20 11:32,11:32,11931850,7260025,-4671825,SELL
22-12-20 11:33,11:33,12002175,7404625,-4597550,SELL
22-12-20 11:34,11:34,12003175,7305150,-4698025,SELL
22-12-20 11:35,11:35,11980475,7419050,-4561425,SELL
22-12-20 11:36,11:36,11992525,7378900,-4613625,SELL
22-12-20 11:37,11:37,11992225,7417050,-4575175,SELL
22-12-20 11:38,11:38,12096525,7589850,-4506675,SELL
22-12-20 11:39,11:39,12091850,7557125,-4534725,SELL
22-12-20 11:40,11:40,12091475,7554375,-4537100,SELL
22-12-20 11:41,11:41,12133500,7512000,-4621500,SELL
22-12-20 11:42,11:42,12135975,7546650,-4589325,SELL
22-12-20 11:43,11:43,12133000,7415350,-4717650,SELL
22-12-20 11:44,11:44,12145925,7607325,-4538600,SELL
22-12-20 11:45,11:45,12143300,7447975,-4695325,SELL
22-12-20 11:46,11:46,12143475,7576875,-4566600,SELL
22-12-20 11:47,11:47,12148450,7583150,-4565300,SELL
22-12-20 11:48,11:48,12146950,7453475,-4693475,SELL
22-12-20 11:49,11:49,12150075,7469650,-4680425,SELL
22-12-20 11:50,11:50,12172325,7306500,-4865825,SELL
22-12-20 11:51,11:51,12172775,7389825,-4782950,SELL
22-12-20 11:52,11:52,12170725,7234150,-4936575,SELL
22-12-20 11:53,11:53,12183750,7392475,-4791275,SELL
22-12-20 11:54,11:54,12186150,7323225,-4862925,SELL
22-12-20 11:55,11:55,12135050,7482475,-4652575,SELL
22-12-20 11:56,11:56,12177975,7268175,-4909800,SELL
22-12-20 11:57,11:57,12065950,7126125,-4939825,SELL
22-12-20 11:58,11:58,12175250,7309500,-4865750,SELL
22-12-20 11:59,11:59,12134425,7432950,-4701475,SELL
22-12-20 12:00,12:00,12238200,7686825,-4551375,SELL
22-12-20 12:01,12:01,12180200,7374825,-4805375,SELL
22-12-20 12:02,12:02,12128425,7305750,-4822675,SELL
22-12-20 12:03,12:03,12241575,7457575,-4784000,SELL
22-12-20 12:04,12:04,12236225,7404375,-4831850,SELL
22-12-20 12:05,12:05,12239375,7591275,-4648100,SELL
22-12-20 12:06,12:06,12256675,7487850,-4768825,SELL
22-12-20 12:07,12:07,12258100,7617200,-4640900,SELL
22-12-20 12:08,12:08,12257925,7344800,-4913125,SELL
22-12-20 12:09,12:09,12256850,7463150,-4793700,SELL
22-12-20 12:10,12:10,12261700,7555500,-4706200,SELL
22-12-20 12:11,12:11,12261425,7559250,-4702175,SELL
22-12-20 12:12,12:12,12351950,7514775,-4837175,SELL
22-12-20 12:13,12:13,12350425,7598825,-4751600,SELL
22-12-20 12:14,12:14,12351950,7668075,-4683875,SELL
22-12-20 12:15,12:15,12408875,7703625,-4705250,SELL
22-12-20 12:16,12:16,12354825,7771100,-4583725,SELL
22-12-20 12:17,12:17,12356875,7772700,-4584175,SELL
22-12-20 12:18,12:18,12291225,7692375,-4598850,SELL
22-12-20 12:19,12:19,12414600,7705100,-4709500,SELL
22-12-20 12:20,12:20,12412375,7592675,-4819700,SELL
22-12-20 12:21,12:21,12279175,7625250,-4653925,SELL
22-12-20 12:22,12:22,12282450,7634875,-4647575,SELL
22-12-20 12:23,12:23,12319000,7726650,-4592350,SELL
22-12-20 12:24,12:24,12334150,7627375,-4706775,SELL
22-12-20 12:25,12:25,12321900,7480025,-4841875,SELL
22-12-20 12:26,12:26,12163500,7678950,-4484550,SELL
22-12-20 12:27,12:27,12384775,7626275,-4758500,SELL
22-12-20 12:28,12:28,12384775,7023350,-5361425,SELL
22-12-20 12:29,12:29,12386200,7627325,-4758875,SELL
22-12-20 12:30,12:30,12448725,7711425,-4737300,SELL
22-12-20 12:31,12:31,12449300,7710800,-4738500,SELL
22-12-20 12:32,12:32,12449050,7647950,-4801100,SELL
22-12-20 12:33,12:33,12335075,7428925,-4906150,SELL
22-12-20 12:34,12:34,12385150,7618975,-4766175,SELL
22-12-20 12:35,12:35,12383500,7489100,-4894400,SELL
22-12-20 12:36,12:36,12381825,7441475,-4940350,SELL
22-12-20 12:37,12:37,12379775,7409775,-4970000,SELL
22-12-20 12:38,12:38,12382450,7545425,-4837025,SELL
22-12-20 12:39,12:39,12404575,7551125,-4853450,SELL
22-12-20 12:40,12:40,12403475,7460800,-4942675,SELL
22-12-20 12:41,12:41,12402850,7331900,-5070950,SELL
22-12-20 12:42,12:42,12371650,7233175,-5138475,SELL
22-12-20 12:43,12:43,12368275,7384550,-4983725,SELL
22-12-20 12:44,12:44,12370350,7510825,-4859525,SELL
22-12-20 12:45,12:45,12369850,7604050,-4765800,SELL
22-12-20 12:46,12:46,12367950,7566450,-4801500,SELL
22-12-20 12:47,12:47,12368100,7547675,-4820425,SELL
22-12-20 12:48,12:48,12343125,7488550,-4854575,SELL
22-12-20 12:49,12:49,12343125,7429450,-4913675,SELL
22-12-20 12:50,12:50,12336375,7373950,-4962425,SELL
22-12-20 12:51,12:51,12441025,7460975,-4980050,SELL
22-12-20 12:52,12:52,12439225,7679875,-4759350,SELL
22-12-20 12:53,12:53,12442600,7532200,-4910400,SELL
22-12-20 12:54,12:54,12429125,7606700,-4822425,SELL
22-12-20 12:55,12:55,12351050,7415625,-4935425,SELL
22-12-20 12:56,12:56,12433550,7411700,-5021850,SELL
22-12-20 12:57,12:57,12533600,7693300,-4840300,SELL
22-12-20 12:58,12:58,12532100,7641350,-4890750,SELL
22-12-20 12:59,12:59,12531200,7399900,-5131300,SELL
22-12-20 13:00,13:00,12595475,7336425,-5259050,SELL
22-12-20 13:01,13:01,12599675,7607300,-4992375,SELL
22-12-20 13:02,13:02,12599225,7583250,-5015975,SELL
22-12-20 13:03,13:03,12673550,7541700,-5131850,SELL
22-12-20 13:04,13:04,12673650,7429675,-5243975,SELL
22-12-20 13:05,13:05,12689375,7678375,-5011000,SELL
22-12-20 13:06,13:06,12700450,7515300,-5185150,SELL
22-12-20 13:07,13:07,12691525,7342450,-5349075,SELL
22-12-20 13:08,13:08,12496550,7367825,-5128725,SELL
22-12-20 13:09,13:09,12215000,7321475,-4893525,SELL
22-12-20 13:10,13:10,12661225,7640150,-5021075,SELL
22-12-20 13:11,13:11,12627375,7400200,-5227175,SELL
22-12-20 13:12,13:12,12509150,7347575,-5161575,SELL
22-12-20 13:13,13:13,12613325,7372900,-5240425,SELL
22-12-20 13:14,13:14,12651075,7215050,-5436025,SELL
22-12-20 13:15,13:15,12399300,7316425,-5082875,SELL
22-12-20 13:16,13:16,12415650,7510075,-4905575,SELL
22-12-20 13:17,13:17,12418975,7613650,-4805325,SELL
22-12-20 13:18,13:18,12427475,7728975,-4698500,SELL
22-12-20 13:19,13:19,12426975,7784125,-4642850,SELL
22-12-20 13:20,13:20,12426975,7766000,-4660975,SELL
22-12-20 13:21,13:21,12196450,7549100,-4647350,SELL
22-12-20 13:22,13:22,12227200,7555725,-4671475,SELL
22-12-20 13:23,13:23,12242975,7700475,-4542500,SELL
22-12-20 13:24,13:24,12223075,7452000,-4771075,SELL
22-12-20 13:25,13:25,12222925,7460050,-4762875,SELL
22-12-20 13:26,13:26,12218425,7593475,-4624950,SELL
22-12-20 13:27,13:27,12312925,7618975,-4693950,SELL
22-12-20 13:28,13:28,12310850,7886425,-4424425,SELL
22-12-20 13:29,13:29,12305875,7640950,-4664925,SELL
22-12-20 13:30,13:30,12398750,7904725,-4494025,SELL
22-12-20 13:31,13:31,12401750,7779000,-4622750,SELL
22-12-20 13:32,13:32,12399875,7846525,-4553350,SELL
22-12-20 13:33,13:33,12426850,7698725,-4728125,SELL
22-12-20 13:34,13:34,12424550,7800175,-4624375,SELL
22-12-20 13:35,13:35,12432350,7772875,-4659475,SELL
22-12-20 13:36,13:36,12429875,7810250,-4619625,SELL
22-12-20 13:37,13:37,12316750,7995600,-4321150,SELL
22-12-20 13:38,13:38,12429875,7843725,-4586150,SELL
22-12-20 13:39,13:39,12366225,7900450,-4465775,SELL
22-12-20 13:40,13:40,12388225,8063000,-4325225,SELL
22-12-20 13:41,13:41,12388700,8112475,-4276225,SELL
22-12-20 13:42,13:42,12415325,8060925,-4354400,SELL
22-12-20 13:43,13:43,12415325,8068350,-4346975,SELL
22-12-20 13:44,13:44,12415325,7970200,-4445125,SELL
22-12-20 13:45,13:45,12444325,8192075,-4252250,SELL
22-12-20 13:46,13:46,12438800,8149500,-4289300,SELL
22-12-20 13:47,13:47,12439275,8149500,-4289775,SELL
22-12-20 13:48,13:48,12368975,7967025,-4401950,SELL
22-12-20 13:49,13:49,12384450,8231525,-4152925,SELL
22-12-20 13:50,13:50,12383925,8052975,-4330950,SELL
22-12-20 13:51,13:51,12175450,7874350,-4301100,SELL
22-12-20 13:52,13:52,12174700,7838025,-4336675,SELL
22-12-20 13:53,13:53,12179700,7877975,-4301725,SELL
22-12-20 13:54,13:54,12250575,7777450,-4473125,SELL
22-12-20 13:55,13:55,12218000,7797525,-4420475,SELL
22-12-20 13:56,13:56,12246150,7951300,-4294850,SELL
22-12-20 13:57,13:57,12261250,8034525,-4226725,SELL
22-12-20 13:58,13:58,12224925,7938925,-4286000,SELL
22-12-20 13:59,13:59,12257450,7991250,-4266200,SELL
22-12-20 14:00,14:00,12242925,8097000,-4145925,SELL
22-12-20 14:01,14:01,12238525,7977600,-4260925,SELL
22-12-20 14:02,14:02,12247675,7886225,-4361450,SELL
22-12-20 14:03,14:03,12359175,8067950,-4291225,SELL
22-12-20 14:04,14:04,12352375,8027125,-4325250,SELL
22-12-20 14:05,14:05,12359150,7874900,-4484250,SELL
22-12-20 14:06,14:06,12325575,7912875,-4412700,SELL
22-12-20 14:07,14:07,12320650,8053650,-4267000,SELL
22-12-20 14:08,14:08,12308825,7891475,-4417350,SELL
22-12-20 14:09,14:09,12111150,8000100,-4111050,SELL
22-12-20 14:10,14:10,12110025,8087350,-4022675,SELL
22-12-20 14:11,14:11,12114050,7810500,-4303550,SELL
22-12-20 14:12,14:12,12054025,8061725,-3992300,SELL
22-12-20 14:13,14:13,12053500,8056700,-3996800,SELL
22-12-20 14:14,14:14,12051650,8003275,-4048375,SELL
22-12-20 14:15,14:15,12027925,7980375,-4047550,SELL
22-12-20 14:16,14:16,12029650,8081550,-3948100,SELL
22-12-20 14:17,14:17,12034975,8135200,-3899775,SELL
22-12-20 14:18,14:18,12019525,8002875,-4016650,SELL
22-12-20 14:19,14:19,12024050,8059900,-3964150,SELL
22-12-20 14:20,14:20,12024050,7821825,-4202225,SELL
22-12-20 14:21,14:21,12044950,8115500,-3929450,SELL
22-12-20 14:22,14:22,12049900,8125350,-3924550,SELL
22-12-20 14:23,14:23,12045400,7908400,-4137000,SELL
22-12-20 14:24,14:24,12030625,7991875,-4038750,SELL
22-12-20 14:25,14:25,12077650,8082400,-3995250,SELL
22-12-20 14:26,14:26,12073750,8124400,-3949350,SELL
22-12-20 14:27,14:27,12128825,8008825,-4120000,SELL
22-12-20 14:28,14:28,12132725,8156550,-3976175,SELL
22-12-20 14:29,14:29,12101050,7954075,-4146975,SELL
22-12-20 14:30,14:30,12175050,8212000,-3963050,SELL
22-12-20 14:31,14:31,12168325,8045200,-4123125,SELL
22-12-20 14:32,14:32,12168325,8023400,-4144925,SELL
22-12-20 14:33,14:33,12154400,8056175,-4098225,SELL
22-12-20 14:34,14:34,12200250,8096850,-4103400,SELL
22-12-20 14:35,14:35,12180050,8153825,-4026225,SELL
22-12-20 14:36,14:36,12150675,8300025,-3850650,SELL
22-12-20 14:37,14:37,12148850,8290325,-3858525,SELL
22-12-20 14:38,14:38,12150725,8299825,-3850900,SELL
22-12-20 14:39,14:39,12162725,8346550,-3816175,SELL
22-12-20 14:40,14:40,12160000,8303525,-3856475,SELL
22-12-20 14:41,14:41,12130475,8360550,-3769925,SELL
22-12-20 14:42,14:42,12164500,8465025,-3699475,SELL
22-12-20 14:43,14:43,12123650,8337925,-3785725,SELL
22-12-20 14:44,14:44,12150175,8317450,-3832725,SELL
22-12-20 14:45,14:45,12091550,8388975,-3702575,SELL
22-12-20 14:46,14:46,12080175,8476650,-3603525,SELL
22-12-20 14:47,14:47,12091275,8484675,-3606600,SELL
22-12-20 14:48,14:48,12041400,8345950,-3695450,SELL
22-12-20 14:49,14:49,12069325,8410825,-3658500,SELL
22-12-20 14:50,14:50,12067450,8508725,-3558725,SELL
22-12-20 14:51,14:51,11736875,8464200,-3272675,SELL
22-12-20 14:52,14:52,11739525,8395625,-3343900,SELL
22-12-20 14:53,14:53,11741525,8309075,-3432450,SELL
22-12-20 14:54,14:54,11644500,8349900,-3294600,SELL
22-12-20 14:55,14:55,11644750,8168650,-3476100,SELL
22-12-20 14:56,14:56,11644750,8320325,-3324425,SELL
22-12-20 14:57,14:57,11619750,8289375,-3330375,SELL
22-12-20 14:58,14:58,11609850,8333200,-3276650,SELL
22-12-20 14:59,14:59,11586825,8164975,-3421850,SELL
22-12-20 15:00,15:00,11694725,8312000,-3382725,SELL
22-12-20 15:01,15:01,11697775,8183825,-3513950,SELL
22-12-20 15:02,15:02,11665925,7941350,-3724575,SELL
22-12-20 15:03,15:03,11639500,8129625,-3509875,SELL
22-12-20 15:04,15:04,11620550,8082325,-3538225,SELL
22-12-20 15:05,15:05,11604025,8173375,-3430650,SELL
22-12-20 15:06,15:06,11582775,8195350,-3387425,SELL
22-12-20 15:07,15:07,11565400,8150975,-3414425,SELL
22-12-20 15:08,15:08,11562350,8241225,-3321125,SELL
22-12-20 15:09,15:09,11481950,8188675,-3293275,SELL
22-12-20 15:10,15:10,11485925,8291275,-3194650,SELL
22-12-20 15:11,15:11,11483100,8183725,-3299375,SELL
22-12-20 15:12,15:12,11426725,8154975,-3271750,SELL
22-12-20 15:13,15:13,11433150,7888725,-3544425,SELL
22-12-20 15:14,15:14,11372200,8100750,-3271450,SELL
22-12-20 15:15,15:15,11469075,8194050,-3275025,SELL
22-12-20 15:16,15:16,11462575,8259150,-3203425,SELL
22-12-20 15:17,15:17,11448100,8122900,-3325200,SELL
22-12-20 15:18,15:18,11417200,8184925,-3232275,SELL
22-12-20 15:19,15:19,11423275,8262525,-3160750,SELL
22-12-20 15:20,15:20,11435275,8236175,-3199100,SELL
22-12-20 15:21,15:21,11391825,8191975,-3199850,SELL
22-12-20 15:22,15:22,11379025,8283075,-3095950,SELL
22-12-20 15:23,15:23,11366025,8251750,-3114275,SELL
22-12-20 15:24,15:24,11227775,8040975,-3186800,SELL
22-12-20 15:25,15:25,11250950,8141050,-3109900,SELL
22-12-20 15:26,15:26,11253700,8046200,-3207500,SELL
22-12-20 15:27,15:27,11241000,8225250,-3015750,SELL
22-12-20 15:28,15:28,11204575,8072325,-3132250,SELL
22-12-20 15:29,15:29,11240925,8184100,-3056825,SELL
23-12-20 9:15,9:15,9950700,7194250,-2756450,SELL
23-12-20 9:16,9:16,9920175,7172400,-2747775,SELL
23-12-20 9:17,9:17,10072100,7348225,-2723875,SELL
23-12-20 9:18,9:18,10074175,7216400,-2857775,SELL
23-12-20 9:19,9:19,10076300,7334100,-2742200,SELL
23-12-20 9:20,9:20,10271400,7517675,-2753725,SELL
23-12-20 9:21,9:21,10268875,7421850,-2847025,SELL
23-12-20 9:22,9:22,10265350,7510650,-2754700,SELL
23-12-20 9:23,9:23,10451350,7726400,-2724950,SELL
23-12-20 9:24,9:24,10480200,7766475,-2713725,SELL
23-12-20 9:25,9:25,10477675,7677675,-2800000,SELL
23-12-20 9:26,9:26,10647300,7994375,-2652925,SELL
23-12-20 9:27,9:27,10643500,8004525,-2638975,SELL
23-12-20 9:28,9:28,10652250,7806950,-2845300,SELL
23-12-20 9:29,9:29,10765775,8054500,-2711275,SELL
23-12-20 9:30,9:30,10911550,8224300,-2687250,SELL
23-12-20 9:31,9:31,10909250,8159650,-2749600,SELL
23-12-20 9:32,9:32,11173625,8303400,-2870225,SELL
23-12-20 9:33,9:33,11192475,8197675,-2994800,SELL
23-12-20 9:34,9:34,11200100,8355400,-2844700,SELL
23-12-20 9:35,9:35,11484475,8579650,-2904825,SELL
23-12-20 9:36,9:36,11282750,8509300,-2773450,SELL
23-12-20 9:37,9:37,11415775,8516225,-2899550,SELL
23-12-20 9:38,9:38,11586475,8592125,-2994350,SELL
23-12-20 9:39,9:39,11587275,8736125,-2851150,SELL
23-12-20 9:40,9:40,11587275,8680200,-2907075,SELL
23-12-20 9:41,9:41,11592875,8643550,-2949325,SELL
23-12-20 9:42,9:42,11577450,8577675,-2999775,SELL
23-12-20 9:43,9:43,11579450,8544650,-3034800,SELL
23-12-20 9:44,9:44,11812275,8687175,-3125100,SELL
23-12-20 9:45,9:45,11703025,8685825,-3017200,SELL
23-12-20 9:46,9:46,11803825,8681625,-3122200,SELL
23-12-20 9:47,9:47,12025475,9057325,-2968150,SELL
23-12-20 9:48,9:48,12019325,9029525,-2989800,SELL
23-12-20 9:49,9:49,12001075,8931050,-3070025,SELL
23-12-20 9:50,9:50,11849900,9148850,-2701050,SELL
23-12-20 9:51,9:51,12114275,9070550,-3043725,SELL
23-12-20 9:52,9:52,12096250,9129350,-2966900,SELL
23-12-20 9:53,9:53,12243450,9620475,-2622975,SELL
23-12-20 9:54,9:54,12155500,9534975,-2620525,SELL
23-12-20 9:55,9:55,12241525,9538300,-2703225,SELL
23-12-20 9:56,9:56,12164925,9571025,-2593900,SELL
23-12-20 9:57,9:57,12122225,9609750,-2512475,SELL
23-12-20 9:58,9:58,12056600,9614275,-2442325,SELL
23-12-20 9:59,9:59,12024475,9557200,-2467275,SELL
23-12-20 10:00,10:00,12014500,9716300,-2298200,SELL
23-12-20 10:01,10:01,12019200,9819075,-2200125,SELL
23-12-20 10:02,10:02,12255150,9762125,-2493025,SELL
23-12-20 10:03,10:03,12245200,9621700,-2623500,SELL
23-12-20 10:04,10:04,12204400,9761300,-2443100,SELL
23-12-20 10:05,10:05,12356350,9726850,-2629500,SELL
23-12-20 10:06,10:06,12337750,9909225,-2428525,SELL
23-12-20 10:07,10:07,12335750,9697925,-2637825,SELL
23-12-20 10:08,10:08,12421375,10051700,-2369675,SELL
23-12-20 10:09,10:09,12389450,9890350,-2499100,SELL
23-12-20 10:10,10:10,12370550,10012750,-2357800,SELL
23-12-20 10:11,10:11,12491350,9855925,-2635425,SELL
23-12-20 10:12,10:12,12252225,9930100,-2322125,SELL
23-12-20 10:13,10:13,12500125,10154050,-2346075,SELL
23-12-20 10:14,10:14,12490025,10162600,-2327425,SELL
23-12-20 10:15,10:15,12502050,10037750,-2464300,SELL
23-12-20 10:16,10:16,12521050,10036650,-2484400,SELL
23-12-20 10:17,10:17,12469225,10035950,-2433275,SELL
23-12-20 10:18,10:18,12458525,10030975,-2427550,SELL
23-12-20 10:19,10:19,12582700,9843075,-2739625,SELL
23-12-20 10:20,10:20,12534075,10030200,-2503875,SELL
23-12-20 10:21,10:21,12598500,9948625,-2649875,SELL
23-12-20 10:22,10:22,12315450,10074525,-2240925,SELL
23-12-20 10:23,10:23,12602300,10164425,-2437875,SELL
23-12-20 10:24,10:24,12745850,10323700,-2422150,SELL
23-12-20 10:25,10:25,12723075,10217175,-2505900,SELL
23-12-20 10:26,10:26,12758075,10291025,-2467050,SELL
23-12-20 10:27,10:27,12780775,10438400,-2342375,SELL
23-12-20 10:28,10:28,12675325,10292400,-2382925,SELL
23-12-20 10:29,10:29,12735425,10560700,-2174725,SELL
23-12-20 10:30,10:30,12733825,10553650,-2180175,SELL
23-12-20 10:31,10:31,12646600,10425775,-2220825,SELL
23-12-20 10:32,10:32,12482375,10586075,-1896300,SELL
23-12-20 10:33,10:33,12480600,10612300,-1868300,SELL
23-12-20 10:34,10:34,12466250,10512925,-1953325,SELL
23-12-20 10:35,10:35,12232800,10646950,-1585850,SELL
23-12-20 10:36,10:36,12247000,10408875,-1838125,SELL
23-12-20 10:37,10:37,12295450,10556275,-1739175,SELL
23-12-20 10:38,10:38,12250975,10527525,-1723450,SELL
23-12-20 10:39,10:39,12263175,10759325,-1503850,SELL
23-12-20 10:40,10:40,12253175,10706600,-1546575,SELL
23-12-20 10:41,10:41,11604400,10753225,-851175,SELL
23-12-20 10:42,10:42,11592200,10656900,-935300,SELL
23-12-20 10:43,10:43,11419400,10756425,-662975,SELL
23-12-20 10:44,10:44,11846175,10832375,-1013800,SELL
23-12-20 10:45,10:45,11892925,10948275,-944650,SELL
23-12-20 10:46,10:46,11881100,10825750,-1055350,SELL
23-12-20 10:47,10:47,12053325,11064700,-988625,SELL
23-12-20 10:48,10:48,11970450,10971250,-999200,SELL
23-12-20 10:49,10:49,12026075,11060300,-965775,SELL
23-12-20 10:50,10:50,12023250,10986800,-1036450,SELL
23-12-20 10:51,10:51,11982400,10980475,-1001925,SELL
23-12-20 10:52,10:52,11998550,10980475,-1018075,SELL
23-12-20 10:53,10:53,11929500,10927325,-1002175,SELL
23-12-20 10:54,10:54,11977075,10802225,-1174850,SELL
23-12-20 10:55,10:55,11946200,11059750,-886450,SELL
23-12-20 10:56,10:56,11939500,11033475,-906025,SELL
23-12-20 10:57,10:57,11945975,11028675,-917300,SELL
23-12-20 10:58,10:58,11973475,10840425,-1133050,SELL
23-12-20 10:59,10:59,11993925,11005875,-988050,SELL
23-12-20 11:00,11:00,11997975,11095975,-902000,SELL
23-12-20 11:01,11:01,11789325,10832225,-957100,SELL
23-12-20 11:02,11:02,11989800,10927800,-1062000,SELL
23-12-20 11:03,11:03,12024100,11030625,-993475,SELL
23-12-20 11:04,11:04,11993375,10989875,-1003500,SELL
23-12-20 11:05,11:05,11880925,11113850,-767075,SELL
23-12-20 11:06,11:06,12076275,11140750,-935525,SELL
23-12-20 11:07,11:07,11944425,11166200,-778225,SELL
23-12-20 11:08,11:08,11922750,10940625,-982125,SELL
23-12-20 11:09,11:09,12016350,11069650,-946700,SELL
23-12-20 11:10,11:10,12073950,11159550,-914400,SELL
23-12-20 11:11,11:11,11924025,11063425,-860600,SELL
23-12-20 11:12,11:12,12039475,11153075,-886400,SELL
23-12-20 11:13,11:13,12076400,10927325,-1149075,SELL
23-12-20 11:14,11:14,11703075,11041025,-662050,SELL
23-12-20 11:15,11:15,12093225,11135500,-957725,SELL
23-12-20 11:16,11:16,12031525,10917350,-1114175,SELL
23-12-20 11:17,11:17,11930875,11117875,-813000,SELL
23-12-20 11:18,11:18,11766100,10961850,-804250,SELL
23-12-20 11:19,11:19,12023950,10952750,-1071200,SELL
23-12-20 11:20,11:20,11977725,11108600,-869125,SELL
23-12-20 11:21,11:21,12105575,11032850,-1072725,SELL
23-12-20 11:22,11:22,12068200,11075300,-992900,SELL
23-12-20 11:23,11:23,12041400,11000725,-1040675,SELL
23-12-20 11:24,11:24,12084725,11121500,-963225,SELL
23-12-20 11:25,11:25,12074850,10934050,-1140800,SELL
23-12-20 11:26,11:26,12114250,11056125,-1058125,SELL
23-12-20 11:27,11:27,12045300,11109850,-935450,SELL
23-12-20 11:28,11:28,12116325,11141425,-974900,SELL
23-12-20 11:29,11:29,12019900,11284275,-735625,SELL
23-12-20 11:30,11:30,12134400,11161200,-973200,SELL
23-12-20 11:31,11:31,11807600,11226400,-581200,SELL
23-12-20 11:32,11:32,12141575,11257200,-884375,SELL
23-12-20 11:33,11:33,12139525,11101625,-1037900,SELL
23-12-20 11:34,11:34,12097500,11011900,-1085600,SELL
23-12-20 11:35,11:35,12173825,11143375,-1030450,SELL
23-12-20 11:36,11:36,11969475,11244725,-724750,SELL
23-12-20 11:37,11:37,12136775,10928775,-1208000,SELL
23-12-20 11:38,11:38,12213900,11045575,-1168325,SELL
23-12-20 11:39,11:39,12209800,11165900,-1043900,SELL
23-12-20 11:40,11:40,12140275,10726900,-1413375,SELL
23-12-20 11:41,11:41,12144250,10950100,-1194150,SELL
23-12-20 11:42,11:42,12113400,10757100,-1356300,SELL
23-12-20 11:43,11:43,12015350,10951625,-1063725,SELL
23-12-20 11:44,11:44,12124975,10839850,-1285125,SELL
23-12-20 11:45,11:45,11875350,10977800,-897550,SELL
23-12-20 11:46,11:46,11820350,10842675,-977675,SELL
23-12-20 11:47,11:47,12057975,11032650,-1025325,SELL
23-12-20 11:48,11:48,11815900,10666150,-1149750,SELL
23-12-20 11:49,11:49,12119275,11051875,-1067400,SELL
23-12-20 11:50,11:50,12027300,10712825,-1314475,SELL
23-12-20 11:51,11:51,12148250,11228975,-919275,SELL
23-12-20 11:52,11:52,12137975,11143975,-994000,SELL
23-12-20 11:53,11:53,12056750,11240950,-815800,SELL
23-12-20 11:54,11:54,12135575,11117350,-1018225,SELL
23-12-20 11:55,11:55,12080950,11241025,-839925,SELL
23-12-20 11:56,11:56,11950375,11108900,-841475,SELL
23-12-20 11:57,11:57,12130700,11125825,-1004875,SELL
23-12-20 11:58,11:58,11894375,10920525,-973850,SELL
23-12-20 11:59,11:59,12026950,10675025,-1351925,SELL
23-12-20 12:00,12:00,12059275,10919100,-1140175,SELL
23-12-20 12:01,12:01,12159100,10983425,-1175675,SELL
23-12-20 12:02,12:02,12003050,11124625,-878425,SELL
23-12-20 12:03,12:03,12201775,10969775,-1232000,SELL
23-12-20 12:04,12:04,12156200,11146725,-1009475,SELL
23-12-20 12:05,12:05,12161000,11103000,-1058000,SELL
23-12-20 12:06,12:06,12313300,11019925,-1293375,SELL
23-12-20 12:07,12:07,12287275,11054275,-1233000,SELL
23-12-20 12:08,12:08,12341225,10926350,-1414875,SELL
23-12-20 12:09,12:09,12187325,10879650,-1307675,SELL
23-12-20 12:10,12:10,11891425,10644825,-1246600,SELL
23-12-20 12:11,12:11,12367200,10836775,-1530425,SELL
23-12-20 12:12,12:12,12230325,10792225,-1438100,SELL
23-12-20 12:13,12:13,12315675,10746325,-1569350,SELL
23-12-20 12:14,12:14,12299025,10754825,-1544200,SELL
23-12-20 12:15,12:15,12393375,11096875,-1296500,SELL
23-12-20 12:16,12:16,12301925,10961325,-1340600,SELL
23-12-20 12:17,12:17,12391825,10679100,-1712725,SELL
23-12-20 12:18,12:18,12376225,11075275,-1300950,SELL
23-12-20 12:19,12:19,12396225,11137550,-1258675,SELL
23-12-20 12:20,12:20,12402675,11102350,-1300325,SELL
23-12-20 12:21,12:21,12221850,10816275,-1405575,SELL
23-12-20 12:22,12:22,12312625,10965475,-1347150,SELL
23-12-20 12:23,12:23,12301575,10977425,-1324150,SELL
23-12-20 12:24,12:24,12353175,10980400,-1372775,SELL
23-12-20 12:25,12:25,12436500,10910425,-1526075,SELL
23-12-20 12:26,12:26,12227225,10698050,-1529175,SELL
23-12-20 12:27,12:27,12289825,11045825,-1244000,SELL
23-12-20 12:28,12:28,12450500,11194300,-1256200,SELL
23-12-20 12:29,12:29,12407450,11001175,-1406275,SELL
23-12-20 12:30,12:30,12506925,10930375,-1576550,SELL
23-12-20 12:31,12:31,12523725,11119050,-1404675,SELL
23-12-20 12:32,12:32,12420525,11080900,-1339625,SELL
23-12-20 12:33,12:33,12572375,11287400,-1284975,SELL
23-12-20 12:34,12:34,12376700,11136675,-1240025,SELL
23-12-20 12:35,12:35,12574775,11319500,-1255275,SELL
23-12-20 12:36,12:36,12677075,11429675,-1247400,SELL
23-12-20 12:37,12:37,12657850,11255375,-1402475,SELL
23-12-20 12:38,12:38,12418275,11229075,-1189200,SELL
23-12-20 12:39,12:39,12401900,11300850,-1101050,SELL
23-12-20 12:40,12:40,12555825,11280900,-1274925,SELL
23-12-20 12:41,12:41,12600500,11219325,-1381175,SELL
23-12-20 12:42,12:42,12670900,11400550,-1270350,SELL
23-12-20 12:43,12:43,12670900,11461000,-1209900,SELL
23-12-20 12:44,12:44,12651650,11415075,-1236575,SELL
23-12-20 12:45,12:45,12707725,11369150,-1338575,SELL
23-12-20 12:46,12:46,12758525,11290075,-1468450,SELL
23-12-20 12:47,12:47,12719075,11454925,-1264150,SELL
23-12-20 12:48,12:48,12712700,11558900,-1153800,SELL
23-12-20 12:49,12:49,12741725,11707025,-1034700,SELL
23-12-20 12:50,12:50,12729750,11585075,-1144675,SELL
23-12-20 12:51,12:51,12624925,11482025,-1142900,SELL
23-12-20 12:52,12:52,12631825,11533725,-1098100,SELL
23-12-20 12:53,12:53,12624925,11554550,-1070375,SELL
23-12-20 12:54,12:54,12547825,11536450,-1011375,SELL
23-12-20 12:55,12:55,12541200,11718200,-823000,SELL
23-12-20 12:56,12:56,12295375,11528600,-766775,SELL
23-12-20 12:57,12:57,12007800,11505450,-502350,SELL
23-12-20 12:58,12:58,11770525,11505450,-265075,SELL
23-12-20 12:59,12:59,12274900,11723175,-551725,SELL
23-12-20 13:00,13:00,12041600,11860125,-181475,SELL
23-12-20 13:01,13:01,12284700,11780400,-504300,SELL
23-12-20 13:02,13:02,12144325,11903775,-240550,SELL
23-12-20 13:03,13:03,12237775,11865850,-371925,SELL
23-12-20 13:04,13:04,11991000,11786675,-204325,SELL
23-12-20 13:05,13:05,12253225,11877300,-375925,SELL
23-12-20 13:06,13:06,12099350,11903425,-195925,SELL
23-12-20 13:07,13:07,12169100,11776725,-392375,SELL
23-12-20 13:08,13:08,12349150,11955425,-393725,SELL
23-12-20 13:09,13:09,12391475,12018400,-373075,SELL
23-12-20 13:10,13:10,12426700,11953200,-473500,SELL
23-12-20 13:11,13:11,12424700,11918975,-505725,SELL
23-12-20 13:12,13:12,12365950,11647625,-718325,SELL
23-12-20 13:13,13:13,12341825,11622575,-719250,SELL
23-12-20 13:14,13:14,12345225,11659000,-686225,SELL
23-12-20 13:15,13:15,12225500,11797625,-427875,SELL
23-12-20 13:16,13:16,12235325,11711450,-523875,SELL
23-12-20 13:17,13:17,12225500,11622725,-602775,SELL
23-12-20 13:18,13:18,12133050,11875275,-257775,SELL
23-12-20 13:19,13:19,12187400,11693800,-493600,SELL
23-12-20 13:20,13:20,12232900,11591075,-641825,SELL
23-12-20 13:21,13:21,12256350,11538175,-718175,SELL
23-12-20 13:22,13:22,12204825,11857225,-347600,SELL
23-12-20 13:23,13:23,12042100,11770025,-272075,SELL
23-12-20 13:24,13:24,12115000,11851225,-263775,SELL
23-12-20 13:25,13:25,12252700,11819925,-432775,SELL
23-12-20 13:26,13:26,12252700,11765250,-487450,SELL
23-12-20 13:27,13:27,12101675,11788275,-313400,SELL
23-12-20 13:28,13:28,12210550,11872725,-337825,SELL
23-12-20 13:29,13:29,12198250,11812250,-386000,SELL
23-12-20 13:30,13:30,12230675,11950100,-280575,SELL
23-12-20 13:31,13:31,11951050,11951400,350,BUY
23-12-20 13:32,13:32,12169900,12008250,-161650,SELL
23-12-20 13:33,13:33,12034825,11899450,-135375,SELL
23-12-20 13:34,13:34,11964250,11841025,-123225,SELL
23-12-20 13:35,13:35,12137750,12074025,-63725,SELL
23-12-20 13:36,13:36,12142900,12090375,-52525,SELL
23-12-20 13:37,13:37,12130125,11951025,-179100,SELL
23-12-20 13:38,13:38,12184425,11786425,-398000,SELL
23-12-20 13:39,13:39,12178225,11945775,-232450,SELL
23-12-20 13:40,13:40,12233575,12150100,-83475,SELL
23-12-20 13:41,13:41,12058100,12019000,-39100,SELL
23-12-20 13:42,13:42,12145100,11736800,-408300,SELL
23-12-20 13:43,13:43,11998750,11990150,-8600,SELL
23-12-20 13:44,13:44,11911125,11861175,-49950,SELL
23-12-20 13:45,13:45,12117150,11793550,-323600,SELL
23-12-20 13:46,13:46,12172275,12160075,-12200,SELL
23-12-20 13:47,13:47,11825275,12104925,279650,BUY
23-12-20 13:48,13:48,11908475,12016325,107850,BUY
23-12-20 13:49,13:49,12034125,12013175,-20950,SELL
23-12-20 13:50,13:50,12024375,11956975,-67400,SELL
23-12-20 13:51,13:51,12092150,11954050,-138100,SELL
23-12-20 13:52,13:52,12075625,11739650,-335975,SELL
23-12-20 13:53,13:53,12049175,11828325,-220850,SELL
23-12-20 13:54,13:54,12063900,11781275,-282625,SELL
23-12-20 13:55,13:55,12057400,11868300,-189100,SELL
23-12-20 13:56,13:56,11996850,11844675,-152175,SELL
23-12-20 13:57,13:57,11823825,11839825,16000,BUY
23-12-20 13:58,13:58,12037950,11781625,-256325,SELL
23-12-20 13:59,13:59,12112025,11935475,-176550,SELL
23-12-20 14:00,14:00,11933975,11902150,-31825,SELL
23-12-20 14:01,14:01,12010775,11769250,-241525,SELL
23-12-20 14:02,14:02,12089075,11895225,-193850,SELL
23-12-20 14:03,14:03,12115850,11869975,-245875,SELL
23-12-20 14:04,14:04,12115850,11778875,-336975,SELL
23-12-20 14:05,14:05,12092800,12050950,-41850,SELL
23-12-20 14:06,14:06,12067550,11858650,-208900,SELL
23-12-20 14:07,14:07,12107800,11582375,-525425,SELL
23-12-20 14:08,14:08,12116550,11948175,-168375,SELL
23-12-20 14:09,14:09,12103400,11888100,-215300,SELL
23-12-20 14:10,14:10,12163800,11764925,-398875,SELL
23-12-20 14:11,14:11,12135475,11861175,-274300,SELL
23-12-20 14:12,14:12,12155750,11803475,-352275,SELL
23-12-20 14:13,14:13,12146900,11741100,-405800,SELL
23-12-20 14:14,14:14,12178550,11852325,-326225,SELL
23-12-20 14:15,14:15,12096775,12019025,-77750,SELL
23-12-20 14:16,14:16,12125675,11850450,-275225,SELL
23-12-20 14:17,14:17,11967925,11714550,-253375,SELL
23-12-20 14:18,14:18,12176150,11856050,-320100,SELL
23-12-20 14:19,14:19,12163050,11829450,-333600,SELL
23-12-20 14:20,14:20,12029950,11676350,-353600,SELL
23-12-20 14:21,14:21,12078525,11984725,-93800,SELL
23-12-20 14:22,14:22,12143200,11794325,-348875,SELL
23-12-20 14:23,14:23,12159375,11991500,-167875,SELL
23-12-20 14:24,14:24,12091375,11703900,-387475,SELL
23-12-20 14:25,14:25,11949000,11775325,-173675,SELL
23-12-20 14:26,14:26,11995300,11844100,-151200,SELL
23-12-20 14:27,14:27,11950775,11755975,-194800,SELL
23-12-20 14:28,14:28,12081800,11529175,-552625,SELL
23-12-20 14:29,14:29,12081700,11871750,-209950,SELL
23-12-20 14:30,14:30,12085850,11554200,-531650,SELL
23-12-20 14:31,14:31,11956600,11366300,-590300,SELL
23-12-20 14:32,14:32,12062350,11510675,-551675,SELL
23-12-20 14:33,14:33,11954500,11508900,-445600,SELL
23-12-20 14:34,14:34,12091525,11642125,-449400,SELL
23-12-20 14:35,14:35,12082125,11545975,-536150,SELL
23-12-20 14:36,14:36,11938850,11555825,-383025,SELL
23-12-20 14:37,14:37,12090825,11537900,-552925,SELL
23-12-20 14:38,14:38,12104025,11643575,-460450,SELL
23-12-20 14:39,14:39,11970775,11494375,-476400,SELL
23-12-20 14:40,14:40,11965075,11445800,-519275,SELL
23-12-20 14:41,14:41,11844575,11582525,-262050,SELL
23-12-20 14:42,14:42,11852450,11453700,-398750,SELL
23-12-20 14:43,14:43,11915075,11461700,-453375,SELL
23-12-20 14:44,14:44,11739225,11395700,-343525,SELL
23-12-20 14:45,14:45,11852525,11277625,-574900,SELL
23-12-20 14:46,14:46,11652875,11370450,-282425,SELL
23-12-20 14:47,14:47,11725725,11344500,-381225,SELL
23-12-20 14:48,14:48,11764000,11216800,-547200,SELL
23-12-20 14:49,14:49,11747050,10899875,-847175,SELL
23-12-20 14:50,14:50,11794600,11195925,-598675,SELL
23-12-20 14:51,14:51,11718450,10911425,-807025,SELL
23-12-20 14:52,14:52,11707800,10937925,-769875,SELL
23-12-20 14:53,14:53,11670500,11055525,-614975,SELL
23-12-20 14:54,14:54,11653550,10767525,-886025,SELL
23-12-20 14:55,14:55,11653550,10914350,-739200,SELL
23-12-20 14:56,14:56,11663050,10947300,-715750,SELL
23-12-20 14:57,14:57,11626900,10808075,-818825,SELL
23-12-20 14:58,14:58,11617625,10835200,-782425,SELL
23-12-20 14:59,14:59,11589125,10756275,-832850,SELL
23-12-20 15:00,15:00,11483525,10838800,-644725,SELL
23-12-20 15:01,15:01,11472075,10839525,-632550,SELL
23-12-20 15:02,15:02,11497000,10845600,-651400,SELL
23-12-20 15:03,15:03,11366575,10751650,-614925,SELL
23-12-20 15:04,15:04,11353625,10819225,-534400,SELL
23-12-20 15:05,15:05,11409375,10780725,-628650,SELL
23-12-20 15:06,15:06,11212450,10537900,-674550,SELL
23-12-20 15:07,15:07,11241125,10498800,-742325,SELL
23-12-20 15:08,15:08,11269175,10586600,-682575,SELL
23-12-20 15:09,15:09,11003200,10371000,-632200,SELL
23-12-20 15:10,15:10,11022300,10379200,-643100,SELL
23-12-20 15:11,15:11,11014350,10402800,-611550,SELL
23-12-20 15:12,15:12,10943075,10318700,-624375,SELL
23-12-20 15:13,15:13,10933075,10219750,-713325,SELL
23-12-20 15:14,15:14,10948075,10400800,-547275,SELL
23-12-20 15:15,15:15,10807175,10268700,-538475,SELL
23-12-20 15:16,15:16,10780475,10152050,-628425,SELL
23-12-20 15:17,15:17,10760350,10314425,-445925,SELL
23-12-20 15:18,15:18,10632825,10272300,-360525,SELL
23-12-20 15:19,15:19,10623825,10171975,-451850,SELL
23-12-20 15:20,15:20,10633775,10278925,-354850,SELL
23-12-20 15:21,15:21,10211125,10013700,-197425,SELL
23-12-20 15:22,15:22,10202175,9922000,-280175,SELL
23-12-20 15:23,15:23,10210225,9949400,-260825,SELL
23-12-20 15:24,15:24,9893025,9645750,-247275,SELL
23-12-20 15:25,15:25,9911300,9811200,-100100,SELL
23-12-20 15:26,15:26,9920400,9769325,-151075,SELL
23-12-20 15:27,15:27,9564350,9554075,-10275,SELL
23-12-20 15:28,15:28,9553525,9464750,-88775,SELL
23-12-20 15:29,15:29,9559125,9513600,-45525,SELL
24-12-20 9:15,9:15,9277700,8730050,-547650,SELL
24-12-20 9:16,9:16,9278825,9306900,28075,BUY
24-12-20 9:17,9:17,9380525,9485500,104975,BUY
24-12-20 9:18,9:18,9386225,9460050,73825,BUY
24-12-20 9:19,9:19,9365550,9478850,113300,BUY
24-12-20 9:20,9:20,9580525,9908575,328050,BUY
24-12-20 9:21,9:21,9589800,9916525,326725,BUY
24-12-20 9:22,9:22,9570900,9915250,344350,BUY
24-12-20 9:23,9:23,10084100,10691675,607575,BUY
24-12-20 9:24,9:24,10101125,10697850,596725,BUY
24-12-20 9:25,9:25,10044950,10703950,659000,BUY
24-12-20 9:26,9:26,10189950,11786825,1596875,BUY
24-12-20 9:27,9:27,10180325,11817000,1636675,BUY
24-12-20 9:28,9:28,10215225,11816500,1601275,BUY
24-12-20 9:29,9:29,10414425,12598700,2184275,BUY
24-12-20 9:30,9:30,10422275,12610300,2188025,BUY
24-12-20 9:31,9:31,10414725,12591400,2176675,BUY
24-12-20 9:32,9:32,11109550,13632875,2523325,BUY
24-12-20 9:33,9:33,11085675,13628875,2543200,BUY
24-12-20 9:34,9:34,11056000,13628875,2572875,BUY
24-12-20 9:35,9:35,11619800,14478175,2858375,BUY
24-12-20 9:36,9:36,11593075,14441525,2848450,BUY
24-12-20 9:37,9:37,11585450,14441525,2856075,BUY
24-12-20 9:38,9:38,12482650,15125750,2643100,BUY
24-12-20 9:39,9:39,12482325,15130350,2648025,BUY
24-12-20 9:40,9:40,12484725,15156650,2671925,BUY
24-12-20 9:41,9:41,12767050,15911675,3144625,BUY
24-12-20 9:42,9:42,12775625,15957800,3182175,BUY
24-12-20 9:43,9:43,12832875,15970750,3137875,BUY
24-12-20 9:44,9:44,13018925,16393800,3374875,BUY
24-12-20 9:45,9:45,13065400,16362625,3297225,BUY
24-12-20 9:46,9:46,13051700,16361550,3309850,BUY
24-12-20 9:47,9:47,13330825,16916725,3585900,BUY
24-12-20 9:48,9:48,13298775,16921950,3623175,BUY
24-12-20 9:49,9:49,13341225,16899575,3558350,BUY
24-12-20 9:50,9:50,13406150,17030125,3623975,BUY
24-12-20 9:51,9:51,13456700,17074600,3617900,BUY
24-12-20 9:52,9:52,13470350,17080900,3610550,BUY
24-12-20 9:53,9:53,12777325,17077825,4300500,BUY
24-12-20 9:54,9:54,12777375,17117375,4340000,BUY
24-12-20 9:55,9:55,12817375,17017750,4200375,BUY
24-12-20 9:56,9:56,12716475,17153975,4437500,BUY
24-12-20 9:57,9:57,12718750,17154175,4435425,BUY
24-12-20 9:58,9:58,12649550,17171425,4521875,BUY
24-12-20 9:59,9:59,12975275,17369200,4393925,BUY
24-12-20 10:00,10:00,12874025,17362450,4488425,BUY
24-12-20 10:01,10:01,12963625,17366450,4402825,BUY
24-12-20 10:02,10:02,12979625,17475575,4495950,BUY
24-12-20 10:03,10:03,12935350,17475575,4540225,BUY
24-12-20 10:04,10:04,13062950,17427575,4364625,BUY
24-12-20 10:05,10:05,12952975,17723875,4770900,BUY
24-12-20 10:06,10:06,12953075,17711050,4757975,BUY
24-12-20 10:07,10:07,12910200,17709525,4799325,BUY
24-12-20 10:08,10:08,12837875,17768050,4930175,BUY
24-12-20 10:09,10:09,12664350,17828550,5164200,BUY
24-12-20 10:10,10:10,13070675,17862150,4791475,BUY
24-12-20 10:11,10:11,12956450,18110825,5154375,BUY
24-12-20 10:12,10:12,12914025,18097650,5183625,BUY
24-12-20 10:13,10:13,12998800,18105350,5106550,BUY
24-12-20 10:14,10:14,12163550,18359125,6195575,BUY
24-12-20 10:15,10:15,12178100,18363075,6184975,BUY
24-12-20 10:16,10:16,12169200,18366825,6197625,BUY
24-12-20 10:17,10:17,12157275,18499625,6342350,BUY
24-12-20 10:18,10:18,12165050,18530100,6365050,BUY
24-12-20 10:19,10:19,12165050,18585150,6420100,BUY
24-12-20 10:20,10:20,12202975,18783975,6581000,BUY
24-12-20 10:21,10:21,12202750,18777175,6574425,BUY
24-12-20 10:22,10:22,12235250,18718775,6483525,BUY
24-12-20 10:23,10:23,12232400,18817550,6585150,BUY
24-12-20 10:24,10:24,12259875,18845725,6585850,BUY
24-12-20 10:25,10:25,12296100,18774625,6478525,BUY
24-12-20 10:26,10:26,12511975,18901100,6389125,BUY
24-12-20 10:27,10:27,12474800,18899025,6424225,BUY
24-12-20 10:28,10:28,12406300,18894100,6487800,BUY
24-12-20 10:29,10:29,12634600,18927225,6292625,BUY
24-12-20 10:30,10:30,12656650,18980100,6323450,BUY
24-12-20 10:31,10:31,12639675,18980100,6340425,BUY
24-12-20 10:32,10:32,12830400,18972850,6142450,BUY
24-12-20 10:33,10:33,12798000,19037650,6239650,BUY
24-12-20 10:34,10:34,12766075,19038925,6272850,BUY
24-12-20 10:35,10:35,13087425,19105375,6017950,BUY
24-12-20 10:36,10:36,12892325,19065700,6173375,BUY
24-12-20 10:37,10:37,13056600,19083775,6027175,BUY
24-12-20 10:38,10:38,12779900,19115450,6335550,BUY
24-12-20 10:39,10:39,12957200,19073550,6116350,BUY
24-12-20 10:40,10:40,13087075,19113200,6026125,BUY
24-12-20 10:41,10:41,13114150,19223350,6109200,BUY
24-12-20 10:42,10:42,13205550,19226200,6020650,BUY
24-12-20 10:43,10:43,12976675,19261550,6284875,BUY
24-12-20 10:44,10:44,13200850,19354975,6154125,BUY
24-12-20 10:45,10:45,13255825,19280325,6024500,BUY
24-12-20 10:46,10:46,13132375,19251575,6119200,BUY
24-12-20 10:47,10:47,13370050,19378200,6008150,BUY
24-12-20 10:48,10:48,13369975,19444525,6074550,BUY
24-12-20 10:49,10:49,13370250,19319775,5949525,BUY
24-12-20 10:50,10:50,13574375,19422625,5848250,BUY
24-12-20 10:51,10:51,13527800,19536100,6008300,BUY
24-12-20 10:52,10:52,13542725,19530350,5987625,BUY
24-12-20 10:53,10:53,13520800,19596850,6076050,BUY
24-12-20 10:54,10:54,13520550,19510575,5990025,BUY
24-12-20 10:55,10:55,13601175,19602825,6001650,BUY
24-12-20 10:56,10:56,13742300,19446175,5703875,BUY
24-12-20 10:57,10:57,13547950,19675625,6127675,BUY
24-12-20 10:58,10:58,13628175,19668850,6040675,BUY
24-12-20 10:59,10:59,13641125,19776625,6135500,BUY
24-12-20 11:00,11:00,13751750,19765100,6013350,BUY
24-12-20 11:01,11:01,13717700,19743400,6025700,BUY
24-12-20 11:02,11:02,13705625,19785525,6079900,BUY
24-12-20 11:03,11:03,13798500,19796475,5997975,BUY
24-12-20 11:04,11:04,13812375,19790750,5978375,BUY
24-12-20 11:05,11:05,13994975,19755275,5760300,BUY
24-12-20 11:06,11:06,13828075,19644400,5816325,BUY
24-12-20 11:07,11:07,13955750,19632275,5676525,BUY
24-12-20 11:08,11:08,13904675,19913075,6008400,BUY
24-12-20 11:09,11:09,13974525,19877100,5902575,BUY
24-12-20 11:10,11:10,13754350,19834250,6079900,BUY
24-12-20 11:11,11:11,14039200,19941550,5902350,BUY
24-12-20 11:12,11:12,14070300,19982475,5912175,BUY
24-12-20 11:13,11:13,14140125,19999625,5859500,BUY
24-12-20 11:14,11:14,14127725,19923525,5795800,BUY
24-12-20 11:15,11:15,14145775,19917100,5771325,BUY
24-12-20 11:16,11:16,14227100,19921975,5694875,BUY
24-12-20 11:17,11:17,14100875,19795325,5694450,BUY
24-12-20 11:18,11:18,14107050,19778225,5671175,BUY
24-12-20 11:19,11:19,13960225,19784300,5824075,BUY
24-12-20 11:20,11:20,14207050,19604075,5397025,BUY
24-12-20 11:21,11:21,14234925,19633775,5398850,BUY
24-12-20 11:22,11:22,14203800,19586650,5382850,BUY
24-12-20 11:23,11:23,14121500,19286625,5165125,BUY
24-12-20 11:24,11:24,14021500,19369475,5347975,BUY
24-12-20 11:25,11:25,14102175,19317250,5215075,BUY
24-12-20 11:26,11:26,14172025,19353500,5181475,BUY
24-12-20 11:27,11:27,14101225,19318400,5217175,BUY
24-12-20 11:28,11:28,14002275,19366625,5364350,BUY
24-12-20 11:29,11:29,14051225,19367125,5315900,BUY
24-12-20 11:30,11:30,13982650,19426775,5444125,BUY
24-12-20 11:31,11:31,14121100,19426775,5305675,BUY
24-12-20 11:32,11:32,14187225,19313625,5126400,BUY
24-12-20 11:33,11:33,14257675,19275525,5017850,BUY
24-12-20 11:34,11:34,14237525,19216425,4978900,BUY
24-12-20 11:35,11:35,14138375,19089375,4951000,BUY
24-12-20 11:36,11:36,14191350,19035800,4844450,BUY
24-12-20 11:37,11:37,13950300,19099575,5149275,BUY
24-12-20 11:38,11:38,14118975,18995050,4876075,BUY
24-12-20 11:39,11:39,13976450,18976300,4999850,BUY
24-12-20 11:40,11:40,14128500,18981325,4852825,BUY
24-12-20 11:41,11:41,13960875,18937225,4976350,BUY
24-12-20 11:42,11:42,13910575,18955150,5044575,BUY
24-12-20 11:43,11:43,13966150,18961825,4995675,BUY
24-12-20 11:44,11:44,13849075,18960725,5111650,BUY
24-12-20 11:45,11:45,14117775,18960575,4842800,BUY
24-12-20 11:46,11:46,14052225,19024550,4972325,BUY
24-12-20 11:47,11:47,14045325,19008625,4963300,BUY
24-12-20 11:48,11:48,14127450,19098300,4970850,BUY
24-12-20 11:49,11:49,14249050,19123375,4874325,BUY
24-12-20 11:50,11:50,14096750,19017225,4920475,BUY
24-12-20 11:51,11:51,14351725,19109125,4757400,BUY
24-12-20 11:52,11:52,14245750,19121675,4875925,BUY
24-12-20 11:53,11:53,14151300,19129075,4977775,BUY
24-12-20 11:54,11:54,14328175,19084025,4755850,BUY
24-12-20 11:55,11:55,14103325,19040600,4937275,BUY
24-12-20 11:56,11:56,14397225,18554225,4157000,BUY
24-12-20 11:57,11:57,14198600,18808625,4610025,BUY
24-12-20 11:58,11:58,14487875,19148900,4661025,BUY
24-12-20 11:59,11:59,14570050,18991950,4421900,BUY
24-12-20 12:00,12:00,14492250,19287725,4795475,BUY
24-12-20 12:01,12:01,14454950,19134850,4679900,BUY
24-12-20 12:02,12:02,14421850,19093975,4672125,BUY
24-12-20 12:03,12:03,14670675,19269500,4598825,BUY
24-12-20 12:04,12:04,14649150,19307700,4658550,BUY
24-12-20 12:05,12:05,14593975,19266200,4672225,BUY
24-12-20 12:06,12:06,14789975,19467050,4677075,BUY
24-12-20 12:07,12:07,14717925,19414525,4696600,BUY
24-12-20 12:08,12:08,14728150,19408925,4680775,BUY
24-12-20 12:09,12:09,14933650,19502775,4569125,BUY
24-12-20 12:10,12:10,14736550,19598025,4861475,BUY
24-12-20 12:11,12:11,14847625,19564875,4717250,BUY
24-12-20 12:12,12:12,14874075,20066025,5191950,BUY
24-12-20 12:13,12:13,14922800,20092325,5169525,BUY
24-12-20 12:14,12:14,14901025,20097225,5196200,BUY
24-12-20 12:15,12:15,15084400,20212825,5128425,BUY
24-12-20 12:16,12:16,14983050,20238375,5255325,BUY
24-12-20 12:17,12:17,15114925,20093300,4978375,BUY
24-12-20 12:18,12:18,14946675,20212475,5265800,BUY
24-12-20 12:19,12:19,15078275,20186025,5107750,BUY
24-12-20 12:20,12:20,15232850,20274325,5041475,BUY
24-12-20 12:21,12:21,15175800,20428150,5252350,BUY
24-12-20 12:22,12:22,15105300,20352025,5246725,BUY
24-12-20 12:23,12:23,15140250,20384925,5244675,BUY
24-12-20 12:24,12:24,15369450,20402475,5033025,BUY
24-12-20 12:25,12:25,15155125,20384975,5229850,BUY
24-12-20 12:26,12:26,15050475,20506475,5456000,BUY
24-12-20 12:27,12:27,14910775,20399200,5488425,BUY
24-12-20 12:28,12:28,14753650,20206050,5452400,BUY
24-12-20 12:29,12:29,14875350,20543925,5668575,BUY
24-12-20 12:30,12:30,15253150,20595025,5341875,BUY
24-12-20 12:31,12:31,15430600,20535050,5104450,BUY
24-12-20 12:32,12:32,15043675,20620800,5577125,BUY
24-12-20 12:33,12:33,15413175,20394950,4981775,BUY
24-12-20 12:34,12:34,15412875,20666375,5253500,BUY
24-12-20 12:35,12:35,15247575,20564675,5317100,BUY
24-12-20 12:36,12:36,15447575,20629625,5182050,BUY
24-12-20 12:37,12:37,15283625,20629625,5346000,BUY
24-12-20 12:38,12:38,15385325,20526200,5140875,BUY
24-12-20 12:39,12:39,14753025,20680625,5927600,BUY
24-12-20 12:40,12:40,15456600,20687850,5231250,BUY
24-12-20 12:41,12:41,15456600,20733500,5276900,BUY
24-12-20 12:42,12:42,15279550,20859000,5579450,BUY
24-12-20 12:43,12:43,15011450,20799625,5788175,BUY
24-12-20 12:44,12:44,14978375,20904975,5926600,BUY
24-12-20 12:45,12:45,15330275,21006875,5676600,BUY
24-12-20 12:46,12:46,15265450,21006875,5741425,BUY
24-12-20 12:47,12:47,15356050,20973725,5617675,BUY
24-12-20 12:48,12:48,15322450,21253625,5931175,BUY
24-12-20 12:49,12:49,15291375,21200250,5908875,BUY
24-12-20 12:50,12:50,15291375,21176825,5885450,BUY
24-12-20 12:51,12:51,15371150,21201825,5830675,BUY
24-12-20 12:52,12:52,15386025,21243450,5857425,BUY
24-12-20 12:53,12:53,15306175,21154175,5848000,BUY
24-12-20 12:54,12:54,15407850,21087125,5679275,BUY
24-12-20 12:55,12:55,15503750,20907050,5403300,BUY
24-12-20 12:56,12:56,15385900,20876875,5490975,BUY
24-12-20 12:57,12:57,15443600,21041800,5598200,BUY
24-12-20 12:58,12:58,15326650,21098075,5771425,BUY
24-12-20 12:59,12:59,15238025,21040525,5802500,BUY
24-12-20 13:00,13:00,15424100,21137100,5713000,BUY
24-12-20 13:01,13:01,15250625,21161750,5911125,BUY
24-12-20 13:02,13:02,15129650,21011800,5882150,BUY
24-12-20 13:03,13:03,15491650,21236250,5744600,BUY
24-12-20 13:04,13:04,15455075,21225800,5770725,BUY
24-12-20 13:05,13:05,15582925,21359750,5776825,BUY
24-12-20 13:06,13:06,15336100,21067575,5731475,BUY
24-12-20 13:07,13:07,15563725,21345700,5781975,BUY
24-12-20 13:08,13:08,15506925,21213675,5706750,BUY
24-12-20 13:09,13:09,15243300,21323025,6079725,BUY
24-12-20 13:10,13:10,15665475,21372025,5706550,BUY
24-12-20 13:11,13:11,15453750,21155225,5701475,BUY
24-12-20 13:12,13:12,15133750,20316700,5182950,BUY
24-12-20 13:13,13:13,15451975,20851675,5399700,BUY
24-12-20 13:14,13:14,15361925,21314400,5952475,BUY
24-12-20 13:15,13:15,15808550,21410225,5601675,BUY
24-12-20 13:16,13:16,15727825,21442225,5714400,BUY
24-12-20 13:17,13:17,15697275,21354750,5657475,BUY
24-12-20 13:18,13:18,15697050,21147500,5450450,BUY
24-12-20 13:19,13:19,15486600,21071575,5584975,BUY
24-12-20 13:20,13:20,15663575,21147500,5483925,BUY
24-12-20 13:21,13:21,15819675,21366925,5547250,BUY
24-12-20 13:22,13:22,15841775,21305725,5463950,BUY
24-12-20 13:23,13:23,15809025,21297925,5488900,BUY
24-12-20 13:24,13:24,15434175,20406800,4972625,BUY
24-12-20 13:25,13:25,15370775,20399950,5029175,BUY
24-12-20 13:26,13:26,15376875,20400175,5023300,BUY
24-12-20 13:27,13:27,14949225,20443850,5494625,BUY
24-12-20 13:28,13:28,14941575,20343725,5402150,BUY
24-12-20 13:29,13:29,15086075,20495800,5409725,BUY
24-12-20 13:30,13:30,15064825,20521775,5456950,BUY
24-12-20 13:31,13:31,14943675,20536700,5593025,BUY
24-12-20 13:32,13:32,14943675,20530175,5586500,BUY
24-12-20 13:33,13:33,14862525,20452925,5590400,BUY
24-12-20 13:34,13:34,14885700,20376225,5490525,BUY
24-12-20 13:35,13:35,14864425,20447700,5583275,BUY
24-12-20 13:36,13:36,14823850,20311275,5487425,BUY
24-12-20 13:37,13:37,14856950,20362725,5505775,BUY
24-12-20 13:38,13:38,14918700,20369475,5450775,BUY
24-12-20 13:39,13:39,14796225,20425450,5629225,BUY
24-12-20 13:40,13:40,14879925,20412300,5532375,BUY
24-12-20 13:41,13:41,14849350,20420575,5571225,BUY
24-12-20 13:42,13:42,15011850,20152725,5140875,BUY
24-12-20 13:43,13:43,14833000,20233950,5400950,BUY
24-12-20 13:44,13:44,14842825,20209350,5366525,BUY
24-12-20 13:45,13:45,14823600,20260975,5437375,BUY
24-12-20 13:46,13:46,14846250,20151700,5305450,BUY
24-12-20 13:47,13:47,14799150,20253050,5453900,BUY
24-12-20 13:48,13:48,15010450,20278600,5268150,BUY
24-12-20 13:49,13:49,14880700,20122150,5241450,BUY
24-12-20 13:50,13:50,14543850,19711050,5167200,BUY
24-12-20 13:51,13:51,3643125,6574725,2931600,BUY
24-12-20 13:52,13:52,14660875,19955375,5294500,BUY
24-12-20 13:53,13:53,14951225,20200200,5248975,BUY
24-12-20 13:54,13:54,14874050,19757100,4883050,BUY
24-12-20 13:55,13:55,14737600,20064350,5326750,BUY
24-12-20 13:56,13:56,14776925,19222350,4445425,BUY
24-12-20 13:57,13:57,15272275,20230775,4958500,BUY
24-12-20 13:58,13:58,13369225,18135100,4765875,BUY
24-12-20 13:59,13:59,3604150,6656625,3052475,BUY
24-12-20 14:00,14:00,3580825,6852625,3271800,BUY
24-12-20 14:01,14:01,3580825,6852625,3271800,BUY
24-12-20 14:02,14:02,15215300,20747000,5531700,BUY
24-12-20 14:03,14:03,15145275,20563075,5417800,BUY
24-12-20 14:04,14:04,15227125,20700875,5473750,BUY
24-12-20 14:05,14:05,15166250,20718000,5551750,BUY
24-12-20 14:06,14:06,15329575,20625450,5295875,BUY
24-12-20 14:07,14:07,15179375,20594525,5415150,BUY
24-12-20 14:08,14:08,15267825,20614075,5346250,BUY
24-12-20 14:09,14:09,15335850,20599650,5263800,BUY
24-12-20 14:10,14:10,15304950,20687900,5382950,BUY
24-12-20 14:11,14:11,15344000,20689450,5345450,BUY
24-12-20 14:12,14:12,15503400,20501525,4998125,BUY
24-12-20 14:13,14:13,15482650,20553375,5070725,BUY
24-12-20 14:14,14:14,15390750,20480100,5089350,BUY
24-12-20 14:15,14:15,15297100,20341000,5043900,BUY
24-12-20 14:16,14:16,15321850,20330675,5008825,BUY
24-12-20 14:17,14:17,15275100,20330675,5055575,BUY
24-12-20 14:18,14:18,15277550,20069000,4791450,BUY
24-12-20 14:19,14:19,15332575,20141775,4809200,BUY
24-12-20 14:20,14:20,15224575,20089875,4865300,BUY
24-12-20 14:21,14:21,15525175,20014725,4489550,BUY
24-12-20 14:22,14:22,15492450,19935300,4442850,BUY
24-12-20 14:23,14:23,15431650,20035000,4603350,BUY
24-12-20 14:24,14:24,15639100,19832900,4193800,BUY
24-12-20 14:25,14:25,15702625,19912475,4209850,BUY
24-12-20 14:26,14:26,15687175,19906150,4218975,BUY
24-12-20 14:27,14:27,15676825,19653025,3976200,BUY
24-12-20 14:28,14:28,15654425,19645425,3991000,BUY
24-12-20 14:29,14:29,15578650,19606525,4027875,BUY
24-12-20 14:30,14:30,15601825,19597275,3995450,BUY
24-12-20 14:31,14:31,15510975,19089125,3578150,BUY
24-12-20 14:32,14:32,13847200,18146275,4299075,BUY
24-12-20 14:33,14:33,15551375,19314275,3762900,BUY
24-12-20 14:34,14:34,15599825,19354925,3755100,BUY
24-12-20 14:35,14:35,15693325,19445675,3752350,BUY
24-12-20 14:36,14:36,15278075,19406575,4128500,BUY
24-12-20 14:37,14:37,15400150,19413900,4013750,BUY
24-12-20 14:38,14:38,15378675,19413900,4035225,BUY
24-12-20 14:39,14:39,15010825,19258525,4247700,BUY
24-12-20 14:40,14:40,14982175,19237950,4255775,BUY
24-12-20 14:41,14:41,15064500,19250875,4186375,BUY
24-12-20 14:42,14:42,15089450,18960075,3870625,BUY
24-12-20 14:43,14:43,15131150,19067950,3936800,BUY
24-12-20 14:44,14:44,15050250,19074425,4024175,BUY
24-12-20 14:45,14:45,14870775,18466325,3595550,BUY
24-12-20 14:46,14:46,15023225,18614475,3591250,BUY
24-12-20 14:47,14:47,14895500,18620600,3725100,BUY
24-12-20 14:48,14:48,14973025,18387250,3414225,BUY
24-12-20 14:49,14:49,15019925,18366275,3346350,BUY
24-12-20 14:50,14:50,15010800,18348525,3337725,BUY
24-12-20 14:51,14:51,14945500,18133675,3188175,BUY
24-12-20 14:52,14:52,15229750,18072625,2842875,BUY
24-12-20 14:53,14:53,15099400,18166975,3067575,BUY
24-12-20 14:54,14:54,14579550,17373400,2793850,BUY
24-12-20 14:55,14:55,14711825,17514825,2803000,BUY
24-12-20 14:56,14:56,14652475,17413875,2761400,BUY
24-12-20 14:57,14:57,14378825,16925350,2546525,BUY
24-12-20 14:58,14:58,14428450,17041250,2612800,BUY
24-12-20 14:59,14:59,14421025,16917725,2496700,BUY
24-12-20 15:00,15:00,14104800,16698875,2594075,BUY
24-12-20 15:01,15:01,14068900,16364750,2295850,BUY
24-12-20 15:02,15:02,14115775,16343275,2227500,BUY
24-12-20 15:03,15:03,13932075,16236725,2304650,BUY
24-12-20 15:04,15:04,13766775,16232050,2465275,BUY
24-12-20 15:05,15:05,13866525,16261275,2394750,BUY
24-12-20 15:06,15:06,13543075,15823475,2280400,BUY
24-12-20 15:07,15:07,13573100,15781575,2208475,BUY
24-12-20 15:08,15:08,13555600,15785000,2229400,BUY
24-12-20 15:09,15:09,12985075,15258650,2273575,BUY
24-12-20 15:10,15:10,13036325,15263475,2227150,BUY
24-12-20 15:11,15:11,12993475,15194200,2200725,BUY
24-12-20 15:12,15:12,12335775,14872500,2536725,BUY
24-12-20 15:13,15:13,12478225,14760425,2282200,BUY
24-12-20 15:14,15:14,12466950,14939425,2472475,BUY
24-12-20 15:15,15:15,11666225,14089175,2422950,BUY
24-12-20 15:16,15:16,11525625,13996800,2471175,BUY
24-12-20 15:17,15:17,11596650,14079525,2482875,BUY
24-12-20 15:18,15:18,11190850,13627550,2436700,BUY
24-12-20 15:19,15:19,10875475,13623550,2748075,BUY
24-12-20 15:20,15:20,10738600,13579525,2840925,BUY
24-12-20 15:21,15:21,10108650,12885975,2777325,BUY
24-12-20 15:22,15:22,9892300,12837525,2945225,BUY
24-12-20 15:23,15:23,9863425,13047500,3184075,BUY
24-12-20 15:24,15:24,9731825,12390275,2658450,BUY
24-12-20 15:25,15:25,9597550,12411675,2814125,BUY
24-12-20 15:26,15:26,9618000,12447975,2829975,BUY
24-12-20 15:27,15:27,9020900,11362800,2341900,BUY
24-12-20 15:28,15:28,9064075,11793475,2729400,BUY
24-12-20 15:29,15:29,8891725,11840775,2949050,BUY
28-12-20 9:15,9:15,5154900,5178200,23300,BUY
28-12-20 9:16,9:16,5154350,5167875,13525,BUY
28-12-20 9:17,9:17,5419775,5404250,-15525,SELL
28-12-20 9:18,9:18,5397975,5404200,6225,BUY
28-12-20 9:19,9:19,5449475,5305500,-143975,SELL
28-12-20 9:20,9:20,5980075,6175250,195175,BUY
28-12-20 9:21,9:21,5932475,6114225,181750,BUY
28-12-20 9:22,9:22,5958550,6221275,262725,BUY
28-12-20 9:23,9:23,6419650,6743075,323425,BUY
28-12-20 9:24,9:24,6419750,6827650,407900,BUY
28-12-20 9:25,9:25,6425200,6851350,426150,BUY
28-12-20 9:26,9:26,6692000,6921550,229550,BUY
28-12-20 9:27,9:27,6713900,7104975,391075,BUY
28-12-20 9:28,9:28,6605475,7065600,460125,BUY
28-12-20 9:29,9:29,6718000,7796350,1078350,BUY
28-12-20 9:30,9:30,6746850,7906100,1159250,BUY
28-12-20 9:31,9:31,6721300,7783125,1061825,BUY
28-12-20 9:32,9:32,6893800,8192950,1299150,BUY
28-12-20 9:33,9:33,6911925,8241950,1330025,BUY
28-12-20 9:34,9:34,6909725,8299650,1389925,BUY
28-12-20 9:35,9:35,6987400,8496575,1509175,BUY
28-12-20 9:36,9:36,7050225,8468375,1418150,BUY
28-12-20 9:37,9:37,6875350,8497200,1621850,BUY
28-12-20 9:38,9:38,7114375,8930850,1816475,BUY
28-12-20 9:39,9:39,7136550,8931025,1794475,BUY
28-12-20 9:40,9:40,7127200,8966100,1838900,BUY
28-12-20 9:41,9:41,7160900,9272650,2111750,BUY
28-12-20 9:42,9:42,7170100,9134150,1964050,BUY
28-12-20 9:43,9:43,7237925,9317025,2079100,BUY
28-12-20 9:44,9:44,7390150,9507200,2117050,BUY
28-12-20 9:45,9:45,7394325,9545700,2151375,BUY
28-12-20 9:46,9:46,7260850,9555425,2294575,BUY
28-12-20 9:47,9:47,7359075,9541075,2182000,BUY
28-12-20 9:48,9:48,7437150,9685425,2248275,BUY
28-12-20 9:49,9:49,7512825,9573675,2060850,BUY
28-12-20 9:50,9:50,7476225,9784850,2308625,BUY
28-12-20 9:51,9:51,7435150,9856350,2421200,BUY
28-12-20 9:52,9:52,7357650,9615075,2257425,BUY
28-12-20 9:53,9:53,7652100,9585575,1933475,BUY
28-12-20 9:54,9:54,7649275,9676250,2026975,BUY
28-12-20 9:55,9:55,7534150,9891275,2357125,BUY
28-12-20 9:56,9:56,7638700,9876225,2237525,BUY
28-12-20 9:57,9:57,7755925,9967225,2211300,BUY
28-12-20 9:58,9:58,7669925,9962550,2292625,BUY
28-12-20 9:59,9:59,7811875,9775850,1963975,BUY
28-12-20 10:00,10:00,7742575,10188150,2445575,BUY
28-12-20 10:01,10:01,7685250,10211650,2526400,BUY
28-12-20 10:02,10:02,7829225,10297275,2468050,BUY
28-12-20 10:03,10:03,7826175,10257275,2431100,BUY
28-12-20 10:04,10:04,7957575,10344225,2386650,BUY
28-12-20 10:05,10:05,7910575,10172575,2262000,BUY
28-12-20 10:06,10:06,7800875,10207575,2406700,BUY
28-12-20 10:07,10:07,7927150,10273250,2346100,BUY
28-12-20 10:08,10:08,7839725,10291700,2451975,BUY
28-12-20 10:09,10:09,7998525,10138200,2139675,BUY
28-12-20 10:10,10:10,8018050,10172350,2154300,BUY
28-12-20 10:11,10:11,8167500,10415900,2248400,BUY
28-12-20 10:12,10:12,7990600,10371150,2380550,BUY
28-12-20 10:13,10:13,7948875,10322325,2373450,BUY
28-12-20 10:14,10:14,7991050,10193450,2202400,BUY
28-12-20 10:15,10:15,8022525,10371775,2349250,BUY
28-12-20 10:16,10:16,8227650,10384750,2157100,BUY
28-12-20 10:17,10:17,8176150,10383000,2206850,BUY
28-12-20 10:18,10:18,8069525,10503550,2434025,BUY
28-12-20 10:19,10:19,8178150,10377125,2198975,BUY
28-12-20 10:20,10:20,8124875,10542450,2417575,BUY
28-12-20 10:21,10:21,8069825,10499375,2429550,BUY
28-12-20 10:22,10:22,8177600,10460675,2283075,BUY
28-12-20 10:23,10:23,8232975,10434725,2201750,BUY
28-12-20 10:24,10:24,7995825,10344675,2348850,BUY
28-12-20 10:25,10:25,8128975,10100775,1971800,BUY
28-12-20 10:26,10:26,8077775,10395925,2318150,BUY
28-12-20 10:27,10:27,8244425,10393375,2148950,BUY
28-12-20 10:28,10:28,8097525,10402825,2305300,BUY
28-12-20 10:29,10:29,8032725,10006950,1974225,BUY
28-12-20 10:30,10:30,8063225,10303550,2240325,BUY
28-12-20 10:31,10:31,8053825,10352925,2299100,BUY
28-12-20 10:32,10:32,8401325,10513825,2112500,BUY
28-12-20 10:33,10:33,8206650,10327775,2121125,BUY
28-12-20 10:34,10:34,8352375,10327250,1974875,BUY
28-12-20 10:35,10:35,8421300,9471550,1050250,BUY
28-12-20 10:36,10:36,8712975,10525400,1812425,BUY
28-12-20 10:37,10:37,8485550,10450825,1965275,BUY
28-12-20 10:38,10:38,8623725,10433300,1809575,BUY
28-12-20 10:39,10:39,8531000,10346400,1815400,BUY
28-12-20 10:40,10:40,8782950,10275300,1492350,BUY
28-12-20 10:41,10:41,8660175,10313800,1653625,BUY
28-12-20 10:42,10:42,8752050,9946775,1194725,BUY
28-12-20 10:43,10:43,8726125,10290325,1564200,BUY
28-12-20 10:44,10:44,8825475,10430125,1604650,BUY
28-12-20 10:45,10:45,8883900,10478225,1594325,BUY
28-12-20 10:46,10:46,8791025,9992800,1201775,BUY
28-12-20 10:47,10:47,8729750,10406800,1677050,BUY
28-12-20 10:48,10:48,8876650,10596900,1720250,BUY
28-12-20 10:49,10:49,8933000,10470775,1537775,BUY
28-12-20 10:50,10:50,8955850,10659575,1703725,BUY
28-12-20 10:51,10:51,8911900,10299975,1388075,BUY
28-12-20 10:52,10:52,8795225,10372125,1576900,BUY
28-12-20 10:53,10:53,8760050,10506875,1746825,BUY
28-12-20 10:54,10:54,8836175,10631325,1795150,BUY
28-12-20 10:55,10:55,8778925,10375525,1596600,BUY
28-12-20 10:56,10:56,9009725,10534425,1524700,BUY
28-12-20 10:57,10:57,8764775,10119450,1354675,BUY
28-12-20 10:58,10:58,8904675,10111275,1206600,BUY
28-12-20 10:59,10:59,8960875,10243800,1282925,BUY
28-12-20 11:00,11:00,9086275,10526400,1440125,BUY
28-12-20 11:01,11:01,8953875,10516650,1562775,BUY
28-12-20 11:02,11:02,9221600,10553250,1331650,BUY
28-12-20 11:03,11:03,9133675,10604675,1471000,BUY
28-12-20 11:04,11:04,9103775,10473175,1369400,BUY
28-12-20 11:05,11:05,9230275,10543050,1312775,BUY
28-12-20 11:06,11:06,9092950,10599875,1506925,BUY
28-12-20 11:07,11:07,9252075,10580975,1328900,BUY
28-12-20 11:08,11:08,9340775,10783850,1443075,BUY
28-12-20 11:09,11:09,9214925,10303925,1089000,BUY
28-12-20 11:10,11:10,9303725,10589075,1285350,BUY
28-12-20 11:11,11:11,9436325,10665300,1228975,BUY
28-12-20 11:12,11:12,9441925,10572050,1130125,BUY
28-12-20 11:13,11:13,9434025,10633875,1199850,BUY
28-12-20 11:14,11:14,9459775,10633625,1173850,BUY
28-12-20 11:15,11:15,9336725,10589100,1252375,BUY
28-12-20 11:16,11:16,9631375,10698025,1066650,BUY
28-12-20 11:17,11:17,9577650,10618275,1040625,BUY
28-12-20 11:18,11:18,9559825,10569100,1009275,BUY
28-12-20 11:19,11:19,9458925,10213125,754200,BUY
28-12-20 11:20,11:20,9581525,10258650,677125,BUY
28-12-20 11:21,11:21,9558500,10328325,769825,BUY
28-12-20 11:22,11:22,9619625,10231125,611500,BUY
28-12-20 11:23,11:23,9585500,10300975,715475,BUY
28-12-20 11:24,11:24,9520225,9823100,302875,BUY
28-12-20 11:25,11:25,9492700,9811550,318850,BUY
28-12-20 11:26,11:26,9590025,10244400,654375,BUY
28-12-20 11:27,11:27,9370375,10214575,844200,BUY
28-12-20 11:28,11:28,9653450,10579350,925900,BUY
28-12-20 11:29,11:29,9692600,10709025,1016425,BUY
28-12-20 11:30,11:30,9645350,10611650,966300,BUY
28-12-20 11:31,11:31,9567300,10879150,1311850,BUY
28-12-20 11:32,11:32,9540625,10710125,1169500,BUY
28-12-20 11:33,11:33,9487225,10687025,1199800,BUY
28-12-20 11:34,11:34,9592925,10651250,1058325,BUY
28-12-20 11:35,11:35,9451475,10652225,1200750,BUY
28-12-20 11:36,11:36,9452300,10748175,1295875,BUY
28-12-20 11:37,11:37,9698175,10938100,1239925,BUY
28-12-20 11:38,11:38,9650525,10407075,756550,BUY
28-12-20 11:39,11:39,9507650,10700225,1192575,BUY
28-12-20 11:40,11:40,9654600,10447925,793325,BUY
28-12-20 11:41,11:41,9678725,10503675,824950,BUY
28-12-20 11:42,11:42,9673400,10948375,1274975,BUY
28-12-20 11:43,11:43,9443450,10603025,1159575,BUY
28-12-20 11:44,11:44,9705525,10808250,1102725,BUY
28-12-20 11:45,11:45,9847425,10892600,1045175,BUY
28-12-20 11:46,11:46,9546300,10928850,1382550,BUY
28-12-20 11:47,11:47,9465050,10660325,1195275,BUY
28-12-20 11:48,11:48,9687750,10488400,800650,BUY
28-12-20 11:49,11:49,9716650,10850500,1133850,BUY
28-12-20 11:50,11:50,9749425,10757325,1007900,BUY
28-12-20 11:51,11:51,9496250,10704700,1208450,BUY
28-12-20 11:52,11:52,9770225,10685500,915275,BUY
28-12-20 11:53,11:53,9589900,10630325,1040425,BUY
28-12-20 11:54,11:54,9620075,10815975,1195900,BUY
28-12-20 11:55,11:55,9707025,10882125,1175100,BUY
28-12-20 11:56,11:56,9577575,10960775,1383200,BUY
28-12-20 11:57,11:57,9612950,10409500,796550,BUY
28-12-20 11:58,11:58,9612950,10409125,796175,BUY
28-12-20 11:59,11:59,9652850,10985150,1332300,BUY
28-12-20 12:00,12:00,9703075,10508450,805375,BUY
28-12-20 12:01,12:01,9709200,10825250,1116050,BUY
28-12-20 12:02,12:02,9608925,10711825,1102900,BUY
28-12-20 12:03,12:03,9669150,10877150,1208000,BUY
28-12-20 12:04,12:04,9618675,10371700,753025,BUY
28-12-20 12:05,12:05,9602500,10805725,1203225,BUY
28-12-20 12:06,12:06,9604300,10578925,974625,BUY
28-12-20 12:07,12:07,9674550,10880600,1206050,BUY
28-12-20 12:08,12:08,9555875,10401300,845425,BUY
28-12-20 12:09,12:09,9699875,10336625,636750,BUY
28-12-20 12:10,12:10,9701825,10783625,1081800,BUY
28-12-20 12:11,12:11,9713775,10852750,1138975,BUY
28-12-20 12:12,12:12,9566050,10054400,488350,BUY
28-12-20 12:13,12:13,9776400,11075225,1298825,BUY
28-12-20 12:14,12:14,10108925,11238150,1129225,BUY
28-12-20 12:15,12:15,9918725,11141575,1222850,BUY
28-12-20 12:16,12:16,9829400,10940575,1111175,BUY
28-12-20 12:17,12:17,9774700,10665475,890775,BUY
28-12-20 12:18,12:18,9647650,10637600,989950,BUY
28-12-20 12:19,12:19,9554500,10708300,1153800,BUY
28-12-20 12:20,12:20,9688950,10933075,1244125,BUY
28-12-20 12:21,12:21,9705500,10623650,918150,BUY
28-12-20 12:22,12:22,9672100,10494350,822250,BUY
28-12-20 12:23,12:23,9649100,10315600,666500,BUY
28-12-20 12:24,12:24,9669575,10735675,1066100,BUY
28-12-20 12:25,12:25,9713900,10628600,914700,BUY
28-12-20 12:26,12:26,9629875,10788875,1159000,BUY
28-12-20 12:27,12:27,9645425,10908250,1262825,BUY
28-12-20 12:28,12:28,9507350,10849500,1342150,BUY
28-12-20 12:29,12:29,9654950,10870175,1215225,BUY
28-12-20 12:30,12:30,9846200,11064025,1217825,BUY
28-12-20 12:31,12:31,9651975,11099500,1447525,BUY
28-12-20 12:32,12:32,9666775,10840050,1173275,BUY
28-12-20 12:33,12:33,9649100,10486825,837725,BUY
28-12-20 12:34,12:34,9749775,10566825,817050,BUY
28-12-20 12:35,12:35,9422975,10972250,1549275,BUY
28-12-20 12:36,12:36,9605150,10577000,971850,BUY
28-12-20 12:37,12:37,9726950,10475125,748175,BUY
28-12-20 12:38,12:38,9681650,10514875,833225,BUY
28-12-20 12:39,12:39,9751525,10986950,1235425,BUY
28-12-20 12:40,12:40,9796300,11078425,1282125,BUY
28-12-20 12:41,12:41,9575325,10538400,963075,BUY
28-12-20 12:42,12:42,9727225,11021925,1294700,BUY
28-12-20 12:43,12:43,9477125,10565350,1088225,BUY
28-12-20 12:44,12:44,9662125,11012450,1350325,BUY
28-12-20 12:45,12:45,9681125,10655525,974400,BUY
28-12-20 12:46,12:46,9839275,10693250,853975,BUY
28-12-20 12:47,12:47,9769575,10904075,1134500,BUY
28-12-20 12:48,12:48,9756350,10600075,843725,BUY
28-12-20 12:49,12:49,9785625,11192200,1406575,BUY
28-12-20 12:50,12:50,9719050,11257375,1538325,BUY
28-12-20 12:51,12:51,9720700,10735525,1014825,BUY
28-12-20 12:52,12:52,9591100,10148675,557575,BUY
28-12-20 12:53,12:53,9760425,11062125,1301700,BUY
28-12-20 12:54,12:54,9448275,11128675,1680400,BUY
28-12-20 12:55,12:55,9648675,11058575,1409900,BUY
28-12-20 12:56,12:56,9478500,10337425,858925,BUY
28-12-20 12:57,12:57,9610675,10718450,1107775,BUY
28-12-20 12:58,12:58,9621775,10876225,1254450,BUY
28-12-20 12:59,12:59,9625700,11006625,1380925,BUY
28-12-20 13:00,13:00,9685650,10329600,643950,BUY
28-12-20 13:01,13:01,9681575,10941025,1259450,BUY
28-12-20 13:02,13:02,9576675,10648075,1071400,BUY
28-12-20 13:03,13:03,9559825,10370775,810950,BUY
28-12-20 13:04,13:04,9427275,10704275,1277000,BUY
28-12-20 13:05,13:05,9637975,10669400,1031425,BUY
28-12-20 13:06,13:06,9559075,9695350,136275,BUY
28-12-20 13:07,13:07,9553450,9803450,250000,BUY
28-12-20 13:08,13:08,9528500,10860175,1331675,BUY
28-12-20 13:09,13:09,9578750,10662925,1084175,BUY
28-12-20 13:10,13:10,9471350,10774600,1303250,BUY
28-12-20 13:11,13:11,9565875,10690800,1124925,BUY
28-12-20 13:12,13:12,9581900,10798500,1216600,BUY
28-12-20 13:13,13:13,9690300,10702400,1012100,BUY
28-12-20 13:14,13:14,9679300,10861925,1182625,BUY
28-12-20 13:15,13:15,9651175,10739025,1087850,BUY
28-12-20 13:16,13:16,9693125,10900325,1207200,BUY
28-12-20 13:17,13:17,9695125,10668025,972900,BUY
28-12-20 13:18,13:18,9821000,10926800,1105800,BUY
28-12-20 13:19,13:19,9774100,10567375,793275,BUY
28-12-20 13:20,13:20,9852550,10707400,854850,BUY
28-12-20 13:21,13:21,9734075,10612425,878350,BUY
28-12-20 13:22,13:22,9776950,11058825,1281875,BUY
28-12-20 13:23,13:23,9908725,10887475,978750,BUY
28-12-20 13:24,13:24,9683425,10708700,1025275,BUY
28-12-20 13:25,13:25,9808700,11152875,1344175,BUY
28-12-20 13:26,13:26,9862025,10823850,961825,BUY
28-12-20 13:27,13:27,9821350,11129125,1307775,BUY
28-12-20 13:28,13:28,9817150,10846950,1029800,BUY
28-12-20 13:29,13:29,9801900,11045650,1243750,BUY
28-12-20 13:30,13:30,9990000,10905350,915350,BUY
28-12-20 13:31,13:31,9860700,10930675,1069975,BUY
28-12-20 13:32,13:32,9956925,11169700,1212775,BUY
28-12-20 13:33,13:33,9817475,11247575,1430100,BUY
28-12-20 13:34,13:34,9031800,10870775,1838975,BUY
28-12-20 13:35,13:35,9870175,10635250,765075,BUY
28-12-20 13:36,13:36,9879425,11138775,1259350,BUY
28-12-20 13:37,13:37,9625875,10270700,644825,BUY
28-12-20 13:38,13:38,9661300,10497850,836550,BUY
28-12-20 13:39,13:39,9825000,11156500,1331500,BUY
28-12-20 13:40,13:40,9871575,10731925,860350,BUY
28-12-20 13:41,13:41,9616500,11035675,1419175,BUY
28-12-20 13:42,13:42,9925100,11199250,1274150,BUY
28-12-20 13:43,13:43,9880150,10839050,958900,BUY
28-12-20 13:44,13:44,9796750,10867600,1070850,BUY
28-12-20 13:45,13:45,9987675,10908225,920550,BUY
28-12-20 13:46,13:46,9850000,10857225,1007225,BUY
28-12-20 13:47,13:47,9774875,11228675,1453800,BUY
28-12-20 13:48,13:48,9864475,10962600,1098125,BUY
28-12-20 13:49,13:49,9842850,10594050,751200,BUY
28-12-20 13:50,13:50,9965700,11158450,1192750,BUY
28-12-20 13:51,13:51,10032675,11214525,1181850,BUY
28-12-20 13:52,13:52,10071700,11429525,1357825,BUY
28-12-20 13:53,13:53,9920500,11148900,1228400,BUY
28-12-20 13:54,13:54,9677800,10813750,1135950,BUY
28-12-20 13:55,13:55,9708275,10934075,1225800,BUY
28-12-20 13:56,13:56,9852275,11021475,1169200,BUY
28-12-20 13:57,13:57,9937050,11250425,1313375,BUY
28-12-20 13:58,13:58,9954900,10875025,920125,BUY
28-12-20 13:59,13:59,10073075,11299425,1226350,BUY
28-12-20 14:00,14:00,9908750,11145825,1237075,BUY
28-12-20 14:01,14:01,9765525,11134575,1369050,BUY
28-12-20 14:02,14:02,9803950,11206775,1402825,BUY
28-12-20 14:03,14:03,9764050,11277950,1513900,BUY
28-12-20 14:04,14:04,9791950,11109325,1317375,BUY
28-12-20 14:05,14:05,9962800,11186500,1223700,BUY
28-12-20 14:06,14:06,9894950,11208375,1313425,BUY
28-12-20 14:07,14:07,9848450,11041025,1192575,BUY
28-12-20 14:08,14:08,9798300,11061200,1262900,BUY
28-12-20 14:09,14:09,9875300,11287275,1411975,BUY
28-12-20 14:10,14:10,9806450,11282875,1476425,BUY
28-12-20 14:11,14:11,9757275,10804825,1047550,BUY
28-12-20 14:12,14:12,9855300,10776825,921525,BUY
28-12-20 14:13,14:13,9732650,10702100,969450,BUY
28-12-20 14:14,14:14,9743275,10690375,947100,BUY
28-12-20 14:15,14:15,9881100,10789375,908275,BUY
28-12-20 14:16,14:16,10071325,11337500,1266175,BUY
28-12-20 14:17,14:17,9973450,10993350,1019900,BUY
28-12-20 14:18,14:18,9684300,10698000,1013700,BUY
28-12-20 14:19,14:19,9771050,10982400,1211350,BUY
28-12-20 14:20,14:20,9705275,10990800,1285525,BUY
28-12-20 14:21,14:21,9880600,11176800,1296200,BUY
28-12-20 14:22,14:22,9811225,10529250,718025,BUY
28-12-20 14:23,14:23,9855600,11050850,1195250,BUY
28-12-20 14:24,14:24,9609125,11063375,1454250,BUY
28-12-20 14:25,14:25,9652300,10979500,1327200,BUY
28-12-20 14:26,14:26,9879050,11099200,1220150,BUY
28-12-20 14:27,14:27,9791725,11140250,1348525,BUY
28-12-20 14:28,14:28,9577650,11219600,1641950,BUY
28-12-20 14:29,14:29,9803225,10841175,1037950,BUY
28-12-20 14:30,14:30,9715275,10816975,1101700,BUY
28-12-20 14:31,14:31,9677800,10921375,1243575,BUY
28-12-20 14:32,14:32,9726775,10981875,1255100,BUY
28-12-20 14:33,14:33,9610125,11067000,1456875,BUY
28-12-20 14:34,14:34,9707425,11054750,1347325,BUY
28-12-20 14:35,14:35,9670925,11094025,1423100,BUY
28-12-20 14:36,14:36,9547050,11085375,1538325,BUY
28-12-20 14:37,14:37,9558275,11110975,1552700,BUY
28-12-20 14:38,14:38,9548900,11111675,1562775,BUY
28-12-20 14:39,14:39,9573025,11125100,1552075,BUY
28-12-20 14:40,14:40,9503425,11096075,1592650,BUY
28-12-20 14:41,14:41,9567625,11162175,1594550,BUY
28-12-20 14:42,14:42,9714850,11123000,1408150,BUY
28-12-20 14:43,14:43,9547775,11204225,1656450,BUY
28-12-20 14:44,14:44,9570950,10997325,1426375,BUY
28-12-20 14:45,14:45,9540750,11039700,1498950,BUY
28-12-20 14:46,14:46,9451750,10979475,1527725,BUY
28-12-20 14:47,14:47,9311125,10997850,1686725,BUY
28-12-20 14:48,14:48,9418750,11103925,1685175,BUY
28-12-20 14:49,14:49,9457600,11051700,1594100,BUY
28-12-20 14:50,14:50,9457550,10938000,1480450,BUY
28-12-20 14:51,14:51,9363875,10824325,1460450,BUY
28-12-20 14:52,14:52,9392100,10859400,1467300,BUY
28-12-20 14:53,14:53,9494650,10910800,1416150,BUY
28-12-20 14:54,14:54,9404300,10891775,1487475,BUY
28-12-20 14:55,14:55,9276900,10813625,1536725,BUY
28-12-20 14:56,14:56,9306800,10791925,1485125,BUY
28-12-20 14:57,14:57,9239725,10852175,1612450,BUY
28-12-20 14:58,14:58,9285300,10752800,1467500,BUY
28-12-20 14:59,14:59,9165350,10766975,1601625,BUY
28-12-20 15:00,15:00,9294250,10861875,1567625,BUY
28-12-20 15:01,15:01,9252050,10768250,1516200,BUY
28-12-20 15:02,15:02,9220875,10884450,1663575,BUY
28-12-20 15:03,15:03,9065650,10688925,1623275,BUY
28-12-20 15:04,15:04,9123825,10629050,1505225,BUY
28-12-20 15:05,15:05,9045250,10638200,1592950,BUY
28-12-20 15:06,15:06,8944800,10509950,1565150,BUY
28-12-20 15:07,15:07,9167575,10508900,1341325,BUY
28-12-20 15:08,15:08,8861425,10581900,1720475,BUY
28-12-20 15:09,15:09,8976050,10521475,1545425,BUY
28-12-20 15:10,15:10,9120900,10582100,1461200,BUY
28-12-20 15:11,15:11,9053525,10434225,1380700,BUY
28-12-20 15:12,15:12,8788575,10311050,1522475,BUY
28-12-20 15:13,15:13,9028100,10481525,1453425,BUY
28-12-20 15:14,15:14,8824150,10443800,1619650,BUY
28-12-20 15:15,15:15,8715675,10091725,1376050,BUY
28-12-20 15:16,15:16,8765350,10217500,1452150,BUY
28-12-20 15:17,15:17,8610850,10180200,1569350,BUY
28-12-20 15:18,15:18,8616125,10123400,1507275,BUY
28-12-20 15:19,15:19,8481725,10122950,1641225,BUY
28-12-20 15:20,15:20,8776525,10101975,1325450,BUY
28-12-20 15:21,15:21,8198550,9999825,1801275,BUY
28-12-20 15:22,15:22,8407600,10091025,1683425,BUY
28-12-20 15:23,15:23,8439100,9688075,1248975,BUY
28-12-20 15:24,15:24,8060850,9938275,1877425,BUY
28-12-20 15:25,15:25,8344100,9793625,1449525,BUY
28-12-20 15:26,15:26,8232850,9940350,1707500,BUY
28-12-20 15:27,15:27,8094875,9648450,1553575,BUY
28-12-20 15:28,15:28,8184125,9707150,1523025,BUY
28-12-20 15:29,15:29,8243700,9802575,1558875,BUY
29-12-20 9:15,9:15,7991100,9613150,1622050,BUY
29-12-20 9:16,9:16,7983200,9298575,1315375,BUY
29-12-20 9:17,9:17,8419150,10000800,1581650,BUY
29-12-20 9:18,9:18,8437475,9977800,1540325,BUY
29-12-20 9:19,9:19,8394150,10101725,1707575,BUY
29-12-20 9:20,9:20,8706650,10587550,1880900,BUY
29-12-20 9:21,9:21,8757675,10642850,1885175,BUY
29-12-20 9:22,9:22,8678650,10434725,1756075,BUY
29-12-20 9:23,9:23,9351125,11136900,1785775,BUY
29-12-20 9:24,9:24,9316575,11013325,1696750,BUY
29-12-20 9:25,9:25,9355350,11065825,1710475,BUY
29-12-20 9:26,9:26,9476500,11389525,1913025,BUY
29-12-20 9:27,9:27,9662625,11382975,1720350,BUY
29-12-20 9:28,9:28,9613200,11373050,1759850,BUY
29-12-20 9:29,9:29,9827050,11540200,1713150,BUY
29-12-20 9:30,9:30,9867475,11206650,1339175,BUY
29-12-20 9:31,9:31,9763375,11467500,1704125,BUY
29-12-20 9:32,9:32,10129875,11753475,1623600,BUY
29-12-20 9:33,9:33,10176725,11788975,1612250,BUY
29-12-20 9:34,9:34,10196350,11189875,993525,BUY
29-12-20 9:35,9:35,9925700,11400550,1474850,BUY
29-12-20 9:36,9:36,10144350,11892850,1748500,BUY
29-12-20 9:37,9:37,10006050,11960825,1954775,BUY
29-12-20 9:38,9:38,10171100,12007875,1836775,BUY
29-12-20 9:39,9:39,10241525,11781800,1540275,BUY
29-12-20 9:40,9:40,10251300,11944975,1693675,BUY
29-12-20 9:41,9:41,10451625,12059175,1607550,BUY
29-12-20 9:42,9:42,10239975,11959175,1719200,BUY
29-12-20 9:43,9:43,10334325,11852925,1518600,BUY
29-12-20 9:44,9:44,10110825,11707575,1596750,BUY
29-12-20 9:45,9:45,10278975,12068575,1789600,BUY
29-12-20 9:46,9:46,10402850,11727500,1324650,BUY
29-12-20 9:47,9:47,10315450,12047100,1731650,BUY
29-12-20 9:48,9:48,10223200,12131850,1908650,BUY
29-12-20 9:49,9:49,10423100,12045925,1622825,BUY
29-12-20 9:50,9:50,10579775,12170575,1590800,BUY
29-12-20 9:51,9:51,10512900,12163200,1650300,BUY
29-12-20 9:52,9:52,10288175,12246100,1957925,BUY
29-12-20 9:53,9:53,10402375,12291825,1889450,BUY
29-12-20 9:54,9:54,10540525,12268825,1728300,BUY
29-12-20 9:55,9:55,10517425,12343400,1825975,BUY
29-12-20 9:56,9:56,10666575,12435875,1769300,BUY
29-12-20 9:57,9:57,10645400,12412600,1767200,BUY
29-12-20 9:58,9:58,10584150,12189825,1605675,BUY
29-12-20 9:59,9:59,10647225,12483850,1836625,BUY
29-12-20 10:00,10:00,10606975,12126950,1519975,BUY
29-12-20 10:01,10:01,10721450,12394025,1672575,BUY
29-12-20 10:02,10:02,10532500,12218575,1686075,BUY
29-12-20 10:03,10:03,10510100,12270475,1760375,BUY
29-12-20 10:04,10:04,10229775,12517200,2287425,BUY
29-12-20 10:05,10:05,10522250,12878375,2356125,BUY
29-12-20 10:06,10:06,10708275,12641600,1933325,BUY
29-12-20 10:07,10:07,10793925,12603175,1809250,BUY
29-12-20 10:08,10:08,10626450,12650400,2023950,BUY
29-12-20 10:09,10:09,10855775,12695525,1839750,BUY
29-12-20 10:10,10:10,10807200,12592400,1785200,BUY
29-12-20 10:11,10:11,10759000,12843450,2084450,BUY
29-12-20 10:12,10:12,10965350,12778525,1813175,BUY
29-12-20 10:13,10:13,10726050,12770600,2044550,BUY
29-12-20 10:14,10:14,10370100,12839675,2469575,BUY
29-12-20 10:15,10:15,10759350,12907775,2148425,BUY
29-12-20 10:16,10:16,10720625,12996750,2276125,BUY
29-12-20 10:17,10:17,10840950,12625375,1784425,BUY
29-12-20 10:18,10:18,10848200,12546275,1698075,BUY
29-12-20 10:19,10:19,10939725,12235775,1296050,BUY
29-12-20 10:20,10:20,10993000,12677775,1684775,BUY
29-12-20 10:21,10:21,10935825,12998700,2062875,BUY
29-12-20 10:22,10:22,11020975,12970200,1949225,BUY
29-12-20 10:23,10:23,11023725,12919325,1895600,BUY
29-12-20 10:24,10:24,10905475,12624800,1719325,BUY
29-12-20 10:25,10:25,10867450,12971625,2104175,BUY
29-12-20 10:26,10:26,11025900,12319050,1293150,BUY
29-12-20 10:27,10:27,11069000,13132675,2063675,BUY
29-12-20 10:28,10:28,11132100,13278075,2145975,BUY
29-12-20 10:29,10:29,11209275,12965300,1756025,BUY
29-12-20 10:30,10:30,11168400,12891825,1723425,BUY
29-12-20 10:31,10:31,11209575,13029000,1819425,BUY
29-12-20 10:32,10:32,11279650,12730750,1451100,BUY
29-12-20 10:33,10:33,11100850,12778800,1677950,BUY
29-12-20 10:34,10:34,11217725,12943375,1725650,BUY
29-12-20 10:35,10:35,11612600,13297275,1684675,BUY
29-12-20 10:36,10:36,11390550,12747450,1356900,BUY
29-12-20 10:37,10:37,11357750,12617125,1259375,BUY
29-12-20 10:38,10:38,11317400,13172200,1854800,BUY
29-12-20 10:39,10:39,11209650,12443225,1233575,BUY
29-12-20 10:40,10:40,11271600,12500825,1229225,BUY
29-12-20 10:41,10:41,11474825,12783700,1308875,BUY
29-12-20 10:42,10:42,11606825,12956100,1349275,BUY
29-12-20 10:43,10:43,11324300,12620600,1296300,BUY
29-12-20 10:44,10:44,11606675,12965050,1358375,BUY
29-12-20 10:45,10:45,11515050,13191400,1676350,BUY
29-12-20 10:46,10:46,11842375,13510425,1668050,BUY
29-12-20 10:47,10:47,11538275,12769525,1231250,BUY
29-12-20 10:48,10:48,11382900,12494075,1111175,BUY
29-12-20 10:49,10:49,11304850,12331300,1026450,BUY
29-12-20 10:50,10:50,11363925,12088225,724300,BUY
29-12-20 10:51,10:51,11354950,12300725,945775,BUY
29-12-20 10:52,10:52,11337075,12390175,1053100,BUY
29-12-20 10:53,10:53,11258150,12173650,915500,BUY
29-12-20 10:54,10:54,11280875,12085850,804975,BUY
29-12-20 10:55,10:55,11292750,12163800,871050,BUY
29-12-20 10:56,10:56,11199025,12098700,899675,BUY
29-12-20 10:57,10:57,11028125,12082300,1054175,BUY
29-12-20 10:58,10:58,10991425,11919225,927800,BUY
29-12-20 10:59,10:59,11181075,12026675,845600,BUY
29-12-20 11:00,11:00,11058300,12004125,945825,BUY
29-12-20 11:01,11:01,11045225,11706200,660975,BUY
29-12-20 11:02,11:02,11161925,11789700,627775,BUY
29-12-20 11:03,11:03,11157400,12146850,989450,BUY
29-12-20 11:04,11:04,11042000,12208750,1166750,BUY
29-12-20 11:05,11:05,10996650,12032550,1035900,BUY
29-12-20 11:06,11:06,11133150,11875800,742650,BUY
29-12-20 11:07,11:07,10900175,11953375,1053200,BUY
29-12-20 11:08,11:08,10870250,11983675,1113425,BUY
29-12-20 11:09,11:09,11071350,11966275,894925,BUY
29-12-20 11:10,11:10,11075450,12015900,940450,BUY
29-12-20 11:11,11:11,10907425,11984750,1077325,BUY
29-12-20 11:12,11:12,11026600,11966475,939875,BUY
29-12-20 11:13,11:13,11173525,12094500,920975,BUY
29-12-20 11:14,11:14,11162225,12186375,1024150,BUY
29-12-20 11:15,11:15,10953250,12190625,1237375,BUY
29-12-20 11:16,11:16,11142425,12186125,1043700,BUY
29-12-20 11:17,11:17,11185625,12203625,1018000,BUY
29-12-20 11:18,11:18,10902600,11926425,1023825,BUY
29-12-20 11:19,11:19,10973050,12276250,1303200,BUY
29-12-20 11:20,11:20,11151350,12152500,1001150,BUY
29-12-20 11:21,11:21,11103775,11804400,700625,BUY
29-12-20 11:22,11:22,11100525,11974225,873700,BUY
29-12-20 11:23,11:23,11165650,12401450,1235800,BUY
29-12-20 11:24,11:24,11275950,12149900,873950,BUY
29-12-20 11:25,11:25,11145100,12446800,1301700,BUY
29-12-20 11:26,11:26,11241225,12343050,1101825,BUY
29-12-20 11:27,11:27,11041325,12396250,1354925,BUY
29-12-20 11:28,11:28,11123500,12189675,1066175,BUY
29-12-20 11:29,11:29,11351825,12325950,974125,BUY
29-12-20 11:30,11:30,11124250,12297425,1173175,BUY
29-12-20 11:31,11:31,11158500,12065550,907050,BUY
29-12-20 11:32,11:32,11249100,12276525,1027425,BUY
29-12-20 11:33,11:33,11477450,12260700,783250,BUY
29-12-20 11:34,11:34,11228625,12375725,1147100,BUY
29-12-20 11:35,11:35,11227850,12089900,862050,BUY
29-12-20 11:36,11:36,11270125,12028450,758325,BUY
29-12-20 11:37,11:37,11413500,11601950,188450,BUY
29-12-20 11:38,11:38,11475300,11882925,407625,BUY
29-12-20 11:39,11:39,11426175,11996750,570575,BUY
29-12-20 11:40,11:40,11365800,11900425,534625,BUY
29-12-20 11:41,11:41,11243475,11997300,753825,BUY
29-12-20 11:42,11:42,11259275,12042850,783575,BUY
29-12-20 11:43,11:43,11206350,11843425,637075,BUY
29-12-20 11:44,11:44,11300100,12138500,838400,BUY
29-12-20 11:45,11:45,11468125,11980100,511975,BUY
29-12-20 11:46,11:46,11425625,11829325,403700,BUY
29-12-20 11:47,11:47,11565450,11933950,368500,BUY
29-12-20 11:48,11:48,11440575,11973100,532525,BUY
29-12-20 11:49,11:49,11206875,12108425,901550,BUY
29-12-20 11:50,11:50,11601625,12462400,860775,BUY
29-12-20 11:51,11:51,11711000,12648700,937700,BUY
29-12-20 11:52,11:52,11479850,12214425,734575,BUY
29-12-20 11:53,11:53,11494800,11700875,206075,BUY
29-12-20 11:54,11:54,11426525,12060300,633775,BUY
29-12-20 11:55,11:55,11538275,12148950,610675,BUY
29-12-20 11:56,11:56,11610825,12216075,605250,BUY
29-12-20 11:57,11:57,11114450,12534775,1420325,BUY
29-12-20 11:58,11:58,11336775,12102750,765975,BUY
29-12-20 11:59,11:59,11141275,12438025,1296750,BUY
29-12-20 12:00,12:00,11317350,11320000,2650,BUY
29-12-20 12:01,12:01,11611700,12213575,601875,BUY
29-12-20 12:02,12:02,11617750,12407575,789825,BUY
29-12-20 12:03,12:03,10976425,12454175,1477750,BUY
29-12-20 12:04,12:04,11406625,12306650,900025,BUY
29-12-20 12:05,12:05,11536800,12327200,790400,BUY
29-12-20 12:06,12:06,11204100,12319125,1115025,BUY
29-12-20 12:07,12:07,11577300,12403225,825925,BUY
29-12-20 12:08,12:08,11464375,12571525,1107150,BUY
29-12-20 12:09,12:09,11557875,12512800,954925,BUY
29-12-20 12:10,12:10,11286600,12458725,1172125,BUY
29-12-20 12:11,12:11,11805800,12756225,950425,BUY
29-12-20 12:12,12:12,11579300,12553675,974375,BUY
29-12-20 12:13,12:13,11736425,12621075,884650,BUY
29-12-20 12:14,12:14,11506525,11488250,-18275,SELL
29-12-20 12:15,12:15,11492525,12447725,955200,BUY
29-12-20 12:16,12:16,11558800,12576425,1017625,BUY
29-12-20 12:17,12:17,11647475,11824850,177375,BUY
29-12-20 12:18,12:18,11662600,12244275,581675,BUY
29-12-20 12:19,12:19,11698375,12198925,500550,BUY
29-12-20 12:20,12:20,11750550,12604075,853525,BUY
29-12-20 12:21,12:21,11664250,12280550,616300,BUY
29-12-20 12:22,12:22,11772025,12545500,773475,BUY
29-12-20 12:23,12:23,11768175,12455800,687625,BUY
29-12-20 12:24,12:24,11741750,12726375,984625,BUY
29-12-20 12:25,12:25,11782250,12725800,943550,BUY
29-12-20 12:26,12:26,11656300,12588750,932450,BUY
29-12-20 12:27,12:27,11671275,12007175,335900,BUY
29-12-20 12:28,12:28,11599150,12629450,1030300,BUY
29-12-20 12:29,12:29,11840400,12587325,746925,BUY
29-12-20 12:30,12:30,11725950,12617075,891125,BUY
29-12-20 12:31,12:31,11294425,12262825,968400,BUY
29-12-20 12:32,12:32,11876275,12600675,724400,BUY
29-12-20 12:33,12:33,11774725,12736150,961425,BUY
29-12-20 12:34,12:34,11966150,12788300,822150,BUY
29-12-20 12:35,12:35,11920450,12502400,581950,BUY
29-12-20 12:36,12:36,11875200,12646225,771025,BUY
29-12-20 12:37,12:37,11682200,11467175,-215025,SELL
29-12-20 12:38,12:38,11771275,12688275,917000,BUY
29-12-20 12:39,12:39,11474425,12811400,1336975,BUY
29-12-20 12:40,12:40,11670525,12881450,1210925,BUY
29-12-20 12:41,12:41,11678550,12773400,1094850,BUY
29-12-20 12:42,12:42,11595000,12300575,705575,BUY
29-12-20 12:43,12:43,11501125,12309125,808000,BUY
29-12-20 12:44,12:44,11556150,12205675,649525,BUY
29-12-20 12:45,12:45,11634750,12348175,713425,BUY
29-12-20 12:46,12:46,11628700,12258300,629600,BUY
29-12-20 12:47,12:47,11619550,12747750,1128200,BUY
29-12-20 12:48,12:48,11588050,12519575,931525,BUY
29-12-20 12:49,12:49,11921625,12113875,192250,BUY
29-12-20 12:50,12:50,11383825,11871875,488050,BUY
29-12-20 12:51,12:51,11467650,11671750,204100,BUY
29-12-20 12:52,12:52,11756175,12468800,712625,BUY
29-12-20 12:53,12:53,11640925,11448375,-192550,SELL
29-12-20 12:54,12:54,11675225,12244950,569725,BUY
29-12-20 12:55,12:55,11423625,12491700,1068075,BUY
29-12-20 12:56,12:56,11636850,12885300,1248450,BUY
29-12-20 12:57,12:57,11583375,12343450,760075,BUY
29-12-20 12:58,12:58,11762750,12507875,745125,BUY
29-12-20 12:59,12:59,11285500,12698700,1413200,BUY
29-12-20 13:00,13:00,11886500,12824200,937700,BUY
29-12-20 13:01,13:01,11601425,12556875,955450,BUY
29-12-20 13:02,13:02,11920725,12900225,979500,BUY
29-12-20 13:03,13:03,11740625,12417275,676650,BUY
29-12-20 13:04,13:04,12300550,13068375,767825,BUY
29-12-20 13:05,13:05,12215975,12652100,436125,BUY
29-12-20 13:06,13:06,11721325,12901425,1180100,BUY
29-12-20 13:07,13:07,11658525,12827875,1169350,BUY
29-12-20 13:08,13:08,11644725,12790700,1145975,BUY
29-12-20 13:09,13:09,11775350,12919850,1144500,BUY
29-12-20 13:10,13:10,11427750,12828200,1400450,BUY
29-12-20 13:11,13:11,11427000,12463475,1036475,BUY
29-12-20 13:12,13:12,10948600,12277225,1328625,BUY
29-12-20 13:13,13:13,11081025,12405350,1324325,BUY
29-12-20 13:14,13:14,11174200,11644500,470300,BUY
29-12-20 13:15,13:15,11054400,12365900,1311500,BUY
29-12-20 13:16,13:16,10928100,12505650,1577550,BUY
29-12-20 13:17,13:17,10905025,12535925,1630900,BUY
29-12-20 13:18,13:18,10683925,12261800,1577875,BUY
29-12-20 13:19,13:19,10944100,12509725,1565625,BUY
29-12-20 13:20,13:20,10924625,12522175,1597550,BUY
29-12-20 13:21,13:21,10919775,12644100,1724325,BUY
29-12-20 13:22,13:22,10869625,12314200,1444575,BUY
29-12-20 13:23,13:23,10868300,12564025,1695725,BUY
29-12-20 13:24,13:24,10687850,11825450,1137600,BUY
29-12-20 13:25,13:25,10744850,12348800,1603950,BUY
29-12-20 13:26,13:26,10443175,12547750,2104575,BUY
29-12-20 13:27,13:27,10754925,12667600,1912675,BUY
29-12-20 13:28,13:28,10569650,12349250,1779600,BUY
29-12-20 13:29,13:29,10892700,12360575,1467875,BUY
29-12-20 13:30,13:30,10823825,12299500,1475675,BUY
29-12-20 13:31,13:31,10823100,12276000,1452900,BUY
29-12-20 13:32,13:32,10864450,12090700,1226250,BUY
29-12-20 13:33,13:33,10574825,12180125,1605300,BUY
29-12-20 13:34,13:34,10265525,12461250,2195725,BUY
29-12-20 13:35,13:35,10556000,12674775,2118775,BUY
29-12-20 13:36,13:36,10664950,12505400,1840450,BUY
29-12-20 13:37,13:37,10727100,12541975,1814875,BUY
29-12-20 13:38,13:38,10905475,12821575,1916100,BUY
29-12-20 13:39,13:39,10673425,12832275,2158850,BUY
29-12-20 13:40,13:40,11147200,13006325,1859125,BUY
29-12-20 13:41,13:41,10879050,12888100,2009050,BUY
29-12-20 13:42,13:42,10833700,12717100,1883400,BUY
29-12-20 13:43,13:43,10923125,12732625,1809500,BUY
29-12-20 13:44,13:44,10635100,12741725,2106625,BUY
29-12-20 13:45,13:45,10971525,12511600,1540075,BUY
29-12-20 13:46,13:46,10853325,12291875,1438550,BUY
29-12-20 13:47,13:47,10592375,12274725,1682350,BUY
29-12-20 13:48,13:48,10945575,11798700,853125,BUY
29-12-20 13:49,13:49,10978950,12836625,1857675,BUY
29-12-20 13:50,13:50,10920200,12857250,1937050,BUY
29-12-20 13:51,13:51,11390050,12478150,1088100,BUY
29-12-20 13:52,13:52,11219375,12087400,868025,BUY
29-12-20 13:53,13:53,10759025,12897975,2138950,BUY
29-12-20 13:54,13:54,11311025,11763925,452900,BUY
29-12-20 13:55,13:55,11249075,12795725,1546650,BUY
29-12-20 13:56,13:56,11317200,12902350,1585150,BUY
29-12-20 13:57,13:57,11245450,12799925,1554475,BUY
29-12-20 13:58,13:58,10780275,12535625,1755350,BUY
29-12-20 13:59,13:59,10794450,12903375,2108925,BUY
29-12-20 14:00,14:00,11279600,13009800,1730200,BUY
29-12-20 14:01,14:01,11223675,12624275,1400600,BUY
29-12-20 14:02,14:02,11252950,12595850,1342900,BUY
29-12-20 14:03,14:03,11359050,12186575,827525,BUY
29-12-20 14:04,14:04,11262975,12625650,1362675,BUY
29-12-20 14:05,14:05,10936900,12166525,1229625,BUY
29-12-20 14:06,14:06,10875675,13078150,2202475,BUY
29-12-20 14:07,14:07,11183750,12915775,1732025,BUY
29-12-20 14:08,14:08,10828525,12568475,1739950,BUY
29-12-20 14:09,14:09,11400125,12774400,1374275,BUY
29-12-20 14:10,14:10,11232700,13061975,1829275,BUY
29-12-20 14:11,14:11,11195475,12516950,1321475,BUY
29-12-20 14:12,14:12,11308550,12518500,1209950,BUY
29-12-20 14:13,14:13,10781450,12829475,2048025,BUY
29-12-20 14:14,14:14,11121825,12622725,1500900,BUY
29-12-20 14:15,14:15,11238825,12682350,1443525,BUY
29-12-20 14:16,14:16,11071325,12658325,1587000,BUY
29-12-20 14:17,14:17,10955550,13140950,2185400,BUY
29-12-20 14:18,14:18,10735100,13233875,2498775,BUY
29-12-20 14:19,14:19,11088325,12703675,1615350,BUY
29-12-20 14:20,14:20,11082900,12597725,1514825,BUY
29-12-20 14:21,14:21,11128275,12978650,1850375,BUY
29-12-20 14:22,14:22,11142950,12687150,1544200,BUY
29-12-20 14:23,14:23,11314775,13109400,1794625,BUY
29-12-20 14:24,14:24,11090125,12960200,1870075,BUY
29-12-20 14:25,14:25,11154100,13149775,1995675,BUY
29-12-20 14:26,14:26,11111150,13200325,2089175,BUY
29-12-20 14:27,14:27,11084825,13030200,1945375,BUY
29-12-20 14:28,14:28,11019150,13197800,2178650,BUY
29-12-20 14:29,14:29,10999900,12984625,1984725,BUY
29-12-20 14:30,14:30,11078450,13188175,2109725,BUY
29-12-20 14:31,14:31,11012275,13115275,2103000,BUY
29-12-20 14:32,14:32,10911525,12816350,1904825,BUY
29-12-20 14:33,14:33,10911600,12980000,2068400,BUY
29-12-20 14:34,14:34,10867375,12685575,1818200,BUY
29-12-20 14:35,14:35,11083350,12793625,1710275,BUY
29-12-20 14:36,14:36,11115425,13058925,1943500,BUY
29-12-20 14:37,14:37,10924975,12698500,1773525,BUY
29-12-20 14:38,14:38,10996175,12814825,1818650,BUY
29-12-20 14:39,14:39,11216350,12706975,1490625,BUY
29-12-20 14:40,14:40,11223225,12812775,1589550,BUY
29-12-20 14:41,14:41,10851150,12699275,1848125,BUY
29-12-20 14:42,14:42,11178050,13180650,2002600,BUY
29-12-20 14:43,14:43,11131900,13259250,2127350,BUY
29-12-20 14:44,14:44,11098725,12731675,1632950,BUY
29-12-20 14:45,14:45,10899175,12995850,2096675,BUY
29-12-20 14:46,14:46,10874625,12596450,1721825,BUY
29-12-20 14:47,14:47,10874900,12958475,2083575,BUY
29-12-20 14:48,14:48,10651175,12570650,1919475,BUY
29-12-20 14:49,14:49,10672225,12266125,1593900,BUY
29-12-20 14:50,14:50,10481700,13069525,2587825,BUY
29-12-20 14:51,14:51,10666450,12968175,2301725,BUY
29-12-20 14:52,14:52,10712850,12884400,2171550,BUY
29-12-20 14:53,14:53,10533725,12139650,1605925,BUY
29-12-20 14:54,14:54,10527575,12972525,2444950,BUY
29-12-20 14:55,14:55,10831950,13007800,2175850,BUY
29-12-20 14:56,14:56,10735750,12785025,2049275,BUY
29-12-20 14:57,14:57,10649525,12555850,1906325,BUY
29-12-20 14:58,14:58,10340500,12970625,2630125,BUY
29-12-20 14:59,14:59,10524625,12853325,2328700,BUY
29-12-20 15:00,15:00,10148525,12928525,2780000,BUY
29-12-20 15:01,15:01,10561750,12935800,2374050,BUY
29-12-20 15:02,15:02,10436300,12934325,2498025,BUY
29-12-20 15:03,15:03,10219750,12311425,2091675,BUY
29-12-20 15:04,15:04,10448275,12779600,2331325,BUY
29-12-20 15:05,15:05,10319825,12640000,2320175,BUY
29-12-20 15:06,15:06,10320375,12580625,2260250,BUY
29-12-20 15:07,15:07,10161825,12689575,2527750,BUY
29-12-20 15:08,15:08,10383300,12555025,2171725,BUY
29-12-20 15:09,15:09,10372500,12622500,2250000,BUY
29-12-20 15:10,15:10,10295050,12555575,2260525,BUY
29-12-20 15:11,15:11,10232775,12545100,2312325,BUY
29-12-20 15:12,15:12,10267800,12404250,2136450,BUY
29-12-20 15:13,15:13,10132000,12535600,2403600,BUY
29-12-20 15:14,15:14,10301425,12367675,2066250,BUY
29-12-20 15:15,15:15,9985250,12337175,2351925,BUY
29-12-20 15:16,15:16,9994250,12356550,2362300,BUY
29-12-20 15:17,15:17,9989400,12398575,2409175,BUY
29-12-20 15:18,15:18,9868300,12180650,2312350,BUY
29-12-20 15:19,15:19,9904650,12207650,2303000,BUY
29-12-20 15:20,15:20,10028950,12247675,2218725,BUY
29-12-20 15:21,15:21,9536000,11878050,2342050,BUY
29-12-20 15:22,15:22,9414600,11903300,2488700,BUY
29-12-20 15:23,15:23,9276525,11859600,2583075,BUY
29-12-20 15:24,15:24,9223775,11441925,2218150,BUY
29-12-20 15:25,15:25,9244800,11733125,2488325,BUY
29-12-20 15:26,15:26,9229550,11748775,2519225,BUY
29-12-20 15:27,15:27,9034550,11590700,2556150,BUY
29-12-20 15:28,15:28,8980325,11545525,2565200,BUY
29-12-20 15:29,15:29,9182525,11582750,2400225,BUY
30-12-20 9:15,9:15,8795850,11229275,2433425,BUY
30-12-20 9:16,9:16,8656025,11250000,2593975,BUY
30-12-20 9:17,9:17,9398375,11526600,2128225,BUY
30-12-20 9:18,9:18,9367050,11735225,2368175,BUY
30-12-20 9:19,9:19,9382350,11789650,2407300,BUY
30-12-20 9:20,9:20,9864900,12351800,2486900,BUY
30-12-20 9:21,9:21,9950750,12421350,2470600,BUY
30-12-20 9:22,9:22,9958700,12391875,2433175,BUY
30-12-20 9:23,9:23,10427175,12631175,2204000,BUY
30-12-20 9:24,9:24,10277125,12617225,2340100,BUY
30-12-20 9:25,9:25,10420625,12516675,2096050,BUY
30-12-20 9:26,9:26,10468350,12677225,2208875,BUY
30-12-20 9:27,9:27,10431775,12392875,1961100,BUY
30-12-20 9:28,9:28,10384375,12752900,2368525,BUY
30-12-20 9:29,9:29,10801125,13038075,2236950,BUY
30-12-20 9:30,9:30,10852600,13078750,2226150,BUY
30-12-20 9:31,9:31,10852600,13093125,2240525,BUY
30-12-20 9:32,9:32,11232500,13380050,2147550,BUY
30-12-20 9:33,9:33,11092275,13271700,2179425,BUY
30-12-20 9:34,9:34,11258425,13359775,2101350,BUY
30-12-20 9:35,9:35,11398750,13134050,1735300,BUY
30-12-20 9:36,9:36,11373825,13550950,2177125,BUY
30-12-20 9:37,9:37,11257825,13416075,2158250,BUY
30-12-20 9:38,9:38,11634575,13333500,1698925,BUY
30-12-20 9:39,9:39,11493375,13524650,2031275,BUY
30-12-20 9:40,9:40,11813200,13767675,1954475,BUY
30-12-20 9:41,9:41,11864075,13730875,1866800,BUY
30-12-20 9:42,9:42,11455850,13405375,1949525,BUY
30-12-20 9:43,9:43,11835025,13742750,1907725,BUY
30-12-20 9:44,9:44,11864700,13797850,1933150,BUY
30-12-20 9:45,9:45,12001900,13286300,1284400,BUY
30-12-20 9:46,9:46,12105150,13575400,1470250,BUY
30-12-20 9:47,9:47,12167900,13980275,1812375,BUY
30-12-20 9:48,9:48,12063200,13871850,1808650,BUY
30-12-20 9:49,9:49,12020525,13582525,1562000,BUY
30-12-20 9:50,9:50,12506075,14242250,1736175,BUY
30-12-20 9:51,9:51,12150225,13733525,1583300,BUY
30-12-20 9:52,9:52,12451875,14227525,1775650,BUY
30-12-20 9:53,9:53,12580600,13788650,1208050,BUY
30-12-20 9:54,9:54,12352075,13856025,1503950,BUY
30-12-20 9:55,9:55,12497775,13923950,1426175,BUY
30-12-20 9:56,9:56,12421000,14033225,1612225,BUY
30-12-20 9:57,9:57,12600750,14387150,1786400,BUY
30-12-20 9:58,9:58,12438450,14052675,1614225,BUY
30-12-20 9:59,9:59,12401425,14086225,1684800,BUY
30-12-20 10:00,10:00,12469000,14188650,1719650,BUY
30-12-20 10:01,10:01,12566500,14467375,1900875,BUY
30-12-20 10:02,10:02,12453425,14365425,1912000,BUY
30-12-20 10:03,10:03,12801950,14359225,1557275,BUY
30-12-20 10:04,10:04,12579700,14417775,1838075,BUY
30-12-20 10:05,10:05,12457375,14598875,2141500,BUY
30-12-20 10:06,10:06,12778275,14241225,1462950,BUY
30-12-20 10:07,10:07,12931675,14486050,1554375,BUY
30-12-20 10:08,10:08,12790575,14378875,1588300,BUY
30-12-20 10:09,10:09,12472675,14347425,1874750,BUY
30-12-20 10:10,10:10,12650075,14777825,2127750,BUY
30-12-20 10:11,10:11,12652275,14787150,2134875,BUY
30-12-20 10:12,10:12,12609500,14703700,2094200,BUY
30-12-20 10:13,10:13,12606675,14711900,2105225,BUY
30-12-20 10:14,10:14,12734300,14303775,1569475,BUY
30-12-20 10:15,10:15,12671475,14404450,1732975,BUY
30-12-20 10:16,10:16,12867125,14597125,1730000,BUY
30-12-20 10:17,10:17,12517550,13555525,1037975,BUY
30-12-20 10:18,10:18,12961825,14806800,1844975,BUY
30-12-20 10:19,10:19,12926675,14192575,1265900,BUY
30-12-20 10:20,10:20,13147125,14618225,1471100,BUY
30-12-20 10:21,10:21,13161675,14460525,1298850,BUY
30-12-20 10:22,10:22,13118725,14863625,1744900,BUY
30-12-20 10:23,10:23,12809350,14194450,1385100,BUY
30-12-20 10:24,10:24,13003125,14204075,1200950,BUY
30-12-20 10:25,10:25,12858225,14612050,1753825,BUY
30-12-20 10:26,10:26,13151950,14606275,1454325,BUY
30-12-20 10:27,10:27,13073775,14808875,1735100,BUY
30-12-20 10:28,10:28,13102000,14675325,1573325,BUY
30-12-20 10:29,10:29,13237800,14664450,1426650,BUY
30-12-20 10:30,10:30,13052325,14626775,1574450,BUY
30-12-20 10:31,10:31,13046150,14512700,1466550,BUY
30-12-20 10:32,10:32,12774250,14281750,1507500,BUY
30-12-20 10:33,10:33,12980325,14213250,1232925,BUY
30-12-20 10:34,10:34,12611375,14421225,1809850,BUY
30-12-20 10:35,10:35,12791925,14273875,1481950,BUY
30-12-20 10:36,10:36,13075200,14532825,1457625,BUY
30-12-20 10:37,10:37,13060525,14440175,1379650,BUY
30-12-20 10:38,10:38,13079100,14521825,1442725,BUY
30-12-20 10:39,10:39,13301400,14386275,1084875,BUY
30-12-20 10:40,10:40,13178575,14618100,1439525,BUY
30-12-20 10:41,10:41,13028950,14269475,1240525,BUY
30-12-20 10:42,10:42,13038250,13911200,872950,BUY
30-12-20 10:43,10:43,13071500,14777675,1706175,BUY
30-12-20 10:44,10:44,13189750,14591375,1401625,BUY
30-12-20 10:45,10:45,13284825,14709025,1424200,BUY
30-12-20 10:46,10:46,13091750,14797700,1705950,BUY
30-12-20 10:47,10:47,12841425,14414050,1572625,BUY
30-12-20 10:48,10:48,13221800,14377275,1155475,BUY
30-12-20 10:49,10:49,13049650,14179925,1130275,BUY
30-12-20 10:50,10:50,13394100,14456975,1062875,BUY
30-12-20 10:51,10:51,13256125,14928625,1672500,BUY
30-12-20 10:52,10:52,13200225,14335875,1135650,BUY
30-12-20 10:53,10:53,13210200,14714550,1504350,BUY
30-12-20 10:54,10:54,12882750,14285750,1403000,BUY
30-12-20 10:55,10:55,13081900,14380300,1298400,BUY
30-12-20 10:56,10:56,13426400,14793600,1367200,BUY
30-12-20 10:57,10:57,13395875,14960075,1564200,BUY
30-12-20 10:58,10:58,13456625,14554500,1097875,BUY
30-12-20 10:59,10:59,13270900,14819625,1548725,BUY
30-12-20 11:00,11:00,13273525,14522600,1249075,BUY
30-12-20 11:01,11:01,13315300,14453600,1138300,BUY
30-12-20 11:02,11:02,13438050,14468125,1030075,BUY
30-12-20 11:03,11:03,13322900,14874300,1551400,BUY
30-12-20 11:04,11:04,13208725,14771025,1562300,BUY
30-12-20 11:05,11:05,13347575,14627175,1279600,BUY
30-12-20 11:06,11:06,13367650,14858050,1490400,BUY
30-12-20 11:07,11:07,13158625,14456275,1297650,BUY
30-12-20 11:08,11:08,13127125,14010100,882975,BUY
30-12-20 11:09,11:09,13334425,13497250,162825,BUY
30-12-20 11:10,11:10,13274700,13804125,529425,BUY
30-12-20 11:11,11:11,13320925,14769775,1448850,BUY
30-12-20 11:12,11:12,12999650,14500025,1500375,BUY
30-12-20 11:13,11:13,13235775,14547675,1311900,BUY
30-12-20 11:14,11:14,13346350,14837500,1491150,BUY
30-12-20 11:15,11:15,13458250,14637525,1179275,BUY
30-12-20 11:16,11:16,13336225,14328575,992350,BUY
30-12-20 11:17,11:17,13373350,13994375,621025,BUY
30-12-20 11:18,11:18,13394600,14388600,994000,BUY
30-12-20 11:19,11:19,13493525,14833900,1340375,BUY
30-12-20 11:20,11:20,13558200,14896475,1338275,BUY
30-12-20 11:21,11:21,13574375,14538600,964225,BUY
30-12-20 11:22,11:22,13689525,14437175,747650,BUY
30-12-20 11:23,11:23,13726025,14936575,1210550,BUY
30-12-20 11:24,11:24,13637625,14598325,960700,BUY
30-12-20 11:25,11:25,13871700,14992900,1121200,BUY
30-12-20 11:26,11:26,13269625,14507025,1237400,BUY
30-12-20 11:27,11:27,13680750,14653275,972525,BUY
30-12-20 11:28,11:28,13609375,14501650,892275,BUY
30-12-20 11:29,11:29,13855025,15163075,1308050,BUY
30-12-20 11:30,11:30,13517775,15089050,1571275,BUY
30-12-20 11:31,11:31,13786300,14190975,404675,BUY
30-12-20 11:32,11:32,13552300,14798775,1246475,BUY
30-12-20 11:33,11:33,13807700,14436550,628850,BUY
30-12-20 11:34,11:34,13553950,14919750,1365800,BUY
30-12-20 11:35,11:35,13615900,14815100,1199200,BUY
30-12-20 11:36,11:36,14039050,15173800,1134750,BUY
30-12-20 11:37,11:37,13902425,14861975,959550,BUY
30-12-20 11:38,11:38,13857625,14697800,840175,BUY
30-12-20 11:39,11:39,13718775,14985275,1266500,BUY
30-12-20 11:40,11:40,13807525,14139225,331700,BUY
30-12-20 11:41,11:41,13889675,14879325,989650,BUY
30-12-20 11:42,11:42,13941625,14872775,931150,BUY
30-12-20 11:43,11:43,14046700,15026375,979675,BUY
30-12-20 11:44,11:44,13928300,15107500,1179200,BUY
30-12-20 11:45,11:45,13894475,14783125,888650,BUY
30-12-20 11:46,11:46,13519725,14576250,1056525,BUY
30-12-20 11:47,11:47,13971150,15034275,1063125,BUY
30-12-20 11:48,11:48,13772200,14745375,973175,BUY
30-12-20 11:49,11:49,13830500,15050475,1219975,BUY
30-12-20 11:50,11:50,13809400,14632650,823250,BUY
30-12-20 11:51,11:51,13875575,14332125,456550,BUY
30-12-20 11:52,11:52,13846250,14858275,1012025,BUY
30-12-20 11:53,11:53,13867700,13823275,-44425,SELL
30-12-20 11:54,11:54,13884525,14150050,265525,BUY
30-12-20 11:55,11:55,13787600,14901750,1114150,BUY
30-12-20 11:56,11:56,13924600,14555450,630850,BUY
30-12-20 11:57,11:57,13812650,13941200,128550,BUY
30-12-20 11:58,11:58,14204825,14962225,757400,BUY
30-12-20 11:59,11:59,13981750,14776375,794625,BUY
30-12-20 12:00,12:00,14017300,14558550,541250,BUY
30-12-20 12:01,12:01,13728175,14836225,1108050,BUY
30-12-20 12:02,12:02,14146650,14716975,570325,BUY
30-12-20 12:03,12:03,13591000,14756925,1165925,BUY
30-12-20 12:04,12:04,13942525,14592475,649950,BUY
30-12-20 12:05,12:05,14065150,15050475,985325,BUY
30-12-20 12:06,12:06,13991450,14552575,561125,BUY
30-12-20 12:07,12:07,13827325,14627100,799775,BUY
30-12-20 12:08,12:08,14070475,15079725,1009250,BUY
30-12-20 12:09,12:09,13901625,14969700,1068075,BUY
30-12-20 12:10,12:10,13694200,14997575,1303375,BUY
30-12-20 12:11,12:11,13865225,14742750,877525,BUY
30-12-20 12:12,12:12,13637375,14980975,1343600,BUY
30-12-20 12:13,12:13,13730550,14986000,1255450,BUY
30-12-20 12:14,12:14,14056225,15122225,1066000,BUY
30-12-20 12:15,12:15,14030525,14781225,750700,BUY
30-12-20 12:16,12:16,13782175,14619425,837250,BUY
30-12-20 12:17,12:17,13646375,14899375,1253000,BUY
30-12-20 12:18,12:18,13946850,14885250,938400,BUY
30-12-20 12:19,12:19,13716125,14409325,693200,BUY
30-12-20 12:20,12:20,14175825,14893725,717900,BUY
30-12-20 12:21,12:21,14039975,14926350,886375,BUY
30-12-20 12:22,12:22,14204600,14616400,411800,BUY
30-12-20 12:23,12:23,13765525,14269350,503825,BUY
30-12-20 12:24,12:24,13917100,13960100,43000,BUY
30-12-20 12:25,12:25,13942625,14597000,654375,BUY
30-12-20 12:26,12:26,14056425,14735375,678950,BUY
30-12-20 12:27,12:27,13796900,14735325,938425,BUY
30-12-20 12:28,12:28,12842150,14812950,1970800,BUY
30-12-20 12:29,12:29,13753175,14565425,812250,BUY
30-12-20 12:30,12:30,14234050,14464725,230675,BUY
30-12-20 12:31,12:31,13951275,14363275,412000,BUY
30-12-20 12:32,12:32,13814300,14642775,828475,BUY
30-12-20 12:33,12:33,13910100,14307400,397300,BUY
30-12-20 12:34,12:34,13792750,14848050,1055300,BUY
30-12-20 12:35,12:35,14073350,14855575,782225,BUY
30-12-20 12:36,12:36,14057725,14424950,367225,BUY
30-12-20 12:37,12:37,14471000,14907425,436425,BUY
30-12-20 12:38,12:38,14241075,15129825,888750,BUY
30-12-20 12:39,12:39,14225600,14709550,483950,BUY
30-12-20 12:40,12:40,14145450,14575625,430175,BUY
30-12-20 12:41,12:41,14002200,14574075,571875,BUY
30-12-20 12:42,12:42,13978700,13801300,-177400,SELL
30-12-20 12:43,12:43,13987025,13717250,-269775,SELL
30-12-20 12:44,12:44,13999300,13922225,-77075,SELL
30-12-20 12:45,12:45,13917175,13669900,-247275,SELL
30-12-20 12:46,12:46,13879850,13791875,-87975,SELL
30-12-20 12:47,12:47,13900700,13838175,-62525,SELL
30-12-20 12:48,12:48,13988250,13980000,-8250,SELL
30-12-20 12:49,12:49,13849975,13924525,74550,BUY
30-12-20 12:50,12:50,13871950,14056575,184625,BUY
30-12-20 12:51,12:51,13712700,13270625,-442075,SELL
30-12-20 12:52,12:52,13982675,13982525,-150,SELL
30-12-20 12:53,12:53,14014200,13915350,-98850,SELL
30-12-20 12:54,12:54,13759925,14004775,244850,BUY
30-12-20 12:55,12:55,13999875,13144550,-855325,SELL
30-12-20 12:56,12:56,13908275,13772400,-135875,SELL
30-12-20 12:57,12:57,13766850,14058925,292075,BUY
30-12-20 12:58,12:58,13593050,13892775,299725,BUY
30-12-20 12:59,12:59,13855400,14060050,204650,BUY
30-12-20 13:00,13:00,14048575,14257925,209350,BUY
30-12-20 13:01,13:01,14086375,14307550,221175,BUY
30-12-20 13:02,13:02,13979675,14033650,53975,BUY
30-12-20 13:03,13:03,13724125,13976550,252425,BUY
30-12-20 13:04,13:04,13901700,14280775,379075,BUY
30-12-20 13:05,13:05,13963075,14204575,241500,BUY
30-12-20 13:06,13:06,14088725,14200150,111425,BUY
30-12-20 13:07,13:07,14075175,13103250,-971925,SELL
30-12-20 13:08,13:08,14090000,14175150,85150,BUY
30-12-20 13:09,13:09,14121650,14050650,-71000,SELL
30-12-20 13:10,13:10,14096425,13989375,-107050,SELL
30-12-20 13:11,13:11,13955225,13556975,-398250,SELL
30-12-20 13:12,13:12,13881075,13955925,74850,BUY
30-12-20 13:13,13:13,13732175,14295325,563150,BUY
30-12-20 13:14,13:14,13971900,13890750,-81150,SELL
30-12-20 13:15,13:15,13894400,14094900,200500,BUY
30-12-20 13:16,13:16,13891800,13660175,-231625,SELL
30-12-20 13:17,13:17,13877175,14367800,490625,BUY
30-12-20 13:18,13:18,14058325,14352325,294000,BUY
30-12-20 13:19,13:19,13935025,14399475,464450,BUY
30-12-20 13:20,13:20,13689500,13829900,140400,BUY
30-12-20 13:21,13:21,13997750,14239650,241900,BUY
30-12-20 13:22,13:22,13700800,14205250,504450,BUY
30-12-20 13:23,13:23,13884525,13858925,-25600,SELL
30-12-20 13:24,13:24,13766575,13726475,-40100,SELL
30-12-20 13:25,13:25,13843050,13923775,80725,BUY
30-12-20 13:26,13:26,13844725,13622800,-221925,SELL
30-12-20 13:27,13:27,13759250,14045325,286075,BUY
30-12-20 13:28,13:28,13863500,13764025,-99475,SELL
30-12-20 13:29,13:29,13944250,14041475,97225,BUY
30-12-20 13:30,13:30,14066600,13925625,-140975,SELL
30-12-20 13:31,13:31,14121150,13936275,-184875,SELL
30-12-20 13:32,13:32,14162975,13951350,-211625,SELL
30-12-20 13:33,13:33,14073225,14004100,-69125,SELL
30-12-20 13:34,13:34,13862250,14023600,161350,BUY
30-12-20 13:35,13:35,14070625,13906975,-163650,SELL
30-12-20 13:36,13:36,13980650,13950525,-30125,SELL
30-12-20 13:37,13:37,14039675,14046450,6775,BUY
30-12-20 13:38,13:38,14051500,13871275,-180225,SELL
30-12-20 13:39,13:39,14211575,14473925,262350,BUY
30-12-20 13:40,13:40,14278775,14194550,-84225,SELL
30-12-20 13:41,13:41,14339100,14429900,90800,BUY
30-12-20 13:42,13:42,13913075,13888325,-24750,SELL
30-12-20 13:43,13:43,13895575,13942675,47100,BUY
30-12-20 13:44,13:44,13808325,14264050,455725,BUY
30-12-20 13:45,13:45,13513475,14283200,769725,BUY
30-12-20 13:46,13:46,13499400,13870375,370975,BUY
30-12-20 13:47,13:47,13519275,13697075,177800,BUY
30-12-20 13:48,13:48,13491050,14266375,775325,BUY
30-12-20 13:49,13:49,13560675,14174050,613375,BUY
30-12-20 13:50,13:50,13761675,14139025,377350,BUY
30-12-20 13:51,13:51,13448825,14258725,809900,BUY
30-12-20 13:52,13:52,13550275,14151475,601200,BUY
30-12-20 13:53,13:53,13583250,14271675,688425,BUY
30-12-20 13:54,13:54,13601125,14124575,523450,BUY
30-12-20 13:55,13:55,13553775,14176000,622225,BUY
30-12-20 13:56,13:56,13257225,14234675,977450,BUY
30-12-20 13:57,13:57,13647525,14009225,361700,BUY
30-12-20 13:58,13:58,13574600,14242450,667850,BUY
30-12-20 13:59,13:59,13630950,13927025,296075,BUY
30-12-20 14:00,14:00,13750025,14248075,498050,BUY
30-12-20 14:01,14:01,13643725,13952800,309075,BUY
30-12-20 14:02,14:02,13722200,14108800,386600,BUY
30-12-20 14:03,14:03,13353575,14400700,1047125,BUY
30-12-20 14:04,14:04,13266275,14413725,1147450,BUY
30-12-20 14:05,14:05,13510700,14422675,911975,BUY
30-12-20 14:06,14:06,13368125,14486475,1118350,BUY
30-12-20 14:07,14:07,13160700,14528325,1367625,BUY
30-12-20 14:08,14:08,13249850,14365100,1115250,BUY
30-12-20 14:09,14:09,13216500,14439825,1223325,BUY
30-12-20 14:10,14:10,13356725,14337725,981000,BUY
30-12-20 14:11,14:11,13232775,14306800,1074025,BUY
30-12-20 14:12,14:12,13189025,14339550,1150525,BUY
30-12-20 14:13,14:13,13230775,14438350,1207575,BUY
30-12-20 14:14,14:14,13261750,14444375,1182625,BUY
30-12-20 14:15,14:15,13157025,14362950,1205925,BUY
30-12-20 14:16,14:16,12865350,14333800,1468450,BUY
30-12-20 14:17,14:17,13224200,14414825,1190625,BUY
30-12-20 14:18,14:18,13121025,13853975,732950,BUY
30-12-20 14:19,14:19,13065650,14397125,1331475,BUY
30-12-20 14:20,14:20,13041675,14321200,1279525,BUY
30-12-20 14:21,14:21,13268375,14391425,1123050,BUY
30-12-20 14:22,14:22,13186100,14391350,1205250,BUY
30-12-20 14:23,14:23,13192075,14423925,1231850,BUY
30-12-20 14:24,14:24,13265300,14152775,887475,BUY
30-12-20 14:25,14:25,13264150,14190475,926325,BUY
30-12-20 14:26,14:26,13306700,14276050,969350,BUY
30-12-20 14:27,14:27,13151725,14474425,1322700,BUY
30-12-20 14:28,14:28,13101250,14222075,1120825,BUY
30-12-20 14:29,14:29,12890050,14425400,1535350,BUY
30-12-20 14:30,14:30,13275675,14461975,1186300,BUY
30-12-20 14:31,14:31,13210650,13802750,592100,BUY
30-12-20 14:32,14:32,13202750,14217300,1014550,BUY
30-12-20 14:33,14:33,13111175,14565825,1454650,BUY
30-12-20 14:34,14:34,13042900,14415275,1372375,BUY
30-12-20 14:35,14:35,13090725,14122550,1031825,BUY
30-12-20 14:36,14:36,13190875,14198075,1007200,BUY
30-12-20 14:37,14:37,13127700,13825325,697625,BUY
30-12-20 14:38,14:38,13003425,14152975,1149550,BUY
30-12-20 14:39,14:39,13037950,14082350,1044400,BUY
30-12-20 14:40,14:40,12954850,14091850,1137000,BUY
30-12-20 14:41,14:41,13022600,14166250,1143650,BUY
30-12-20 14:42,14:42,12806700,13638200,831500,BUY
30-12-20 14:43,14:43,12937600,13965200,1027600,BUY
30-12-20 14:44,14:44,13144000,14085450,941450,BUY
30-12-20 14:45,14:45,13150950,14096025,945075,BUY
30-12-20 14:46,14:46,12813425,13905900,1092475,BUY
30-12-20 14:47,14:47,13109075,14325775,1216700,BUY
30-12-20 14:48,14:48,13048200,14318850,1270650,BUY
30-12-20 14:49,14:49,13101475,13894025,792550,BUY
30-12-20 14:50,14:50,12840450,14138575,1298125,BUY
30-12-20 14:51,14:51,13037525,14040700,1003175,BUY
30-12-20 14:52,14:52,12890325,14304925,1414600,BUY
30-12-20 14:53,14:53,12945075,14330100,1385025,BUY
30-12-20 14:54,14:54,12676875,14060800,1383925,BUY
30-12-20 14:55,14:55,12825700,14169125,1343425,BUY
30-12-20 14:56,14:56,12800350,14215600,1415250,BUY
30-12-20 14:57,14:57,12965100,14063125,1098025,BUY
30-12-20 14:58,14:58,12865950,13950750,1084800,BUY
30-12-20 14:59,14:59,12385575,14026000,1640425,BUY
30-12-20 15:00,15:00,12745375,14009125,1263750,BUY
30-12-20 15:01,15:01,12638825,13993800,1354975,BUY
30-12-20 15:02,15:02,12755200,13883075,1127875,BUY
30-12-20 15:03,15:03,12223275,13768000,1544725,BUY
30-12-20 15:04,15:04,12525150,13835100,1309950,BUY
30-12-20 15:05,15:05,12467525,13800875,1333350,BUY
30-12-20 15:06,15:06,12272125,13695250,1423125,BUY
30-12-20 15:07,15:07,12197300,13695900,1498600,BUY
30-12-20 15:08,15:08,12398500,13672725,1274225,BUY
30-12-20 15:09,15:09,12284625,13565425,1280800,BUY
30-12-20 15:10,15:10,12065700,13557500,1491800,BUY
30-12-20 15:11,15:11,12380725,13413975,1033250,BUY
30-12-20 15:12,15:12,12076425,13533100,1456675,BUY
30-12-20 15:13,15:13,12117025,13547675,1430650,BUY
30-12-20 15:14,15:14,12085250,13510150,1424900,BUY
30-12-20 15:15,15:15,12010400,13232850,1222450,BUY
30-12-20 15:16,15:16,11932600,13314200,1381600,BUY
30-12-20 15:17,15:17,11979375,13252675,1273300,BUY
30-12-20 15:18,15:18,11829700,12999075,1169375,BUY
30-12-20 15:19,15:19,11591500,12983425,1391925,BUY
30-12-20 15:20,15:20,11677925,12916850,1238925,BUY
30-12-20 15:21,15:21,11341075,12656425,1315350,BUY
30-12-20 15:22,15:22,11373625,12626750,1253125,BUY
30-12-20 15:23,15:23,11287025,12638200,1351175,BUY
30-12-20 15:24,15:24,10965375,12291100,1325725,BUY
30-12-20 15:25,15:25,11122625,12353075,1230450,BUY
30-12-20 15:26,15:26,10872250,12111925,1239675,BUY
30-12-20 15:27,15:27,10950675,12091150,1140475,BUY
30-12-20 15:28,15:28,11004075,12117050,1112975,BUY
30-12-20 15:29,15:29,11052875,12171350,1118475,BUY
31-12-20 9:15,9:15,10866350,11874975,1008625,BUY
31-12-20 9:16,9:16,10914300,11829325,915025,BUY
31-12-20 9:17,9:17,11558725,12717575,1158850,BUY
31-12-20 9:18,9:18,11596075,12773600,1177525,BUY
31-12-20 9:19,9:19,11628125,12820875,1192750,BUY
31-12-20 9:20,9:20,12510650,13549950,1039300,BUY
31-12-20 9:21,9:21,12441525,13449825,1008300,BUY
31-12-20 9:22,9:22,12320250,13519725,1199475,BUY
31-12-20 9:23,9:23,12723450,13875700,1152250,BUY
31-12-20 9:24,9:24,12812625,14024775,1212150,BUY
31-12-20 9:25,9:25,12753250,14023500,1270250,BUY
31-12-20 9:26,9:26,13563350,14601800,1038450,BUY
31-12-20 9:27,9:27,13592775,14661025,1068250,BUY
31-12-20 9:28,9:28,13608625,14745675,1137050,BUY
31-12-20 9:29,9:29,14001625,15039925,1038300,BUY
31-12-20 9:30,9:30,13950375,15412250,1461875,BUY
31-12-20 9:31,9:31,13965750,15431675,1465925,BUY
31-12-20 9:32,9:32,14305575,15897350,1591775,BUY
31-12-20 9:33,9:33,14414775,15912600,1497825,BUY
31-12-20 9:34,9:34,14328525,15887900,1559375,BUY
31-12-20 9:35,9:35,14659400,16254350,1594950,BUY
31-12-20 9:36,9:36,14691600,16255700,1564100,BUY
31-12-20 9:37,9:37,14548825,16264500,1715675,BUY
31-12-20 9:38,9:38,15112375,16446550,1334175,BUY
31-12-20 9:39,9:39,14869925,16322625,1452700,BUY
31-12-20 9:40,9:40,14957275,16462100,1504825,BUY
31-12-20 9:41,9:41,15383950,16540550,1156600,BUY
31-12-20 9:42,9:42,15114525,16216250,1101725,BUY
31-12-20 9:43,9:43,15309250,16458875,1149625,BUY
31-12-20 9:44,9:44,15291800,16653300,1361500,BUY
31-12-20 9:45,9:45,15447475,16645950,1198475,BUY
31-12-20 9:46,9:46,15170725,16756150,1585425,BUY
31-12-20 9:47,9:47,15589875,16866350,1276475,BUY
31-12-20 9:48,9:48,15455325,16607925,1152600,BUY
31-12-20 9:49,9:49,15591650,16718725,1127075,BUY
31-12-20 9:50,9:50,15569050,17131175,1562125,BUY
31-12-20 9:51,9:51,15583700,16993700,1410000,BUY
31-12-20 9:52,9:52,15452225,16890525,1438300,BUY
31-12-20 9:53,9:53,15715250,16843850,1128600,BUY
31-12-20 9:54,9:54,15315850,17272325,1956475,BUY
31-12-20 9:55,9:55,15682425,17420475,1738050,BUY
31-12-20 9:56,9:56,15957775,17696625,1738850,BUY
31-12-20 9:57,9:57,15680425,17590800,1910375,BUY
31-12-20 9:58,9:58,15691150,17556475,1865325,BUY
31-12-20 9:59,9:59,15847350,17762375,1915025,BUY
31-12-20 10:00,10:00,15660175,17673075,2012900,BUY
31-12-20 10:01,10:01,15659975,17760450,2100475,BUY
31-12-20 10:02,10:02,15900700,17826375,1925675,BUY
31-12-20 10:03,10:03,15765250,17853725,2088475,BUY
31-12-20 10:04,10:04,15715325,17707050,1991725,BUY
31-12-20 10:05,10:05,15739550,17816675,2077125,BUY
31-12-20 10:06,10:06,15669875,18007325,2337450,BUY
31-12-20 10:07,10:07,16178300,18006500,1828200,BUY
31-12-20 10:08,10:08,15969475,17560000,1590525,BUY
31-12-20 10:09,10:09,16056225,18161750,2105525,BUY
31-12-20 10:10,10:10,15829725,18116400,2286675,BUY
31-12-20 10:11,10:11,15822150,18108475,2286325,BUY
31-12-20 10:12,10:12,16048750,17842750,1794000,BUY
31-12-20 10:13,10:13,16007625,18027475,2019850,BUY
31-12-20 10:14,10:14,15937775,18381950,2444175,BUY
31-12-20 10:15,10:15,15938900,18390725,2451825,BUY
31-12-20 10:16,10:16,15541250,18203550,2662300,BUY
31-12-20 10:17,10:17,15840400,17633950,1793550,BUY
31-12-20 10:18,10:18,16217600,18386250,2168650,BUY
31-12-20 10:19,10:19,15487300,18421475,2934175,BUY
31-12-20 10:20,10:20,16006800,18185550,2178750,BUY
31-12-20 10:21,10:21,16066100,17951975,1885875,BUY
31-12-20 10:22,10:22,15742850,18369350,2626500,BUY
31-12-20 10:23,10:23,16108175,18503275,2395100,BUY
31-12-20 10:24,10:24,15917100,18113775,2196675,BUY
31-12-20 10:25,10:25,16222225,18530775,2308550,BUY
31-12-20 10:26,10:26,16209425,17682775,1473350,BUY
31-12-20 10:27,10:27,15637200,18559400,2922200,BUY
31-12-20 10:28,10:28,15928675,18616525,2687850,BUY
31-12-20 10:29,10:29,16194925,18362575,2167650,BUY
31-12-20 10:30,10:30,16089475,18163250,2073775,BUY
31-12-20 10:31,10:31,16320325,18461150,2140825,BUY
31-12-20 10:32,10:32,16281925,17965800,1683875,BUY
31-12-20 10:33,10:33,16351725,18061475,1709750,BUY
31-12-20 10:34,10:34,16154600,18758625,2604025,BUY
31-12-20 10:35,10:35,16170900,18218100,2047200,BUY
31-12-20 10:36,10:36,16178025,18013675,1835650,BUY
31-12-20 10:37,10:37,16243675,18435625,2191950,BUY
31-12-20 10:38,10:38,16482925,18962500,2479575,BUY
31-12-20 10:39,10:39,16196850,18779275,2582425,BUY
31-12-20 10:40,10:40,16283250,18407725,2124475,BUY
31-12-20 10:41,10:41,16426250,18837625,2411375,BUY
31-12-20 10:42,10:42,16363200,18491225,2128025,BUY
31-12-20 10:43,10:43,16371150,18732825,2361675,BUY
31-12-20 10:44,10:44,16367875,18747275,2379400,BUY
31-12-20 10:45,10:45,16615925,19164100,2548175,BUY
31-12-20 10:46,10:46,16072625,18511575,2438950,BUY
31-12-20 10:47,10:47,16255775,18569350,2313575,BUY
31-12-20 10:48,10:48,16043600,19015350,2971750,BUY
31-12-20 10:49,10:49,16142075,18256400,2114325,BUY
31-12-20 10:50,10:50,16002025,19249750,3247725,BUY
31-12-20 10:51,10:51,16331800,18834125,2502325,BUY
31-12-20 10:52,10:52,16191200,18932125,2740925,BUY
31-12-20 10:53,10:53,16511375,18869725,2358350,BUY
31-12-20 10:54,10:54,16862125,19582225,2720100,BUY
31-12-20 10:55,10:55,16899775,19597350,2697575,BUY
31-12-20 10:56,10:56,16430825,18557525,2126700,BUY
31-12-20 10:57,10:57,16467575,18712200,2244625,BUY
31-12-20 10:58,10:58,16473125,18520450,2047325,BUY
31-12-20 10:59,10:59,16932375,18603625,1671250,BUY
31-12-20 11:00,11:00,16763400,18489875,1726475,BUY
31-12-20 11:01,11:01,16706500,18744825,2038325,BUY
31-12-20 11:02,11:02,16950275,18711975,1761700,BUY
31-12-20 11:03,11:03,16967825,18996475,2028650,BUY
31-12-20 11:04,11:04,16851025,18878850,2027825,BUY
31-12-20 11:05,11:05,16996750,18792050,1795300,BUY
31-12-20 11:06,11:06,16719525,18361775,1642250,BUY
31-12-20 11:07,11:07,16872300,18619050,1746750,BUY
31-12-20 11:08,11:08,16847425,18537525,1690100,BUY
31-12-20 11:09,11:09,16778675,18694575,1915900,BUY
31-12-20 11:10,11:10,16607075,18249950,1642875,BUY
31-12-20 11:11,11:11,16609150,18924150,2315000,BUY
31-12-20 11:12,11:12,16862600,18917450,2054850,BUY
31-12-20 11:13,11:13,16695200,18080675,1385475,BUY
31-12-20 11:14,11:14,16531400,18793375,2261975,BUY
31-12-20 11:15,11:15,16921775,18682900,1761125,BUY
31-12-20 11:16,11:16,17066925,19247500,2180575,BUY
31-12-20 11:17,11:17,17035525,19212025,2176500,BUY
31-12-20 11:18,11:18,16455200,19007650,2552450,BUY
31-12-20 11:19,11:19,17018450,18731800,1713350,BUY
31-12-20 11:20,11:20,17164550,19015350,1850800,BUY
31-12-20 11:21,11:21,17004700,18393250,1388550,BUY
31-12-20 11:22,11:22,16971275,18793175,1821900,BUY
31-12-20 11:23,11:23,17001775,19090875,2089100,BUY
31-12-20 11:24,11:24,17175625,19119250,1943625,BUY
31-12-20 11:25,11:25,17021350,18914775,1893425,BUY
31-12-20 11:26,11:26,17454375,19699625,2245250,BUY
31-12-20 11:27,11:27,17196700,19617500,2420800,BUY
31-12-20 11:28,11:28,17357450,19236300,1878850,BUY
31-12-20 11:29,11:29,17294975,19592550,2297575,BUY
31-12-20 11:30,11:30,17252000,19638000,2386000,BUY
31-12-20 11:31,11:31,17256325,19489400,2233075,BUY
31-12-20 11:32,11:32,17405450,19169475,1764025,BUY
31-12-20 11:33,11:33,17451900,19030100,1578200,BUY
31-12-20 11:34,11:34,17444825,18995275,1550450,BUY
31-12-20 11:35,11:35,17647475,19688225,2040750,BUY
31-12-20 11:36,11:36,17117775,19603375,2485600,BUY
31-12-20 11:37,11:37,17536575,18408450,871875,BUY
31-12-20 11:38,11:38,17000350,19244450,2244100,BUY
31-12-20 11:39,11:39,17282650,19509375,2226725,BUY
31-12-20 11:40,11:40,17396400,19312025,1915625,BUY
31-12-20 11:41,11:41,17680600,19391225,1710625,BUY
31-12-20 11:42,11:42,17414775,19167075,1752300,BUY
31-12-20 11:43,11:43,17848225,19917850,2069625,BUY
31-12-20 11:44,11:44,17629625,19884775,2255150,BUY
31-12-20 11:45,11:45,17867650,19951200,2083550,BUY
31-12-20 11:46,11:46,17812425,19869625,2057200,BUY
31-12-20 11:47,11:47,17236100,19973875,2737775,BUY
31-12-20 11:48,11:48,17657150,20225625,2568475,BUY
31-12-20 11:49,11:49,17391375,20244500,2853125,BUY
31-12-20 11:50,11:50,17411100,19993900,2582800,BUY
31-12-20 11:51,11:51,17358050,20501125,3143075,BUY
31-12-20 11:52,11:52,17683675,20280225,2596550,BUY
31-12-20 11:53,11:53,17940075,20715150,2775075,BUY
31-12-20 11:54,11:54,17771950,20394550,2622600,BUY
31-12-20 11:55,11:55,17784500,20057150,2272650,BUY
31-12-20 11:56,11:56,17861175,20374800,2513625,BUY
31-12-20 11:57,11:57,17465175,19561975,2096800,BUY
31-12-20 11:58,11:58,17702050,20032675,2330625,BUY
31-12-20 11:59,11:59,17666625,19834150,2167525,BUY
31-12-20 12:00,12:00,17682125,19368750,1686625,BUY
31-12-20 12:01,12:01,17462100,19546200,2084100,BUY
31-12-20 12:02,12:02,17609600,19686175,2076575,BUY
31-12-20 12:03,12:03,17711825,20215350,2503525,BUY
31-12-20 12:04,12:04,17554550,20054175,2499625,BUY
31-12-20 12:05,12:05,17665275,20366725,2701450,BUY
31-12-20 12:06,12:06,17480775,20116175,2635400,BUY
31-12-20 12:07,12:07,17756725,19742000,1985275,BUY
31-12-20 12:08,12:08,17868775,20152475,2283700,BUY
31-12-20 12:09,12:09,17575900,19744800,2168900,BUY
31-12-20 12:10,12:10,17486750,19403500,1916750,BUY
31-12-20 12:11,12:11,17532975,19856525,2323550,BUY
31-12-20 12:12,12:12,17501350,19882750,2381400,BUY
31-12-20 12:13,12:13,17611650,19884925,2273275,BUY
31-12-20 12:14,12:14,17816825,20145500,2328675,BUY
31-12-20 12:15,12:15,17645700,19812075,2166375,BUY
31-12-20 12:16,12:16,17576600,19867925,2291325,BUY
31-12-20 12:17,12:17,17359025,19725650,2366625,BUY
31-12-20 12:18,12:18,17397725,18783275,1385550,BUY
31-12-20 12:19,12:19,17715600,18888375,1172775,BUY
31-12-20 12:20,12:20,17244325,19252025,2007700,BUY
31-12-20 12:21,12:21,17791350,19498050,1706700,BUY
31-12-20 12:22,12:22,17655725,19519225,1863500,BUY
31-12-20 12:23,12:23,17787000,19647000,1860000,BUY
31-12-20 12:24,12:24,17821425,19294350,1472925,BUY
31-12-20 12:25,12:25,17834125,18861675,1027550,BUY
31-12-20 12:26,12:26,17908475,19278150,1369675,BUY
31-12-20 12:27,12:27,17780400,19159975,1379575,BUY
31-12-20 12:28,12:28,17869550,18933375,1063825,BUY
31-12-20 12:29,12:29,17957600,19327225,1369625,BUY
31-12-20 12:30,12:30,18119900,19777700,1657800,BUY
31-12-20 12:31,12:31,18210350,19834700,1624350,BUY
31-12-20 12:32,12:32,18202700,19677750,1475050,BUY
31-12-20 12:33,12:33,17873050,19435500,1562450,BUY
31-12-20 12:34,12:34,17787800,19460400,1672600,BUY
31-12-20 12:35,12:35,17662075,19371325,1709250,BUY
31-12-20 12:36,12:36,17343075,19107975,1764900,BUY
31-12-20 12:37,12:37,17559825,19019675,1459850,BUY
31-12-20 12:38,12:38,17555975,18947875,1391900,BUY
31-12-20 12:39,12:39,17467125,18980475,1513350,BUY
31-12-20 12:40,12:40,17459400,19090700,1631300,BUY
31-12-20 12:41,12:41,17301125,19079425,1778300,BUY
31-12-20 12:42,12:42,17340250,18638500,1298250,BUY
31-12-20 12:43,12:43,17621825,19138750,1516925,BUY
31-12-20 12:44,12:44,17572350,19237675,1665325,BUY
31-12-20 12:45,12:45,17619675,19253450,1633775,BUY
31-12-20 12:46,12:46,17714875,19178350,1463475,BUY
31-12-20 12:47,12:47,17393375,19020475,1627100,BUY
31-12-20 12:48,12:48,17596275,19126700,1530425,BUY
31-12-20 12:49,12:49,17489500,18952600,1463100,BUY
31-12-20 12:50,12:50,17405800,19180875,1775075,BUY
31-12-20 12:51,12:51,17816200,19688800,1872600,BUY
31-12-20 12:52,12:52,17905250,19740700,1835450,BUY
31-12-20 12:53,12:53,17819475,19353350,1533875,BUY
31-12-20 12:54,12:54,17337650,18959050,1621400,BUY
31-12-20 12:55,12:55,17879975,19658425,1778450,BUY
31-12-20 12:56,12:56,17594850,19774700,2179850,BUY
31-12-20 12:57,12:57,17784175,19519450,1735275,BUY
31-12-20 12:58,12:58,17901025,19420650,1519625,BUY
31-12-20 12:59,12:59,17974100,19614225,1640125,BUY
31-12-20 13:00,13:00,17798525,19674750,1876225,BUY
31-12-20 13:01,13:01,17820450,19624050,1803600,BUY
31-12-20 13:02,13:02,17909975,19326850,1416875,BUY
31-12-20 13:03,13:03,17791350,19835825,2044475,BUY
31-12-20 13:04,13:04,17599450,19657000,2057550,BUY
31-12-20 13:05,13:05,17899625,19841850,1942225,BUY
31-12-20 13:06,13:06,17854400,19722850,1868450,BUY
31-12-20 13:07,13:07,17836025,19843400,2007375,BUY
31-12-20 13:08,13:08,17788525,19997450,2208925,BUY
31-12-20 13:09,13:09,17974675,19157450,1182775,BUY
31-12-20 13:10,13:10,17737500,19222300,1484800,BUY
31-12-20 13:11,13:11,17740500,18706900,966400,BUY
31-12-20 13:12,13:12,17710550,19857625,2147075,BUY
31-12-20 13:13,13:13,17603100,20011175,2408075,BUY
31-12-20 13:14,13:14,17700925,19934575,2233650,BUY
31-12-20 13:15,13:15,17750125,20030050,2279925,BUY
31-12-20 13:16,13:16,17708625,20109525,2400900,BUY
31-12-20 13:17,13:17,17802050,19474800,1672750,BUY
31-12-20 13:18,13:18,18303850,20253400,1949550,BUY
31-12-20 13:19,13:19,18120600,19688275,1567675,BUY
31-12-20 13:20,13:20,18076925,20138375,2061450,BUY
31-12-20 13:21,13:21,17913525,19786125,1872600,BUY
31-12-20 13:22,13:22,17680850,19794700,2113850,BUY
31-12-20 13:23,13:23,17763050,20102875,2339825,BUY
31-12-20 13:24,13:24,17625475,19802075,2176600,BUY
31-12-20 13:25,13:25,17722025,20063400,2341375,BUY
31-12-20 13:26,13:26,18033750,20234375,2200625,BUY
31-12-20 13:27,13:27,17566050,20334975,2768925,BUY
31-12-20 13:28,13:28,18223075,20369150,2146075,BUY
31-12-20 13:29,13:29,18238425,20423250,2184825,BUY
31-12-20 13:30,13:30,17946025,20247050,2301025,BUY
31-12-20 13:31,13:31,17935575,20271850,2336275,BUY
31-12-20 13:32,13:32,17875075,20091900,2216825,BUY
31-12-20 13:33,13:33,17735175,20152175,2417000,BUY
31-12-20 13:34,13:34,17428500,19608150,2179650,BUY
31-12-20 13:35,13:35,17642875,20162750,2519875,BUY
31-12-20 13:36,13:36,17928025,20317100,2389075,BUY
31-12-20 13:37,13:37,17835350,20287550,2452200,BUY
31-12-20 13:38,13:38,17890575,20290625,2400050,BUY
31-12-20 13:39,13:39,17629150,20312225,2683075,BUY
31-12-20 13:40,13:40,17581900,20394150,2812250,BUY
31-12-20 13:41,13:41,17784025,20100325,2316300,BUY
31-12-20 13:42,13:42,17843525,20295350,2451825,BUY
31-12-20 13:43,13:43,17832675,19861600,2028925,BUY
31-12-20 13:44,13:44,17810750,19877000,2066250,BUY
31-12-20 13:45,13:45,17822125,20188825,2366700,BUY
31-12-20 13:46,13:46,17649325,20479500,2830175,BUY
31-12-20 13:47,13:47,17716750,20367825,2651075,BUY
31-12-20 13:48,13:48,17591650,20425225,2833575,BUY
31-12-20 13:49,13:49,17459925,20259575,2799650,BUY
31-12-20 13:50,13:50,17860050,20280975,2420925,BUY
31-12-20 13:51,13:51,17894875,20092750,2197875,BUY
31-12-20 13:52,13:52,17628350,20058775,2430425,BUY
31-12-20 13:53,13:53,17680075,20229700,2549625,BUY
31-12-20 13:54,13:54,17819200,20039600,2220400,BUY
31-12-20 13:55,13:55,17879875,20245350,2365475,BUY
31-12-20 13:56,13:56,17757175,19824250,2067075,BUY
31-12-20 13:57,13:57,17426325,20150500,2724175,BUY
31-12-20 13:58,13:58,17552150,20035500,2483350,BUY
31-12-20 13:59,13:59,17440925,19786175,2345250,BUY
31-12-20 14:00,14:00,17426025,20059450,2633425,BUY
31-12-20 14:01,14:01,17547600,19961775,2414175,BUY
31-12-20 14:02,14:02,17491500,20112100,2620600,BUY
31-12-20 14:03,14:03,17426025,20382700,2956675,BUY
31-12-20 14:04,14:04,17397700,19936175,2538475,BUY
31-12-20 14:05,14:05,17247125,20332250,3085125,BUY
31-12-20 14:06,14:06,17103650,20185575,3081925,BUY
31-12-20 14:07,14:07,16941400,19899500,2958100,BUY
31-12-20 14:08,14:08,16941575,19963550,3021975,BUY
31-12-20 14:09,14:09,17231925,20074500,2842575,BUY
31-12-20 14:10,14:10,17427275,20306575,2879300,BUY
31-12-20 14:11,14:11,17414050,20145100,2731050,BUY
31-12-20 14:12,14:12,17188100,19697025,2508925,BUY
31-12-20 14:13,14:13,17119725,19875825,2756100,BUY
31-12-20 14:14,14:14,17388650,20018500,2629850,BUY
31-12-20 14:15,14:15,17427375,20127300,2699925,BUY
31-12-20 14:16,14:16,17271250,20083350,2812100,BUY
31-12-20 14:17,14:17,17257350,19869025,2611675,BUY
31-12-20 14:18,14:18,17208400,19380750,2172350,BUY
31-12-20 14:19,14:19,17235625,19315050,2079425,BUY
31-12-20 14:20,14:20,17067450,18674300,1606850,BUY
31-12-20 14:21,14:21,16913750,19087675,2173925,BUY
31-12-20 14:22,14:22,16846275,19456700,2610425,BUY
31-12-20 14:23,14:23,16766275,18846925,2080650,BUY
31-12-20 14:24,14:24,16934200,19195350,2261150,BUY
31-12-20 14:25,14:25,16996750,18407725,1410975,BUY
31-12-20 14:26,14:26,17032225,18502950,1470725,BUY
31-12-20 14:27,14:27,17032325,19611800,2579475,BUY
31-12-20 14:28,14:28,17049825,19606925,2557100,BUY
31-12-20 14:29,14:29,17024250,19478775,2454525,BUY
31-12-20 14:30,14:30,17068050,19183100,2115050,BUY
31-12-20 14:31,14:31,16805175,19418075,2612900,BUY
31-12-20 14:32,14:32,17055300,19534500,2479200,BUY
31-12-20 14:33,14:33,16970250,19810425,2840175,BUY
31-12-20 14:34,14:34,16871950,19805050,2933100,BUY
31-12-20 14:35,14:35,16845275,19455200,2609925,BUY
31-12-20 14:36,14:36,16622300,19364075,2741775,BUY
31-12-20 14:37,14:37,16784250,19120575,2336325,BUY
31-12-20 14:38,14:38,16773900,18888325,2114425,BUY
31-12-20 14:39,14:39,16650850,19223750,2572900,BUY
31-12-20 14:40,14:40,16695850,19115225,2419375,BUY
31-12-20 14:41,14:41,16849975,18546925,1696950,BUY
31-12-20 14:42,14:42,16865775,19021725,2155950,BUY
31-12-20 14:43,14:43,16769300,18209025,1439725,BUY
31-12-20 14:44,14:44,16600925,18961000,2360075,BUY
31-12-20 14:45,14:45,16904775,18785600,1880825,BUY
31-12-20 14:46,14:46,16649850,18932875,2283025,BUY
31-12-20 14:47,14:47,16884500,18705600,1821100,BUY
31-12-20 14:48,14:48,16893725,19000975,2107250,BUY
31-12-20 14:49,14:49,16749600,18694425,1944825,BUY
31-12-20 14:50,14:50,16723250,18874500,2151250,BUY
31-12-20 14:51,14:51,16901750,19079950,2178200,BUY
31-12-20 14:52,14:52,16739350,18929650,2190300,BUY
31-12-20 14:53,14:53,16812125,18796100,1983975,BUY
31-12-20 14:54,14:54,16805525,18905375,2099850,BUY
31-12-20 14:55,14:55,16617475,18949125,2331650,BUY
31-12-20 14:56,14:56,16741150,18895050,2153900,BUY
31-12-20 14:57,14:57,16945775,19053975,2108200,BUY
31-12-20 14:58,14:58,16851325,18981125,2129800,BUY
31-12-20 14:59,14:59,16685375,18998350,2312975,BUY
31-12-20 15:00,15:00,16692300,19171100,2478800,BUY
31-12-20 15:01,15:01,16588850,19063825,2474975,BUY
31-12-20 15:02,15:02,16542400,18980875,2438475,BUY
31-12-20 15:03,15:03,16283125,18323650,2040525,BUY
31-12-20 15:04,15:04,16176600,18521275,2344675,BUY
31-12-20 15:05,15:05,16437450,17492375,1054925,BUY
31-12-20 15:06,15:06,16506175,17520350,1014175,BUY
31-12-20 15:07,15:07,16484025,17679875,1195850,BUY
31-12-20 15:08,15:08,16426025,17995775,1569750,BUY
31-12-20 15:09,15:09,16170550,18011425,1840875,BUY
31-12-20 15:10,15:10,16246275,17792350,1546075,BUY
31-12-20 15:11,15:11,16203800,17636125,1432325,BUY
31-12-20 15:12,15:12,15809725,17239975,1430250,BUY
31-12-20 15:13,15:13,15748000,17278625,1530625,BUY
31-12-20 15:14,15:14,15926775,17510375,1583600,BUY
31-12-20 15:15,15:15,15725250,16950600,1225350,BUY
31-12-20 15:16,15:16,15653050,17013150,1360100,BUY
31-12-20 15:17,15:17,15731725,17246850,1515125,BUY
31-12-20 15:18,15:18,15436450,16255975,819525,BUY
31-12-20 15:19,15:19,15333750,16068925,735175,BUY
31-12-20 15:20,15:20,15321125,16446450,1125325,BUY
31-12-20 15:21,15:21,14700500,15439225,738725,BUY
31-12-20 15:22,15:22,14679950,15427925,747975,BUY
31-12-20 15:23,15:23,14722725,15804725,1082000,BUY
31-12-20 15:24,15:24,14322475,14333450,10975,BUY
31-12-20 15:25,15:25,14386100,14564300,178200,BUY
31-12-20 15:26,15:26,14099600,14206825,107225,BUY
31-12-20 15:27,15:27,13714100,13307625,-406475,SELL
31-12-20 15:28,15:28,13666975,13633325,-33650,SELL
31-12-20 15:29,15:29,13582425,14256200,673775,BUY
