,timestamp,call,put,diff,sellOrBuy
2020-11-27 09:15:00,09:15,3926775,3091825,-834950,SELL
2020-11-27 09:16:00,09:16,3899350,3091100,-808250,SELL
2020-11-27 09:17:00,09:17,4365300,3457700,-907600,SELL
2020-11-27 09:18:00,09:18,4375100,3457500,-917600,SELL
2020-11-27 09:19:00,09:19,4364725,3456275,-908450,SELL
2020-11-27 09:20:00,09:20,4768275,3902500,-865775,SELL
2020-11-27 09:21:00,09:21,4771525,3902500,-869025,SELL
2020-11-27 09:22:00,09:22,4772875,3904150,-868725,SELL
2020-11-27 09:23:00,09:23,5015075,4184800,-830275,SELL
2020-11-27 09:24:00,09:24,5038150,4194925,-843225,SELL
2020-11-27 09:25:00,09:25,5039675,4198350,-841325,SELL
2020-11-27 09:26:00,09:26,5224075,4359450,-864625,SELL
2020-11-27 09:27:00,09:27,5254850,4359750,-895100,SELL
2020-11-27 09:28:00,09:28,5246325,4362175,-884150,SELL
2020-11-27 09:29:00,09:29,5456800,4564350,-892450,SELL
2020-11-27 09:30:00,09:30,5439800,4563000,-876800,SELL
2020-11-27 09:31:00,09:31,5454900,4563875,-891025,SELL
2020-11-27 09:32:00,09:32,5648200,4720675,-927525,SELL
2020-11-27 09:33:00,09:33,5605500,4718650,-886850,SELL
2020-11-27 09:34:00,09:34,5658425,4720425,-938000,SELL
2020-11-27 09:35:00,09:35,5845725,4740925,-1104800,SELL
2020-11-27 09:36:00,09:36,5843350,4747300,-1096050,SELL
2020-11-27 09:37:00,09:37,5800600,4748775,-1051825,SELL
2020-11-27 09:38:00,09:38,6023500,4817800,-1205700,SELL
2020-11-27 09:39:00,09:39,6023325,4838550,-1184775,SELL
2020-11-27 09:40:00,09:40,6011225,4826550,-1184675,SELL
2020-11-27 09:41:00,09:41,6132025,4852625,-1279400,SELL
2020-11-27 09:42:00,09:42,6153125,4857900,-1295225,SELL
2020-11-27 09:43:00,09:43,6137275,4845125,-1292150,SELL
2020-11-27 09:44:00,09:44,6257450,4841900,-1415550,SELL
2020-11-27 09:45:00,09:45,6241425,4834075,-1407350,SELL
2020-11-27 09:46:00,09:46,6266300,4845525,-1420775,SELL
2020-11-27 09:47:00,09:47,6399600,4925425,-1474175,SELL
2020-11-27 09:48:00,09:48,6409275,4936375,-1472900,SELL
2020-11-27 09:49:00,09:49,6384175,4926850,-1457325,SELL
2020-11-27 09:50:00,09:50,6495700,5004200,-1491500,SELL
2020-11-27 09:51:00,09:51,6508050,5008475,-1499575,SELL
2020-11-27 09:52:00,09:52,6514175,5009475,-1504700,SELL
2020-11-27 09:53:00,09:53,6364600,5025325,-1339275,SELL
2020-11-27 09:54:00,09:54,6353300,5023775,-1329525,SELL
2020-11-27 09:55:00,09:55,6351725,5029525,-1322200,SELL
2020-11-27 09:56:00,09:56,6403950,5085225,-1318725,SELL
2020-11-27 09:57:00,09:57,6359875,5091700,-1268175,SELL
2020-11-27 09:58:00,09:58,6406100,5086825,-1319275,SELL
2020-11-27 09:59:00,09:59,6455850,5158675,-1297175,SELL
2020-11-27 10:00:00,10:00,6455725,5175975,-1279750,SELL
2020-11-27 10:01:00,10:01,6447825,5157900,-1289925,SELL
2020-11-27 10:02:00,10:02,6514450,5223925,-1290525,SELL
2020-11-27 10:03:00,10:03,6505450,5217225,-1288225,SELL
2020-11-27 10:04:00,10:04,6472450,5210325,-1262125,SELL
2020-11-27 10:05:00,10:05,6523250,5284125,-1239125,SELL
2020-11-27 10:06:00,10:06,6540150,5265775,-1274375,SELL
2020-11-27 10:07:00,10:07,6540150,5275700,-1264450,SELL
2020-11-27 10:08:00,10:08,6627100,5368025,-1259075,SELL
2020-11-27 10:09:00,10:09,6628875,5366550,-1262325,SELL
2020-11-27 10:10:00,10:10,6635775,5368025,-1267750,SELL
2020-11-27 10:11:00,10:11,6614825,5371975,-1242850,SELL
2020-11-27 10:12:00,10:12,6658075,5369775,-1288300,SELL
2020-11-27 10:13:00,10:13,6614850,5381950,-1232900,SELL
2020-11-27 10:14:00,10:14,6655425,5418775,-1236650,SELL
2020-11-27 10:15:00,10:15,6714700,5420925,-1293775,SELL
2020-11-27 10:16:00,10:16,6688675,5421750,-1266925,SELL
2020-11-27 10:17:00,10:17,6758650,5483925,-1274725,SELL
2020-11-27 10:18:00,10:18,6715225,5485675,-1229550,SELL
2020-11-27 10:19:00,10:19,6771150,5483825,-1287325,SELL
2020-11-27 10:20:00,10:20,6782100,5516050,-1266050,SELL
2020-11-27 10:21:00,10:21,6763125,5503625,-1259500,SELL
2020-11-27 10:22:00,10:22,6765125,5510875,-1254250,SELL
2020-11-27 10:23:00,10:23,6766250,5560250,-1206000,SELL
2020-11-27 10:24:00,10:24,6812600,5548550,-1264050,SELL
2020-11-27 10:25:00,10:25,6820300,5572575,-1247725,SELL
2020-11-27 10:26:00,10:26,6794725,5585675,-1209050,SELL
2020-11-27 10:27:00,10:27,6830575,5575000,-1255575,SELL
2020-11-27 10:28:00,10:28,6781425,5571850,-1209575,SELL
2020-11-27 10:29:00,10:29,6831175,5628150,-1203025,SELL
2020-11-27 10:30:00,10:30,6819875,5625925,-1193950,SELL
2020-11-27 10:31:00,10:31,6837500,5617775,-1219725,SELL
2020-11-27 10:32:00,10:32,6872275,5619000,-1253275,SELL
2020-11-27 10:33:00,10:33,6906375,5631475,-1274900,SELL
2020-11-27 10:34:00,10:34,6855450,5616825,-1238625,SELL
2020-11-27 10:35:00,10:35,6886425,5618850,-1267575,SELL
2020-11-27 10:36:00,10:36,6915025,5632225,-1282800,SELL
2020-11-27 10:37:00,10:37,6916775,5635700,-1281075,SELL
2020-11-27 10:38:00,10:38,6934975,5626000,-1308975,SELL
2020-11-27 10:39:00,10:39,6944150,5646200,-1297950,SELL
2020-11-27 10:40:00,10:40,6921450,5626100,-1295350,SELL
2020-11-27 10:41:00,10:41,6987575,5654325,-1333250,SELL
2020-11-27 10:42:00,10:42,6976025,5663400,-1312625,SELL
2020-11-27 10:43:00,10:43,7047050,5691275,-1355775,SELL
2020-11-27 10:44:00,10:44,7066700,5684150,-1382550,SELL
2020-11-27 10:45:00,10:45,7108825,5705150,-1403675,SELL
2020-11-27 10:46:00,10:46,7085875,5657975,-1427900,SELL
2020-11-27 10:47:00,10:47,7055600,5749400,-1306200,SELL
2020-11-27 10:48:00,10:48,7035400,5730200,-1305200,SELL
2020-11-27 10:49:00,10:49,7080700,5731425,-1349275,SELL
2020-11-27 10:50:00,10:50,7056100,5774875,-1281225,SELL
2020-11-27 10:51:00,10:51,7079250,5742150,-1337100,SELL
2020-11-27 10:52:00,10:52,7077125,5753200,-1323925,SELL
2020-11-27 10:53:00,10:53,7076325,5752075,-1324250,SELL
2020-11-27 10:54:00,10:54,7129375,5761700,-1367675,SELL
2020-11-27 10:55:00,10:55,7104775,5775125,-1329650,SELL
2020-11-27 10:56:00,10:56,7085650,5768550,-1317100,SELL
2020-11-27 10:57:00,10:57,7090475,5772400,-1318075,SELL
2020-11-27 10:58:00,10:58,7061150,5759475,-1301675,SELL
2020-11-27 10:59:00,10:59,7118025,5779950,-1338075,SELL
2020-11-27 11:00:00,11:00,7095225,5766750,-1328475,SELL
2020-11-27 11:01:00,11:01,7101125,5769225,-1331900,SELL
2020-11-27 11:02:00,11:02,7136975,5830975,-1306000,SELL
2020-11-27 11:03:00,11:03,7124325,5817100,-1307225,SELL
2020-11-27 11:04:00,11:04,7116275,5789800,-1326475,SELL
2020-11-27 11:05:00,11:05,7155100,5841600,-1313500,SELL
2020-11-27 11:06:00,11:06,7200225,5818725,-1381500,SELL
2020-11-27 11:07:00,11:07,7152975,5829575,-1323400,SELL
2020-11-27 11:08:00,11:08,7195400,5853000,-1342400,SELL
2020-11-27 11:09:00,11:09,7174075,5821150,-1352925,SELL
2020-11-27 11:10:00,11:10,7241025,5867875,-1373150,SELL
2020-11-27 11:11:00,11:11,7258025,5804800,-1453225,SELL
2020-11-27 11:12:00,11:12,7225425,5821450,-1403975,SELL
2020-11-27 11:13:00,11:13,7238325,5817800,-1420525,SELL
2020-11-27 11:14:00,11:14,7206600,5819725,-1386875,SELL
2020-11-27 11:15:00,11:15,7233850,5823200,-1410650,SELL
2020-11-27 11:16:00,11:16,7216925,5811750,-1405175,SELL
2020-11-27 11:17:00,11:17,7230825,5837325,-1393500,SELL
2020-11-27 11:18:00,11:18,7170400,5801400,-1369000,SELL
2020-11-27 11:19:00,11:19,7196075,5810300,-1385775,SELL
2020-11-27 11:20:00,11:20,7240475,5834575,-1405900,SELL
2020-11-27 11:21:00,11:21,7236625,5828925,-1407700,SELL
2020-11-27 11:22:00,11:22,7176725,5713800,-1462925,SELL
2020-11-27 11:23:00,11:23,7214650,5834875,-1379775,SELL
2020-11-27 11:24:00,11:24,7267675,5845350,-1422325,SELL
2020-11-27 11:25:00,11:25,7276025,5865925,-1410100,SELL
2020-11-27 11:26:00,11:26,7293175,5828650,-1464525,SELL
2020-11-27 11:27:00,11:27,7294425,5851650,-1442775,SELL
2020-11-27 11:28:00,11:28,7268600,5827300,-1441300,SELL
2020-11-27 11:29:00,11:29,7284800,5872550,-1412250,SELL
2020-11-27 11:30:00,11:30,7280100,5860775,-1419325,SELL
2020-11-27 11:31:00,11:31,7310875,5861850,-1449025,SELL
2020-11-27 11:32:00,11:32,7287550,5890900,-1396650,SELL
2020-11-27 11:33:00,11:33,7329475,5898700,-1430775,SELL
2020-11-27 11:34:00,11:34,7346400,5891750,-1454650,SELL
2020-11-27 11:35:00,11:35,7294150,5899625,-1394525,SELL
2020-11-27 11:36:00,11:36,7301275,5886800,-1414475,SELL
2020-11-27 11:37:00,11:37,7313600,5888150,-1425450,SELL
2020-11-27 11:38:00,11:38,7284275,5931225,-1353050,SELL
2020-11-27 11:39:00,11:39,7261325,5914700,-1346625,SELL
2020-11-27 11:40:00,11:40,7232575,5914450,-1318125,SELL
2020-11-27 11:41:00,11:41,7243925,5867800,-1376125,SELL
2020-11-27 11:42:00,11:42,7185075,5866575,-1318500,SELL
2020-11-27 11:43:00,11:43,7192425,5860350,-1332075,SELL
2020-11-27 11:44:00,11:44,7257875,5858475,-1399400,SELL
2020-11-27 11:45:00,11:45,7305650,5876050,-1429600,SELL
2020-11-27 11:46:00,11:46,7279250,5866825,-1412425,SELL
2020-11-27 11:47:00,11:47,7311275,5927225,-1384050,SELL
2020-11-27 11:48:00,11:48,7287000,5926025,-1360975,SELL
2020-11-27 11:49:00,11:49,7256375,5913525,-1342850,SELL
2020-11-27 11:50:00,11:50,7349925,5901900,-1448025,SELL
2020-11-27 11:51:00,11:51,7343975,5911075,-1432900,SELL
2020-11-27 11:52:00,11:52,7350200,5932425,-1417775,SELL
2020-11-27 11:53:00,11:53,7392950,5955500,-1437450,SELL
2020-11-27 11:54:00,11:54,7392950,5968575,-1424375,SELL
2020-11-27 11:55:00,11:55,7402450,5960300,-1442150,SELL
2020-11-27 11:56:00,11:56,7416325,5971250,-1445075,SELL
2020-11-27 11:57:00,11:57,7430625,5990800,-1439825,SELL
2020-11-27 11:58:00,11:58,7469450,5994650,-1474800,SELL
2020-11-27 11:59:00,11:59,7456550,6043250,-1413300,SELL
2020-11-27 12:00:00,12:00,7504725,6082750,-1421975,SELL
2020-11-27 12:01:00,12:01,7499975,6075450,-1424525,SELL
2020-11-27 12:02:00,12:02,7497500,6100200,-1397300,SELL
2020-11-27 12:03:00,12:03,7484025,6094350,-1389675,SELL
2020-11-27 12:04:00,12:04,7447225,6086500,-1360725,SELL
2020-11-27 12:05:00,12:05,7458475,6114100,-1344375,SELL
2020-11-27 12:06:00,12:06,7476575,6122225,-1354350,SELL
2020-11-27 12:07:00,12:07,7475225,6120325,-1354900,SELL
2020-11-27 12:08:00,12:08,7504150,6149975,-1354175,SELL
2020-11-27 12:09:00,12:09,7501625,6140825,-1360800,SELL
2020-11-27 12:10:00,12:10,7525750,6136800,-1388950,SELL
2020-11-27 12:11:00,12:11,7488800,6154925,-1333875,SELL
2020-11-27 12:12:00,12:12,7516375,6154175,-1362200,SELL
2020-11-27 12:13:00,12:13,7489525,6168050,-1321475,SELL
2020-11-27 12:14:00,12:14,7484550,6171400,-1313150,SELL
2020-11-27 12:15:00,12:15,7512100,6211150,-1300950,SELL
2020-11-27 12:16:00,12:16,7519175,6182800,-1336375,SELL
2020-11-27 12:17:00,12:17,7518050,6212600,-1305450,SELL
2020-11-27 12:18:00,12:18,7536575,6220700,-1315875,SELL
2020-11-27 12:19:00,12:19,7570975,6219325,-1351650,SELL
2020-11-27 12:20:00,12:20,7535600,6206475,-1329125,SELL
2020-11-27 12:21:00,12:21,7482400,6193625,-1288775,SELL
2020-11-27 12:22:00,12:22,7500675,6155200,-1345475,SELL
2020-11-27 12:23:00,12:23,7503675,6257475,-1246200,SELL
2020-11-27 12:24:00,12:24,7527325,6257125,-1270200,SELL
2020-11-27 12:25:00,12:25,7532475,6251250,-1281225,SELL
2020-11-27 12:26:00,12:26,7517725,6267200,-1250525,SELL
2020-11-27 12:27:00,12:27,7487825,6266350,-1221475,SELL
2020-11-27 12:28:00,12:28,7496575,6270450,-1226125,SELL
2020-11-27 12:29:00,12:29,7448475,6251625,-1196850,SELL
2020-11-27 12:30:00,12:30,7448375,6255725,-1192650,SELL
2020-11-27 12:31:00,12:31,7464675,6257450,-1207225,SELL
2020-11-27 12:32:00,12:32,7426875,6285425,-1141450,SELL
2020-11-27 12:33:00,12:33,7428575,6296625,-1131950,SELL
2020-11-27 12:34:00,12:34,7436600,6297375,-1139225,SELL
2020-11-27 12:35:00,12:35,7446775,6348625,-1098150,SELL
2020-11-27 12:36:00,12:36,7444600,6336950,-1107650,SELL
2020-11-27 12:37:00,12:37,7396075,6325675,-1070400,SELL
2020-11-27 12:38:00,12:38,7387300,6340250,-1047050,SELL
2020-11-27 12:39:00,12:39,7453175,6344500,-1108675,SELL
2020-11-27 12:40:00,12:40,7418075,6338050,-1080025,SELL
2020-11-27 12:41:00,12:41,7469075,6348325,-1120750,SELL
2020-11-27 12:42:00,12:42,7471275,6359650,-1111625,SELL
2020-11-27 12:43:00,12:43,7452125,6347525,-1104600,SELL
2020-11-27 12:44:00,12:44,7494200,6342225,-1151975,SELL
2020-11-27 12:45:00,12:45,7492975,6344650,-1148325,SELL
2020-11-27 12:46:00,12:46,7459625,6332250,-1127375,SELL
2020-11-27 12:47:00,12:47,7435300,6333400,-1101900,SELL
2020-11-27 12:48:00,12:48,7453350,6332325,-1121025,SELL
2020-11-27 12:49:00,12:49,7410100,6317750,-1092350,SELL
2020-11-27 12:50:00,12:50,7428975,6347000,-1081975,SELL
2020-11-27 12:51:00,12:51,7485550,6352550,-1133000,SELL
2020-11-27 12:52:00,12:52,7486225,6345250,-1140975,SELL
2020-11-27 12:53:00,12:53,7384900,6269125,-1115775,SELL
2020-11-27 12:54:00,12:54,7408100,6271025,-1137075,SELL
2020-11-27 12:55:00,12:55,7433900,6286225,-1147675,SELL
2020-11-27 12:56:00,12:56,7480050,6277875,-1202175,SELL
2020-11-27 12:57:00,12:57,7452275,6282550,-1169725,SELL
2020-11-27 12:58:00,12:58,7449050,6270925,-1178125,SELL
2020-11-27 12:59:00,12:59,7411175,6280925,-1130250,SELL
2020-11-27 13:00:00,13:00,7421250,6273275,-1147975,SELL
2020-11-27 13:01:00,13:01,7393550,6242050,-1151500,SELL
2020-11-27 13:02:00,13:02,7441875,6266525,-1175350,SELL
2020-11-27 13:03:00,13:03,7470825,6295500,-1175325,SELL
2020-11-27 13:04:00,13:04,7443750,6296375,-1147375,SELL
2020-11-27 13:05:00,13:05,7459450,6235475,-1223975,SELL
2020-11-27 13:06:00,13:06,7435425,6251700,-1183725,SELL
2020-11-27 13:07:00,13:07,7452350,6252225,-1200125,SELL
2020-11-27 13:08:00,13:08,7494100,6238225,-1255875,SELL
2020-11-27 13:09:00,13:09,7470850,6267875,-1202975,SELL
2020-11-27 13:10:00,13:10,7449050,6236800,-1212250,SELL
2020-11-27 13:11:00,13:11,7468150,6246525,-1221625,SELL
2020-11-27 13:12:00,13:12,7444700,6281500,-1163200,SELL
2020-11-27 13:13:00,13:13,7486750,6260950,-1225800,SELL
2020-11-27 13:14:00,13:14,7568675,6245075,-1323600,SELL
2020-11-27 13:15:00,13:15,7569575,6236300,-1333275,SELL
2020-11-27 13:16:00,13:16,7530075,6234375,-1295700,SELL
2020-11-27 13:17:00,13:17,7567900,6180850,-1387050,SELL
2020-11-27 13:18:00,13:18,7576175,6197150,-1379025,SELL
2020-11-27 13:19:00,13:19,7551700,6192800,-1358900,SELL
2020-11-27 13:20:00,13:20,7628300,6187150,-1441150,SELL
2020-11-27 13:21:00,13:21,7646025,6202175,-1443850,SELL
2020-11-27 13:22:00,13:22,7600900,6199975,-1400925,SELL
2020-11-27 13:23:00,13:23,7636250,6188550,-1447700,SELL
2020-11-27 13:24:00,13:24,7627275,6229875,-1397400,SELL
2020-11-27 13:25:00,13:25,7683650,6248275,-1435375,SELL
2020-11-27 13:26:00,13:26,7588750,6221300,-1367450,SELL
2020-11-27 13:27:00,13:27,7695150,6258275,-1436875,SELL
2020-11-27 13:28:00,13:28,7644900,6253650,-1391250,SELL
2020-11-27 13:29:00,13:29,7651625,6249250,-1402375,SELL
2020-11-27 13:30:00,13:30,7702650,6228425,-1474225,SELL
2020-11-27 13:31:00,13:31,7657150,6221875,-1435275,SELL
2020-11-27 13:32:00,13:32,7711150,6237625,-1473525,SELL
2020-11-27 13:33:00,13:33,7759375,6244075,-1515300,SELL
2020-11-27 13:34:00,13:34,7755300,6251950,-1503350,SELL
2020-11-27 13:35:00,13:35,7736350,6237200,-1499150,SELL
2020-11-27 13:36:00,13:36,7794425,6272725,-1521700,SELL
2020-11-27 13:37:00,13:37,7800775,6272425,-1528350,SELL
2020-11-27 13:38:00,13:38,7778150,6270525,-1507625,SELL
2020-11-27 13:39:00,13:39,7694675,6181425,-1513250,SELL
2020-11-27 13:40:00,13:40,7713875,6189350,-1524525,SELL
2020-11-27 13:41:00,13:41,7660800,6189350,-1471450,SELL
2020-11-27 13:42:00,13:42,7662225,6192025,-1470200,SELL
2020-11-27 13:43:00,13:43,7669350,6195675,-1473675,SELL
2020-11-27 13:44:00,13:44,7664775,6183075,-1481700,SELL
2020-11-27 13:45:00,13:45,7670850,6212975,-1457875,SELL
2020-11-27 13:46:00,13:46,7716675,6221675,-1495000,SELL
2020-11-27 13:47:00,13:47,7714875,6219375,-1495500,SELL
2020-11-27 13:48:00,13:48,7696225,6238925,-1457300,SELL
2020-11-27 13:49:00,13:49,7674475,6238025,-1436450,SELL
2020-11-27 13:50:00,13:50,7688775,6243050,-1445725,SELL
2020-11-27 13:51:00,13:51,7639100,6278525,-1360575,SELL
2020-11-27 13:52:00,13:52,7622800,6272275,-1350525,SELL
2020-11-27 13:53:00,13:53,7650550,6255175,-1395375,SELL
2020-11-27 13:54:00,13:54,7708800,6282025,-1426775,SELL
2020-11-27 13:55:00,13:55,7684150,6275775,-1408375,SELL
2020-11-27 13:56:00,13:56,7681925,6275775,-1406150,SELL
2020-11-27 13:57:00,13:57,7662400,6273500,-1388900,SELL
2020-11-27 13:58:00,13:58,7688000,6268250,-1419750,SELL
2020-11-27 13:59:00,13:59,7697650,6250650,-1447000,SELL
2020-11-27 14:00:00,14:00,7670825,6285600,-1385225,SELL
2020-11-27 14:01:00,14:01,7696975,6265600,-1431375,SELL
2020-11-27 14:02:00,14:02,7678075,6307250,-1370825,SELL
2020-11-27 14:03:00,14:03,7714575,6282900,-1431675,SELL
2020-11-27 14:04:00,14:04,7694675,6270625,-1424050,SELL
2020-11-27 14:05:00,14:05,7667075,6270150,-1396925,SELL
2020-11-27 14:06:00,14:06,7710400,6270350,-1440050,SELL
2020-11-27 14:07:00,14:07,7736050,6288450,-1447600,SELL
2020-11-27 14:08:00,14:08,7699000,6279975,-1419025,SELL
2020-11-27 14:09:00,14:09,7703475,6297375,-1406100,SELL
2020-11-27 14:10:00,14:10,7723750,6308775,-1414975,SELL
2020-11-27 14:11:00,14:11,7755050,6291325,-1463725,SELL
2020-11-27 14:12:00,14:12,7724175,6274125,-1450050,SELL
2020-11-27 14:13:00,14:13,7730475,6286450,-1444025,SELL
2020-11-27 14:14:00,14:14,7673425,6282425,-1391000,SELL
2020-11-27 14:15:00,14:15,7726850,6300400,-1426450,SELL
2020-11-27 14:16:00,14:16,7717500,6257825,-1459675,SELL
2020-11-27 14:17:00,14:17,7685275,6276475,-1408800,SELL
2020-11-27 14:18:00,14:18,7671500,6293450,-1378050,SELL
2020-11-27 14:19:00,14:19,7652800,6305850,-1346950,SELL
2020-11-27 14:20:00,14:20,7706750,6318675,-1388075,SELL
2020-11-27 14:21:00,14:21,7660550,6276600,-1383950,SELL
2020-11-27 14:22:00,14:22,7677300,6316850,-1360450,SELL
2020-11-27 14:23:00,14:23,7641125,6279800,-1361325,SELL
2020-11-27 14:24:00,14:24,7583600,6307025,-1276575,SELL
2020-11-27 14:25:00,14:25,7662675,6275850,-1386825,SELL
2020-11-27 14:26:00,14:26,7637550,6289225,-1348325,SELL
2020-11-27 14:27:00,14:27,7540325,6272325,-1268000,SELL
2020-11-27 14:28:00,14:28,7572075,6273275,-1298800,SELL
2020-11-27 14:29:00,14:29,7544200,6273600,-1270600,SELL
2020-11-27 14:30:00,14:30,7451650,6259925,-1191725,SELL
2020-11-27 14:31:00,14:31,7407450,6231875,-1175575,SELL
2020-11-27 14:32:00,14:32,7407450,6254450,-1153000,SELL
2020-11-27 14:33:00,14:33,7455700,6240825,-1214875,SELL
2020-11-27 14:34:00,14:34,7373650,6216100,-1157550,SELL
2020-11-27 14:35:00,14:35,7411500,6219900,-1191600,SELL
2020-11-27 14:36:00,14:36,7436975,6229975,-1207000,SELL
2020-11-27 14:37:00,14:37,7422800,6228625,-1194175,SELL
2020-11-27 14:38:00,14:38,7437675,6244200,-1193475,SELL
2020-11-27 14:39:00,14:39,7412025,6201450,-1210575,SELL
2020-11-27 14:40:00,14:40,7419375,6209450,-1209925,SELL
2020-11-27 14:41:00,14:41,7412250,6209450,-1202800,SELL
2020-11-27 14:42:00,14:42,7386900,6219700,-1167200,SELL
2020-11-27 14:43:00,14:43,7419975,6240625,-1179350,SELL
2020-11-27 14:44:00,14:44,7422025,6243350,-1178675,SELL
2020-11-27 14:45:00,14:45,7458925,6163150,-1295775,SELL
2020-11-27 14:46:00,14:46,7458175,6162900,-1295275,SELL
2020-11-27 14:47:00,14:47,7445925,6161950,-1283975,SELL
2020-11-27 14:48:00,14:48,7320200,5984875,-1335325,SELL
2020-11-27 14:49:00,14:49,7324125,5985450,-1338675,SELL
2020-11-27 14:50:00,14:50,7324750,5981025,-1343725,SELL
2020-11-27 14:51:00,14:51,7167850,5937575,-1230275,SELL
2020-11-27 14:52:00,14:52,7142775,5925450,-1217325,SELL
2020-11-27 14:53:00,14:53,7199175,5939775,-1259400,SELL
2020-11-27 14:54:00,14:54,7164975,5901275,-1263700,SELL
2020-11-27 14:55:00,14:55,7161875,5901275,-1260600,SELL
2020-11-27 14:56:00,14:56,7169700,5907075,-1262625,SELL
2020-11-27 14:57:00,14:57,7069050,5858225,-1210825,SELL
2020-11-27 14:58:00,14:58,7062225,5850850,-1211375,SELL
2020-11-27 14:59:00,14:59,7066850,5884575,-1182275,SELL
2020-11-27 15:00:00,15:00,7007850,5897825,-1110025,SELL
2020-11-27 15:01:00,15:01,7016575,5905575,-1111000,SELL
2020-11-27 15:02:00,15:02,7001050,5875275,-1125775,SELL
2020-11-27 15:03:00,15:03,6873925,5773875,-1100050,SELL
2020-11-27 15:04:00,15:04,6905150,5773875,-1131275,SELL
2020-11-27 15:05:00,15:05,6907275,5772675,-1134600,SELL
2020-11-27 15:06:00,15:06,6749000,5766200,-982800,SELL
2020-11-27 15:07:00,15:07,6775075,5768450,-1006625,SELL
2020-11-27 15:08:00,15:08,6773475,5768450,-1005025,SELL
2020-11-27 15:09:00,15:09,6748000,5790450,-957550,SELL
2020-11-27 15:10:00,15:10,6721675,5787375,-934300,SELL
2020-11-27 15:11:00,15:11,6740250,5786800,-953450,SELL
2020-11-27 15:12:00,15:12,6644075,5730250,-913825,SELL
2020-11-27 15:13:00,15:13,6611875,5706075,-905800,SELL
2020-11-27 15:14:00,15:14,6605025,5706850,-898175,SELL
2020-11-27 15:15:00,15:15,6576450,5622750,-953700,SELL
2020-11-27 15:16:00,15:16,6549875,5646975,-902900,SELL
2020-11-27 15:17:00,15:17,6557825,5642575,-915250,SELL
2020-11-27 15:18:00,15:18,6482125,5584900,-897225,SELL
2020-11-27 15:19:00,15:19,6472875,5584300,-888575,SELL
2020-11-27 15:20:00,15:20,6493900,5589150,-904750,SELL
2020-11-27 15:21:00,15:21,6372325,5477075,-895250,SELL
2020-11-27 15:22:00,15:22,6367525,5470700,-896825,SELL
2020-11-27 15:23:00,15:23,6362350,5476675,-885675,SELL
2020-11-27 15:24:00,15:24,6276550,5353175,-923375,SELL
2020-11-27 15:25:00,15:25,6308625,5357650,-950975,SELL
2020-11-27 15:26:00,15:26,6303950,5332375,-971575,SELL
2020-11-27 15:27:00,15:27,6229125,5258675,-970450,SELL
2020-11-27 15:28:00,15:28,6202475,5254850,-947625,SELL
2020-11-27 15:29:00,15:29,6222500,5258625,-963875,SELL
2020-12-01 09:15:00,09:15,5949925,5204325,-745600,SELL
2020-12-01 09:16:00,09:16,5962850,5210625,-752225,SELL
2020-12-01 09:17:00,09:17,6451650,5700550,-751100,SELL
2020-12-01 09:18:00,09:18,6471900,5701800,-770100,SELL
2020-12-01 09:19:00,09:19,6465625,5699675,-765950,SELL
2020-12-01 09:20:00,09:20,7024225,6292125,-732100,SELL
2020-12-01 09:21:00,09:21,7022725,6292125,-730600,SELL
2020-12-01 09:22:00,09:22,7015975,6297425,-718550,SELL
2020-12-01 09:23:00,09:23,7451925,6580325,-871600,SELL
2020-12-01 09:24:00,09:24,7479750,6576200,-903550,SELL
2020-12-01 09:25:00,09:25,7479700,6580325,-899375,SELL
2020-12-01 09:26:00,09:26,7751725,6759750,-991975,SELL
2020-12-01 09:27:00,09:27,7768275,6761250,-1007025,SELL
2020-12-01 09:28:00,09:28,7753300,6762700,-990600,SELL
2020-12-01 09:29:00,09:29,7885300,6907650,-977650,SELL
2020-12-01 09:30:00,09:30,7937975,6915150,-1022825,SELL
2020-12-01 09:31:00,09:31,7913150,6881625,-1031525,SELL
2020-12-01 09:32:00,09:32,7987000,7025250,-961750,SELL
2020-12-01 09:33:00,09:33,8008025,7029225,-978800,SELL
2020-12-01 09:34:00,09:34,7988350,6990850,-997500,SELL
2020-12-01 09:35:00,09:35,8018600,7059350,-959250,SELL
2020-12-01 09:36:00,09:36,8018600,7039800,-978800,SELL
2020-12-01 09:37:00,09:37,7995325,7061725,-933600,SELL
2020-12-01 09:38:00,09:38,8106075,7171325,-934750,SELL
2020-12-01 09:39:00,09:39,8142200,7191050,-951150,SELL
2020-12-01 09:40:00,09:40,8149400,7193050,-956350,SELL
2020-12-01 09:41:00,09:41,8202450,7346875,-855575,SELL
2020-12-01 09:42:00,09:42,8233850,7318925,-914925,SELL
2020-12-01 09:43:00,09:43,8217325,7330525,-886800,SELL
2020-12-01 09:44:00,09:44,8336400,7468525,-867875,SELL
2020-12-01 09:45:00,09:45,8342250,7468525,-873725,SELL
2020-12-01 09:46:00,09:46,8360500,7441875,-918625,SELL
2020-12-01 09:47:00,09:47,8504475,7582675,-921800,SELL
2020-12-01 09:48:00,09:48,8465050,7588200,-876850,SELL
2020-12-01 09:49:00,09:49,8490600,7576750,-913850,SELL
2020-12-01 09:50:00,09:50,8593150,7703350,-889800,SELL
2020-12-01 09:51:00,09:51,8580525,7690225,-890300,SELL
2020-12-01 09:52:00,09:52,8616825,7703350,-913475,SELL
2020-12-01 09:53:00,09:53,8597925,7744475,-853450,SELL
2020-12-01 09:54:00,09:54,8590825,7730500,-860325,SELL
2020-12-01 09:55:00,09:55,8598400,7748100,-850300,SELL
2020-12-01 09:56:00,09:56,8586600,7836100,-750500,SELL
2020-12-01 09:57:00,09:57,8632225,7852100,-780125,SELL
2020-12-01 09:58:00,09:58,8574050,7849400,-724650,SELL
2020-12-01 09:59:00,09:59,8704500,7955075,-749425,SELL
2020-12-01 10:00:00,10:00,8712350,7967700,-744650,SELL
2020-12-01 10:01:00,10:01,8735050,7929050,-806000,SELL
2020-12-01 10:02:00,10:02,8807575,8060425,-747150,SELL
2020-12-01 10:03:00,10:03,8785775,8055350,-730425,SELL
2020-12-01 10:04:00,10:04,8785775,8027975,-757800,SELL
2020-12-01 10:05:00,10:05,8899775,8117775,-782000,SELL
2020-12-01 10:06:00,10:06,8883500,8098350,-785150,SELL
2020-12-01 10:07:00,10:07,8849325,8069450,-779875,SELL
2020-12-01 10:08:00,10:08,9043650,8146125,-897525,SELL
2020-12-01 10:09:00,10:09,9100950,8155750,-945200,SELL
2020-12-01 10:10:00,10:10,9115275,8152850,-962425,SELL
2020-12-01 10:11:00,10:11,9189875,8233175,-956700,SELL
2020-12-01 10:12:00,10:12,9222675,8236075,-986600,SELL
2020-12-01 10:13:00,10:13,9173600,8245850,-927750,SELL
2020-12-01 10:14:00,10:14,9200025,8205100,-994925,SELL
2020-12-01 10:15:00,10:15,9188550,8245450,-943100,SELL
2020-12-01 10:16:00,10:16,9161400,8240650,-920750,SELL
2020-12-01 10:17:00,10:17,9196775,8320825,-875950,SELL
2020-12-01 10:18:00,10:18,9245800,8328925,-916875,SELL
2020-12-01 10:19:00,10:19,9224000,8310725,-913275,SELL
2020-12-01 10:20:00,10:20,9231475,8344200,-887275,SELL
2020-12-01 10:21:00,10:21,9249800,8327875,-921925,SELL
2020-12-01 10:22:00,10:22,9247675,8368275,-879400,SELL
2020-12-01 10:23:00,10:23,9194750,8379475,-815275,SELL
2020-12-01 10:24:00,10:24,9250850,8408900,-841950,SELL
2020-12-01 10:25:00,10:25,9265700,8408725,-856975,SELL
2020-12-01 10:26:00,10:26,9303350,8400750,-902600,SELL
2020-12-01 10:27:00,10:27,9288850,8441325,-847525,SELL
2020-12-01 10:28:00,10:28,9323050,8443600,-879450,SELL
2020-12-01 10:29:00,10:29,9266100,8487325,-778775,SELL
2020-12-01 10:30:00,10:30,9273875,8487325,-786550,SELL
2020-12-01 10:31:00,10:31,9291400,8487325,-804075,SELL
2020-12-01 10:32:00,10:32,9288825,8585100,-703725,SELL
2020-12-01 10:33:00,10:33,9341750,8588500,-753250,SELL
2020-12-01 10:34:00,10:34,9259500,8583225,-676275,SELL
2020-12-01 10:35:00,10:35,9348575,8637550,-711025,SELL
2020-12-01 10:36:00,10:36,9352500,8642250,-710250,SELL
2020-12-01 10:37:00,10:37,9327050,8638950,-688100,SELL
2020-12-01 10:38:00,10:38,9186825,8556050,-630775,SELL
2020-12-01 10:39:00,10:39,9210250,8604225,-606025,SELL
2020-12-01 10:40:00,10:40,9155275,8599175,-556100,SELL
2020-12-01 10:41:00,10:41,9238150,8686025,-552125,SELL
2020-12-01 10:42:00,10:42,9227850,8675300,-552550,SELL
2020-12-01 10:43:00,10:43,9163350,8684375,-478975,SELL
2020-12-01 10:44:00,10:44,8989650,8768025,-221625,SELL
2020-12-01 10:45:00,10:45,9070700,8769675,-301025,SELL
2020-12-01 10:46:00,10:46,9015350,8733600,-281750,SELL
2020-12-01 10:47:00,10:47,8888375,8765325,-123050,SELL
2020-12-01 10:48:00,10:48,8878000,8783000,-95000,SELL
2020-12-01 10:49:00,10:49,8890200,8773425,-116775,SELL
2020-12-01 10:50:00,10:50,8869050,8800550,-68500,SELL
2020-12-01 10:51:00,10:51,8878175,8834000,-44175,SELL
2020-12-01 10:52:00,10:52,8875225,8843575,-31650,SELL
2020-12-01 10:53:00,10:53,8913700,8974450,60750,BUY
2020-12-01 10:54:00,10:54,8917225,8976250,59025,BUY
2020-12-01 10:55:00,10:55,8905600,8975575,69975,BUY
2020-12-01 10:56:00,10:56,8924850,8995150,70300,BUY
2020-12-01 10:57:00,10:57,8916075,8922200,6125,BUY
2020-12-01 10:58:00,10:58,8921400,8956075,34675,BUY
2020-12-01 10:59:00,10:59,8958750,9081375,122625,BUY
2020-12-01 11:00:00,11:00,8952150,9048200,96050,BUY
2020-12-01 11:01:00,11:01,8935275,9058375,123100,BUY
2020-12-01 11:02:00,11:02,8963075,9140000,176925,BUY
2020-12-01 11:03:00,11:03,9000200,9126350,126150,BUY
2020-12-01 11:04:00,11:04,8981725,9152975,171250,BUY
2020-12-01 11:05:00,11:05,8978150,9138025,159875,BUY
2020-12-01 11:06:00,11:06,9023575,9137075,113500,BUY
2020-12-01 11:07:00,11:07,8990850,9079150,88300,BUY
2020-12-01 11:08:00,11:08,8946450,9120925,174475,BUY
2020-12-01 11:09:00,11:09,8927300,9090250,162950,BUY
2020-12-01 11:10:00,11:10,8993675,9166100,172425,BUY
2020-12-01 11:11:00,11:11,8940025,9155975,215950,BUY
2020-12-01 11:12:00,11:12,9010300,9165800,155500,BUY
2020-12-01 11:13:00,11:13,8910300,9066400,156100,BUY
2020-12-01 11:14:00,11:14,8997000,9218850,221850,BUY
2020-12-01 11:15:00,11:15,8929950,9151800,221850,BUY
2020-12-01 11:16:00,11:16,8945950,9174275,228325,BUY
2020-12-01 11:17:00,11:17,8954525,9151700,197175,BUY
2020-12-01 11:18:00,11:18,8888050,9158175,270125,BUY
2020-12-01 11:19:00,11:19,9019925,9226225,206300,BUY
2020-12-01 11:20:00,11:20,9017750,9198750,181000,BUY
2020-12-01 11:21:00,11:21,9017800,9191700,173900,BUY
2020-12-01 11:22:00,11:22,9026725,9169225,142500,BUY
2020-12-01 11:23:00,11:23,9022625,9211475,188850,BUY
2020-12-01 11:24:00,11:24,9001225,9207850,206625,BUY
2020-12-01 11:25:00,11:25,8966475,9199075,232600,BUY
2020-12-01 11:26:00,11:26,9047850,9140475,92625,BUY
2020-12-01 11:27:00,11:27,9062975,9143050,80075,BUY
2020-12-01 11:28:00,11:28,9020475,9200900,180425,BUY
2020-12-01 11:29:00,11:29,9024175,9211550,187375,BUY
2020-12-01 11:30:00,11:30,9024175,9207800,183625,BUY
2020-12-01 11:31:00,11:31,9013075,9206475,193400,BUY
2020-12-01 11:32:00,11:32,9095775,9209075,113300,BUY
2020-12-01 11:33:00,11:33,9050425,9142850,92425,BUY
2020-12-01 11:34:00,11:34,8782350,9229100,446750,BUY
2020-12-01 11:35:00,11:35,9166775,9148650,-18125,SELL
2020-12-01 11:36:00,11:36,9082700,9200075,117375,BUY
2020-12-01 11:37:00,11:37,9094900,9081150,-13750,SELL
2020-12-01 11:38:00,11:38,9071925,9223725,151800,BUY
2020-12-01 11:39:00,11:39,9106275,9119700,13425,BUY
2020-12-01 11:40:00,11:40,9110475,9192525,82050,BUY
2020-12-01 11:41:00,11:41,9090325,9171150,80825,BUY
2020-12-01 11:42:00,11:42,9056825,9155425,98600,BUY
2020-12-01 11:43:00,11:43,9099975,9247175,147200,BUY
2020-12-01 11:44:00,11:44,9123750,9256225,132475,BUY
2020-12-01 11:45:00,11:45,9063025,9184650,121625,BUY
2020-12-01 11:46:00,11:46,9089400,9219225,129825,BUY
2020-12-01 11:47:00,11:47,9057700,9231600,173900,BUY
2020-12-01 11:48:00,11:48,9047900,9244125,196225,BUY
2020-12-01 11:49:00,11:49,9145500,9282275,136775,BUY
2020-12-01 11:50:00,11:50,9090500,9307250,216750,BUY
2020-12-01 11:51:00,11:51,9064350,9230875,166525,BUY
2020-12-01 11:52:00,11:52,9150825,9298400,147575,BUY
2020-12-01 11:53:00,11:53,9135175,9234300,99125,BUY
2020-12-01 11:54:00,11:54,9173050,9245175,72125,BUY
2020-12-01 11:55:00,11:55,9072950,9343175,270225,BUY
2020-12-01 11:56:00,11:56,9139325,9406025,266700,BUY
2020-12-01 11:57:00,11:57,9099700,9407425,307725,BUY
2020-12-01 11:58:00,11:58,9150100,9355200,205100,BUY
2020-12-01 11:59:00,11:59,9159175,9451450,292275,BUY
2020-12-01 12:00:00,12:00,9176125,9443725,267600,BUY
2020-12-01 12:01:00,12:01,9092100,9398650,306550,BUY
2020-12-01 12:02:00,12:02,9162050,9448800,286750,BUY
2020-12-01 12:03:00,12:03,9189275,9415050,225775,BUY
2020-12-01 12:04:00,12:04,9160925,9395975,235050,BUY
2020-12-01 12:05:00,12:05,9161225,9435925,274700,BUY
2020-12-01 12:06:00,12:06,9120075,9474425,354350,BUY
2020-12-01 12:07:00,12:07,9144800,9513850,369050,BUY
2020-12-01 12:08:00,12:08,9072475,9441350,368875,BUY
2020-12-01 12:09:00,12:09,9153175,9455250,302075,BUY
2020-12-01 12:10:00,12:10,9136250,9443450,307200,BUY
2020-12-01 12:11:00,12:11,9180750,9403475,222725,BUY
2020-12-01 12:12:00,12:12,9146400,9432100,285700,BUY
2020-12-01 12:13:00,12:13,9212850,9463750,250900,BUY
2020-12-01 12:14:00,12:14,9272650,9387000,114350,BUY
2020-12-01 12:15:00,12:15,9186975,9510725,323750,BUY
2020-12-01 12:16:00,12:16,9270775,9459375,188600,BUY
2020-12-01 12:17:00,12:17,9242900,9489500,246600,BUY
2020-12-01 12:18:00,12:18,9185300,9544700,359400,BUY
2020-12-01 12:19:00,12:19,9170575,9508075,337500,BUY
2020-12-01 12:20:00,12:20,9327850,9551250,223400,BUY
2020-12-01 12:21:00,12:21,9280175,9577000,296825,BUY
2020-12-01 12:22:00,12:22,9259700,9597750,338050,BUY
2020-12-01 12:23:00,12:23,9238825,9629275,390450,BUY
2020-12-01 12:24:00,12:24,9067000,9596650,529650,BUY
2020-12-01 12:25:00,12:25,9279975,9618500,338525,BUY
2020-12-01 12:26:00,12:26,9347425,9610050,262625,BUY
2020-12-01 12:27:00,12:27,9330825,9593800,262975,BUY
2020-12-01 12:28:00,12:28,9433400,9668150,234750,BUY
2020-12-01 12:29:00,12:29,9325600,9524550,198950,BUY
2020-12-01 12:30:00,12:30,9310925,9525400,214475,BUY
2020-12-01 12:31:00,12:31,9327425,9527000,199575,BUY
2020-12-01 12:32:00,12:32,9349975,9556250,206275,BUY
2020-12-01 12:33:00,12:33,9351375,9546050,194675,BUY
2020-12-01 12:34:00,12:34,9351375,9469325,117950,BUY
2020-12-01 12:35:00,12:35,9333100,9524850,191750,BUY
2020-12-01 12:36:00,12:36,9396825,9562525,165700,BUY
2020-12-01 12:37:00,12:37,9346800,9497450,150650,BUY
2020-12-01 12:38:00,12:38,9357475,9586425,228950,BUY
2020-12-01 12:39:00,12:39,9354200,9530725,176525,BUY
2020-12-01 12:40:00,12:40,9381550,9603100,221550,BUY
2020-12-01 12:41:00,12:41,9450000,9547675,97675,BUY
2020-12-01 12:42:00,12:42,9437325,9542375,105050,BUY
2020-12-01 12:43:00,12:43,9407775,9542375,134600,BUY
2020-12-01 12:44:00,12:44,9466725,9509975,43250,BUY
2020-12-01 12:45:00,12:45,9496150,9517825,21675,BUY
2020-12-01 12:46:00,12:46,9503250,9499325,-3925,SELL
2020-12-01 12:47:00,12:47,9474150,9481875,7725,BUY
2020-12-01 12:48:00,12:48,9488075,9477000,-11075,SELL
2020-12-01 12:49:00,12:49,9527775,9498675,-29100,SELL
2020-12-01 12:50:00,12:50,9542100,9512225,-29875,SELL
2020-12-01 12:51:00,12:51,9415025,9452925,37900,BUY
2020-12-01 12:52:00,12:52,9525125,9517450,-7675,SELL
2020-12-01 12:53:00,12:53,9505850,9535775,29925,BUY
2020-12-01 12:54:00,12:54,9517700,9513700,-4000,SELL
2020-12-01 12:55:00,12:55,9478525,9429625,-48900,SELL
2020-12-01 12:56:00,12:56,9516125,9534250,18125,BUY
2020-12-01 12:57:00,12:57,9598825,9431800,-167025,SELL
2020-12-01 12:58:00,12:58,9579650,9531625,-48025,SELL
2020-12-01 12:59:00,12:59,9561350,9545500,-15850,SELL
2020-12-01 13:00:00,13:00,9553325,9529575,-23750,SELL
2020-12-01 13:01:00,13:01,9557025,9530900,-26125,SELL
2020-12-01 13:02:00,13:02,9610325,9521275,-89050,SELL
2020-12-01 13:03:00,13:03,9585600,9522300,-63300,SELL
2020-12-01 13:04:00,13:04,9613075,9544325,-68750,SELL
2020-12-01 13:05:00,13:05,9655225,9542925,-112300,SELL
2020-12-01 13:06:00,13:06,9657050,9557625,-99425,SELL
2020-12-01 13:07:00,13:07,9715450,9586475,-128975,SELL
2020-12-01 13:08:00,13:08,9660875,9453775,-207100,SELL
2020-12-01 13:09:00,13:09,9658725,9458225,-200500,SELL
2020-12-01 13:10:00,13:10,9638300,9436650,-201650,SELL
2020-12-01 13:11:00,13:11,9542650,9413375,-129275,SELL
2020-12-01 13:12:00,13:12,9533125,9390475,-142650,SELL
2020-12-01 13:13:00,13:13,9556750,9428275,-128475,SELL
2020-12-01 13:14:00,13:14,9653425,9420975,-232450,SELL
2020-12-01 13:15:00,13:15,9554700,9287125,-267575,SELL
2020-12-01 13:16:00,13:16,9560375,9311600,-248775,SELL
2020-12-01 13:17:00,13:17,9561900,9403475,-158425,SELL
2020-12-01 13:18:00,13:18,9553700,9370075,-183625,SELL
2020-12-01 13:19:00,13:19,9592925,9416350,-176575,SELL
2020-12-01 13:20:00,13:20,9541950,9422050,-119900,SELL
2020-12-01 13:21:00,13:21,9545100,9425825,-119275,SELL
2020-12-01 13:22:00,13:22,9601650,9377225,-224425,SELL
2020-12-01 13:23:00,13:23,9581700,9391975,-189725,SELL
2020-12-01 13:24:00,13:24,9573950,9349825,-224125,SELL
2020-12-01 13:25:00,13:25,9540450,9344600,-195850,SELL
2020-12-01 13:26:00,13:26,9603875,9466175,-137700,SELL
2020-12-01 13:27:00,13:27,9558400,9383875,-174525,SELL
2020-12-01 13:28:00,13:28,9524975,9432975,-92000,SELL
2020-12-01 13:29:00,13:29,9484175,9463975,-20200,SELL
2020-12-01 13:30:00,13:30,9674500,9491525,-182975,SELL
2020-12-01 13:31:00,13:31,9689550,9484250,-205300,SELL
2020-12-01 13:32:00,13:32,9659600,9426100,-233500,SELL
2020-12-01 13:33:00,13:33,9555925,9397475,-158450,SELL
2020-12-01 13:34:00,13:34,9652325,9377425,-274900,SELL
2020-12-01 13:35:00,13:35,9623475,9413975,-209500,SELL
2020-12-01 13:36:00,13:36,9721400,9480950,-240450,SELL
2020-12-01 13:37:00,13:37,9697750,9467550,-230200,SELL
2020-12-01 13:38:00,13:38,9712950,9496650,-216300,SELL
2020-12-01 13:39:00,13:39,9712950,9524675,-188275,SELL
2020-12-01 13:40:00,13:40,9679950,9527275,-152675,SELL
2020-12-01 13:41:00,13:41,9680525,9524925,-155600,SELL
2020-12-01 13:42:00,13:42,9546650,9492450,-54200,SELL
2020-12-01 13:43:00,13:43,9561175,9497725,-63450,SELL
2020-12-01 13:44:00,13:44,9577600,9497625,-79975,SELL
2020-12-01 13:45:00,13:45,9577450,9478950,-98500,SELL
2020-12-01 13:46:00,13:46,9556425,9312175,-244250,SELL
2020-12-01 13:47:00,13:47,9585925,9374025,-211900,SELL
2020-12-01 13:48:00,13:48,9598975,9443775,-155200,SELL
2020-12-01 13:49:00,13:49,9632575,9451175,-181400,SELL
2020-12-01 13:50:00,13:50,9555550,9462825,-92725,SELL
2020-12-01 13:51:00,13:51,9579075,9480925,-98150,SELL
2020-12-01 13:52:00,13:52,9631425,9452325,-179100,SELL
2020-12-01 13:53:00,13:53,9569300,9483925,-85375,SELL
2020-12-01 13:54:00,13:54,9546675,9446050,-100625,SELL
2020-12-01 13:55:00,13:55,9526400,9416775,-109625,SELL
2020-12-01 13:56:00,13:56,9586325,9424850,-161475,SELL
2020-12-01 13:57:00,13:57,9371550,9392750,21200,BUY
2020-12-01 13:58:00,13:58,9477050,9446200,-30850,SELL
2020-12-01 13:59:00,13:59,9393650,9422800,29150,BUY
2020-12-01 14:00:00,14:00,9608975,9466475,-142500,SELL
2020-12-01 14:01:00,14:01,9627825,9453900,-173925,SELL
2020-12-01 14:02:00,14:02,9584175,9463975,-120200,SELL
2020-12-01 14:03:00,14:03,9550800,9385875,-164925,SELL
2020-12-01 14:04:00,14:04,9564300,9383425,-180875,SELL
2020-12-01 14:05:00,14:05,9531525,9429275,-102250,SELL
2020-12-01 14:06:00,14:06,9572625,9461600,-111025,SELL
2020-12-01 14:07:00,14:07,9466450,9481400,14950,BUY
2020-12-01 14:08:00,14:08,9581325,9499900,-81425,SELL
2020-12-01 14:09:00,14:09,9600800,9481125,-119675,SELL
2020-12-01 14:10:00,14:10,9577875,9452450,-125425,SELL
2020-12-01 14:11:00,14:11,9584575,9463550,-121025,SELL
2020-12-01 14:12:00,14:12,9589725,9563625,-26100,SELL
2020-12-01 14:13:00,14:13,9621300,9563525,-57775,SELL
2020-12-01 14:14:00,14:14,9581150,9562225,-18925,SELL
2020-12-01 14:15:00,14:15,9521025,9482325,-38700,SELL
2020-12-01 14:16:00,14:16,9541900,9414975,-126925,SELL
2020-12-01 14:17:00,14:17,9520100,9483550,-36550,SELL
2020-12-01 14:18:00,14:18,9468175,9512225,44050,BUY
2020-12-01 14:19:00,14:19,9474075,9505975,31900,BUY
2020-12-01 14:20:00,14:20,9498675,9491300,-7375,SELL
2020-12-01 14:21:00,14:21,9533375,9525550,-7825,SELL
2020-12-01 14:22:00,14:22,9509600,9525550,15950,BUY
2020-12-01 14:23:00,14:23,9535075,9526825,-8250,SELL
2020-12-01 14:24:00,14:24,9514050,9430000,-84050,SELL
2020-12-01 14:25:00,14:25,9552125,9453175,-98950,SELL
2020-12-01 14:26:00,14:26,9566075,9478650,-87425,SELL
2020-12-01 14:27:00,14:27,9538250,9489150,-49100,SELL
2020-12-01 14:28:00,14:28,9516200,9449775,-66425,SELL
2020-12-01 14:29:00,14:29,9525425,9484675,-40750,SELL
2020-12-01 14:30:00,14:30,9526050,9477925,-48125,SELL
2020-12-01 14:31:00,14:31,9527150,9492650,-34500,SELL
2020-12-01 14:32:00,14:32,9547800,9500250,-47550,SELL
2020-12-01 14:33:00,14:33,9607125,9478250,-128875,SELL
2020-12-01 14:34:00,14:34,9565200,9417450,-147750,SELL
2020-12-01 14:35:00,14:35,9626500,9484050,-142450,SELL
2020-12-01 14:36:00,14:36,9604575,9510250,-94325,SELL
2020-12-01 14:37:00,14:37,9588100,9456275,-131825,SELL
2020-12-01 14:38:00,14:38,9592125,9462175,-129950,SELL
2020-12-01 14:39:00,14:39,9638200,9556825,-81375,SELL
2020-12-01 14:40:00,14:40,9651550,9555400,-96150,SELL
2020-12-01 14:41:00,14:41,9633225,9557175,-76050,SELL
2020-12-01 14:42:00,14:42,9366550,9437425,70875,BUY
2020-12-01 14:43:00,14:43,9388750,9434625,45875,BUY
2020-12-01 14:44:00,14:44,9401700,9437475,35775,BUY
2020-12-01 14:45:00,14:45,9407500,9417325,9825,BUY
2020-12-01 14:46:00,14:46,9356350,9439550,83200,BUY
2020-12-01 14:47:00,14:47,9352100,9433400,81300,BUY
2020-12-01 14:48:00,14:48,9310000,9416675,106675,BUY
2020-12-01 14:49:00,14:49,9356625,9398550,41925,BUY
2020-12-01 14:50:00,14:50,9356625,9394375,37750,BUY
2020-12-01 14:51:00,14:51,9358825,9296400,-62425,SELL
2020-12-01 14:52:00,14:52,9311900,9300125,-11775,SELL
2020-12-01 14:53:00,14:53,9333225,9297775,-35450,SELL
2020-12-01 14:54:00,14:54,9299525,9240225,-59300,SELL
2020-12-01 14:55:00,14:55,9303750,9270775,-32975,SELL
2020-12-01 14:56:00,14:56,9303750,9266800,-36950,SELL
2020-12-01 14:57:00,14:57,9277775,9224450,-53325,SELL
2020-12-01 14:58:00,14:58,9278575,9261325,-17250,SELL
2020-12-01 14:59:00,14:59,9297150,9264325,-32825,SELL
2020-12-01 15:00:00,15:00,8956350,9017000,60650,BUY
2020-12-01 15:01:00,15:01,8952625,9018050,65425,BUY
2020-12-01 15:02:00,15:02,8930850,9011475,80625,BUY
2020-12-01 15:03:00,15:03,8879650,8868075,-11575,SELL
2020-12-01 15:04:00,15:04,8833625,8861925,28300,BUY
2020-12-01 15:05:00,15:05,8892725,8866550,-26175,SELL
2020-12-01 15:06:00,15:06,8854800,8862050,7250,BUY
2020-12-01 15:07:00,15:07,8857100,8863275,6175,BUY
2020-12-01 15:08:00,15:08,8863175,8866400,3225,BUY
2020-12-01 15:09:00,15:09,8799950,8869775,69825,BUY
2020-12-01 15:10:00,15:10,8801625,8872700,71075,BUY
2020-12-01 15:11:00,15:11,8846550,8872950,26400,BUY
2020-12-01 15:12:00,15:12,8787550,8804375,16825,BUY
2020-12-01 15:13:00,15:13,8771275,8802600,31325,BUY
2020-12-01 15:14:00,15:14,8796675,8802025,5350,BUY
2020-12-01 15:15:00,15:15,8742675,8667250,-75425,SELL
2020-12-01 15:16:00,15:16,8697775,8703400,5625,BUY
2020-12-01 15:17:00,15:17,8693825,8703475,9650,BUY
2020-12-01 15:18:00,15:18,8687875,8608475,-79400,SELL
2020-12-01 15:19:00,15:19,8714625,8616850,-97775,SELL
2020-12-01 15:20:00,15:20,8710775,8619100,-91675,SELL
2020-12-01 15:21:00,15:21,8615350,8466300,-149050,SELL
2020-12-01 15:22:00,15:22,8566700,8457525,-109175,SELL
2020-12-01 15:23:00,15:23,8571850,8452625,-119225,SELL
2020-12-01 15:24:00,15:24,8660050,8428250,-231800,SELL
2020-12-01 15:25:00,15:25,8670925,8428875,-242050,SELL
2020-12-01 15:26:00,15:26,8579050,8415975,-163075,SELL
2020-12-01 15:27:00,15:27,8791900,8575000,-216900,SELL
2020-12-01 15:28:00,15:28,8804175,8550025,-254150,SELL
2020-12-01 15:29:00,15:29,8798950,8574450,-224500,SELL
2020-12-02 09:15:00,09:15,8842650,8438575,-404075,SELL
2020-12-02 09:16:00,09:16,8849325,8450325,-399000,SELL
2020-12-02 09:17:00,09:17,9272100,8982800,-289300,SELL
2020-12-02 09:18:00,09:18,9290725,8948350,-342375,SELL
2020-12-02 09:19:00,09:19,9271300,8977725,-293575,SELL
2020-12-02 09:20:00,09:20,9730250,9447550,-282700,SELL
2020-12-02 09:21:00,09:21,9725000,9445250,-279750,SELL
2020-12-02 09:22:00,09:22,9694350,9442500,-251850,SELL
2020-12-02 09:23:00,09:23,9983425,9718700,-264725,SELL
2020-12-02 09:24:00,09:24,9981075,9714025,-267050,SELL
2020-12-02 09:25:00,09:25,10004725,9661500,-343225,SELL
2020-12-02 09:26:00,09:26,10294000,9953775,-340225,SELL
2020-12-02 09:27:00,09:27,10263900,9917200,-346700,SELL
2020-12-02 09:28:00,09:28,10321600,9855425,-466175,SELL
2020-12-02 09:29:00,09:29,10563325,10069025,-494300,SELL
2020-12-02 09:30:00,09:30,10557600,10078250,-479350,SELL
2020-12-02 09:31:00,09:31,10558075,10079250,-478825,SELL
2020-12-02 09:32:00,09:32,10640200,10192550,-447650,SELL
2020-12-02 09:33:00,09:33,10653000,10209625,-443375,SELL
2020-12-02 09:34:00,09:34,10666725,10220125,-446600,SELL
2020-12-02 09:35:00,09:35,10659300,10275525,-383775,SELL
2020-12-02 09:36:00,09:36,10663825,10279125,-384700,SELL
2020-12-02 09:37:00,09:37,10678200,10324400,-353800,SELL
2020-12-02 09:38:00,09:38,10658200,10484500,-173700,SELL
2020-12-02 09:39:00,09:39,10622800,10444175,-178625,SELL
2020-12-02 09:40:00,09:40,10648875,10436875,-212000,SELL
2020-12-02 09:41:00,09:41,10720175,10605625,-114550,SELL
2020-12-02 09:42:00,09:42,10713525,10603950,-109575,SELL
2020-12-02 09:43:00,09:43,10710750,10567850,-142900,SELL
2020-12-02 09:44:00,09:44,10646500,10620225,-26275,SELL
2020-12-02 09:45:00,09:45,10682150,10567900,-114250,SELL
2020-12-02 09:46:00,09:46,10697050,10618950,-78100,SELL
2020-12-02 09:47:00,09:47,10762375,10600400,-161975,SELL
2020-12-02 09:48:00,09:48,10735550,10698850,-36700,SELL
2020-12-02 09:49:00,09:49,10753325,10700475,-52850,SELL
2020-12-02 09:50:00,09:50,10752850,10761325,8475,BUY
2020-12-02 09:51:00,09:51,10760425,10765775,5350,BUY
2020-12-02 09:52:00,09:52,10776500,10766475,-10025,SELL
2020-12-02 09:53:00,09:53,10812300,10706175,-106125,SELL
2020-12-02 09:54:00,09:54,10778625,10771300,-7325,SELL
2020-12-02 09:55:00,09:55,10813975,10806800,-7175,SELL
2020-12-02 09:56:00,09:56,10813100,10768525,-44575,SELL
2020-12-02 09:57:00,09:57,10876725,10869925,-6800,SELL
2020-12-02 09:58:00,09:58,10842900,10865425,22525,BUY
2020-12-02 09:59:00,09:59,10970050,10848575,-121475,SELL
2020-12-02 10:00:00,10:00,10964800,10853275,-111525,SELL
2020-12-02 10:01:00,10:01,10935325,10802800,-132525,SELL
2020-12-02 10:02:00,10:02,11088825,10898700,-190125,SELL
2020-12-02 10:03:00,10:03,11061050,10821500,-239550,SELL
2020-12-02 10:04:00,10:04,11077175,10900375,-176800,SELL
2020-12-02 10:05:00,10:05,11125325,10771625,-353700,SELL
2020-12-02 10:06:00,10:06,11106625,10776300,-330325,SELL
2020-12-02 10:07:00,10:07,11141500,10688050,-453450,SELL
2020-12-02 10:08:00,10:08,11161750,10838150,-323600,SELL
2020-12-02 10:09:00,10:09,11137175,10878725,-258450,SELL
2020-12-02 10:10:00,10:10,11144025,10800300,-343725,SELL
2020-12-02 10:11:00,10:11,11222725,10897150,-325575,SELL
2020-12-02 10:12:00,10:12,11229575,10871975,-357600,SELL
2020-12-02 10:13:00,10:13,11245500,10888475,-357025,SELL
2020-12-02 10:14:00,10:14,11232125,10918825,-313300,SELL
2020-12-02 10:15:00,10:15,11287700,10987800,-299900,SELL
2020-12-02 10:16:00,10:16,11315400,10987750,-327650,SELL
2020-12-02 10:17:00,10:17,11421475,10972675,-448800,SELL
2020-12-02 10:18:00,10:18,11430125,10983200,-446925,SELL
2020-12-02 10:19:00,10:19,11395325,10989050,-406275,SELL
2020-12-02 10:20:00,10:20,11397575,10929450,-468125,SELL
2020-12-02 10:21:00,10:21,11380125,10867000,-513125,SELL
2020-12-02 10:22:00,10:22,11348300,10891050,-457250,SELL
2020-12-02 10:23:00,10:23,11316250,10919525,-396725,SELL
2020-12-02 10:24:00,10:24,11399600,10946825,-452775,SELL
2020-12-02 10:25:00,10:25,11476025,10963450,-512575,SELL
2020-12-02 10:26:00,10:26,11442800,10756025,-686775,SELL
2020-12-02 10:27:00,10:27,11475750,10708800,-766950,SELL
2020-12-02 10:28:00,10:28,11385350,10776800,-608550,SELL
2020-12-02 10:29:00,10:29,11449800,10797925,-651875,SELL
2020-12-02 10:30:00,10:30,11473700,10790150,-683550,SELL
2020-12-02 10:31:00,10:31,11383075,10754750,-628325,SELL
2020-12-02 10:32:00,10:32,11526550,10870650,-655900,SELL
2020-12-02 10:33:00,10:33,11539575,10880850,-658725,SELL
2020-12-02 10:34:00,10:34,11528550,10866025,-662525,SELL
2020-12-02 10:35:00,10:35,11619475,10840375,-779100,SELL
2020-12-02 10:36:00,10:36,11597825,10831025,-766800,SELL
2020-12-02 10:37:00,10:37,11585725,10852525,-733200,SELL
2020-12-02 10:38:00,10:38,11601975,10789800,-812175,SELL
2020-12-02 10:39:00,10:39,11601975,10798075,-803900,SELL
2020-12-02 10:40:00,10:40,11594150,10762800,-831350,SELL
2020-12-02 10:41:00,10:41,11605375,10824475,-780900,SELL
2020-12-02 10:42:00,10:42,11585850,10860850,-725000,SELL
2020-12-02 10:43:00,10:43,11605350,10824475,-780875,SELL
2020-12-02 10:44:00,10:44,11657275,10864050,-793225,SELL
2020-12-02 10:45:00,10:45,11639200,10864750,-774450,SELL
2020-12-02 10:46:00,10:46,11583925,10834525,-749400,SELL
2020-12-02 10:47:00,10:47,11624650,10880550,-744100,SELL
2020-12-02 10:48:00,10:48,11679850,10865300,-814550,SELL
2020-12-02 10:49:00,10:49,11686625,10828125,-858500,SELL
2020-12-02 10:50:00,10:50,11678675,10758550,-920125,SELL
2020-12-02 10:51:00,10:51,11662850,10815575,-847275,SELL
2020-12-02 10:52:00,10:52,11699250,10886325,-812925,SELL
2020-12-02 10:53:00,10:53,11701475,10849675,-851800,SELL
2020-12-02 10:54:00,10:54,11684500,10817025,-867475,SELL
2020-12-02 10:55:00,10:55,11506800,10817025,-689775,SELL
2020-12-02 10:56:00,10:56,11743325,10812725,-930600,SELL
2020-12-02 10:57:00,10:57,11576100,10806575,-769525,SELL
2020-12-02 10:58:00,10:58,11614125,10811300,-802825,SELL
2020-12-02 10:59:00,10:59,11695025,10821700,-873325,SELL
2020-12-02 11:00:00,11:00,11612425,10839900,-772525,SELL
2020-12-02 11:01:00,11:01,11664775,10719350,-945425,SELL
2020-12-02 11:02:00,11:02,11787375,10860975,-926400,SELL
2020-12-02 11:03:00,11:03,11804625,10915300,-889325,SELL
2020-12-02 11:04:00,11:04,11790850,10904850,-886000,SELL
2020-12-02 11:05:00,11:05,11898425,10938450,-959975,SELL
2020-12-02 11:06:00,11:06,11850650,10943100,-907550,SELL
2020-12-02 11:07:00,11:07,11901175,10850600,-1050575,SELL
2020-12-02 11:08:00,11:08,12024775,10959675,-1065100,SELL
2020-12-02 11:09:00,11:09,12038025,11000175,-1037850,SELL
2020-12-02 11:10:00,11:10,12047325,10987975,-1059350,SELL
2020-12-02 11:11:00,11:11,12128800,10967675,-1161125,SELL
2020-12-02 11:12:00,11:12,12101500,10952175,-1149325,SELL
2020-12-02 11:13:00,11:13,12120975,11001975,-1119000,SELL
2020-12-02 11:14:00,11:14,12066000,11045350,-1020650,SELL
2020-12-02 11:15:00,11:15,12203200,11019175,-1184025,SELL
2020-12-02 11:16:00,11:16,12198975,11052525,-1146450,SELL
2020-12-02 11:17:00,11:17,12159325,11053250,-1106075,SELL
2020-12-02 11:18:00,11:18,12245450,10994500,-1250950,SELL
2020-12-02 11:19:00,11:19,12245450,11013700,-1231750,SELL
2020-12-02 11:20:00,11:20,12181150,11029250,-1151900,SELL
2020-12-02 11:21:00,11:21,12200275,11094975,-1105300,SELL
2020-12-02 11:22:00,11:22,12204825,11039675,-1165150,SELL
2020-12-02 11:23:00,11:23,12205325,11077300,-1128025,SELL
2020-12-02 11:24:00,11:24,12205325,11049125,-1156200,SELL
2020-12-02 11:25:00,11:25,12241850,11066675,-1175175,SELL
2020-12-02 11:26:00,11:26,12224425,11075075,-1149350,SELL
2020-12-02 11:27:00,11:27,12325650,11106075,-1219575,SELL
2020-12-02 11:28:00,11:28,12331500,11107850,-1223650,SELL
2020-12-02 11:29:00,11:29,12315175,10871050,-1444125,SELL
2020-12-02 11:30:00,11:30,12331600,10876175,-1455425,SELL
2020-12-02 11:31:00,11:31,12321150,10879400,-1441750,SELL
2020-12-02 11:32:00,11:32,12237475,10696350,-1541125,SELL
2020-12-02 11:33:00,11:33,12235075,10704225,-1530850,SELL
2020-12-02 11:34:00,11:34,12211425,10709175,-1502250,SELL
2020-12-02 11:35:00,11:35,12267975,10709025,-1558950,SELL
2020-12-02 11:36:00,11:36,12089475,10707550,-1381925,SELL
2020-12-02 11:37:00,11:37,12143000,10696050,-1446950,SELL
2020-12-02 11:38:00,11:38,12219250,10649500,-1569750,SELL
2020-12-02 11:39:00,11:39,12262900,10742975,-1519925,SELL
2020-12-02 11:40:00,11:40,12212700,10697875,-1514825,SELL
2020-12-02 11:41:00,11:41,12211800,10709025,-1502775,SELL
2020-12-02 11:42:00,11:42,12286850,10724825,-1562025,SELL
2020-12-02 11:43:00,11:43,12285425,10734050,-1551375,SELL
2020-12-02 11:44:00,11:44,12263550,10645050,-1618500,SELL
2020-12-02 11:45:00,11:45,12320225,10719750,-1600475,SELL
2020-12-02 11:46:00,11:46,12263775,10680275,-1583500,SELL
2020-12-02 11:47:00,11:47,12406275,10737725,-1668550,SELL
2020-12-02 11:48:00,11:48,12400300,10759125,-1641175,SELL
2020-12-02 11:49:00,11:49,12391225,10757625,-1633600,SELL
2020-12-02 11:50:00,11:50,12386300,10721650,-1664650,SELL
2020-12-02 11:51:00,11:51,12317050,10719850,-1597200,SELL
2020-12-02 11:52:00,11:52,12396825,10631550,-1765275,SELL
2020-12-02 11:53:00,11:53,12236125,9861075,-2375050,SELL
2020-12-02 11:54:00,11:54,12286375,10670725,-1615650,SELL
2020-12-02 11:55:00,11:55,12257375,10631800,-1625575,SELL
2020-12-02 11:56:00,11:56,12297275,10656175,-1641100,SELL
2020-12-02 11:57:00,11:57,12390750,10704700,-1686050,SELL
2020-12-02 11:58:00,11:58,12439725,10687925,-1751800,SELL
2020-12-02 11:59:00,11:59,12305625,10723075,-1582550,SELL
2020-12-02 12:00:00,12:00,12286700,10743825,-1542875,SELL
2020-12-02 12:01:00,12:01,12457375,10758850,-1698525,SELL
2020-12-02 12:02:00,12:02,12448150,10762650,-1685500,SELL
2020-12-02 12:03:00,12:03,12492375,10660300,-1832075,SELL
2020-12-02 12:04:00,12:04,12488025,10744450,-1743575,SELL
2020-12-02 12:05:00,12:05,12505225,10701800,-1803425,SELL
2020-12-02 12:06:00,12:06,12560200,10725750,-1834450,SELL
2020-12-02 12:07:00,12:07,12265425,10712250,-1553175,SELL
2020-12-02 12:08:00,12:08,12493500,10783925,-1709575,SELL
2020-12-02 12:09:00,12:09,12561675,10728225,-1833450,SELL
2020-12-02 12:10:00,12:10,12395700,10701100,-1694600,SELL
2020-12-02 12:11:00,12:11,12568975,10740250,-1828725,SELL
2020-12-02 12:12:00,12:12,12627375,10762550,-1864825,SELL
2020-12-02 12:13:00,12:13,12453925,10731350,-1722575,SELL
2020-12-02 12:14:00,12:14,12621800,10766600,-1855200,SELL
2020-12-02 12:15:00,12:15,12676100,10816150,-1859950,SELL
2020-12-02 12:16:00,12:16,12703500,10783800,-1919700,SELL
2020-12-02 12:17:00,12:17,12732300,10849075,-1883225,SELL
2020-12-02 12:18:00,12:18,12639800,10843575,-1796225,SELL
2020-12-02 12:19:00,12:19,12710900,10842300,-1868600,SELL
2020-12-02 12:20:00,12:20,12720750,10836075,-1884675,SELL
2020-12-02 12:21:00,12:21,12619800,10665750,-1954050,SELL
2020-12-02 12:22:00,12:22,12705700,10767450,-1938250,SELL
2020-12-02 12:23:00,12:23,12668425,10739250,-1929175,SELL
2020-12-02 12:24:00,12:24,12783900,10779750,-2004150,SELL
2020-12-02 12:25:00,12:25,12691000,10786975,-1904025,SELL
2020-12-02 12:26:00,12:26,12882350,10835350,-2047000,SELL
2020-12-02 12:27:00,12:27,12660000,10794175,-1865825,SELL
2020-12-02 12:28:00,12:28,12897825,10867275,-2030550,SELL
2020-12-02 12:29:00,12:29,12846975,10851575,-1995400,SELL
2020-12-02 12:30:00,12:30,12896750,10921625,-1975125,SELL
2020-12-02 12:31:00,12:31,12846450,10864825,-1981625,SELL
2020-12-02 12:32:00,12:32,12809850,10815400,-1994450,SELL
2020-12-02 12:33:00,12:33,12737750,10801750,-1936000,SELL
2020-12-02 12:34:00,12:34,12764775,10754750,-2010025,SELL
2020-12-02 12:35:00,12:35,12807750,10877825,-1929925,SELL
2020-12-02 12:36:00,12:36,12672500,10873100,-1799400,SELL
2020-12-02 12:37:00,12:37,12714350,10884150,-1830200,SELL
2020-12-02 12:38:00,12:38,12744425,10803225,-1941200,SELL
2020-12-02 12:39:00,12:39,12809250,10842175,-1967075,SELL
2020-12-02 12:40:00,12:40,12802975,10806125,-1996850,SELL
2020-12-02 12:41:00,12:41,12714275,10831200,-1883075,SELL
2020-12-02 12:42:00,12:42,12778825,10817300,-1961525,SELL
2020-12-02 12:43:00,12:43,12800950,10823900,-1977050,SELL
2020-12-02 12:44:00,12:44,12836750,10871700,-1965050,SELL
2020-12-02 12:45:00,12:45,12885825,10884025,-2001800,SELL
2020-12-02 12:46:00,12:46,12864950,10877625,-1987325,SELL
2020-12-02 12:47:00,12:47,12635375,10848850,-1786525,SELL
2020-12-02 12:48:00,12:48,12788450,10873225,-1915225,SELL
2020-12-02 12:49:00,12:49,12703725,10868425,-1835300,SELL
2020-12-02 12:50:00,12:50,12792300,10842175,-1950125,SELL
2020-12-02 12:51:00,12:51,12854150,10917050,-1937100,SELL
2020-12-02 12:52:00,12:52,12776150,10917050,-1859100,SELL
2020-12-02 12:53:00,12:53,12948700,10924600,-2024100,SELL
2020-12-02 12:54:00,12:54,12956500,10929125,-2027375,SELL
2020-12-02 12:55:00,12:55,12973650,10908150,-2065500,SELL
2020-12-02 12:56:00,12:56,12837175,10643700,-2193475,SELL
2020-12-02 12:57:00,12:57,12848300,10642950,-2205350,SELL
2020-12-02 12:58:00,12:58,12838975,10642700,-2196275,SELL
2020-12-02 12:59:00,12:59,12431650,9628350,-2803300,SELL
2020-12-02 13:00:00,13:00,12448275,9639375,-2808900,SELL
2020-12-02 13:01:00,13:01,12452925,9626825,-2826100,SELL
2020-12-02 13:02:00,13:02,12159225,9338650,-2820575,SELL
2020-12-02 13:03:00,13:03,12160175,9338150,-2822025,SELL
2020-12-02 13:04:00,13:04,12148775,9338150,-2810625,SELL
2020-12-02 13:05:00,13:05,11988350,9418100,-2570250,SELL
2020-12-02 13:06:00,13:06,11982900,9435150,-2547750,SELL
2020-12-02 13:07:00,13:07,11943800,9429000,-2514800,SELL
2020-12-02 13:08:00,13:08,11976000,9451850,-2524150,SELL
2020-12-02 13:09:00,13:09,11959250,9448850,-2510400,SELL
2020-12-02 13:10:00,13:10,11956100,9458475,-2497625,SELL
2020-12-02 13:11:00,13:11,11944750,9393025,-2551725,SELL
2020-12-02 13:12:00,13:12,11937650,9364475,-2573175,SELL
2020-12-02 13:13:00,13:13,11942900,9376725,-2566175,SELL
2020-12-02 13:14:00,13:14,11962100,9321500,-2640600,SELL
2020-12-02 13:15:00,13:15,11944875,9325450,-2619425,SELL
2020-12-02 13:16:00,13:16,11955000,9289250,-2665750,SELL
2020-12-02 13:17:00,13:17,11988475,9267375,-2721100,SELL
2020-12-02 13:18:00,13:18,11955800,9268275,-2687525,SELL
2020-12-02 13:19:00,13:19,11969525,9268275,-2701250,SELL
2020-12-02 13:20:00,13:20,11994675,9309475,-2685200,SELL
2020-12-02 13:21:00,13:21,11984100,9284250,-2699850,SELL
2020-12-02 13:22:00,13:22,11996450,9284150,-2712300,SELL
2020-12-02 13:23:00,13:23,11955425,9313300,-2642125,SELL
2020-12-02 13:24:00,13:24,12011250,9332100,-2679150,SELL
2020-12-02 13:25:00,13:25,12002700,9326275,-2676425,SELL
2020-12-02 13:26:00,13:26,12011700,9308325,-2703375,SELL
2020-12-02 13:27:00,13:27,12057125,9349200,-2707925,SELL
2020-12-02 13:28:00,13:28,12053900,9365650,-2688250,SELL
2020-12-02 13:29:00,13:29,12081800,9352850,-2728950,SELL
2020-12-02 13:30:00,13:30,12063200,9455475,-2607725,SELL
2020-12-02 13:31:00,13:31,12101350,9454850,-2646500,SELL
2020-12-02 13:32:00,13:32,12051150,9457200,-2593950,SELL
2020-12-02 13:33:00,13:33,12193525,9366925,-2826600,SELL
2020-12-02 13:34:00,13:34,12227325,9341000,-2886325,SELL
2020-12-02 13:35:00,13:35,12217525,9355375,-2862150,SELL
2020-12-02 13:36:00,13:36,12264575,9445575,-2819000,SELL
2020-12-02 13:37:00,13:37,12260725,9433275,-2827450,SELL
2020-12-02 13:38:00,13:38,12240750,9433275,-2807475,SELL
2020-12-02 13:39:00,13:39,12199600,9095875,-3103725,SELL
2020-12-02 13:40:00,13:40,12164200,9117300,-3046900,SELL
2020-12-02 13:41:00,13:41,12187750,9098850,-3088900,SELL
2020-12-02 13:42:00,13:42,12189125,9086650,-3102475,SELL
2020-12-02 13:43:00,13:43,12176775,9086650,-3090125,SELL
2020-12-02 13:44:00,13:44,12167050,9067950,-3099100,SELL
2020-12-02 13:45:00,13:45,12061925,9040925,-3021000,SELL
2020-12-02 13:46:00,13:46,12049900,9068150,-2981750,SELL
2020-12-02 13:47:00,13:47,12053925,9046425,-3007500,SELL
2020-12-02 13:48:00,13:48,11972100,8995100,-2977000,SELL
2020-12-02 13:49:00,13:49,11955975,9015700,-2940275,SELL
2020-12-02 13:50:00,13:50,11972125,9012750,-2959375,SELL
2020-12-02 13:51:00,13:51,11979650,8911600,-3068050,SELL
2020-12-02 13:52:00,13:52,11958825,8956275,-3002550,SELL
2020-12-02 13:53:00,13:53,11963225,8965250,-2997975,SELL
2020-12-02 13:54:00,13:54,11966725,8996600,-2970125,SELL
2020-12-02 13:55:00,13:55,11965150,8938900,-3026250,SELL
2020-12-02 13:56:00,13:56,11971125,8974750,-2996375,SELL
2020-12-02 13:57:00,13:57,11957950,8982425,-2975525,SELL
2020-12-02 13:58:00,13:58,11952375,8982425,-2969950,SELL
2020-12-02 13:59:00,13:59,11955225,8955500,-2999725,SELL
2020-12-02 14:00:00,14:00,11916225,8967050,-2949175,SELL
2020-12-02 14:01:00,14:01,11976475,8978250,-2998225,SELL
2020-12-02 14:02:00,14:02,11952475,8917775,-3034700,SELL
2020-12-02 14:03:00,14:03,11950500,9016475,-2934025,SELL
2020-12-02 14:04:00,14:04,11955950,9002350,-2953600,SELL
2020-12-02 14:05:00,14:05,11990575,9031250,-2959325,SELL
2020-12-02 14:06:00,14:06,11917375,8855150,-3062225,SELL
2020-12-02 14:07:00,14:07,11940400,8869250,-3071150,SELL
2020-12-02 14:08:00,14:08,11932875,8871400,-3061475,SELL
2020-12-02 14:09:00,14:09,11694900,8630075,-3064825,SELL
2020-12-02 14:10:00,14:10,11717050,8639175,-3077875,SELL
2020-12-02 14:11:00,14:11,11698100,8645000,-3053100,SELL
2020-12-02 14:12:00,14:12,11645125,8652675,-2992450,SELL
2020-12-02 14:13:00,14:13,11620550,8657600,-2962950,SELL
2020-12-02 14:14:00,14:14,11638475,8652675,-2985800,SELL
2020-12-02 14:15:00,14:15,11521975,8659900,-2862075,SELL
2020-12-02 14:16:00,14:16,11515150,8027175,-3487975,SELL
2020-12-02 14:17:00,14:17,11535725,8650800,-2884925,SELL
2020-12-02 14:18:00,14:18,11638375,8598100,-3040275,SELL
2020-12-02 14:19:00,14:19,11629650,8591175,-3038475,SELL
2020-12-02 14:20:00,14:20,11624900,8583050,-3041850,SELL
2020-12-02 14:21:00,14:21,11480450,8609575,-2870875,SELL
2020-12-02 14:22:00,14:22,11493525,8628325,-2865200,SELL
2020-12-02 14:23:00,14:23,11493625,8590275,-2903350,SELL
2020-12-02 14:24:00,14:24,11308625,8509900,-2798725,SELL
2020-12-02 14:25:00,14:25,11294875,8514250,-2780625,SELL
2020-12-02 14:26:00,14:26,11294875,8504375,-2790500,SELL
2020-12-02 14:27:00,14:27,11321800,8544925,-2776875,SELL
2020-12-02 14:28:00,14:28,11320875,8531475,-2789400,SELL
2020-12-02 14:29:00,14:29,11320875,8573800,-2747075,SELL
2020-12-02 14:30:00,14:30,11297725,8646825,-2650900,SELL
2020-12-02 14:31:00,14:31,11237550,8656825,-2580725,SELL
2020-12-02 14:32:00,14:32,11305725,8656475,-2649250,SELL
2020-12-02 14:33:00,14:33,11358350,8621675,-2736675,SELL
2020-12-02 14:34:00,14:34,11353650,8636950,-2716700,SELL
2020-12-02 14:35:00,14:35,11347950,8584425,-2763525,SELL
2020-12-02 14:36:00,14:36,11291200,8640600,-2650600,SELL
2020-12-02 14:37:00,14:37,11339800,8597200,-2742600,SELL
2020-12-02 14:38:00,14:38,11309850,8670125,-2639725,SELL
2020-12-02 14:39:00,14:39,11380150,8747425,-2632725,SELL
2020-12-02 14:40:00,14:40,11382125,8791850,-2590275,SELL
2020-12-02 14:41:00,14:41,11350675,8811225,-2539450,SELL
2020-12-02 14:42:00,14:42,11346400,8740700,-2605700,SELL
2020-12-02 14:43:00,14:43,11350325,8771250,-2579075,SELL
2020-12-02 14:44:00,14:44,11342350,8796550,-2545800,SELL
2020-12-02 14:45:00,14:45,11203850,8841975,-2361875,SELL
2020-12-02 14:46:00,14:46,11259125,8856225,-2402900,SELL
2020-12-02 14:47:00,14:47,11259125,8858275,-2400850,SELL
2020-12-02 14:48:00,14:48,10985850,8562500,-2423350,SELL
2020-12-02 14:49:00,14:49,10978500,8554475,-2424025,SELL
2020-12-02 14:50:00,14:50,10968600,8550075,-2418525,SELL
2020-12-02 14:51:00,14:51,10882925,8474625,-2408300,SELL
2020-12-02 14:52:00,14:52,10862625,8477375,-2385250,SELL
2020-12-02 14:53:00,14:53,10769200,8477375,-2291825,SELL
2020-12-02 14:54:00,14:54,10830600,8531150,-2299450,SELL
2020-12-02 14:55:00,14:55,10857900,8498325,-2359575,SELL
2020-12-02 14:56:00,14:56,10846675,8533025,-2313650,SELL
2020-12-02 14:57:00,14:57,10769975,8473675,-2296300,SELL
2020-12-02 14:58:00,14:58,10787450,8503725,-2283725,SELL
2020-12-02 14:59:00,14:59,10799200,8495500,-2303700,SELL
2020-12-02 15:00:00,15:00,10570750,8365500,-2205250,SELL
2020-12-02 15:01:00,15:01,10570750,8360750,-2210000,SELL
2020-12-02 15:02:00,15:02,10584075,8351350,-2232725,SELL
2020-12-02 15:03:00,15:03,10357875,8199650,-2158225,SELL
2020-12-02 15:04:00,15:04,10377250,8185350,-2191900,SELL
2020-12-02 15:05:00,15:05,10383800,8191225,-2192575,SELL
2020-12-02 15:06:00,15:06,10438800,8077750,-2361050,SELL
2020-12-02 15:07:00,15:07,10435050,8060025,-2375025,SELL
2020-12-02 15:08:00,15:08,10409950,8078800,-2331150,SELL
2020-12-02 15:09:00,15:09,10560975,8071575,-2489400,SELL
2020-12-02 15:10:00,15:10,10579750,8062175,-2517575,SELL
2020-12-02 15:11:00,15:11,10559325,8077425,-2481900,SELL
2020-12-02 15:12:00,15:12,10627175,8078175,-2549000,SELL
2020-12-02 15:13:00,15:13,10641925,8030875,-2611050,SELL
2020-12-02 15:14:00,15:14,10625675,8037225,-2588450,SELL
2020-12-02 15:15:00,15:15,10674300,7987675,-2686625,SELL
2020-12-02 15:16:00,15:16,10668250,7977275,-2690975,SELL
2020-12-02 15:17:00,15:17,10672925,8010500,-2662425,SELL
2020-12-02 15:18:00,15:18,10655125,8000375,-2654750,SELL
2020-12-02 15:19:00,15:19,10632050,7986325,-2645725,SELL
2020-12-02 15:20:00,15:20,10636675,7993650,-2643025,SELL
2020-12-02 15:21:00,15:21,10648300,7909225,-2739075,SELL
2020-12-02 15:22:00,15:22,10648950,7907725,-2741225,SELL
2020-12-02 15:23:00,15:23,10643500,7899725,-2743775,SELL
2020-12-02 15:24:00,15:24,10452350,7808700,-2643650,SELL
2020-12-02 15:25:00,15:25,10497700,7811725,-2685975,SELL
2020-12-02 15:26:00,15:26,10494125,7798125,-2696000,SELL
2020-12-02 15:27:00,15:27,10416400,7712425,-2703975,SELL
2020-12-02 15:28:00,15:28,10423075,7693600,-2729475,SELL
2020-12-02 15:29:00,15:29,10439250,7722725,-2716525,SELL
2020-12-03 09:15:00,09:15,8309400,7523525,-785875,SELL
2020-12-03 09:16:00,09:16,10273150,7496575,-2776575,SELL
2020-12-03 09:17:00,09:17,10785450,8151100,-2634350,SELL
2020-12-03 09:18:00,09:18,10741600,8162900,-2578700,SELL
2020-12-03 09:19:00,09:19,10770550,8117450,-2653100,SELL
2020-12-03 09:20:00,09:20,11822750,8865150,-2957600,SELL
2020-12-03 09:21:00,09:21,11823075,8852575,-2970500,SELL
2020-12-03 09:22:00,09:22,11772825,8858150,-2914675,SELL
2020-12-03 09:23:00,09:23,12390275,9343100,-3047175,SELL
2020-12-03 09:24:00,09:24,12354150,9291425,-3062725,SELL
2020-12-03 09:25:00,09:25,12341800,9345625,-2996175,SELL
2020-12-03 09:26:00,09:26,12724600,9551925,-3172675,SELL
2020-12-03 09:27:00,09:27,12724975,9611950,-3113025,SELL
2020-12-03 09:28:00,09:28,12790100,9566625,-3223475,SELL
2020-12-03 09:29:00,09:29,12999075,9665250,-3333825,SELL
2020-12-03 09:30:00,09:30,12977925,9634550,-3343375,SELL
2020-12-03 09:31:00,09:31,12967825,9623000,-3344825,SELL
2020-12-03 09:32:00,09:32,13258375,9980525,-3277850,SELL
2020-12-03 09:33:00,09:33,13245550,10065225,-3180325,SELL
2020-12-03 09:34:00,09:34,13159000,10104625,-3054375,SELL
2020-12-03 09:35:00,09:35,13352575,10345475,-3007100,SELL
2020-12-03 09:36:00,09:36,13388350,10299500,-3088850,SELL
2020-12-03 09:37:00,09:37,13394925,10351975,-3042950,SELL
2020-12-03 09:38:00,09:38,13417825,10395650,-3022175,SELL
2020-12-03 09:39:00,09:39,13472325,10347675,-3124650,SELL
2020-12-03 09:40:00,09:40,13308500,10339625,-2968875,SELL
2020-12-03 09:41:00,09:41,13588500,10404550,-3183950,SELL
2020-12-03 09:42:00,09:42,13501800,10477050,-3024750,SELL
2020-12-03 09:43:00,09:43,13632000,10537200,-3094800,SELL
2020-12-03 09:44:00,09:44,13621850,10632850,-2989000,SELL
2020-12-03 09:45:00,09:45,13712950,10695725,-3017225,SELL
2020-12-03 09:46:00,09:46,13706600,10708025,-2998575,SELL
2020-12-03 09:47:00,09:47,13834400,11077200,-2757200,SELL
2020-12-03 09:48:00,09:48,13808250,11075675,-2732575,SELL
2020-12-03 09:49:00,09:49,13786825,11051000,-2735825,SELL
2020-12-03 09:50:00,09:50,13546900,11454575,-2092325,SELL
2020-12-03 09:51:00,09:51,13535125,11331625,-2203500,SELL
2020-12-03 09:52:00,09:52,13568775,11436725,-2132050,SELL
2020-12-03 09:53:00,09:53,13500350,11886950,-1613400,SELL
2020-12-03 09:54:00,09:54,13489700,11910075,-1579625,SELL
2020-12-03 09:55:00,09:55,13497925,11903150,-1594775,SELL
2020-12-03 09:56:00,09:56,13787500,12034725,-1752775,SELL
2020-12-03 09:57:00,09:57,13667200,11997425,-1669775,SELL
2020-12-03 09:58:00,09:58,13813575,12005125,-1808450,SELL
2020-12-03 09:59:00,09:59,13856600,12307825,-1548775,SELL
2020-12-03 10:00:00,10:00,13926500,12262175,-1664325,SELL
2020-12-03 10:01:00,10:01,13987175,12271075,-1716100,SELL
2020-12-03 10:02:00,10:02,13870050,12568825,-1301225,SELL
2020-12-03 10:03:00,10:03,13857450,12543225,-1314225,SELL
2020-12-03 10:04:00,10:04,13874475,12549875,-1324600,SELL
2020-12-03 10:05:00,10:05,13777275,12671675,-1105600,SELL
2020-12-03 10:06:00,10:06,13829800,12657950,-1171850,SELL
2020-12-03 10:07:00,10:07,13773950,12536650,-1237300,SELL
2020-12-03 10:08:00,10:08,13932075,12637925,-1294150,SELL
2020-12-03 10:09:00,10:09,14008375,12749500,-1258875,SELL
2020-12-03 10:10:00,10:10,13822575,12762875,-1059700,SELL
2020-12-03 10:11:00,10:11,14020625,12952100,-1068525,SELL
2020-12-03 10:12:00,10:12,12817025,12898400,81375,BUY
2020-12-03 10:13:00,10:13,14058275,12974700,-1083575,SELL
2020-12-03 10:14:00,10:14,13916500,13237100,-679400,SELL
2020-12-03 10:15:00,10:15,14006275,13246975,-759300,SELL
2020-12-03 10:16:00,10:16,13927700,13235125,-692575,SELL
2020-12-03 10:17:00,10:17,13620025,13510150,-109875,SELL
2020-12-03 10:18:00,10:18,13653900,13461725,-192175,SELL
2020-12-03 10:19:00,10:19,13750950,13484275,-266675,SELL
2020-12-03 10:20:00,10:20,13535125,13699425,164300,BUY
2020-12-03 10:21:00,10:21,13502600,13703025,200425,BUY
2020-12-03 10:22:00,10:22,13371525,13675525,304000,BUY
2020-12-03 10:23:00,10:23,13380675,13915350,534675,BUY
2020-12-03 10:24:00,10:24,13353125,13827200,474075,BUY
2020-12-03 10:25:00,10:25,13417225,13919300,502075,BUY
2020-12-03 10:26:00,10:26,13186050,13978400,792350,BUY
2020-12-03 10:27:00,10:27,13220100,13982400,762300,BUY
2020-12-03 10:28:00,10:28,13094650,13976900,882250,BUY
2020-12-03 10:29:00,10:29,13426175,14131800,705625,BUY
2020-12-03 10:30:00,10:30,13390375,14054550,664175,BUY
2020-12-03 10:31:00,10:31,13417275,13778575,361300,BUY
2020-12-03 10:32:00,10:32,13258625,14333075,1074450,BUY
2020-12-03 10:33:00,10:33,13367625,14284575,916950,BUY
2020-12-03 10:34:00,10:34,13224450,14140950,916500,BUY
2020-12-03 10:35:00,10:35,13507200,14448350,941150,BUY
2020-12-03 10:36:00,10:36,13463750,14455775,992025,BUY
2020-12-03 10:37:00,10:37,13426275,14578175,1151900,BUY
2020-12-03 10:38:00,10:38,13323750,14775275,1451525,BUY
2020-12-03 10:39:00,10:39,13421975,14775625,1353650,BUY
2020-12-03 10:40:00,10:40,13343450,14772875,1429425,BUY
2020-12-03 10:41:00,10:41,13457975,14736325,1278350,BUY
2020-12-03 10:42:00,10:42,13437400,14722375,1284975,BUY
2020-12-03 10:43:00,10:43,13424725,14728900,1304175,BUY
2020-12-03 10:44:00,10:44,13207725,14690275,1482550,BUY
2020-12-03 10:45:00,10:45,13324525,14696475,1371950,BUY
2020-12-03 10:46:00,10:46,13448825,14423875,975050,BUY
2020-12-03 10:47:00,10:47,13523650,14576125,1052475,BUY
2020-12-03 10:48:00,10:48,13512925,14634350,1121425,BUY
2020-12-03 10:49:00,10:49,12928250,14631700,1703450,BUY
2020-12-03 10:50:00,10:50,13547925,14736425,1188500,BUY
2020-12-03 10:51:00,10:51,13578450,14571425,992975,BUY
2020-12-03 10:52:00,10:52,13472800,14659800,1187000,BUY
2020-12-03 10:53:00,10:53,13638450,14664950,1026500,BUY
2020-12-03 10:54:00,10:54,13696525,14433500,736975,BUY
2020-12-03 10:55:00,10:55,13550025,14465575,915550,BUY
2020-12-03 10:56:00,10:56,13735150,14863600,1128450,BUY
2020-12-03 10:57:00,10:57,13757850,14821925,1064075,BUY
2020-12-03 10:58:00,10:58,13717025,14842425,1125400,BUY
2020-12-03 10:59:00,10:59,13914025,14569850,655825,BUY
2020-12-03 11:00:00,11:00,13875425,14611150,735725,BUY
2020-12-03 11:01:00,11:01,13362675,14635725,1273050,BUY
2020-12-03 11:02:00,11:02,14104125,14569450,465325,BUY
2020-12-03 11:03:00,11:03,14098575,14566500,467925,BUY
2020-12-03 11:04:00,11:04,14133075,14559575,426500,BUY
2020-12-03 11:05:00,11:05,14131000,14589875,458875,BUY
2020-12-03 11:06:00,11:06,14139825,14502950,363125,BUY
2020-12-03 11:07:00,11:07,14173625,14597325,423700,BUY
2020-12-03 11:08:00,11:08,14231800,14719300,487500,BUY
2020-12-03 11:09:00,11:09,14021175,14644325,623150,BUY
2020-12-03 11:10:00,11:10,14061075,14675200,614125,BUY
2020-12-03 11:11:00,11:11,14021550,13968725,-52825,SELL
2020-12-03 11:12:00,11:12,14041675,14674000,632325,BUY
2020-12-03 11:13:00,11:13,14032675,14776825,744150,BUY
2020-12-03 11:14:00,11:14,14248700,14856250,607550,BUY
2020-12-03 11:15:00,11:15,14114675,14456550,341875,BUY
2020-12-03 11:16:00,11:16,14183850,14755750,571900,BUY
2020-12-03 11:17:00,11:17,14272950,14016900,-256050,SELL
2020-12-03 11:18:00,11:18,14324625,14879050,554425,BUY
2020-12-03 11:19:00,11:19,14286225,14843375,557150,BUY
2020-12-03 11:20:00,11:20,14104950,14979125,874175,BUY
2020-12-03 11:21:00,11:21,14377075,14875475,498400,BUY
2020-12-03 11:22:00,11:22,14299900,14921050,621150,BUY
2020-12-03 11:23:00,11:23,14578650,14804625,225975,BUY
2020-12-03 11:24:00,11:24,14387350,14836750,449400,BUY
2020-12-03 11:25:00,11:25,14138125,14910175,772050,BUY
2020-12-03 11:26:00,11:26,13862475,14952325,1089850,BUY
2020-12-03 11:27:00,11:27,14518375,14929300,410925,BUY
2020-12-03 11:28:00,11:28,14636225,14850675,214450,BUY
2020-12-03 11:29:00,11:29,14671925,14916475,244550,BUY
2020-12-03 11:30:00,11:30,14439050,14765925,326875,BUY
2020-12-03 11:31:00,11:31,14685925,14882175,196250,BUY
2020-12-03 11:32:00,11:32,14769900,14704450,-65450,SELL
2020-12-03 11:33:00,11:33,14854350,14966900,112550,BUY
2020-12-03 11:34:00,11:34,14825950,14905375,79425,BUY
2020-12-03 11:35:00,11:35,14860950,14575550,-285400,SELL
2020-12-03 11:36:00,11:36,14795525,14586325,-209200,SELL
2020-12-03 11:37:00,11:37,14589250,14605075,15825,BUY
2020-12-03 11:38:00,11:38,14696500,14661575,-34925,SELL
2020-12-03 11:39:00,11:39,14787825,14630300,-157525,SELL
2020-12-03 11:40:00,11:40,14780675,14660175,-120500,SELL
2020-12-03 11:41:00,11:41,14748950,14691850,-57100,SELL
2020-12-03 11:42:00,11:42,14681125,14624975,-56150,SELL
2020-12-03 11:43:00,11:43,14725700,14683650,-42050,SELL
2020-12-03 11:44:00,11:44,14879600,14819450,-60150,SELL
2020-12-03 11:45:00,11:45,14367950,14754650,386700,BUY
2020-12-03 11:46:00,11:46,13764175,14730200,966025,BUY
2020-12-03 11:47:00,11:47,14851525,14005525,-846000,SELL
2020-12-03 11:48:00,11:48,15059725,14868825,-190900,SELL
2020-12-03 11:49:00,11:49,14778925,14239050,-539875,SELL
2020-12-03 11:50:00,11:50,14858350,14916500,58150,BUY
2020-12-03 11:51:00,11:51,15215050,14843950,-371100,SELL
2020-12-03 11:52:00,11:52,15077975,14867025,-210950,SELL
2020-12-03 11:53:00,11:53,15078550,14899500,-179050,SELL
2020-12-03 11:54:00,11:54,15019625,14844125,-175500,SELL
2020-12-03 11:55:00,11:55,15088650,14185100,-903550,SELL
2020-12-03 11:56:00,11:56,15094800,14902050,-192750,SELL
2020-12-03 11:57:00,11:57,14603500,14865775,262275,BUY
2020-12-03 11:58:00,11:58,14908325,14227725,-680600,SELL
2020-12-03 11:59:00,11:59,15255700,15021525,-234175,SELL
2020-12-03 12:00:00,12:00,14525100,14144575,-380525,SELL
2020-12-03 12:01:00,12:01,14551075,14173725,-377350,SELL
2020-12-03 12:02:00,12:02,14718725,14727700,8975,BUY
2020-12-03 12:03:00,12:03,15235250,14888550,-346700,SELL
2020-12-03 12:04:00,12:04,14881375,14826450,-54925,SELL
2020-12-03 12:05:00,12:05,15573875,14819325,-754550,SELL
2020-12-03 12:06:00,12:06,15396900,14826750,-570150,SELL
2020-12-03 12:07:00,12:07,15441725,14832775,-608950,SELL
2020-12-03 12:08:00,12:08,15501600,14770775,-730825,SELL
2020-12-03 12:09:00,12:09,15501725,14808800,-692925,SELL
2020-12-03 12:10:00,12:10,15623175,14705375,-917800,SELL
2020-12-03 12:11:00,12:11,15589075,14703000,-886075,SELL
2020-12-03 12:12:00,12:12,15749625,14801150,-948475,SELL
2020-12-03 12:13:00,12:13,15724750,14784575,-940175,SELL
2020-12-03 12:14:00,12:14,15347025,14880275,-466750,SELL
2020-12-03 12:15:00,12:15,15741925,14925375,-816550,SELL
2020-12-03 12:16:00,12:16,15814625,14880650,-933975,SELL
2020-12-03 12:17:00,12:17,15981900,14874800,-1107100,SELL
2020-12-03 12:18:00,12:18,15990450,14885750,-1104700,SELL
2020-12-03 12:19:00,12:19,15885825,14893875,-991950,SELL
2020-12-03 12:20:00,12:20,16238800,14504525,-1734275,SELL
2020-12-03 12:21:00,12:21,16217075,14527300,-1689775,SELL
2020-12-03 12:22:00,12:22,16266600,14493175,-1773425,SELL
2020-12-03 12:23:00,12:23,16464325,13870675,-2593650,SELL
2020-12-03 12:24:00,12:24,16485825,13929525,-2556300,SELL
2020-12-03 12:25:00,12:25,16457775,13915550,-2542225,SELL
2020-12-03 12:26:00,12:26,16553675,13968150,-2585525,SELL
2020-12-03 12:27:00,12:27,16512900,14014625,-2498275,SELL
2020-12-03 12:28:00,12:28,16549075,13958525,-2590550,SELL
2020-12-03 12:29:00,12:29,16651700,13870425,-2781275,SELL
2020-12-03 12:30:00,12:30,16684150,14157650,-2526500,SELL
2020-12-03 12:31:00,12:31,16684900,14180675,-2504225,SELL
2020-12-03 12:32:00,12:32,16747625,14186050,-2561575,SELL
2020-12-03 12:33:00,12:33,16660275,14119425,-2540850,SELL
2020-12-03 12:34:00,12:34,16728475,13543150,-3185325,SELL
2020-12-03 12:35:00,12:35,16715050,14321375,-2393675,SELL
2020-12-03 12:36:00,12:36,15968175,14302375,-1665800,SELL
2020-12-03 12:37:00,12:37,16533750,14243275,-2290475,SELL
2020-12-03 12:38:00,12:38,16686825,14495075,-2191750,SELL
2020-12-03 12:39:00,12:39,16682625,14475500,-2207125,SELL
2020-12-03 12:40:00,12:40,16645825,14483075,-2162750,SELL
2020-12-03 12:41:00,12:41,16463225,14579850,-1883375,SELL
2020-12-03 12:42:00,12:42,16435450,14569450,-1866000,SELL
2020-12-03 12:43:00,12:43,16614500,14534100,-2080400,SELL
2020-12-03 12:44:00,12:44,16589075,14599475,-1989600,SELL
2020-12-03 12:45:00,12:45,16714100,14615575,-2098525,SELL
2020-12-03 12:46:00,12:46,16464650,14574525,-1890125,SELL
2020-12-03 12:47:00,12:47,16635750,14513300,-2122450,SELL
2020-12-03 12:48:00,12:48,16702150,14475775,-2226375,SELL
2020-12-03 12:49:00,12:49,16424475,14573750,-1850725,SELL
2020-12-03 12:50:00,12:50,16662650,14593000,-2069650,SELL
2020-12-03 12:51:00,12:51,16655925,14650700,-2005225,SELL
2020-12-03 12:52:00,12:52,16535600,14747725,-1787875,SELL
2020-12-03 12:53:00,12:53,16731700,14714075,-2017625,SELL
2020-12-03 12:54:00,12:54,16649775,14729925,-1919850,SELL
2020-12-03 12:55:00,12:55,16776975,14750200,-2026775,SELL
2020-12-03 12:56:00,12:56,17010725,14034275,-2976450,SELL
2020-12-03 12:57:00,12:57,16898250,13983525,-2914725,SELL
2020-12-03 12:58:00,12:58,16902950,13988600,-2914350,SELL
2020-12-03 12:59:00,12:59,17389825,13695900,-3693925,SELL
2020-12-03 13:00:00,13:00,17422550,13742750,-3679800,SELL
2020-12-03 13:01:00,13:01,17370550,13067650,-4302900,SELL
2020-12-03 13:02:00,13:02,17451925,13467425,-3984500,SELL
2020-12-03 13:03:00,13:03,17327425,13482125,-3845300,SELL
2020-12-03 13:04:00,13:04,17448200,13401375,-4046825,SELL
2020-12-03 13:05:00,13:05,17686225,13486150,-4200075,SELL
2020-12-03 13:06:00,13:06,17615475,12767100,-4848375,SELL
2020-12-03 13:07:00,13:07,17537075,13409675,-4127400,SELL
2020-12-03 13:08:00,13:08,17600200,13639525,-3960675,SELL
2020-12-03 13:09:00,13:09,17751575,12895875,-4855700,SELL
2020-12-03 13:10:00,13:10,17696100,13581125,-4114975,SELL
2020-12-03 13:11:00,13:11,17840125,12903775,-4936350,SELL
2020-12-03 13:12:00,13:12,17802250,13526675,-4275575,SELL
2020-12-03 13:13:00,13:13,17740525,13558050,-4182475,SELL
2020-12-03 13:14:00,13:14,17831950,13777450,-4054500,SELL
2020-12-03 13:15:00,13:15,17804675,13708150,-4096525,SELL
2020-12-03 13:16:00,13:16,17772400,13640625,-4131775,SELL
2020-12-03 13:17:00,13:17,17838200,13728900,-4109300,SELL
2020-12-03 13:18:00,13:18,17941050,12905150,-5035900,SELL
2020-12-03 13:19:00,13:19,17809550,13681950,-4127600,SELL
2020-12-03 13:20:00,13:20,18017225,13692100,-4325125,SELL
2020-12-03 13:21:00,13:21,17994450,13808575,-4185875,SELL
2020-12-03 13:22:00,13:22,17965475,13772925,-4192550,SELL
2020-12-03 13:23:00,13:23,17853250,13848625,-4004625,SELL
2020-12-03 13:24:00,13:24,17801125,13966575,-3834550,SELL
2020-12-03 13:25:00,13:25,17797700,13889700,-3908000,SELL
2020-12-03 13:26:00,13:26,17779225,14073000,-3706225,SELL
2020-12-03 13:27:00,13:27,17912150,14115525,-3796625,SELL
2020-12-03 13:28:00,13:28,17885200,14052075,-3833125,SELL
2020-12-03 13:29:00,13:29,17765100,13350700,-4414400,SELL
2020-12-03 13:30:00,13:30,17819875,13954125,-3865750,SELL
2020-12-03 13:31:00,13:31,17808475,13969250,-3839225,SELL
2020-12-03 13:32:00,13:32,17871725,14204250,-3667475,SELL
2020-12-03 13:33:00,13:33,17910825,13570700,-4340125,SELL
2020-12-03 13:34:00,13:34,17997125,14282875,-3714250,SELL
2020-12-03 13:35:00,13:35,17938775,13930150,-4008625,SELL
2020-12-03 13:36:00,13:36,17935175,13846325,-4088850,SELL
2020-12-03 13:37:00,13:37,17836625,13853800,-3982825,SELL
2020-12-03 13:38:00,13:38,17880150,13832000,-4048150,SELL
2020-12-03 13:39:00,13:39,18097375,14091475,-4005900,SELL
2020-12-03 13:40:00,13:40,18062800,13958400,-4104400,SELL
2020-12-03 13:41:00,13:41,17170125,14070500,-3099625,SELL
2020-12-03 13:42:00,13:42,17707700,13358025,-4349675,SELL
2020-12-03 13:43:00,13:43,17704100,14055125,-3648975,SELL
2020-12-03 13:44:00,13:44,17990725,14065025,-3925700,SELL
2020-12-03 13:45:00,13:45,17914750,13931625,-3983125,SELL
2020-12-03 13:46:00,13:46,17647050,13529575,-4117475,SELL
2020-12-03 13:47:00,13:47,17525000,13579125,-3945875,SELL
2020-12-03 13:48:00,13:48,17911725,14374275,-3537450,SELL
2020-12-03 13:49:00,13:49,17943225,14301775,-3641450,SELL
2020-12-03 13:50:00,13:50,17876050,14254275,-3621775,SELL
2020-12-03 13:51:00,13:51,17367325,13975325,-3392000,SELL
2020-12-03 13:52:00,13:52,17289075,14030275,-3258800,SELL
2020-12-03 13:53:00,13:53,17360400,13934700,-3425700,SELL
2020-12-03 13:54:00,13:54,17418675,14034450,-3384225,SELL
2020-12-03 13:55:00,13:55,17460200,14059525,-3400675,SELL
2020-12-03 13:56:00,13:56,17393200,14012000,-3381200,SELL
2020-12-03 13:57:00,13:57,17311525,14100825,-3210700,SELL
2020-12-03 13:58:00,13:58,17306900,14058075,-3248825,SELL
2020-12-03 13:59:00,13:59,17291550,14175925,-3115625,SELL
2020-12-03 14:00:00,14:00,17222475,14061650,-3160825,SELL
2020-12-03 14:01:00,14:01,17210675,14049475,-3161200,SELL
2020-12-03 14:02:00,14:02,17267825,13844450,-3423375,SELL
2020-12-03 14:03:00,14:03,17335300,13978500,-3356800,SELL
2020-12-03 14:04:00,14:04,16896950,13967825,-2929125,SELL
2020-12-03 14:05:00,14:05,16875175,14072050,-2803125,SELL
2020-12-03 14:06:00,14:06,17234100,14190250,-3043850,SELL
2020-12-03 14:07:00,14:07,17233200,12895050,-4338150,SELL
2020-12-03 14:08:00,14:08,16835175,13988200,-2846975,SELL
2020-12-03 14:09:00,14:09,17198925,14243900,-2955025,SELL
2020-12-03 14:10:00,14:10,17188275,14196300,-2991975,SELL
2020-12-03 14:11:00,14:11,17203075,14229200,-2973875,SELL
2020-12-03 14:12:00,14:12,16317150,13482550,-2834600,SELL
2020-12-03 14:13:00,14:13,16843550,14217450,-2626100,SELL
2020-12-03 14:14:00,14:14,16782125,14267125,-2515000,SELL
2020-12-03 14:15:00,14:15,16940700,14269675,-2671025,SELL
2020-12-03 14:16:00,14:16,16828800,13577125,-3251675,SELL
2020-12-03 14:17:00,14:17,16989700,14398625,-2591075,SELL
2020-12-03 14:18:00,14:18,16949425,14121325,-2828100,SELL
2020-12-03 14:19:00,14:19,16965825,14090000,-2875825,SELL
2020-12-03 14:20:00,14:20,17043575,14101275,-2942300,SELL
2020-12-03 14:21:00,14:21,16831825,13408325,-3423500,SELL
2020-12-03 14:22:00,14:22,16860200,13508625,-3351575,SELL
2020-12-03 14:23:00,14:23,16830150,13567025,-3263125,SELL
2020-12-03 14:24:00,14:24,16726475,13564275,-3162200,SELL
2020-12-03 14:25:00,14:25,16894350,13609950,-3284400,SELL
2020-12-03 14:26:00,14:26,16930975,13513800,-3417175,SELL
2020-12-03 14:27:00,14:27,16879975,13615025,-3264950,SELL
2020-12-03 14:28:00,14:28,16926300,13630500,-3295800,SELL
2020-12-03 14:29:00,14:29,16802475,13608100,-3194375,SELL
2020-12-03 14:30:00,14:30,16629150,13763975,-2865175,SELL
2020-12-03 14:31:00,14:31,16830600,13780750,-3049850,SELL
2020-12-03 14:32:00,14:32,16890350,13760650,-3129700,SELL
2020-12-03 14:33:00,14:33,16399100,13857650,-2541450,SELL
2020-12-03 14:34:00,14:34,16613575,13916475,-2697100,SELL
2020-12-03 14:35:00,14:35,16620350,13894550,-2725800,SELL
2020-12-03 14:36:00,14:36,16338325,13665375,-2672950,SELL
2020-12-03 14:37:00,14:37,16361975,13650550,-2711425,SELL
2020-12-03 14:38:00,14:38,15932550,12883125,-3049425,SELL
2020-12-03 14:39:00,14:39,16318600,13685875,-2632725,SELL
2020-12-03 14:40:00,14:40,16494300,13681400,-2812900,SELL
2020-12-03 14:41:00,14:41,15962475,13412900,-2549575,SELL
2020-12-03 14:42:00,14:42,16442875,13588000,-2854875,SELL
2020-12-03 14:43:00,14:43,16484175,13591475,-2892700,SELL
2020-12-03 14:44:00,14:44,16445575,13607325,-2838250,SELL
2020-12-03 14:45:00,14:45,16248950,13599150,-2649800,SELL
2020-12-03 14:46:00,14:46,16332225,13453475,-2878750,SELL
2020-12-03 14:47:00,14:47,16300650,13522150,-2778500,SELL
2020-12-03 14:48:00,14:48,16016725,12739325,-3277400,SELL
2020-12-03 14:49:00,14:49,16118025,13461550,-2656475,SELL
2020-12-03 14:50:00,14:50,16073275,13456200,-2617075,SELL
2020-12-03 14:51:00,14:51,15835325,13020375,-2814950,SELL
2020-12-03 14:52:00,14:52,15956625,13042275,-2914350,SELL
2020-12-03 14:53:00,14:53,15350125,13096025,-2254100,SELL
2020-12-03 14:54:00,14:54,15771625,12929650,-2841975,SELL
2020-12-03 14:55:00,14:55,15743950,12939100,-2804850,SELL
2020-12-03 14:56:00,14:56,15795050,12971050,-2824000,SELL
2020-12-03 14:57:00,14:57,15547375,12671100,-2876275,SELL
2020-12-03 14:58:00,14:58,15596075,12725250,-2870825,SELL
2020-12-03 14:59:00,14:59,15202300,12718475,-2483825,SELL
2020-12-03 15:00:00,15:00,15256600,12731275,-2525325,SELL
2020-12-03 15:01:00,15:01,15224700,12732475,-2492225,SELL
2020-12-03 15:02:00,15:02,15266125,12767350,-2498775,SELL
2020-12-03 15:03:00,15:03,15247100,12537550,-2709550,SELL
2020-12-03 15:04:00,15:04,15291425,12509300,-2782125,SELL
2020-12-03 15:05:00,15:05,15295000,12384800,-2910200,SELL
2020-12-03 15:06:00,15:06,15160100,12295600,-2864500,SELL
2020-12-03 15:07:00,15:07,15161425,12332225,-2829200,SELL
2020-12-03 15:08:00,15:08,15083775,12280500,-2803275,SELL
2020-12-03 15:09:00,15:09,14844275,11982125,-2862150,SELL
2020-12-03 15:10:00,15:10,14913925,12056425,-2857500,SELL
2020-12-03 15:11:00,15:11,14920625,11979275,-2941350,SELL
2020-12-03 15:12:00,15:12,14504525,11599100,-2905425,SELL
2020-12-03 15:13:00,15:13,14642950,11536425,-3106525,SELL
2020-12-03 15:14:00,15:14,14668200,11611675,-3056525,SELL
2020-12-03 15:15:00,15:15,14208575,11463525,-2745050,SELL
2020-12-03 15:16:00,15:16,14218300,11383825,-2834475,SELL
2020-12-03 15:17:00,15:17,14186250,11437950,-2748300,SELL
2020-12-03 15:18:00,15:18,13407950,11033650,-2374300,SELL
2020-12-03 15:19:00,15:19,13363850,10345950,-3017900,SELL
2020-12-03 15:20:00,15:20,13295250,11097250,-2198000,SELL
2020-12-03 15:21:00,15:21,12601475,10367675,-2233800,SELL
2020-12-03 15:22:00,15:22,12575375,9671825,-2903550,SELL
2020-12-03 15:23:00,15:23,12578775,9085750,-3493025,SELL
2020-12-03 15:24:00,15:24,11872925,8399100,-3473825,SELL
2020-12-03 15:25:00,15:25,11824475,8445775,-3378700,SELL
2020-12-03 15:26:00,15:26,11735925,8893100,-2842825,SELL
2020-12-03 15:27:00,15:27,10753300,6430800,-4322500,SELL
2020-12-03 15:28:00,15:28,10897875,8756925,-2140950,SELL
2020-12-03 15:29:00,15:29,10739925,8065425,-2674500,SELL
