,timestamp,call,put,diff,sellOrBuy
2020-10-09 09:15:00,09:15,2629050,2875625,246575,BUY
2020-10-09 09:16:00,09:16,2629900,2875675,245775,BUY
2020-10-09 09:17:00,09:17,2867700,3222975,355275,BUY
2020-10-09 09:18:00,09:18,2869050,3222575,353525,BUY
2020-10-09 09:19:00,09:19,2869050,3224625,355575,BUY
2020-10-09 09:20:00,09:20,3219850,3569150,349300,BUY
2020-10-09 09:21:00,09:21,3213900,3564825,350925,BUY
2020-10-09 09:22:00,09:22,3216800,3563800,347000,BUY
2020-10-09 09:23:00,09:23,3444150,3855275,411125,BUY
2020-10-09 09:24:00,09:24,3466650,3870700,404050,BUY
2020-10-09 09:25:00,09:25,3468575,3885225,416650,BUY
2020-10-09 09:26:00,09:26,3559525,4041075,481550,BUY
2020-10-09 09:27:00,09:27,3581550,4058000,476450,BUY
2020-10-09 09:28:00,09:28,3585100,4058175,473075,BUY
2020-10-09 09:29:00,09:29,3736350,4182950,446600,BUY
2020-10-09 09:30:00,09:30,3733100,4201550,468450,BUY
2020-10-09 09:31:00,09:31,3733100,4180900,447800,BUY
2020-10-09 09:32:00,09:32,3872850,4326975,454125,BUY
2020-10-09 09:33:00,09:33,3831525,4312350,480825,BUY
2020-10-09 09:34:00,09:34,3870475,4331900,461425,BUY
2020-10-09 09:35:00,09:35,3947725,4407125,459400,BUY
2020-10-09 09:36:00,09:36,3950400,4416600,466200,BUY
2020-10-09 09:37:00,09:37,3957875,4430675,472800,BUY
2020-10-09 09:38:00,09:38,3984325,4511900,527575,BUY
2020-10-09 09:39:00,09:39,3982975,4519575,536600,BUY
2020-10-09 09:40:00,09:40,4012025,4520675,508650,BUY
2020-10-09 09:41:00,09:41,4027925,4609425,581500,BUY
2020-10-09 09:42:00,09:42,4022275,4611125,588850,BUY
2020-10-09 09:43:00,09:43,4025000,4597950,572950,BUY
2020-10-09 09:44:00,09:44,4181050,4733350,552300,BUY
2020-10-09 09:45:00,09:45,4168650,4727400,558750,BUY
2020-10-09 09:46:00,09:46,4125200,4721200,596000,BUY
2020-10-09 09:47:00,09:47,4227525,4838750,611225,BUY
2020-10-09 09:48:00,09:48,4221100,4845850,624750,BUY
2020-10-09 09:49:00,09:49,4230750,4830000,599250,BUY
2020-10-09 09:50:00,09:50,4327175,4897425,570250,BUY
2020-10-09 09:51:00,09:51,4305250,4883750,578500,BUY
2020-10-09 09:52:00,09:52,4322875,4877575,554700,BUY
2020-10-09 09:53:00,09:53,4387825,4984925,597100,BUY
2020-10-09 09:54:00,09:54,4388600,5013825,625225,BUY
2020-10-09 09:55:00,09:55,4421725,5023825,602100,BUY
2020-10-09 09:56:00,09:56,4464950,5072050,607100,BUY
2020-10-09 09:57:00,09:57,4467625,5068350,600725,BUY
2020-10-09 09:58:00,09:58,4432450,5069000,636550,BUY
2020-10-09 09:59:00,09:59,4513350,5110025,596675,BUY
2020-10-09 10:00:00,10:00,4547375,5108475,561100,BUY
2020-10-09 10:01:00,10:01,4517650,5120075,602425,BUY
2020-10-09 10:02:00,10:02,4612700,5166150,553450,BUY
2020-10-09 10:03:00,10:03,4592725,5219450,626725,BUY
2020-10-09 10:04:00,10:04,4585125,5225050,639925,BUY
2020-10-09 10:05:00,10:05,4754225,5373275,619050,BUY
2020-10-09 10:06:00,10:06,4752250,5368825,616575,BUY
2020-10-09 10:07:00,10:07,4743325,5374625,631300,BUY
2020-10-09 10:08:00,10:08,4787350,5547400,760050,BUY
2020-10-09 10:09:00,10:09,4751225,5539100,787875,BUY
2020-10-09 10:10:00,10:10,4790775,5546375,755600,BUY
2020-10-09 10:11:00,10:11,4925850,5647250,721400,BUY
2020-10-09 10:12:00,10:12,4930175,5677750,747575,BUY
2020-10-09 10:13:00,10:13,4913350,5661200,747850,BUY
2020-10-09 10:14:00,10:14,4999775,5766700,766925,BUY
2020-10-09 10:15:00,10:15,4949850,5774825,824975,BUY
2020-10-09 10:16:00,10:16,4987325,5766400,779075,BUY
2020-10-09 10:17:00,10:17,5107850,5894200,786350,BUY
2020-10-09 10:18:00,10:18,5134700,5909350,774650,BUY
2020-10-09 10:19:00,10:19,5123875,5892925,769050,BUY
2020-10-09 10:20:00,10:20,5159250,6019725,860475,BUY
2020-10-09 10:21:00,10:21,5192950,5994050,801100,BUY
2020-10-09 10:22:00,10:22,5187400,6016375,828975,BUY
2020-10-09 10:23:00,10:23,5229725,6111525,881800,BUY
2020-10-09 10:24:00,10:24,5229725,6117700,887975,BUY
2020-10-09 10:25:00,10:25,5230425,6127825,897400,BUY
2020-10-09 10:26:00,10:26,5228250,6220325,992075,BUY
2020-10-09 10:27:00,10:27,5262400,6213150,950750,BUY
2020-10-09 10:28:00,10:28,5266750,6231800,965050,BUY
2020-10-09 10:29:00,10:29,5207325,6257225,1049900,BUY
2020-10-09 10:30:00,10:30,5225700,6308700,1083000,BUY
2020-10-09 10:31:00,10:31,5242400,6306800,1064400,BUY
2020-10-09 10:32:00,10:32,5290650,6434425,1143775,BUY
2020-10-09 10:33:00,10:33,5320500,6393775,1073275,BUY
2020-10-09 10:34:00,10:34,5317850,6416400,1098550,BUY
2020-10-09 10:35:00,10:35,5388925,6521200,1132275,BUY
2020-10-09 10:36:00,10:36,5396000,6552475,1156475,BUY
2020-10-09 10:37:00,10:37,5358300,6527950,1169650,BUY
2020-10-09 10:38:00,10:38,5379325,6561675,1182350,BUY
2020-10-09 10:39:00,10:39,5391525,6573025,1181500,BUY
2020-10-09 10:40:00,10:40,5393000,6552000,1159000,BUY
2020-10-09 10:41:00,10:41,5266450,6611875,1345425,BUY
2020-10-09 10:42:00,10:42,5267150,6646625,1379475,BUY
2020-10-09 10:43:00,10:43,5306700,6666725,1360025,BUY
2020-10-09 10:44:00,10:44,5177550,6845125,1667575,BUY
2020-10-09 10:45:00,10:45,5186050,6846075,1660025,BUY
2020-10-09 10:46:00,10:46,5170250,6827700,1657450,BUY
2020-10-09 10:47:00,10:47,5129250,7105375,1976125,BUY
2020-10-09 10:48:00,10:48,5158750,7070475,1911725,BUY
2020-10-09 10:49:00,10:49,5159975,7070050,1910075,BUY
2020-10-09 10:50:00,10:50,5217775,7272775,2055000,BUY
2020-10-09 10:51:00,10:51,5213900,7296075,2082175,BUY
2020-10-09 10:52:00,10:52,5226950,7281075,2054125,BUY
2020-10-09 10:53:00,10:53,5264100,7390050,2125950,BUY
2020-10-09 10:54:00,10:54,5270275,7406425,2136150,BUY
2020-10-09 10:55:00,10:55,5267925,7405025,2137100,BUY
2020-10-09 10:56:00,10:56,5362700,7480625,2117925,BUY
2020-10-09 10:57:00,10:57,5346925,7454825,2107900,BUY
2020-10-09 10:58:00,10:58,5352025,7465625,2113600,BUY
2020-10-09 10:59:00,10:59,5353050,7542825,2189775,BUY
2020-10-09 11:00:00,11:00,5338775,7552450,2213675,BUY
2020-10-09 11:01:00,11:01,5375125,7545025,2169900,BUY
2020-10-09 11:02:00,11:02,5357575,7653700,2296125,BUY
2020-10-09 11:03:00,11:03,5358000,7679025,2321025,BUY
2020-10-09 11:04:00,11:04,5357450,7680850,2323400,BUY
2020-10-09 11:05:00,11:05,4973750,7734850,2761100,BUY
2020-10-09 11:06:00,11:06,4972700,7742050,2769350,BUY
2020-10-09 11:07:00,11:07,4974200,7758425,2784225,BUY
2020-10-09 11:08:00,11:08,4943650,7858550,2914900,BUY
2020-10-09 11:09:00,11:09,4942125,7815525,2873400,BUY
2020-10-09 11:10:00,11:10,4942725,7853150,2910425,BUY
2020-10-09 11:11:00,11:11,4910175,8058275,3148100,BUY
2020-10-09 11:12:00,11:12,4877525,8054575,3177050,BUY
2020-10-09 11:13:00,11:13,4898550,8026550,3128000,BUY
2020-10-09 11:14:00,11:14,4934150,8194000,3259850,BUY
2020-10-09 11:15:00,11:15,4956775,8217175,3260400,BUY
2020-10-09 11:16:00,11:16,4957000,8210350,3253350,BUY
2020-10-09 11:17:00,11:17,5003350,8358750,3355400,BUY
2020-10-09 11:18:00,11:18,5016175,8363500,3347325,BUY
2020-10-09 11:19:00,11:19,4986250,8358900,3372650,BUY
2020-10-09 11:20:00,11:20,4986875,8402650,3415775,BUY
2020-10-09 11:21:00,11:21,5009700,8427600,3417900,BUY
2020-10-09 11:22:00,11:22,4999000,8462675,3463675,BUY
2020-10-09 11:23:00,11:23,5114225,8420350,3306125,BUY
2020-10-09 11:24:00,11:24,5080450,8397925,3317475,BUY
2020-10-09 11:25:00,11:25,5077525,8419675,3342150,BUY
2020-10-09 11:26:00,11:26,5127625,8382475,3254850,BUY
2020-10-09 11:27:00,11:27,5108200,8396200,3288000,BUY
2020-10-09 11:28:00,11:28,5105100,8396925,3291825,BUY
2020-10-09 11:29:00,11:29,5109125,8432550,3323425,BUY
2020-10-09 11:30:00,11:30,5100025,8428600,3328575,BUY
2020-10-09 11:31:00,11:31,5105975,8405250,3299275,BUY
2020-10-09 11:32:00,11:32,5195700,8466375,3270675,BUY
2020-10-09 11:33:00,11:33,5237150,8463675,3226525,BUY
2020-10-09 11:34:00,11:34,5200075,8447725,3247650,BUY
2020-10-09 11:35:00,11:35,5246475,8509350,3262875,BUY
2020-10-09 11:36:00,11:36,5234175,8518375,3284200,BUY
2020-10-09 11:37:00,11:37,5187450,8526350,3338900,BUY
2020-10-09 11:38:00,11:38,5211500,8465700,3254200,BUY
2020-10-09 11:39:00,11:39,5229975,8459350,3229375,BUY
2020-10-09 11:40:00,11:40,5218950,8482925,3263975,BUY
2020-10-09 11:41:00,11:41,5274050,8482650,3208600,BUY
2020-10-09 11:42:00,11:42,5301125,8488350,3187225,BUY
2020-10-09 11:43:00,11:43,5249475,8469300,3219825,BUY
2020-10-09 11:44:00,11:44,5299925,8494125,3194200,BUY
2020-10-09 11:45:00,11:45,5324550,8479625,3155075,BUY
2020-10-09 11:46:00,11:46,5315525,8526900,3211375,BUY
2020-10-09 11:47:00,11:47,5283450,8601475,3318025,BUY
2020-10-09 11:48:00,11:48,5237500,8597100,3359600,BUY
2020-10-09 11:49:00,11:49,5257900,8557700,3299800,BUY
2020-10-09 11:50:00,11:50,5282525,8567950,3285425,BUY
2020-10-09 11:51:00,11:51,5277550,8585975,3308425,BUY
2020-10-09 11:52:00,11:52,5290900,8614125,3323225,BUY
2020-10-09 11:53:00,11:53,5353700,8602675,3248975,BUY
2020-10-09 11:54:00,11:54,5321425,8613250,3291825,BUY
2020-10-09 11:55:00,11:55,5349150,8613375,3264225,BUY
2020-10-09 11:56:00,11:56,5341000,8668225,3327225,BUY
2020-10-09 11:57:00,11:57,5316750,8638500,3321750,BUY
2020-10-09 11:58:00,11:58,5322625,8670175,3347550,BUY
2020-10-09 11:59:00,11:59,5400250,8632575,3232325,BUY
2020-10-09 12:00:00,12:00,5359550,8629675,3270125,BUY
2020-10-09 12:01:00,12:01,5358075,8673825,3315750,BUY
2020-10-09 12:02:00,12:02,5358500,8697675,3339175,BUY
2020-10-09 12:03:00,12:03,5381400,8704075,3322675,BUY
2020-10-09 12:04:00,12:04,5379625,8648350,3268725,BUY
2020-10-09 12:05:00,12:05,5421275,8704000,3282725,BUY
2020-10-09 12:06:00,12:06,5424050,8701500,3277450,BUY
2020-10-09 12:07:00,12:07,5370525,8656150,3285625,BUY
2020-10-09 12:08:00,12:08,5425325,8639200,3213875,BUY
2020-10-09 12:09:00,12:09,5399225,8639850,3240625,BUY
2020-10-09 12:10:00,12:10,5359400,8573250,3213850,BUY
2020-10-09 12:11:00,12:11,5396200,8684550,3288350,BUY
2020-10-09 12:12:00,12:12,5326150,8688575,3362425,BUY
2020-10-09 12:13:00,12:13,5412200,8433650,3021450,BUY
2020-10-09 12:14:00,12:14,5421725,8657875,3236150,BUY
2020-10-09 12:15:00,12:15,5422125,8731000,3308875,BUY
2020-10-09 12:16:00,12:16,5441025,8731000,3289975,BUY
2020-10-09 12:17:00,12:17,5395025,8638050,3243025,BUY
2020-10-09 12:18:00,12:18,5354500,8604100,3249600,BUY
2020-10-09 12:19:00,12:19,5365400,8604450,3239050,BUY
2020-10-09 12:20:00,12:20,5396850,8636825,3239975,BUY
2020-10-09 12:21:00,12:21,5400675,8613400,3212725,BUY
2020-10-09 12:22:00,12:22,5409625,8592550,3182925,BUY
2020-10-09 12:23:00,12:23,5336400,8602400,3266000,BUY
2020-10-09 12:24:00,12:24,5431175,8621750,3190575,BUY
2020-10-09 12:25:00,12:25,5387725,8572750,3185025,BUY
2020-10-09 12:26:00,12:26,5404000,8660025,3256025,BUY
2020-10-09 12:27:00,12:27,5362950,8616875,3253925,BUY
2020-10-09 12:28:00,12:28,5436775,8674150,3237375,BUY
2020-10-09 12:29:00,12:29,5496700,8664750,3168050,BUY
2020-10-09 12:30:00,12:30,5468875,8659900,3191025,BUY
2020-10-09 12:31:00,12:31,5372275,8600825,3228550,BUY
2020-10-09 12:32:00,12:32,5422875,8611375,3188500,BUY
2020-10-09 12:33:00,12:33,5479375,8638850,3159475,BUY
2020-10-09 12:34:00,12:34,5447275,8617150,3169875,BUY
2020-10-09 12:35:00,12:35,5488825,8615350,3126525,BUY
2020-10-09 12:36:00,12:36,5496675,8638725,3142050,BUY
2020-10-09 12:37:00,12:37,5462250,8632075,3169825,BUY
2020-10-09 12:38:00,12:38,5464775,8647950,3183175,BUY
2020-10-09 12:39:00,12:39,5470625,8640225,3169600,BUY
2020-10-09 12:40:00,12:40,5435000,8614150,3179150,BUY
2020-10-09 12:41:00,12:41,5483825,8650550,3166725,BUY
2020-10-09 12:42:00,12:42,5483250,8656300,3173050,BUY
2020-10-09 12:43:00,12:43,5397250,8609250,3212000,BUY
2020-10-09 12:44:00,12:44,5435375,8721225,3285850,BUY
2020-10-09 12:45:00,12:45,5561425,8737000,3175575,BUY
2020-10-09 12:46:00,12:46,5426400,8733625,3307225,BUY
2020-10-09 12:47:00,12:47,5540675,8753275,3212600,BUY
2020-10-09 12:48:00,12:48,5505300,8733300,3228000,BUY
2020-10-09 12:49:00,12:49,5502700,8742725,3240025,BUY
2020-10-09 12:50:00,12:50,5487125,8764725,3277600,BUY
2020-10-09 12:51:00,12:51,5473175,8761825,3288650,BUY
2020-10-09 12:52:00,12:52,5491225,8764900,3273675,BUY
2020-10-09 12:53:00,12:53,5530975,8722400,3191425,BUY
2020-10-09 12:54:00,12:54,5443675,8722350,3278675,BUY
2020-10-09 12:55:00,12:55,5543875,8740475,3196600,BUY
2020-10-09 12:56:00,12:56,5506900,8797675,3290775,BUY
2020-10-09 12:57:00,12:57,5456925,8746075,3289150,BUY
2020-10-09 12:58:00,12:58,5460400,8481825,3021425,BUY
2020-10-09 12:59:00,12:59,5479650,8707275,3227625,BUY
2020-10-09 13:00:00,13:00,5536175,8756400,3220225,BUY
2020-10-09 13:01:00,13:01,5444675,8685075,3240400,BUY
2020-10-09 13:02:00,13:02,5443825,8710325,3266500,BUY
2020-10-09 13:03:00,13:03,5558475,8724775,3166300,BUY
2020-10-09 13:04:00,13:04,5481875,8658350,3176475,BUY
2020-10-09 13:05:00,13:05,5562375,8724825,3162450,BUY
2020-10-09 13:06:00,13:06,5564600,8789875,3225275,BUY
2020-10-09 13:07:00,13:07,5473800,8782775,3308975,BUY
2020-10-09 13:08:00,13:08,5472425,8730350,3257925,BUY
2020-10-09 13:09:00,13:09,5513375,8700100,3186725,BUY
2020-10-09 13:10:00,13:10,5539400,8700100,3160700,BUY
2020-10-09 13:11:00,13:11,5594400,8716850,3122450,BUY
2020-10-09 13:12:00,13:12,5575700,8758250,3182550,BUY
2020-10-09 13:13:00,13:13,5472175,8721175,3249000,BUY
2020-10-09 13:14:00,13:14,5565600,8797425,3231825,BUY
2020-10-09 13:15:00,13:15,5569125,8774825,3205700,BUY
2020-10-09 13:16:00,13:16,5567500,8773050,3205550,BUY
2020-10-09 13:17:00,13:17,5572850,8762475,3189625,BUY
2020-10-09 13:18:00,13:18,5567875,8795600,3227725,BUY
2020-10-09 13:19:00,13:19,5448600,8579275,3130675,BUY
2020-10-09 13:20:00,13:20,5554575,8770350,3215775,BUY
2020-10-09 13:21:00,13:21,5537000,8161750,2624750,BUY
2020-10-09 13:22:00,13:22,5527475,8804650,3277175,BUY
2020-10-09 13:23:00,13:23,5531525,8705025,3173500,BUY
2020-10-09 13:24:00,13:24,5479850,8724875,3245025,BUY
2020-10-09 13:25:00,13:25,5598525,8772200,3173675,BUY
2020-10-09 13:26:00,13:26,5531700,8778750,3247050,BUY
2020-10-09 13:27:00,13:27,5526725,8754175,3227450,BUY
2020-10-09 13:28:00,13:28,5507925,8775400,3267475,BUY
2020-10-09 13:29:00,13:29,5486900,8847875,3360975,BUY
2020-10-09 13:30:00,13:30,5487575,8784450,3296875,BUY
2020-10-09 13:31:00,13:31,5557950,8773500,3215550,BUY
2020-10-09 13:32:00,13:32,5473950,8834925,3360975,BUY
2020-10-09 13:33:00,13:33,5519775,8829475,3309700,BUY
2020-10-09 13:34:00,13:34,5562825,8851025,3288200,BUY
2020-10-09 13:35:00,13:35,5568225,8829850,3261625,BUY
2020-10-09 13:36:00,13:36,5588175,8835025,3246850,BUY
2020-10-09 13:37:00,13:37,5570675,8765475,3194800,BUY
2020-10-09 13:38:00,13:38,5593000,8764000,3171000,BUY
2020-10-09 13:39:00,13:39,5613750,8817625,3203875,BUY
2020-10-09 13:40:00,13:40,5659475,8935975,3276500,BUY
2020-10-09 13:41:00,13:41,5653675,8887650,3233975,BUY
2020-10-09 13:42:00,13:42,5586875,8708050,3121175,BUY
2020-10-09 13:43:00,13:43,5490200,8713875,3223675,BUY
2020-10-09 13:44:00,13:44,5549100,8709575,3160475,BUY
2020-10-09 13:45:00,13:45,5631075,8749275,3118200,BUY
2020-10-09 13:46:00,13:46,5503075,8710550,3207475,BUY
2020-10-09 13:47:00,13:47,5640125,8721700,3081575,BUY
2020-10-09 13:48:00,13:48,5574150,8712925,3138775,BUY
2020-10-09 13:49:00,13:49,5516900,8714875,3197975,BUY
2020-10-09 13:50:00,13:50,5585575,8674600,3089025,BUY
2020-10-09 13:51:00,13:51,5636300,8689125,3052825,BUY
2020-10-09 13:52:00,13:52,5629275,8717700,3088425,BUY
2020-10-09 13:53:00,13:53,5655325,8711550,3056225,BUY
2020-10-09 13:54:00,13:54,5588600,8748100,3159500,BUY
2020-10-09 13:55:00,13:55,5574025,8742600,3168575,BUY
2020-10-09 13:56:00,13:56,5604850,8733150,3128300,BUY
2020-10-09 13:57:00,13:57,5633625,8739925,3106300,BUY
2020-10-09 13:58:00,13:58,5566075,8638775,3072700,BUY
2020-10-09 13:59:00,13:59,5590550,8721675,3131125,BUY
2020-10-09 14:00:00,14:00,5658250,8724075,3065825,BUY
2020-10-09 14:01:00,14:01,5614675,8735375,3120700,BUY
2020-10-09 14:02:00,14:02,5662225,8769075,3106850,BUY
2020-10-09 14:03:00,14:03,5618175,8718100,3099925,BUY
2020-10-09 14:04:00,14:04,5653425,8714600,3061175,BUY
2020-10-09 14:05:00,14:05,5641425,8698800,3057375,BUY
2020-10-09 14:06:00,14:06,5590425,8723850,3133425,BUY
2020-10-09 14:07:00,14:07,5595175,8718175,3123000,BUY
2020-10-09 14:08:00,14:08,5682125,8698775,3016650,BUY
2020-10-09 14:09:00,14:09,5669875,8705675,3035800,BUY
2020-10-09 14:10:00,14:10,5714300,8746150,3031850,BUY
2020-10-09 14:11:00,14:11,5695350,8752425,3057075,BUY
2020-10-09 14:12:00,14:12,5787125,8821275,3034150,BUY
2020-10-09 14:13:00,14:13,5780375,8782675,3002300,BUY
2020-10-09 14:14:00,14:14,5723750,8779650,3055900,BUY
2020-10-09 14:15:00,14:15,5544050,8537300,2993250,BUY
2020-10-09 14:16:00,14:16,5552950,8537350,2984400,BUY
2020-10-09 14:17:00,14:17,5487350,8516750,3029400,BUY
2020-10-09 14:18:00,14:18,5478650,8560825,3082175,BUY
2020-10-09 14:19:00,14:19,5482625,8536175,3053550,BUY
2020-10-09 14:20:00,14:20,5493950,8523975,3030025,BUY
2020-10-09 14:21:00,14:21,5424400,8481750,3057350,BUY
2020-10-09 14:22:00,14:22,5407050,8500925,3093875,BUY
2020-10-09 14:23:00,14:23,5415250,8501250,3086000,BUY
2020-10-09 14:24:00,14:24,5478475,8464050,2985575,BUY
2020-10-09 14:25:00,14:25,5492050,8483200,2991150,BUY
2020-10-09 14:26:00,14:26,5504700,8505225,3000525,BUY
2020-10-09 14:27:00,14:27,5444250,8528550,3084300,BUY
2020-10-09 14:28:00,14:28,5416275,8534675,3118400,BUY
2020-10-09 14:29:00,14:29,5434475,8529325,3094850,BUY
2020-10-09 14:30:00,14:30,5385725,8622600,3236875,BUY
2020-10-09 14:31:00,14:31,5445600,8632375,3186775,BUY
2020-10-09 14:32:00,14:32,5439700,8635125,3195425,BUY
2020-10-09 14:33:00,14:33,5358725,8668350,3309625,BUY
2020-10-09 14:34:00,14:34,5366450,8675025,3308575,BUY
2020-10-09 14:35:00,14:35,5379400,8678200,3298800,BUY
2020-10-09 14:36:00,14:36,5386525,8704950,3318425,BUY
2020-10-09 14:37:00,14:37,5352000,8697125,3345125,BUY
2020-10-09 14:38:00,14:38,5362375,8706300,3343925,BUY
2020-10-09 14:39:00,14:39,5346875,8675500,3328625,BUY
2020-10-09 14:40:00,14:40,5374625,8688700,3314075,BUY
2020-10-09 14:41:00,14:41,5405050,8728925,3323875,BUY
2020-10-09 14:42:00,14:42,5307275,8690075,3382800,BUY
2020-10-09 14:43:00,14:43,5314525,8695325,3380800,BUY
2020-10-09 14:44:00,14:44,5291325,8700775,3409450,BUY
2020-10-09 14:45:00,14:45,5305200,8635450,3330250,BUY
2020-10-09 14:46:00,14:46,5234850,8592800,3357950,BUY
2020-10-09 14:47:00,14:47,5321825,8611300,3289475,BUY
2020-10-09 14:48:00,14:48,5242150,8618475,3376325,BUY
2020-10-09 14:49:00,14:49,5202600,8670700,3468100,BUY
2020-10-09 14:50:00,14:50,5286700,8644100,3357400,BUY
2020-10-09 14:51:00,14:51,5218775,8659000,3440225,BUY
2020-10-09 14:52:00,14:52,5245825,8617375,3371550,BUY
2020-10-09 14:53:00,14:53,5229150,8637025,3407875,BUY
2020-10-09 14:54:00,14:54,5190500,8649050,3458550,BUY
2020-10-09 14:55:00,14:55,5262125,8637025,3374900,BUY
2020-10-09 14:56:00,14:56,5192575,8602550,3409975,BUY
2020-10-09 14:57:00,14:57,5230425,8601875,3371450,BUY
2020-10-09 14:58:00,14:58,5249675,8630050,3380375,BUY
2020-10-09 14:59:00,14:59,5225025,8592425,3367400,BUY
2020-10-09 15:00:00,15:00,5160325,8594450,3434125,BUY
2020-10-09 15:01:00,15:01,5152225,8583350,3431125,BUY
2020-10-09 15:02:00,15:02,5189500,8579200,3389700,BUY
2020-10-09 15:03:00,15:03,5161725,8567225,3405500,BUY
2020-10-09 15:04:00,15:04,5159025,8597575,3438550,BUY
2020-10-09 15:05:00,15:05,5176225,8602775,3426550,BUY
2020-10-09 15:06:00,15:06,5014850,8400275,3385425,BUY
2020-10-09 15:07:00,15:07,5039350,8406000,3366650,BUY
2020-10-09 15:08:00,15:08,5056475,8396800,3340325,BUY
2020-10-09 15:09:00,15:09,4991775,8349150,3357375,BUY
2020-10-09 15:10:00,15:10,5023725,8351300,3327575,BUY
2020-10-09 15:11:00,15:11,4994500,8339375,3344875,BUY
2020-10-09 15:12:00,15:12,4847225,8235050,3387825,BUY
2020-10-09 15:13:00,15:13,4843550,8253800,3410250,BUY
2020-10-09 15:14:00,15:14,4827850,8226150,3398300,BUY
2020-10-09 15:15:00,15:15,4797350,8059950,3262600,BUY
2020-10-09 15:16:00,15:16,4787950,8069600,3281650,BUY
2020-10-09 15:17:00,15:17,4819875,8093550,3273675,BUY
2020-10-09 15:18:00,15:18,4599725,7885550,3285825,BUY
2020-10-09 15:19:00,15:19,4647675,7890100,3242425,BUY
2020-10-09 15:20:00,15:20,4661875,7863075,3201200,BUY
2020-10-09 15:21:00,15:21,4452725,7707100,3254375,BUY
2020-10-09 15:22:00,15:22,4465350,7706200,3240850,BUY
2020-10-09 15:23:00,15:23,4429600,7723475,3293875,BUY
2020-10-09 15:24:00,15:24,4337450,7603175,3265725,BUY
2020-10-09 15:25:00,15:25,4365250,7598250,3233000,BUY
2020-10-09 15:26:00,15:26,4331275,7599075,3267800,BUY
2020-10-09 15:27:00,15:27,4212275,7413400,3201125,BUY
2020-10-09 15:28:00,15:28,4203850,7425750,3221900,BUY
2020-10-09 15:29:00,15:29,4212375,7436025,3223650,BUY
2020-10-12 09:15:00,09:15,3952125,7165925,3213800,BUY
2020-10-12 09:16:00,09:16,3985325,7200950,3215625,BUY
2020-10-12 09:17:00,09:17,4342350,7422675,3080325,BUY
2020-10-12 09:18:00,09:18,4343350,7418950,3075600,BUY
2020-10-12 09:19:00,09:19,4354975,7416800,3061825,BUY
2020-10-12 09:20:00,09:20,4634300,7845800,3211500,BUY
2020-10-12 09:21:00,09:21,4629075,7833075,3204000,BUY
2020-10-12 09:22:00,09:22,4604900,7849950,3245050,BUY
2020-10-12 09:23:00,09:23,4816975,8108550,3291575,BUY
2020-10-12 09:24:00,09:24,4826575,8116050,3289475,BUY
2020-10-12 09:25:00,09:25,4795200,8126175,3330975,BUY
2020-10-12 09:26:00,09:26,4929225,8284700,3355475,BUY
2020-10-12 09:27:00,09:27,4922650,8270350,3347700,BUY
2020-10-12 09:28:00,09:28,4871325,8279625,3408300,BUY
2020-10-12 09:29:00,09:29,4910475,8173100,3262625,BUY
2020-10-12 09:30:00,09:30,4968775,8256575,3287800,BUY
2020-10-12 09:31:00,09:31,4972600,8264225,3291625,BUY
2020-10-12 09:32:00,09:32,5009525,8236325,3226800,BUY
2020-10-12 09:33:00,09:33,5069975,8245950,3175975,BUY
2020-10-12 09:34:00,09:34,5054575,8260475,3205900,BUY
2020-10-12 09:35:00,09:35,5136075,8245775,3109700,BUY
2020-10-12 09:36:00,09:36,5088975,8219675,3130700,BUY
2020-10-12 09:37:00,09:37,5072650,8215875,3143225,BUY
2020-10-12 09:38:00,09:38,5238725,8271125,3032400,BUY
2020-10-12 09:39:00,09:39,5239350,8141600,2902250,BUY
2020-10-12 09:40:00,09:40,5253725,8223250,2969525,BUY
2020-10-12 09:41:00,09:41,5290625,8176800,2886175,BUY
2020-10-12 09:42:00,09:42,5338950,8268425,2929475,BUY
2020-10-12 09:43:00,09:43,5308375,8272450,2964075,BUY
2020-10-12 09:44:00,09:44,5395300,8263625,2868325,BUY
2020-10-12 09:45:00,09:45,5379025,8246175,2867150,BUY
2020-10-12 09:46:00,09:46,5386625,8269300,2882675,BUY
2020-10-12 09:47:00,09:47,5483600,8467425,2983825,BUY
2020-10-12 09:48:00,09:48,5503925,8464500,2960575,BUY
2020-10-12 09:49:00,09:49,5432325,8425650,2993325,BUY
2020-10-12 09:50:00,09:50,5554450,8465675,2911225,BUY
2020-10-12 09:51:00,09:51,5561800,8472575,2910775,BUY
2020-10-12 09:52:00,09:52,5550200,8502925,2952725,BUY
2020-10-12 09:53:00,09:53,5615275,8468700,2853425,BUY
2020-10-12 09:54:00,09:54,5527175,8465925,2938750,BUY
2020-10-12 09:55:00,09:55,5591350,8371225,2779875,BUY
2020-10-12 09:56:00,09:56,5639975,8468975,2829000,BUY
2020-10-12 09:57:00,09:57,5592250,8479650,2887400,BUY
2020-10-12 09:58:00,09:58,5583125,8450525,2867400,BUY
2020-10-12 09:59:00,09:59,5719800,8485850,2766050,BUY
2020-10-12 10:00:00,10:00,5716850,8469150,2752300,BUY
2020-10-12 10:01:00,10:01,5718825,8493900,2775075,BUY
2020-10-12 10:02:00,10:02,5840450,8483875,2643425,BUY
2020-10-12 10:03:00,10:03,5857250,8431550,2574300,BUY
2020-10-12 10:04:00,10:04,5773275,8485975,2712700,BUY
2020-10-12 10:05:00,10:05,5832675,8401550,2568875,BUY
2020-10-12 10:06:00,10:06,5904925,8196925,2292000,BUY
2020-10-12 10:07:00,10:07,5841825,8371450,2529625,BUY
2020-10-12 10:08:00,10:08,5952050,8390575,2438525,BUY
2020-10-12 10:09:00,10:09,5931750,8272175,2340425,BUY
2020-10-12 10:10:00,10:10,5919025,8406575,2487550,BUY
2020-10-12 10:11:00,10:11,5978750,8418250,2439500,BUY
2020-10-12 10:12:00,10:12,5959000,8412025,2453025,BUY
2020-10-12 10:13:00,10:13,5940825,8451150,2510325,BUY
2020-10-12 10:14:00,10:14,5996775,8358750,2361975,BUY
2020-10-12 10:15:00,10:15,6016075,8433800,2417725,BUY
2020-10-12 10:16:00,10:16,5996575,8375125,2378550,BUY
2020-10-12 10:17:00,10:17,6036750,8468375,2431625,BUY
2020-10-12 10:18:00,10:18,6076600,8513525,2436925,BUY
2020-10-12 10:19:00,10:19,6035250,8507925,2472675,BUY
2020-10-12 10:20:00,10:20,6077100,8489000,2411900,BUY
2020-10-12 10:21:00,10:21,6055950,8496375,2440425,BUY
2020-10-12 10:22:00,10:22,6052200,8500175,2447975,BUY
2020-10-12 10:23:00,10:23,6165625,8543325,2377700,BUY
2020-10-12 10:24:00,10:24,5989750,8555850,2566100,BUY
2020-10-12 10:25:00,10:25,6158075,8569325,2411250,BUY
2020-10-12 10:26:00,10:26,6256725,8537650,2280925,BUY
2020-10-12 10:27:00,10:27,6224100,8542575,2318475,BUY
2020-10-12 10:28:00,10:28,6163650,8498725,2335075,BUY
2020-10-12 10:29:00,10:29,6207725,8358925,2151200,BUY
2020-10-12 10:30:00,10:30,6262675,8368625,2105950,BUY
2020-10-12 10:31:00,10:31,6248225,8371325,2123100,BUY
2020-10-12 10:32:00,10:32,6212100,8349125,2137025,BUY
2020-10-12 10:33:00,10:33,6152050,8322850,2170800,BUY
2020-10-12 10:34:00,10:34,6185825,8338975,2153150,BUY
2020-10-12 10:35:00,10:35,6269100,8362500,2093400,BUY
2020-10-12 10:36:00,10:36,6194200,8366475,2172275,BUY
2020-10-12 10:37:00,10:37,6184475,8295600,2111125,BUY
2020-10-12 10:38:00,10:38,6286075,8437925,2151850,BUY
2020-10-12 10:39:00,10:39,6296825,8421700,2124875,BUY
2020-10-12 10:40:00,10:40,6251750,8415450,2163700,BUY
2020-10-12 10:41:00,10:41,6288925,8385675,2096750,BUY
2020-10-12 10:42:00,10:42,6180150,8417425,2237275,BUY
2020-10-12 10:43:00,10:43,6256550,8508575,2252025,BUY
2020-10-12 10:44:00,10:44,6321825,8464250,2142425,BUY
2020-10-12 10:45:00,10:45,6267125,8342975,2075850,BUY
2020-10-12 10:46:00,10:46,6237100,8399800,2162700,BUY
2020-10-12 10:47:00,10:47,5969050,8464625,2495575,BUY
2020-10-12 10:48:00,10:48,5979075,8423475,2444400,BUY
2020-10-12 10:49:00,10:49,6254875,8433525,2178650,BUY
2020-10-12 10:50:00,10:50,6280050,8466800,2186750,BUY
2020-10-12 10:51:00,10:51,6260600,8509450,2248850,BUY
2020-10-12 10:52:00,10:52,6356050,8516175,2160125,BUY
2020-10-12 10:53:00,10:53,6324325,8510450,2186125,BUY
2020-10-12 10:54:00,10:54,6294300,8439875,2145575,BUY
2020-10-12 10:55:00,10:55,6242550,8389625,2147075,BUY
2020-10-12 10:56:00,10:56,6338125,8535725,2197600,BUY
2020-10-12 10:57:00,10:57,6361250,8585700,2224450,BUY
2020-10-12 10:58:00,10:58,6190275,8586775,2396500,BUY
2020-10-12 10:59:00,10:59,6391375,8589150,2197775,BUY
2020-10-12 11:00:00,11:00,6257250,8527450,2270200,BUY
2020-10-12 11:01:00,11:01,6410825,8496450,2085625,BUY
2020-10-12 11:02:00,11:02,6304450,8537900,2233450,BUY
2020-10-12 11:03:00,11:03,6478150,8585500,2107350,BUY
2020-10-12 11:04:00,11:04,6402375,8567700,2165325,BUY
2020-10-12 11:05:00,11:05,6501450,8598225,2096775,BUY
2020-10-12 11:06:00,11:06,6469350,8591325,2121975,BUY
2020-10-12 11:07:00,11:07,6534825,8621075,2086250,BUY
2020-10-12 11:08:00,11:08,6484275,8514425,2030150,BUY
2020-10-12 11:09:00,11:09,6452775,8512150,2059375,BUY
2020-10-12 11:10:00,11:10,6504975,8523000,2018025,BUY
2020-10-12 11:11:00,11:11,6512725,8530775,2018050,BUY
2020-10-12 11:12:00,11:12,6502200,8526775,2024575,BUY
2020-10-12 11:13:00,11:13,6512725,8541500,2028775,BUY
2020-10-12 11:14:00,11:14,6533925,8575100,2041175,BUY
2020-10-12 11:15:00,11:15,6535925,8557250,2021325,BUY
2020-10-12 11:16:00,11:16,6542825,8557375,2014550,BUY
2020-10-12 11:17:00,11:17,6491675,8561450,2069775,BUY
2020-10-12 11:18:00,11:18,6518050,8533900,2015850,BUY
2020-10-12 11:19:00,11:19,6655125,8581650,1926525,BUY
2020-10-12 11:20:00,11:20,6670700,8529200,1858500,BUY
2020-10-12 11:21:00,11:21,6598200,8547550,1949350,BUY
2020-10-12 11:22:00,11:22,6585725,8562575,1976850,BUY
2020-10-12 11:23:00,11:23,6665400,8567050,1901650,BUY
2020-10-12 11:24:00,11:24,6656425,8627025,1970600,BUY
2020-10-12 11:25:00,11:25,6685850,8548700,1862850,BUY
2020-10-12 11:26:00,11:26,6654300,8598925,1944625,BUY
2020-10-12 11:27:00,11:27,6647600,8562500,1914900,BUY
2020-10-12 11:28:00,11:28,6674225,8633125,1958900,BUY
2020-10-12 11:29:00,11:29,6727600,8684250,1956650,BUY
2020-10-12 11:30:00,11:30,6710100,8688625,1978525,BUY
2020-10-12 11:31:00,11:31,6707600,8652875,1945275,BUY
2020-10-12 11:32:00,11:32,6772875,8710600,1937725,BUY
2020-10-12 11:33:00,11:33,6786350,8721400,1935050,BUY
2020-10-12 11:34:00,11:34,6622800,8684350,2061550,BUY
2020-10-12 11:35:00,11:35,6738250,8714200,1975950,BUY
2020-10-12 11:36:00,11:36,6666175,8695650,2029475,BUY
2020-10-12 11:37:00,11:37,6700225,8689325,1989100,BUY
2020-10-12 11:38:00,11:38,6499150,8686850,2187700,BUY
2020-10-12 11:39:00,11:39,6664175,8510500,1846325,BUY
2020-10-12 11:40:00,11:40,6603825,8689600,2085775,BUY
2020-10-12 11:41:00,11:41,6514450,8634625,2120175,BUY
2020-10-12 11:42:00,11:42,6623275,8544325,1921050,BUY
2020-10-12 11:43:00,11:43,6622600,8632025,2009425,BUY
2020-10-12 11:44:00,11:44,6724900,8652900,1928000,BUY
2020-10-12 11:45:00,11:45,6723450,8687800,1964350,BUY
2020-10-12 11:46:00,11:46,6665975,8485775,1819800,BUY
2020-10-12 11:47:00,11:47,6716675,8695700,1979025,BUY
2020-10-12 11:48:00,11:48,6473600,8544750,2071150,BUY
2020-10-12 11:49:00,11:49,6681575,8680825,1999250,BUY
2020-10-12 11:50:00,11:50,6669425,8622600,1953175,BUY
2020-10-12 11:51:00,11:51,6722950,8488650,1765700,BUY
2020-10-12 11:52:00,11:52,6648900,8420650,1771750,BUY
2020-10-12 11:53:00,11:53,6738300,8464250,1725950,BUY
2020-10-12 11:54:00,11:54,6698700,8772900,2074200,BUY
2020-10-12 11:55:00,11:55,6807800,8790625,1982825,BUY
2020-10-12 11:56:00,11:56,6808375,8753325,1944950,BUY
2020-10-12 11:57:00,11:57,6826325,8836450,2010125,BUY
2020-10-12 11:58:00,11:58,6837100,8610025,1772925,BUY
2020-10-12 11:59:00,11:59,6832500,8849975,2017475,BUY
2020-10-12 12:00:00,12:00,6812000,8507000,1695000,BUY
2020-10-12 12:01:00,12:01,6839175,8860450,2021275,BUY
2020-10-12 12:02:00,12:02,6868125,8890225,2022100,BUY
2020-10-12 12:03:00,12:03,6887100,8820450,1933350,BUY
2020-10-12 12:04:00,12:04,6950775,8914425,1963650,BUY
2020-10-12 12:05:00,12:05,6950225,8751875,1801650,BUY
2020-10-12 12:06:00,12:06,6900100,8704500,1804400,BUY
2020-10-12 12:07:00,12:07,6932825,8697375,1764550,BUY
2020-10-12 12:08:00,12:08,6768050,8696275,1928225,BUY
2020-10-12 12:09:00,12:09,6970175,8716750,1746575,BUY
2020-10-12 12:10:00,12:10,6929175,8696325,1767150,BUY
2020-10-12 12:11:00,12:11,6811250,8803400,1992150,BUY
2020-10-12 12:12:00,12:12,6991475,8745900,1754425,BUY
2020-10-12 12:13:00,12:13,7064550,8800675,1736125,BUY
2020-10-12 12:14:00,12:14,7007125,8689900,1682775,BUY
2020-10-12 12:15:00,12:15,6993350,8666650,1673300,BUY
2020-10-12 12:16:00,12:16,7020975,8666275,1645300,BUY
2020-10-12 12:17:00,12:17,6980250,8694225,1713975,BUY
2020-10-12 12:18:00,12:18,7007775,8638100,1630325,BUY
2020-10-12 12:19:00,12:19,6980850,8584500,1603650,BUY
2020-10-12 12:20:00,12:20,6952025,8555500,1603475,BUY
2020-10-12 12:21:00,12:21,7029900,8629950,1600050,BUY
2020-10-12 12:22:00,12:22,6974750,8455000,1480250,BUY
2020-10-12 12:23:00,12:23,6971175,8588950,1617775,BUY
2020-10-12 12:24:00,12:24,6910475,8607300,1696825,BUY
2020-10-12 12:25:00,12:25,6957025,8580100,1623075,BUY
2020-10-12 12:26:00,12:26,6905625,8575125,1669500,BUY
2020-10-12 12:27:00,12:27,7001300,8596150,1594850,BUY
2020-10-12 12:28:00,12:28,6981850,8630950,1649100,BUY
2020-10-12 12:29:00,12:29,7069575,8582200,1512625,BUY
2020-10-12 12:30:00,12:30,7023625,8542000,1518375,BUY
2020-10-12 12:31:00,12:31,7015600,8633700,1618100,BUY
2020-10-12 12:32:00,12:32,7023275,8597200,1573925,BUY
2020-10-12 12:33:00,12:33,7028925,8620275,1591350,BUY
2020-10-12 12:34:00,12:34,7035675,8547625,1511950,BUY
2020-10-12 12:35:00,12:35,7046575,8599625,1553050,BUY
2020-10-12 12:36:00,12:36,7046375,8610850,1564475,BUY
2020-10-12 12:37:00,12:37,7083125,8625575,1542450,BUY
2020-10-12 12:38:00,12:38,6844475,8622275,1777800,BUY
2020-10-12 12:39:00,12:39,7158575,8701050,1542475,BUY
2020-10-12 12:40:00,12:40,7087950,8700350,1612400,BUY
2020-10-12 12:41:00,12:41,6980950,8714775,1733825,BUY
2020-10-12 12:42:00,12:42,7014825,8711350,1696525,BUY
2020-10-12 12:43:00,12:43,7028575,8470100,1441525,BUY
2020-10-12 12:44:00,12:44,7058300,8720700,1662400,BUY
2020-10-12 12:45:00,12:45,7121775,8725225,1603450,BUY
2020-10-12 12:46:00,12:46,7130975,8773250,1642275,BUY
2020-10-12 12:47:00,12:47,7067150,8718500,1651350,BUY
2020-10-12 12:48:00,12:48,6978275,8712475,1734200,BUY
2020-10-12 12:49:00,12:49,7132100,8693025,1560925,BUY
2020-10-12 12:50:00,12:50,7086575,8714300,1627725,BUY
2020-10-12 12:51:00,12:51,7108975,8722000,1613025,BUY
2020-10-12 12:52:00,12:52,7098200,8708350,1610150,BUY
2020-10-12 12:53:00,12:53,7174275,8716150,1541875,BUY
2020-10-12 12:54:00,12:54,7079825,8734900,1655075,BUY
2020-10-12 12:55:00,12:55,7049175,8759875,1710700,BUY
2020-10-12 12:56:00,12:56,7260900,8764975,1504075,BUY
2020-10-12 12:57:00,12:57,7084600,8457450,1372850,BUY
2020-10-12 12:58:00,12:58,7242700,8723075,1480375,BUY
2020-10-12 12:59:00,12:59,7236375,8770550,1534175,BUY
2020-10-12 13:00:00,13:00,7281325,8596750,1315425,BUY
2020-10-12 13:01:00,13:01,7328275,8826325,1498050,BUY
2020-10-12 13:02:00,13:02,7313600,8802525,1488925,BUY
2020-10-12 13:03:00,13:03,7273175,8834200,1561025,BUY
2020-10-12 13:04:00,13:04,7249850,8375725,1125875,BUY
2020-10-12 13:05:00,13:05,7366175,8609975,1243800,BUY
2020-10-12 13:06:00,13:06,7348100,8861350,1513250,BUY
2020-10-12 13:07:00,13:07,7331100,8892025,1560925,BUY
2020-10-12 13:08:00,13:08,7389600,8858525,1468925,BUY
2020-10-12 13:09:00,13:09,7358650,8805125,1446475,BUY
2020-10-12 13:10:00,13:10,7400625,8856625,1456000,BUY
2020-10-12 13:11:00,13:11,7357325,8880700,1523375,BUY
2020-10-12 13:12:00,13:12,7460825,8553200,1092375,BUY
2020-10-12 13:13:00,13:13,7424250,8878350,1454100,BUY
2020-10-12 13:14:00,13:14,7343725,8660175,1316450,BUY
2020-10-12 13:15:00,13:15,7443825,8744200,1300375,BUY
2020-10-12 13:16:00,13:16,7443825,8870600,1426775,BUY
2020-10-12 13:17:00,13:17,7487625,8854100,1366475,BUY
2020-10-12 13:18:00,13:18,7537200,8921225,1384025,BUY
2020-10-12 13:19:00,13:19,7605075,8950900,1345825,BUY
2020-10-12 13:20:00,13:20,7577800,8944175,1366375,BUY
2020-10-12 13:21:00,13:21,7457825,8792300,1334475,BUY
2020-10-12 13:22:00,13:22,7497275,8768250,1270975,BUY
2020-10-12 13:23:00,13:23,7466525,8787625,1321100,BUY
2020-10-12 13:24:00,13:24,7544375,8639050,1094675,BUY
2020-10-12 13:25:00,13:25,7587075,8839875,1252800,BUY
2020-10-12 13:26:00,13:26,7620450,8887725,1267275,BUY
2020-10-12 13:27:00,13:27,7644400,8868775,1224375,BUY
2020-10-12 13:28:00,13:28,7631250,8856525,1225275,BUY
2020-10-12 13:29:00,13:29,7631250,8795950,1164700,BUY
2020-10-12 13:30:00,13:30,7703725,8793400,1089675,BUY
2020-10-12 13:31:00,13:31,7674175,8818975,1144800,BUY
2020-10-12 13:32:00,13:32,7685800,8770050,1084250,BUY
2020-10-12 13:33:00,13:33,7753800,8890150,1136350,BUY
2020-10-12 13:34:00,13:34,7457350,7548375,91025,BUY
2020-10-12 13:40:00,13:40,7721675,8919850,1198175,BUY
2020-10-12 13:41:00,13:41,7723175,8943875,1220700,BUY
2020-10-12 13:42:00,13:42,7804425,9003275,1198850,BUY
2020-10-12 13:43:00,13:43,7804425,8982725,1178300,BUY
2020-10-12 13:44:00,13:44,7763600,9002775,1239175,BUY
2020-10-12 13:45:00,13:45,7851150,8959400,1108250,BUY
2020-10-12 13:46:00,13:46,7830700,8958075,1127375,BUY
2020-10-12 13:47:00,13:47,7781100,8936675,1155575,BUY
2020-10-12 13:48:00,13:48,7835875,8977000,1141125,BUY
2020-10-12 13:49:00,13:49,7787500,8948875,1161375,BUY
2020-10-12 13:50:00,13:50,7765225,8934675,1169450,BUY
2020-10-12 13:51:00,13:51,7822450,8952800,1130350,BUY
2020-10-12 13:52:00,13:52,7886175,8974175,1088000,BUY
2020-10-12 13:53:00,13:53,7885300,9016625,1131325,BUY
2020-10-12 13:54:00,13:54,7877925,8921625,1043700,BUY
2020-10-12 13:55:00,13:55,7838550,8991575,1153025,BUY
2020-10-12 13:56:00,13:56,7877150,8973875,1096725,BUY
2020-10-12 13:57:00,13:57,7813700,9058400,1244700,BUY
2020-10-12 13:58:00,13:58,7863500,9051125,1187625,BUY
2020-10-12 13:59:00,13:59,7824925,9052625,1227700,BUY
2020-10-12 14:00:00,14:00,7829300,8992525,1163225,BUY
2020-10-12 14:01:00,14:01,7772400,9032650,1260250,BUY
2020-10-12 14:02:00,14:02,7776550,8955625,1179075,BUY
2020-10-12 14:03:00,14:03,7927200,9097825,1170625,BUY
2020-10-12 14:04:00,14:04,7900250,9081150,1180900,BUY
2020-10-12 14:05:00,14:05,7872875,9090950,1218075,BUY
2020-10-12 14:06:00,14:06,7936850,9095025,1158175,BUY
2020-10-12 14:07:00,14:07,7911175,9137600,1226425,BUY
2020-10-12 14:08:00,14:08,7928300,9111125,1182825,BUY
2020-10-12 14:09:00,14:09,7835550,9100750,1265200,BUY
2020-10-12 14:10:00,14:10,7899950,9109675,1209725,BUY
2020-10-12 14:11:00,14:11,7895675,9086750,1191075,BUY
2020-10-12 14:12:00,14:12,7979350,9076275,1096925,BUY
2020-10-12 14:13:00,14:13,7951475,9090750,1139275,BUY
2020-10-12 14:14:00,14:14,7983575,9082225,1098650,BUY
2020-10-12 14:15:00,14:15,8039300,9035100,995800,BUY
2020-10-12 14:16:00,14:16,8005175,9038900,1033725,BUY
2020-10-12 14:17:00,14:17,7996225,9027100,1030875,BUY
2020-10-12 14:18:00,14:18,8000725,9034550,1033825,BUY
2020-10-12 14:19:00,14:19,7977100,9028100,1051000,BUY
2020-10-12 14:20:00,14:20,7998975,9070625,1071650,BUY
2020-10-12 14:21:00,14:21,7990475,8873625,883150,BUY
2020-10-12 14:22:00,14:22,8043150,8895475,852325,BUY
2020-10-12 14:23:00,14:23,8017200,8909825,892625,BUY
2020-10-12 14:24:00,14:24,8040275,8851925,811650,BUY
2020-10-12 14:25:00,14:25,8006250,8892775,886525,BUY
2020-10-12 14:26:00,14:26,8057475,8885250,827775,BUY
2020-10-12 14:27:00,14:27,8039450,8825750,786300,BUY
2020-10-12 14:28:00,14:28,8039000,8852725,813725,BUY
2020-10-12 14:29:00,14:29,8043125,8780925,737800,BUY
2020-10-12 14:30:00,14:30,8110925,8836525,725600,BUY
2020-10-12 14:31:00,14:31,8042925,8882825,839900,BUY
2020-10-12 14:32:00,14:32,8058200,8859750,801550,BUY
2020-10-12 14:33:00,14:33,8025975,8828850,802875,BUY
2020-10-12 14:34:00,14:34,8054800,8765125,710325,BUY
2020-10-12 14:35:00,14:35,8056425,8765600,709175,BUY
2020-10-12 14:36:00,14:36,8002825,8780550,777725,BUY
2020-10-12 14:37:00,14:37,7968525,8757750,789225,BUY
2020-10-12 14:38:00,14:38,8001875,8778625,776750,BUY
2020-10-12 14:39:00,14:39,8113450,8811050,697600,BUY
2020-10-12 14:40:00,14:40,8010575,8785350,774775,BUY
2020-10-12 14:41:00,14:41,8076925,8816925,740000,BUY
2020-10-12 14:42:00,14:42,7983625,8458600,474975,BUY
2020-10-12 14:43:00,14:43,8053600,8872425,818825,BUY
2020-10-12 14:44:00,14:44,8054500,8823550,769050,BUY
2020-10-12 14:45:00,14:45,7967500,8800950,833450,BUY
2020-10-12 14:46:00,14:46,8052425,8811550,759125,BUY
2020-10-12 14:47:00,14:47,7960250,8866350,906100,BUY
2020-10-12 14:48:00,14:48,7953550,8786275,832725,BUY
2020-10-12 14:49:00,14:49,7993000,8789425,796425,BUY
2020-10-12 14:50:00,14:50,7957850,8791650,833800,BUY
2020-10-12 14:51:00,14:51,7925425,8756700,831275,BUY
2020-10-12 14:52:00,14:52,7967575,8719450,751875,BUY
2020-10-12 14:53:00,14:53,7928350,8768550,840200,BUY
2020-10-12 14:54:00,14:54,7926675,8724900,798225,BUY
2020-10-12 14:55:00,14:55,7926675,8753700,827025,BUY
2020-10-12 14:56:00,14:56,7910000,8695100,785100,BUY
2020-10-12 14:57:00,14:57,7901125,8545625,644500,BUY
2020-10-12 14:58:00,14:58,7891025,8707075,816050,BUY
2020-10-12 14:59:00,14:59,7952150,8745200,793050,BUY
2020-10-12 15:00:00,15:00,7863450,8803775,940325,BUY
2020-10-12 15:01:00,15:01,7851075,8752875,901800,BUY
2020-10-12 15:02:00,15:02,7801000,8777475,976475,BUY
2020-10-12 15:03:00,15:03,7709700,8706775,997075,BUY
2020-10-12 15:04:00,15:04,7702025,8736125,1034100,BUY
2020-10-12 15:05:00,15:05,7710325,8680000,969675,BUY
2020-10-12 15:06:00,15:06,7697700,8708325,1010625,BUY
2020-10-12 15:07:00,15:07,7659400,8712600,1053200,BUY
2020-10-12 15:08:00,15:08,7718375,8718775,1000400,BUY
2020-10-12 15:09:00,15:09,7711725,8676625,964900,BUY
2020-10-12 15:10:00,15:10,7720000,8677200,957200,BUY
2020-10-12 15:11:00,15:11,7707475,8634075,926600,BUY
2020-10-12 15:12:00,15:12,7697625,8619000,921375,BUY
2020-10-12 15:13:00,15:13,7572900,8630875,1057975,BUY
2020-10-12 15:14:00,15:14,7612525,8588150,975625,BUY
2020-10-12 15:15:00,15:15,7611950,8569250,957300,BUY
2020-10-12 15:16:00,15:16,7625775,8590175,964400,BUY
2020-10-12 15:17:00,15:17,7588475,8609300,1020825,BUY
2020-10-12 15:18:00,15:18,7494700,8531800,1037100,BUY
2020-10-12 15:19:00,15:19,7436600,8519400,1082800,BUY
2020-10-12 15:20:00,15:20,7477500,8526900,1049400,BUY
2020-10-12 15:21:00,15:21,7320425,8375075,1054650,BUY
2020-10-12 15:22:00,15:22,7283200,8356200,1073000,BUY
2020-10-12 15:23:00,15:23,7237425,8331575,1094150,BUY
2020-10-12 15:24:00,15:24,7216250,8286675,1070425,BUY
2020-10-12 15:25:00,15:25,7270675,8332725,1062050,BUY
2020-10-12 15:26:00,15:26,7172550,8310325,1137775,BUY
2020-10-12 15:27:00,15:27,7065525,8146400,1080875,BUY
2020-10-12 15:28:00,15:28,7079225,8160900,1081675,BUY
2020-10-12 15:29:00,15:29,7087250,8149450,1062200,BUY
2020-10-13 09:15:00,09:15,6902675,7868500,965825,BUY
2020-10-13 09:16:00,09:16,6882700,7851775,969075,BUY
2020-10-13 09:17:00,09:17,7113925,8089600,975675,BUY
2020-10-13 09:18:00,09:18,7103450,8124775,1021325,BUY
2020-10-13 09:19:00,09:19,7110850,8109950,999100,BUY
2020-10-13 09:20:00,09:20,7432125,8636350,1204225,BUY
2020-10-13 09:21:00,09:21,7424900,8569850,1144950,BUY
2020-10-13 09:22:00,09:22,7371750,8635325,1263575,BUY
2020-10-13 09:23:00,09:23,7667025,8946575,1279550,BUY
2020-10-13 09:24:00,09:24,7721900,8950900,1229000,BUY
2020-10-13 09:25:00,09:25,7709350,8924550,1215200,BUY
2020-10-13 09:26:00,09:26,7890900,9015075,1124175,BUY
2020-10-13 09:27:00,09:27,7878800,8988475,1109675,BUY
2020-10-13 09:28:00,09:28,7884025,8988700,1104675,BUY
2020-10-13 09:29:00,09:29,7943400,8955425,1012025,BUY
2020-10-13 09:30:00,09:30,7970650,9002850,1032200,BUY
2020-10-13 09:31:00,09:31,7951675,9024500,1072825,BUY
2020-10-13 09:32:00,09:32,8017925,9077850,1059925,BUY
2020-10-13 09:33:00,09:33,8032575,9046625,1014050,BUY
2020-10-13 09:34:00,09:34,7992025,9038825,1046800,BUY
2020-10-13 09:35:00,09:35,8048775,9259450,1210675,BUY
2020-10-13 09:36:00,09:36,8002375,9256300,1253925,BUY
2020-10-13 09:37:00,09:37,8021725,9231925,1210200,BUY
2020-10-13 09:38:00,09:38,8086350,9217075,1130725,BUY
2020-10-13 09:39:00,09:39,8086275,9202900,1116625,BUY
2020-10-13 09:40:00,09:40,8095425,9271925,1176500,BUY
2020-10-13 09:41:00,09:41,8145400,9136025,990625,BUY
2020-10-13 09:42:00,09:42,8144825,9070350,925525,BUY
2020-10-13 09:43:00,09:43,8183150,9152525,969375,BUY
2020-10-13 09:44:00,09:44,8225700,9104525,878825,BUY
2020-10-13 09:45:00,09:45,8238100,9112450,874350,BUY
2020-10-13 09:46:00,09:46,8156350,9102350,946000,BUY
2020-10-13 09:47:00,09:47,8137175,9084100,946925,BUY
2020-10-13 09:48:00,09:48,8143700,9106225,962525,BUY
2020-10-13 09:49:00,09:49,8134400,9051350,916950,BUY
2020-10-13 09:50:00,09:50,8211000,9125325,914325,BUY
2020-10-13 09:51:00,09:51,8228325,9200475,972150,BUY
2020-10-13 09:52:00,09:52,8180775,9135400,954625,BUY
2020-10-13 09:53:00,09:53,8283050,9180850,897800,BUY
2020-10-13 09:54:00,09:54,8200450,9133250,932800,BUY
2020-10-13 09:55:00,09:55,8296725,8761400,464675,BUY
2020-10-13 09:56:00,09:56,8317850,9161875,844025,BUY
2020-10-13 09:57:00,09:57,8318825,9170125,851300,BUY
2020-10-13 09:58:00,09:58,8247500,9145875,898375,BUY
2020-10-13 09:59:00,09:59,8345825,9163975,818150,BUY
2020-10-13 10:00:00,10:00,8384175,9221725,837550,BUY
2020-10-13 10:01:00,10:01,8387975,9246650,858675,BUY
2020-10-13 10:02:00,10:02,8464000,9343875,879875,BUY
2020-10-13 10:03:00,10:03,8470375,9270350,799975,BUY
2020-10-13 10:04:00,10:04,8408525,9293050,884525,BUY
2020-10-13 10:05:00,10:05,8533125,9346975,813850,BUY
2020-10-13 10:06:00,10:06,8574475,9348700,774225,BUY
2020-10-13 10:07:00,10:07,8502000,9401950,899950,BUY
2020-10-13 10:08:00,10:08,8612225,9389375,777150,BUY
2020-10-13 10:09:00,10:09,8564600,9384175,819575,BUY
2020-10-13 10:10:00,10:10,8597650,9354250,756600,BUY
2020-10-13 10:11:00,10:11,8560925,9319950,759025,BUY
2020-10-13 10:12:00,10:12,8577825,9331475,753650,BUY
2020-10-13 10:13:00,10:13,8589450,9287075,697625,BUY
2020-10-13 10:14:00,10:14,8615575,9363075,747500,BUY
2020-10-13 10:15:00,10:15,8633525,9390700,757175,BUY
2020-10-13 10:16:00,10:16,8585900,9312325,726425,BUY
2020-10-13 10:17:00,10:17,8611250,9326625,715375,BUY
2020-10-13 10:18:00,10:18,8603100,9312825,709725,BUY
2020-10-13 10:19:00,10:19,8555900,9382375,826475,BUY
2020-10-13 10:20:00,10:20,8619550,9439600,820050,BUY
2020-10-13 10:21:00,10:21,8626250,9377675,751425,BUY
2020-10-13 10:22:00,10:22,8653925,9505725,851800,BUY
2020-10-13 10:23:00,10:23,8620850,9533550,912700,BUY
2020-10-13 10:24:00,10:24,8598075,9475175,877100,BUY
2020-10-13 10:25:00,10:25,8534425,9491900,957475,BUY
2020-10-13 10:26:00,10:26,8544950,9440325,895375,BUY
2020-10-13 10:27:00,10:27,8507350,9405700,898350,BUY
2020-10-13 10:28:00,10:28,8542475,9459825,917350,BUY
2020-10-13 10:29:00,10:29,8581925,9452775,870850,BUY
2020-10-13 10:30:00,10:30,8554100,9427450,873350,BUY
2020-10-13 10:31:00,10:31,8590500,9467100,876600,BUY
2020-10-13 10:32:00,10:32,8536300,9434300,898000,BUY
2020-10-13 10:33:00,10:33,8545325,9468675,923350,BUY
2020-10-13 10:34:00,10:34,8551575,9504125,952550,BUY
2020-10-13 10:35:00,10:35,8617175,9064875,447700,BUY
2020-10-13 10:36:00,10:36,8579375,9530275,950900,BUY
2020-10-13 10:37:00,10:37,8596700,9532150,935450,BUY
2020-10-13 10:38:00,10:38,8567800,9283125,715325,BUY
2020-10-13 10:39:00,10:39,8662025,9595625,933600,BUY
2020-10-13 10:40:00,10:40,8657950,9572775,914825,BUY
2020-10-13 10:41:00,10:41,8297450,9545950,1248500,BUY
2020-10-13 10:42:00,10:42,8228625,8977250,748625,BUY
2020-10-13 10:43:00,10:43,8228975,9526775,1297800,BUY
2020-10-13 10:44:00,10:44,8321600,9560450,1238850,BUY
2020-10-13 10:45:00,10:45,8419725,9589025,1169300,BUY
2020-10-13 10:46:00,10:46,8382775,9614050,1231275,BUY
2020-10-13 10:47:00,10:47,8220300,9581425,1361125,BUY
2020-10-13 10:48:00,10:48,8123925,9601300,1477375,BUY
2020-10-13 10:49:00,10:49,8245550,9602625,1357075,BUY
2020-10-13 10:50:00,10:50,8269700,9656325,1386625,BUY
2020-10-13 10:51:00,10:51,8269700,9644875,1375175,BUY
2020-10-13 10:52:00,10:52,8301250,9651450,1350200,BUY
2020-10-13 10:53:00,10:53,8270800,9668825,1398025,BUY
2020-10-13 10:54:00,10:54,8300425,9712600,1412175,BUY
2020-10-13 10:55:00,10:55,8285800,9718850,1433050,BUY
2020-10-13 10:56:00,10:56,8351050,9627050,1276000,BUY
2020-10-13 10:57:00,10:57,8399150,9648825,1249675,BUY
2020-10-13 10:58:00,10:58,8358850,9650475,1291625,BUY
2020-10-13 10:59:00,10:59,8495675,9527450,1031775,BUY
2020-10-13 11:00:00,11:00,8524375,9724700,1200325,BUY
2020-10-13 11:01:00,11:01,8468600,9407650,939050,BUY
2020-10-13 11:02:00,11:02,8632775,9496200,863425,BUY
2020-10-13 11:03:00,11:03,8632775,9706925,1074150,BUY
2020-10-13 11:04:00,11:04,8683450,9743125,1059675,BUY
2020-10-13 11:05:00,11:05,8693375,9778700,1085325,BUY
2020-10-13 11:06:00,11:06,8638300,9475925,837625,BUY
2020-10-13 11:07:00,11:07,8696925,9514450,817525,BUY
2020-10-13 11:08:00,11:08,8721175,9559575,838400,BUY
2020-10-13 11:09:00,11:09,8780975,9603375,822400,BUY
2020-10-13 11:10:00,11:10,8781800,9842475,1060675,BUY
2020-10-13 11:11:00,11:11,8854675,9803775,949100,BUY
2020-10-13 11:12:00,11:12,8845650,9636400,790750,BUY
2020-10-13 11:13:00,11:13,8798700,9668125,869425,BUY
2020-10-13 11:14:00,11:14,8800325,9625900,825575,BUY
2020-10-13 11:15:00,11:15,8873675,9583800,710125,BUY
2020-10-13 11:16:00,11:16,8865775,9562125,696350,BUY
2020-10-13 11:17:00,11:17,8965500,9771825,806325,BUY
2020-10-13 11:18:00,11:18,8846250,9748925,902675,BUY
2020-10-13 11:19:00,11:19,8861700,9818475,956775,BUY
2020-10-13 11:20:00,11:20,8653350,9778225,1124875,BUY
2020-10-13 11:21:00,11:21,8911800,9473775,561975,BUY
2020-10-13 11:22:00,11:22,8923250,9816025,892775,BUY
2020-10-13 11:23:00,11:23,8907375,9796150,888775,BUY
2020-10-13 11:24:00,11:24,8846700,9814375,967675,BUY
2020-10-13 11:25:00,11:25,8925875,9869575,943700,BUY
2020-10-13 11:26:00,11:26,8928525,9672725,744200,BUY
2020-10-13 11:27:00,11:27,8984750,9920125,935375,BUY
2020-10-13 11:28:00,11:28,8974675,9890175,915500,BUY
2020-10-13 11:29:00,11:29,8989100,9883175,894075,BUY
2020-10-13 11:30:00,11:30,8932675,9674750,742075,BUY
2020-10-13 11:31:00,11:31,8925125,9787375,862250,BUY
2020-10-13 11:32:00,11:32,8904400,9596725,692325,BUY
2020-10-13 11:33:00,11:33,8926700,9529225,602525,BUY
2020-10-13 11:34:00,11:34,8952875,9648775,695900,BUY
2020-10-13 11:35:00,11:35,8931275,9756000,824725,BUY
2020-10-13 11:36:00,11:36,9010275,9725975,715700,BUY
2020-10-13 11:37:00,11:37,8959500,9415850,456350,BUY
2020-10-13 11:38:00,11:38,8931700,9092875,161175,BUY
2020-10-13 11:39:00,11:39,9002550,9529725,527175,BUY
2020-10-13 11:40:00,11:40,8940475,9582175,641700,BUY
2020-10-13 11:41:00,11:41,8974825,9469825,495000,BUY
2020-10-13 11:42:00,11:42,8955200,9814925,859725,BUY
2020-10-13 11:43:00,11:43,8976550,9513675,537125,BUY
2020-10-13 11:44:00,11:44,8911325,9848850,937525,BUY
2020-10-13 11:45:00,11:45,8975325,9788700,813375,BUY
2020-10-13 11:46:00,11:46,8930425,9825850,895425,BUY
2020-10-13 11:47:00,11:47,9020525,9843800,823275,BUY
2020-10-13 11:48:00,11:48,8980225,9746475,766250,BUY
2020-10-13 11:49:00,11:49,8909200,9757175,847975,BUY
2020-10-13 11:50:00,11:50,8984025,9708325,724300,BUY
2020-10-13 11:51:00,11:51,8887725,9740575,852850,BUY
2020-10-13 11:52:00,11:52,8974250,9754425,780175,BUY
2020-10-13 11:53:00,11:53,8990550,9798000,807450,BUY
2020-10-13 11:54:00,11:54,8981925,9771800,789875,BUY
2020-10-13 11:55:00,11:55,8981550,9832575,851025,BUY
2020-10-13 11:56:00,11:56,9021175,9824325,803150,BUY
2020-10-13 11:57:00,11:57,8938325,9822575,884250,BUY
2020-10-13 11:58:00,11:58,8994300,9587775,593475,BUY
2020-10-13 11:59:00,11:59,8968725,9527300,558575,BUY
2020-10-13 12:00:00,12:00,8972225,9878350,906125,BUY
2020-10-13 12:01:00,12:01,8987700,9898175,910475,BUY
2020-10-13 12:02:00,12:02,8889325,9807175,917850,BUY
2020-10-13 12:03:00,12:03,8906525,9823275,916750,BUY
2020-10-13 12:04:00,12:04,8825025,9774150,949125,BUY
2020-10-13 12:05:00,12:05,9031800,9899875,868075,BUY
2020-10-13 12:06:00,12:06,8992825,9872425,879600,BUY
2020-10-13 12:07:00,12:07,8966400,9798350,831950,BUY
2020-10-13 12:08:00,12:08,8942500,9840775,898275,BUY
2020-10-13 12:09:00,12:09,8885400,9810900,925500,BUY
2020-10-13 12:10:00,12:10,8907175,9801275,894100,BUY
2020-10-13 12:11:00,12:11,8912925,9833450,920525,BUY
2020-10-13 12:12:00,12:12,8913075,9810300,897225,BUY
2020-10-13 12:13:00,12:13,8927925,9863400,935475,BUY
2020-10-13 12:14:00,12:14,8941100,9912500,971400,BUY
2020-10-13 12:15:00,12:15,9007875,9921575,913700,BUY
2020-10-13 12:16:00,12:16,8996400,9919725,923325,BUY
2020-10-13 12:17:00,12:17,8952575,9765450,812875,BUY
2020-10-13 12:18:00,12:18,8937200,9741250,804050,BUY
2020-10-13 12:19:00,12:19,8976250,9759425,783175,BUY
2020-10-13 12:20:00,12:20,9033000,9829500,796500,BUY
2020-10-13 12:21:00,12:21,9015325,9795975,780650,BUY
2020-10-13 12:22:00,12:22,9006575,9735425,728850,BUY
2020-10-13 12:23:00,12:23,8974225,9788300,814075,BUY
2020-10-13 12:24:00,12:24,9026950,9781125,754175,BUY
2020-10-13 12:25:00,12:25,9013175,9751950,738775,BUY
2020-10-13 12:26:00,12:26,9004200,9504525,500325,BUY
2020-10-13 12:27:00,12:27,9031800,9823700,791900,BUY
2020-10-13 12:28:00,12:28,9069825,9857075,787250,BUY
2020-10-13 12:29:00,12:29,9001225,9823425,822200,BUY
2020-10-13 12:30:00,12:30,9022200,9821675,799475,BUY
2020-10-13 12:31:00,12:31,8951525,9759700,808175,BUY
2020-10-13 12:32:00,12:32,9081050,9811400,730350,BUY
2020-10-13 12:33:00,12:33,9025350,9816850,791500,BUY
2020-10-13 12:34:00,12:34,9026200,9414925,388725,BUY
2020-10-13 12:35:00,12:35,9118025,9836025,718000,BUY
2020-10-13 12:36:00,12:36,9110175,9841175,731000,BUY
2020-10-13 12:37:00,12:37,9108950,9824800,715850,BUY
2020-10-13 12:38:00,12:38,9042700,9806950,764250,BUY
2020-10-13 12:39:00,12:39,9102650,9653950,551300,BUY
2020-10-13 12:40:00,12:40,9027800,9828975,801175,BUY
2020-10-13 12:41:00,12:41,9072950,9504925,431975,BUY
2020-10-13 12:42:00,12:42,9098125,9870725,772600,BUY
2020-10-13 12:43:00,12:43,9069375,9578400,509025,BUY
2020-10-13 12:44:00,12:44,9137850,9484875,347025,BUY
2020-10-13 12:45:00,12:45,9124125,9864600,740475,BUY
2020-10-13 12:46:00,12:46,9198675,9842725,644050,BUY
2020-10-13 12:47:00,12:47,9189975,9686000,496025,BUY
2020-10-13 12:48:00,12:48,9108675,9698125,589450,BUY
2020-10-13 12:49:00,12:49,9159475,9656975,497500,BUY
2020-10-13 12:50:00,12:50,9235050,9719375,484325,BUY
2020-10-13 12:51:00,12:51,9223175,9739950,516775,BUY
2020-10-13 12:52:00,12:52,9226000,9726725,500725,BUY
2020-10-13 12:53:00,12:53,9187650,9679700,492050,BUY
2020-10-13 12:54:00,12:54,9249650,9686100,436450,BUY
2020-10-13 12:55:00,12:55,9187525,9713375,525850,BUY
2020-10-13 12:56:00,12:56,9229150,9701300,472150,BUY
2020-10-13 12:57:00,12:57,9305425,9701925,396500,BUY
2020-10-13 12:58:00,12:58,9253775,9341750,87975,BUY
2020-10-13 12:59:00,12:59,9313725,9703600,389875,BUY
2020-10-13 13:00:00,13:00,9261925,9616175,354250,BUY
2020-10-13 13:01:00,13:01,9284550,9642575,358025,BUY
2020-10-13 13:02:00,13:02,9254875,9318225,63350,BUY
2020-10-13 13:03:00,13:03,9362550,9666100,303550,BUY
2020-10-13 13:04:00,13:04,9319900,9610850,290950,BUY
2020-10-13 13:05:00,13:05,9378025,9628450,250425,BUY
2020-10-13 13:06:00,13:06,9411300,9755300,344000,BUY
2020-10-13 13:07:00,13:07,9467350,9760575,293225,BUY
2020-10-13 13:08:00,13:08,9425300,9408475,-16825,SELL
2020-10-13 13:09:00,13:09,9382550,9743525,360975,BUY
2020-10-13 13:10:00,13:10,9387000,9671350,284350,BUY
2020-10-13 13:11:00,13:11,9406225,9770625,364400,BUY
2020-10-13 13:12:00,13:12,9386875,9654325,267450,BUY
2020-10-13 13:13:00,13:13,9316925,9662450,345525,BUY
2020-10-13 13:14:00,13:14,9358900,9614675,255775,BUY
2020-10-13 13:15:00,13:15,9422800,9349300,-73500,SELL
2020-10-13 13:16:00,13:16,9371125,9471100,99975,BUY
2020-10-13 13:17:00,13:17,9399600,9670875,271275,BUY
2020-10-13 13:18:00,13:18,9305450,9557425,251975,BUY
2020-10-13 13:19:00,13:19,9436000,9694050,258050,BUY
2020-10-13 13:20:00,13:20,9388025,9030675,-357350,SELL
2020-10-13 13:21:00,13:21,9360225,9524300,164075,BUY
2020-10-13 13:22:00,13:22,9286850,9555975,269125,BUY
2020-10-13 13:23:00,13:23,9385125,9396425,11300,BUY
2020-10-13 13:24:00,13:24,9437075,9595200,158125,BUY
2020-10-13 13:25:00,13:25,9362575,9635475,272900,BUY
2020-10-13 13:26:00,13:26,9338850,9586125,247275,BUY
2020-10-13 13:27:00,13:27,9330725,9354100,23375,BUY
2020-10-13 13:28:00,13:28,9331775,9061575,-270200,SELL
2020-10-13 13:29:00,13:29,9363725,9266450,-97275,SELL
2020-10-13 13:30:00,13:30,9350500,9611075,260575,BUY
2020-10-13 13:31:00,13:31,9395200,9336525,-58675,SELL
2020-10-13 13:32:00,13:32,9420025,9658850,238825,BUY
2020-10-13 13:33:00,13:33,9391100,9083000,-308100,SELL
2020-10-13 13:34:00,13:34,9346400,9630950,284550,BUY
2020-10-13 13:35:00,13:35,9283950,9543025,259075,BUY
2020-10-13 13:36:00,13:36,9379175,9643375,264200,BUY
2020-10-13 13:37:00,13:37,9396200,9586800,190600,BUY
2020-10-13 13:38:00,13:38,9480875,9604800,123925,BUY
2020-10-13 13:39:00,13:39,9391575,9561750,170175,BUY
2020-10-13 13:40:00,13:40,9357000,9035200,-321800,SELL
2020-10-13 13:41:00,13:41,9320000,9371675,51675,BUY
2020-10-13 13:42:00,13:42,9443625,9652275,208650,BUY
2020-10-13 13:43:00,13:43,9374200,9635125,260925,BUY
2020-10-13 13:44:00,13:44,9407400,9648575,241175,BUY
2020-10-13 13:45:00,13:45,9529375,9686150,156775,BUY
2020-10-13 13:46:00,13:46,9484925,9208300,-276625,SELL
2020-10-13 13:47:00,13:47,9491650,9458350,-33300,SELL
2020-10-13 13:48:00,13:48,9557375,9788250,230875,BUY
2020-10-13 13:49:00,13:49,9505000,9719000,214000,BUY
2020-10-13 13:50:00,13:50,9538850,9515450,-23400,SELL
2020-10-13 13:51:00,13:51,9587150,9761750,174600,BUY
2020-10-13 13:52:00,13:52,9570475,9425000,-145475,SELL
2020-10-13 13:53:00,13:53,9483475,9665175,181700,BUY
2020-10-13 13:54:00,13:54,9500150,9648275,148125,BUY
2020-10-13 13:55:00,13:55,9546900,9692350,145450,BUY
2020-10-13 13:56:00,13:56,9569825,9670200,100375,BUY
2020-10-13 13:57:00,13:57,9575100,9192200,-382900,SELL
2020-10-13 13:58:00,13:58,9556475,9749750,193275,BUY
2020-10-13 13:59:00,13:59,9548575,9654050,105475,BUY
2020-10-13 14:00:00,14:00,9627650,9781800,154150,BUY
2020-10-13 14:01:00,14:01,9628400,9708100,79700,BUY
2020-10-13 14:02:00,14:02,9636500,9781275,144775,BUY
2020-10-13 14:03:00,14:03,9601325,9654200,52875,BUY
2020-10-13 14:04:00,14:04,9559425,9680125,120700,BUY
2020-10-13 14:05:00,14:05,9611900,9652975,41075,BUY
2020-10-13 14:06:00,14:06,9573125,9738525,165400,BUY
2020-10-13 14:07:00,14:07,9627625,9430125,-197500,SELL
2020-10-13 14:08:00,14:08,9597525,9741300,143775,BUY
2020-10-13 14:09:00,14:09,9665350,9474475,-190875,SELL
2020-10-13 14:10:00,14:10,9627400,9751725,124325,BUY
2020-10-13 14:11:00,14:11,9643450,9709000,65550,BUY
2020-10-13 14:12:00,14:12,9625750,9749000,123250,BUY
2020-10-13 14:13:00,14:13,9621475,9584200,-37275,SELL
2020-10-13 14:14:00,14:14,9642375,9744950,102575,BUY
2020-10-13 14:15:00,14:15,9710175,9813250,103075,BUY
2020-10-13 14:16:00,14:16,9677175,9782350,105175,BUY
2020-10-13 14:17:00,14:17,9638100,9721650,83550,BUY
2020-10-13 14:18:00,14:18,9596050,9664300,68250,BUY
2020-10-13 14:19:00,14:19,9640725,9664575,23850,BUY
2020-10-13 14:20:00,14:20,9677625,9694300,16675,BUY
2020-10-13 14:21:00,14:21,9623850,9594300,-29550,SELL
2020-10-13 14:22:00,14:22,9600225,9601175,950,BUY
2020-10-13 14:23:00,14:23,9605200,9307850,-297350,SELL
2020-10-13 14:24:00,14:24,9667500,9633975,-33525,SELL
2020-10-13 14:25:00,14:25,9684800,9611475,-73325,SELL
2020-10-13 14:26:00,14:26,9668300,9645500,-22800,SELL
2020-10-13 14:27:00,14:27,9694800,9568700,-126100,SELL
2020-10-13 14:28:00,14:28,9677550,9550950,-126600,SELL
2020-10-13 14:29:00,14:29,9698650,9332725,-365925,SELL
2020-10-13 14:30:00,14:30,9739350,9613225,-126125,SELL
2020-10-13 14:31:00,14:31,9696600,9573025,-123575,SELL
2020-10-13 14:32:00,14:32,9719275,9625975,-93300,SELL
2020-10-13 14:33:00,14:33,9669875,9556450,-113425,SELL
2020-10-13 14:34:00,14:34,9653325,9578875,-74450,SELL
2020-10-13 14:35:00,14:35,9697875,9602750,-95125,SELL
2020-10-13 14:36:00,14:36,9713500,9382325,-331175,SELL
2020-10-13 14:37:00,14:37,9709550,9556950,-152600,SELL
2020-10-13 14:38:00,14:38,9733325,9401050,-332275,SELL
2020-10-13 14:39:00,14:39,9746075,9606300,-139775,SELL
2020-10-13 14:40:00,14:40,9683075,9571825,-111250,SELL
2020-10-13 14:41:00,14:41,9670625,9542675,-127950,SELL
2020-10-13 14:42:00,14:42,9606775,9515850,-90925,SELL
2020-10-13 14:43:00,14:43,9678750,9542900,-135850,SELL
2020-10-13 14:44:00,14:44,9653975,9566575,-87400,SELL
2020-10-13 14:45:00,14:45,9624400,9517275,-107125,SELL
2020-10-13 14:46:00,14:46,9641075,9491275,-149800,SELL
2020-10-13 14:47:00,14:47,9566775,9435375,-131400,SELL
2020-10-13 14:48:00,14:48,9687000,9514850,-172150,SELL
2020-10-13 14:49:00,14:49,9631300,9508825,-122475,SELL
2020-10-13 14:50:00,14:50,9593550,9456425,-137125,SELL
2020-10-13 14:51:00,14:51,9485075,9368400,-116675,SELL
2020-10-13 14:52:00,14:52,9493150,9338175,-154975,SELL
2020-10-13 14:53:00,14:53,9491075,9355600,-135475,SELL
2020-10-13 14:54:00,14:54,9487075,9357575,-129500,SELL
2020-10-13 14:55:00,14:55,9504050,9411650,-92400,SELL
2020-10-13 14:56:00,14:56,9492750,9168450,-324300,SELL
2020-10-13 14:57:00,14:57,9403000,9305325,-97675,SELL
2020-10-13 14:58:00,14:58,9419350,9305925,-113425,SELL
2020-10-13 14:59:00,14:59,9435425,9126900,-308525,SELL
2020-10-13 15:00:00,15:00,9385725,9207775,-177950,SELL
2020-10-13 15:01:00,15:01,9392200,9290850,-101350,SELL
2020-10-13 15:02:00,15:02,9350275,9306550,-43725,SELL
2020-10-13 15:03:00,15:03,9375825,9217075,-158750,SELL
2020-10-13 15:04:00,15:04,9359225,9222175,-137050,SELL
2020-10-13 15:05:00,15:05,9319025,9185425,-133600,SELL
2020-10-13 15:06:00,15:06,9179850,9042525,-137325,SELL
2020-10-13 15:07:00,15:07,9229875,9044275,-185600,SELL
2020-10-13 15:08:00,15:08,9227600,9090050,-137550,SELL
2020-10-13 15:09:00,15:09,9216425,9039550,-176875,SELL
2020-10-13 15:10:00,15:10,9206200,9045850,-160350,SELL
2020-10-13 15:11:00,15:11,9231225,9043425,-187800,SELL
2020-10-13 15:12:00,15:12,9181400,8982125,-199275,SELL
2020-10-13 15:13:00,15:13,9172225,8962325,-209900,SELL
2020-10-13 15:14:00,15:14,9179050,8688725,-490325,SELL
2020-10-13 15:15:00,15:15,9139175,8841700,-297475,SELL
2020-10-13 15:16:00,15:16,9084700,8851650,-233050,SELL
2020-10-13 15:17:00,15:17,9117350,8852900,-264450,SELL
2020-10-13 15:18:00,15:18,9035150,8750700,-284450,SELL
2020-10-13 15:19:00,15:19,8976550,8692075,-284475,SELL
2020-10-13 15:20:00,15:20,9050850,8778250,-272600,SELL
2020-10-13 15:21:00,15:21,8823975,8533650,-290325,SELL
2020-10-13 15:22:00,15:22,8829175,8535575,-293600,SELL
2020-10-13 15:23:00,15:23,8811025,8515400,-295625,SELL
2020-10-13 15:24:00,15:24,8681125,8357425,-323700,SELL
2020-10-13 15:25:00,15:25,8700900,8441650,-259250,SELL
2020-10-13 15:26:00,15:26,8649550,8352575,-296975,SELL
2020-10-13 15:27:00,15:27,8600650,8170775,-429875,SELL
2020-10-13 15:28:00,15:28,8576175,8212900,-363275,SELL
2020-10-13 15:29:00,15:29,8565775,8227400,-338375,SELL
2020-10-14 09:15:00,09:15,8373100,7913300,-459800,SELL
2020-10-14 09:16:00,09:16,8362875,7887750,-475125,SELL
2020-10-14 09:17:00,09:17,8772875,8324025,-448850,SELL
2020-10-14 09:18:00,09:18,8770625,8316600,-454025,SELL
2020-10-14 09:19:00,09:19,8759050,8340325,-418725,SELL
2020-10-14 09:20:00,09:20,9160600,8691025,-469575,SELL
2020-10-14 09:21:00,09:21,9152625,8587775,-564850,SELL
2020-10-14 09:22:00,09:22,9129775,8650200,-479575,SELL
2020-10-14 09:23:00,09:23,9383325,8856700,-526625,SELL
2020-10-14 09:24:00,09:24,9396125,8876000,-520125,SELL
2020-10-14 09:25:00,09:25,9388550,8831325,-557225,SELL
2020-10-14 09:26:00,09:26,9459475,9012200,-447275,SELL
2020-10-14 09:27:00,09:27,9449150,8981800,-467350,SELL
2020-10-14 09:28:00,09:28,9444050,8969325,-474725,SELL
2020-10-14 09:29:00,09:29,9647325,9051850,-595475,SELL
2020-10-14 09:30:00,09:30,9644300,9012125,-632175,SELL
2020-10-14 09:31:00,09:31,9614100,9067950,-546150,SELL
2020-10-14 09:32:00,09:32,9818300,9223875,-594425,SELL
2020-10-14 09:33:00,09:33,9783050,9181650,-601400,SELL
2020-10-14 09:34:00,09:34,9795525,9170650,-624875,SELL
2020-10-14 09:35:00,09:35,9867525,9215300,-652225,SELL
2020-10-14 09:36:00,09:36,9891900,9197275,-694625,SELL
2020-10-14 09:37:00,09:37,9866625,9141425,-725200,SELL
2020-10-14 09:38:00,09:38,10029925,9296725,-733200,SELL
2020-10-14 09:39:00,09:39,10026975,9284925,-742050,SELL
2020-10-14 09:40:00,09:40,10048925,9284575,-764350,SELL
2020-10-14 09:41:00,09:41,10154075,9421350,-732725,SELL
2020-10-14 09:42:00,09:42,10145000,9473750,-671250,SELL
2020-10-14 09:43:00,09:43,10131475,9412550,-718925,SELL
2020-10-14 09:44:00,09:44,10360150,9531025,-829125,SELL
2020-10-14 09:45:00,09:45,10358900,9500300,-858600,SELL
2020-10-14 09:46:00,09:46,10337475,9505525,-831950,SELL
2020-10-14 09:47:00,09:47,10509175,9364600,-1144575,SELL
2020-10-14 09:48:00,09:48,10493475,9380800,-1112675,SELL
2020-10-14 09:49:00,09:49,10501375,9325950,-1175425,SELL
2020-10-14 09:50:00,09:50,10603075,9536200,-1066875,SELL
2020-10-14 09:51:00,09:51,10598050,9467875,-1130175,SELL
2020-10-14 09:52:00,09:52,10588700,9496425,-1092275,SELL
2020-10-14 09:53:00,09:53,10668275,9577600,-1090675,SELL
2020-10-14 09:54:00,09:54,10689650,9603800,-1085850,SELL
2020-10-14 09:55:00,09:55,10690875,9574175,-1116700,SELL
2020-10-14 09:56:00,09:56,10702125,9621700,-1080425,SELL
2020-10-14 09:57:00,09:57,10689150,9613575,-1075575,SELL
2020-10-14 09:58:00,09:58,10683875,9606800,-1077075,SELL
2020-10-14 09:59:00,09:59,10678850,9394225,-1284625,SELL
2020-10-14 10:00:00,10:00,10671825,9657625,-1014200,SELL
2020-10-14 10:01:00,10:01,10675625,9656625,-1019000,SELL
2020-10-14 10:02:00,10:02,10699425,9643450,-1055975,SELL
2020-10-14 10:03:00,10:03,10687350,9605750,-1081600,SELL
2020-10-14 10:04:00,10:04,10704450,9610525,-1093925,SELL
2020-10-14 10:05:00,10:05,10778200,9539025,-1239175,SELL
2020-10-14 10:06:00,10:06,10737800,9500700,-1237100,SELL
2020-10-14 10:07:00,10:07,10789150,9722325,-1066825,SELL
2020-10-14 10:08:00,10:08,10839100,9711475,-1127625,SELL
2020-10-14 10:09:00,10:09,10855350,9785350,-1070000,SELL
2020-10-14 10:10:00,10:10,10803300,9781150,-1022150,SELL
2020-10-14 10:11:00,10:11,10879175,9588500,-1290675,SELL
2020-10-14 10:12:00,10:12,10879350,9828500,-1050850,SELL
2020-10-14 10:13:00,10:13,10840325,9469675,-1370650,SELL
2020-10-14 10:14:00,10:14,10958700,9749275,-1209425,SELL
2020-10-14 10:15:00,10:15,10989100,9521750,-1467350,SELL
2020-10-14 10:16:00,10:16,10934475,9714975,-1219500,SELL
2020-10-14 10:17:00,10:17,11090800,9871050,-1219750,SELL
2020-10-14 10:18:00,10:18,11060500,9854225,-1206275,SELL
2020-10-14 10:19:00,10:19,11105850,9956150,-1149700,SELL
2020-10-14 10:20:00,10:20,11044025,9584375,-1459650,SELL
2020-10-14 10:21:00,10:21,11045425,9596450,-1448975,SELL
2020-10-14 10:22:00,10:22,10985475,9230100,-1755375,SELL
2020-10-14 10:23:00,10:23,11125075,9429400,-1695675,SELL
2020-10-14 10:24:00,10:24,11124775,9912450,-1212325,SELL
2020-10-14 10:25:00,10:25,11118975,9805725,-1313250,SELL
2020-10-14 10:26:00,10:26,11216700,9747125,-1469575,SELL
2020-10-14 10:27:00,10:27,11218000,9689425,-1528575,SELL
2020-10-14 10:28:00,10:28,11172400,9689825,-1482575,SELL
2020-10-14 10:29:00,10:29,11291450,9916525,-1374925,SELL
2020-10-14 10:30:00,10:30,11296225,9748500,-1547725,SELL
2020-10-14 10:31:00,10:31,11294050,9390375,-1903675,SELL
2020-10-14 10:32:00,10:32,11358150,9572750,-1785400,SELL
2020-10-14 10:33:00,10:33,11371100,9460350,-1910750,SELL
2020-10-14 10:34:00,10:34,11368325,9862625,-1505700,SELL
2020-10-14 10:35:00,10:35,11397025,9739600,-1657425,SELL
2020-10-14 10:36:00,10:36,11398475,9951375,-1447100,SELL
2020-10-14 10:37:00,10:37,11392325,9638250,-1754075,SELL
2020-10-14 10:38:00,10:38,11448100,9913550,-1534550,SELL
2020-10-14 10:39:00,10:39,11387375,9623075,-1764300,SELL
2020-10-14 10:40:00,10:40,11356925,9837450,-1519475,SELL
2020-10-14 10:41:00,10:41,11465775,9880550,-1585225,SELL
2020-10-14 10:42:00,10:42,11471100,9793925,-1677175,SELL
2020-10-14 10:43:00,10:43,11420925,9940400,-1480525,SELL
2020-10-14 10:44:00,10:44,11437625,9889050,-1548575,SELL
2020-10-14 10:45:00,10:45,11475000,9153575,-2321425,SELL
2020-10-14 10:46:00,10:46,11457625,9917725,-1539900,SELL
2020-10-14 10:47:00,10:47,11499000,9991550,-1507450,SELL
2020-10-14 10:48:00,10:48,11503500,9990175,-1513325,SELL
2020-10-14 10:49:00,10:49,11484250,9946800,-1537450,SELL
2020-10-14 10:50:00,10:50,11546325,10001000,-1545325,SELL
2020-10-14 10:51:00,10:51,11535300,9750325,-1784975,SELL
2020-10-14 10:52:00,10:52,11527975,9993975,-1534000,SELL
2020-10-14 10:53:00,10:53,11620775,9973550,-1647225,SELL
2020-10-14 10:54:00,10:54,11546400,9745450,-1800950,SELL
2020-10-14 10:55:00,10:55,11565950,8921925,-2644025,SELL
2020-10-14 10:56:00,10:56,11637450,9944925,-1692525,SELL
2020-10-14 10:57:00,10:57,11580750,9859025,-1721725,SELL
2020-10-14 10:58:00,10:58,11635950,9791900,-1844050,SELL
2020-10-14 10:59:00,10:59,11654650,9074350,-2580300,SELL
2020-10-14 11:00:00,11:00,11680125,9925850,-1754275,SELL
2020-10-14 11:01:00,11:01,11691600,9949325,-1742275,SELL
2020-10-14 11:02:00,11:02,11748300,8944175,-2804125,SELL
2020-10-14 11:03:00,11:03,11703175,9816275,-1886900,SELL
2020-10-14 11:04:00,11:04,11728850,9934175,-1794675,SELL
2020-10-14 11:05:00,11:05,11802800,9577800,-2225000,SELL
2020-10-14 11:06:00,11:06,11837125,10081225,-1755900,SELL
2020-10-14 11:07:00,11:07,11798425,10089750,-1708675,SELL
2020-10-14 11:08:00,11:08,11732675,9869050,-1863625,SELL
2020-10-14 11:09:00,11:09,11716125,9958775,-1757350,SELL
2020-10-14 11:10:00,11:10,11713050,9885275,-1827775,SELL
2020-10-14 11:11:00,11:11,11761000,9708125,-2052875,SELL
2020-10-14 11:12:00,11:12,11755450,9929600,-1825850,SELL
2020-10-14 11:13:00,11:13,11738900,9258625,-2480275,SELL
2020-10-14 11:14:00,11:14,11821575,9603500,-2218075,SELL
2020-10-14 11:15:00,11:15,11774350,9593600,-2180750,SELL
2020-10-14 11:16:00,11:16,11761250,9699600,-2061650,SELL
2020-10-14 11:17:00,11:17,11898650,9755725,-2142925,SELL
2020-10-14 11:18:00,11:18,11916500,10029525,-1886975,SELL
2020-10-14 11:19:00,11:19,11897650,9927900,-1969750,SELL
2020-10-14 11:20:00,11:20,11878550,9866875,-2011675,SELL
2020-10-14 11:21:00,11:21,11890900,9889875,-2001025,SELL
2020-10-14 11:22:00,11:22,11877250,9880000,-1997250,SELL
2020-10-14 11:23:00,11:23,11907475,9881100,-2026375,SELL
2020-10-14 11:24:00,11:24,11913125,9636700,-2276425,SELL
2020-10-14 11:25:00,11:25,11853175,9649550,-2203625,SELL
2020-10-14 11:26:00,11:26,11954775,9268925,-2685850,SELL
2020-10-14 11:27:00,11:27,11995925,9895900,-2100025,SELL
2020-10-14 11:28:00,11:28,11910650,9484900,-2425750,SELL
2020-10-14 11:29:00,11:29,12099025,9663075,-2435950,SELL
2020-10-14 11:30:00,11:30,12105925,9979175,-2126750,SELL
2020-10-14 11:31:00,11:31,12098800,9733925,-2364875,SELL
2020-10-14 11:32:00,11:32,12047650,9600400,-2447250,SELL
2020-10-14 11:33:00,11:33,12035700,9720600,-2315100,SELL
2020-10-14 11:34:00,11:34,12052550,9799575,-2252975,SELL
2020-10-14 11:35:00,11:35,12106475,9838700,-2267775,SELL
2020-10-14 11:36:00,11:36,12095275,9281250,-2814025,SELL
2020-10-14 11:37:00,11:37,12009150,9617425,-2391725,SELL
2020-10-14 11:38:00,11:38,12076300,9725875,-2350425,SELL
2020-10-14 11:39:00,11:39,12047975,9269950,-2778025,SELL
2020-10-14 11:40:00,11:40,12087500,9782625,-2304875,SELL
2020-10-14 11:41:00,11:41,12030450,9408675,-2621775,SELL
2020-10-14 11:42:00,11:42,12079225,9216275,-2862950,SELL
2020-10-14 11:43:00,11:43,12092425,9321725,-2770700,SELL
2020-10-14 11:44:00,11:44,12112350,9748000,-2364350,SELL
2020-10-14 11:45:00,11:45,12100625,9748025,-2352600,SELL
2020-10-14 11:46:00,11:46,12111675,9543850,-2567825,SELL
2020-10-14 11:47:00,11:47,11864600,9744775,-2119825,SELL
2020-10-14 11:48:00,11:48,12131650,9498775,-2632875,SELL
2020-10-14 11:49:00,11:49,12104300,9565675,-2538625,SELL
2020-10-14 11:50:00,11:50,12138375,9211450,-2926925,SELL
2020-10-14 11:51:00,11:51,12115050,9470200,-2644850,SELL
2020-10-14 11:52:00,11:52,12128850,9681375,-2447475,SELL
2020-10-14 11:53:00,11:53,12205275,9812325,-2392950,SELL
2020-10-14 11:54:00,11:54,12206450,9746675,-2459775,SELL
2020-10-14 11:55:00,11:55,12235150,9852550,-2382600,SELL
2020-10-14 11:56:00,11:56,12189400,9757225,-2432175,SELL
2020-10-14 11:57:00,11:57,12195725,9037450,-3158275,SELL
2020-10-14 11:58:00,11:58,12174600,9186875,-2987725,SELL
2020-10-14 11:59:00,11:59,12236275,9877250,-2359025,SELL
2020-10-14 12:00:00,12:00,12256925,9590000,-2666925,SELL
2020-10-14 12:01:00,12:01,12240350,9626050,-2614300,SELL
2020-10-14 12:02:00,12:02,12305075,9821150,-2483925,SELL
2020-10-14 12:03:00,12:03,12304225,9869825,-2434400,SELL
2020-10-14 12:04:00,12:04,12286525,9575050,-2711475,SELL
2020-10-14 12:05:00,12:05,12401000,9842900,-2558100,SELL
2020-10-14 12:06:00,12:06,12375350,9761925,-2613425,SELL
2020-10-14 12:07:00,12:07,12366500,9886825,-2479675,SELL
2020-10-14 12:08:00,12:08,12365300,9815625,-2549675,SELL
2020-10-14 12:09:00,12:09,12320500,9648950,-2671550,SELL
2020-10-14 12:10:00,12:10,12320500,9833950,-2486550,SELL
2020-10-14 12:11:00,12:11,12387675,9856625,-2531050,SELL
2020-10-14 12:12:00,12:12,12401900,9817200,-2584700,SELL
2020-10-14 12:13:00,12:13,12442375,9197775,-3244600,SELL
2020-10-14 12:14:00,12:14,12460200,9726050,-2734150,SELL
2020-10-14 12:15:00,12:15,12471025,9860125,-2610900,SELL
2020-10-14 12:16:00,12:16,12441100,9967150,-2473950,SELL
2020-10-14 12:17:00,12:17,12450125,9764200,-2685925,SELL
2020-10-14 12:18:00,12:18,12483975,9867625,-2616350,SELL
2020-10-14 12:19:00,12:19,12458900,9560000,-2898900,SELL
2020-10-14 12:20:00,12:20,12456725,9739225,-2717500,SELL
2020-10-14 12:21:00,12:21,12433075,9880175,-2552900,SELL
2020-10-14 12:22:00,12:22,12450725,9518200,-2932525,SELL
2020-10-14 12:23:00,12:23,12426125,9678300,-2747825,SELL
2020-10-14 12:24:00,12:24,12545675,10052300,-2493375,SELL
2020-10-14 12:25:00,12:25,12534600,10051800,-2482800,SELL
2020-10-14 12:26:00,12:26,12006450,9910525,-2095925,SELL
2020-10-14 12:27:00,12:27,11992575,9833350,-2159225,SELL
2020-10-14 12:28:00,12:28,11991350,9828950,-2162400,SELL
2020-10-14 12:29:00,12:29,12058625,9925850,-2132775,SELL
2020-10-14 12:30:00,12:30,12067100,9804000,-2263100,SELL
2020-10-14 12:31:00,12:31,12024850,9912200,-2112650,SELL
2020-10-14 12:32:00,12:32,12090650,9946225,-2144425,SELL
2020-10-14 12:33:00,12:33,12105950,10027075,-2078875,SELL
2020-10-14 12:34:00,12:34,12090700,9799550,-2291150,SELL
2020-10-14 12:35:00,12:35,12064200,9974650,-2089550,SELL
2020-10-14 12:36:00,12:36,12046950,9960925,-2086025,SELL
2020-10-14 12:37:00,12:37,12008925,9973550,-2035375,SELL
2020-10-14 12:38:00,12:38,12048975,9948600,-2100375,SELL
2020-10-14 12:39:00,12:39,12057200,9976625,-2080575,SELL
2020-10-14 12:40:00,12:40,12049825,10026275,-2023550,SELL
2020-10-14 12:41:00,12:41,12101075,10171325,-1929750,SELL
2020-10-14 12:42:00,12:42,12063825,9965475,-2098350,SELL
2020-10-14 12:43:00,12:43,12033525,10082425,-1951100,SELL
2020-10-14 12:44:00,12:44,12012350,10044075,-1968275,SELL
2020-10-14 12:45:00,12:45,12038525,9680025,-2358500,SELL
2020-10-14 12:46:00,12:46,12082650,10012450,-2070200,SELL
2020-10-14 12:47:00,12:47,12065100,9979450,-2085650,SELL
2020-10-14 12:48:00,12:48,12025625,9961800,-2063825,SELL
2020-10-14 12:49:00,12:49,12056950,9771850,-2285100,SELL
2020-10-14 12:50:00,12:50,12104225,9923100,-2181125,SELL
2020-10-14 12:51:00,12:51,12067225,10024500,-2042725,SELL
2020-10-14 12:52:00,12:52,12056225,9669825,-2386400,SELL
2020-10-14 12:53:00,12:53,12051100,9635675,-2415425,SELL
2020-10-14 12:54:00,12:54,12066275,9832000,-2234275,SELL
2020-10-14 12:55:00,12:55,12068925,10093450,-1975475,SELL
2020-10-14 12:56:00,12:56,12059050,9980375,-2078675,SELL
2020-10-14 12:57:00,12:57,12076850,9922950,-2153900,SELL
2020-10-14 12:58:00,12:58,12017000,10026625,-1990375,SELL
2020-10-14 12:59:00,12:59,12039150,10100825,-1938325,SELL
2020-10-14 13:00:00,13:00,12078100,10054425,-2023675,SELL
2020-10-14 13:01:00,13:01,12024425,10047800,-1976625,SELL
2020-10-14 13:02:00,13:02,12115575,10091200,-2024375,SELL
2020-10-14 13:03:00,13:03,12099250,10031400,-2067850,SELL
2020-10-14 13:04:00,13:04,12106075,10026250,-2079825,SELL
2020-10-14 13:05:00,13:05,12080325,9782100,-2298225,SELL
2020-10-14 13:06:00,13:06,11993925,9832400,-2161525,SELL
2020-10-14 13:07:00,13:07,12006125,9588750,-2417375,SELL
2020-10-14 13:08:00,13:08,12021050,9073175,-2947875,SELL
2020-10-14 13:09:00,13:09,12016375,9487525,-2528850,SELL
2020-10-14 13:10:00,13:10,11994500,9553700,-2440800,SELL
2020-10-14 13:11:00,13:11,12026950,9627875,-2399075,SELL
2020-10-14 13:12:00,13:12,12042775,9662750,-2380025,SELL
2020-10-14 13:13:00,13:13,12074550,9932550,-2142000,SELL
2020-10-14 13:14:00,13:14,12060150,9779700,-2280450,SELL
2020-10-14 13:15:00,13:15,12042950,9903650,-2139300,SELL
2020-10-14 13:16:00,13:16,12055775,9872900,-2182875,SELL
2020-10-14 13:17:00,13:17,12066425,9398100,-2668325,SELL
2020-10-14 13:18:00,13:18,12101800,9711875,-2389925,SELL
2020-10-14 13:19:00,13:19,12101800,9688875,-2412925,SELL
2020-10-14 13:20:00,13:20,12047375,9457525,-2589850,SELL
2020-10-14 13:21:00,13:21,12130050,9632175,-2497875,SELL
2020-10-14 13:22:00,13:22,12123650,9862850,-2260800,SELL
2020-10-14 13:23:00,13:23,12158725,9729925,-2428800,SELL
2020-10-14 13:24:00,13:24,12200000,9713525,-2486475,SELL
2020-10-14 13:25:00,13:25,12223325,9446950,-2776375,SELL
2020-10-14 13:26:00,13:26,12159400,9506500,-2652900,SELL
2020-10-14 13:27:00,13:27,12175825,9710800,-2465025,SELL
2020-10-14 13:28:00,13:28,12187650,9196200,-2991450,SELL
2020-10-14 13:29:00,13:29,12216050,9652300,-2563750,SELL
2020-10-14 13:30:00,13:30,12257325,9889775,-2367550,SELL
2020-10-14 13:31:00,13:31,12234125,9896350,-2337775,SELL
2020-10-14 13:32:00,13:32,12192600,9962975,-2229625,SELL
2020-10-14 13:33:00,13:33,12243775,9666850,-2576925,SELL
2020-10-14 13:34:00,13:34,12225125,9426600,-2798525,SELL
2020-10-14 13:35:00,13:35,12262725,9964525,-2298200,SELL
2020-10-14 13:36:00,13:36,12166925,9735275,-2431650,SELL
2020-10-14 13:37:00,13:37,12207850,9446575,-2761275,SELL
2020-10-14 13:38:00,13:38,12207850,9636100,-2571750,SELL
2020-10-14 13:39:00,13:39,12246275,9771950,-2474325,SELL
2020-10-14 13:40:00,13:40,12263300,10053400,-2209900,SELL
2020-10-14 13:41:00,13:41,12233500,9580575,-2652925,SELL
2020-10-14 13:42:00,13:42,12245400,9629050,-2616350,SELL
2020-10-14 13:43:00,13:43,12234800,9772600,-2462200,SELL
2020-10-14 13:44:00,13:44,12248175,9950100,-2298075,SELL
2020-10-14 13:45:00,13:45,12279575,9766900,-2512675,SELL
2020-10-14 13:46:00,13:46,12268050,9947575,-2320475,SELL
2020-10-14 13:47:00,13:47,12282500,9906650,-2375850,SELL
2020-10-14 13:48:00,13:48,12218875,9619175,-2599700,SELL
2020-10-14 13:49:00,13:49,12274250,9959825,-2314425,SELL
2020-10-14 13:50:00,13:50,12229975,10019900,-2210075,SELL
2020-10-14 13:51:00,13:51,12279725,9678950,-2600775,SELL
2020-10-14 13:52:00,13:52,12256075,9488400,-2767675,SELL
2020-10-14 13:53:00,13:53,12256075,9163075,-3093000,SELL
2020-10-14 13:54:00,13:54,12284125,9980625,-2303500,SELL
2020-10-14 13:55:00,13:55,12268275,9733975,-2534300,SELL
2020-10-14 13:56:00,13:56,12294175,10063200,-2230975,SELL
2020-10-14 13:57:00,13:57,12229625,9524300,-2705325,SELL
2020-10-14 13:58:00,13:58,12240050,9800825,-2439225,SELL
2020-10-14 13:59:00,13:59,12257350,10033375,-2223975,SELL
2020-10-14 14:00:00,14:00,12245550,10097225,-2148325,SELL
2020-10-14 14:01:00,14:01,12210200,9842875,-2367325,SELL
2020-10-14 14:02:00,14:02,12213100,9806825,-2406275,SELL
2020-10-14 14:03:00,14:03,12031525,9977075,-2054450,SELL
2020-10-14 14:04:00,14:04,12075350,9885400,-2189950,SELL
2020-10-14 14:05:00,14:05,12091250,9773750,-2317500,SELL
2020-10-14 14:06:00,14:06,12049100,9538000,-2511100,SELL
2020-10-14 14:07:00,14:07,12064825,9730650,-2334175,SELL
2020-10-14 14:08:00,14:08,12078500,9804450,-2274050,SELL
2020-10-14 14:09:00,14:09,12047675,9773850,-2273825,SELL
2020-10-14 14:10:00,14:10,12056725,9872625,-2184100,SELL
2020-10-14 14:11:00,14:11,12027475,9782375,-2245100,SELL
2020-10-14 14:12:00,14:12,12028325,9685050,-2343275,SELL
2020-10-14 14:13:00,14:13,12019600,9548075,-2471525,SELL
2020-10-14 14:14:00,14:14,12023375,9677250,-2346125,SELL
2020-10-14 14:15:00,14:15,12011550,9871675,-2139875,SELL
2020-10-14 14:16:00,14:16,12006975,9671175,-2335800,SELL
2020-10-14 14:17:00,14:17,12011575,9830700,-2180875,SELL
2020-10-14 14:18:00,14:18,11957400,9807425,-2149975,SELL
2020-10-14 14:19:00,14:19,12011725,9934075,-2077650,SELL
2020-10-14 14:20:00,14:20,12015350,9994175,-2021175,SELL
2020-10-14 14:21:00,14:21,11163525,9693200,-1470325,SELL
2020-10-14 14:22:00,14:22,11175650,9877125,-1298525,SELL
2020-10-14 14:23:00,14:23,11151450,9900375,-1251075,SELL
2020-10-14 14:24:00,14:24,10689675,9813975,-875700,SELL
2020-10-14 14:25:00,14:25,10689675,9811125,-878550,SELL
2020-10-14 14:26:00,14:26,10687425,9632200,-1055225,SELL
2020-10-14 14:27:00,14:27,10592625,9916000,-676625,SELL
2020-10-14 14:28:00,14:28,10590150,9892750,-697400,SELL
2020-10-14 14:29:00,14:29,10562100,9906375,-655725,SELL
2020-10-14 14:30:00,14:30,10379925,9938950,-440975,SELL
2020-10-14 14:31:00,14:31,10379275,9886900,-492375,SELL
2020-10-14 14:32:00,14:32,10378100,9927075,-451025,SELL
2020-10-14 14:33:00,14:33,10124775,9996075,-128700,SELL
2020-10-14 14:34:00,14:34,10146950,10002850,-144100,SELL
2020-10-14 14:35:00,14:35,10134325,10023175,-111150,SELL
2020-10-14 14:36:00,14:36,10211250,9880250,-331000,SELL
2020-10-14 14:37:00,14:37,10188725,9997475,-191250,SELL
2020-10-14 14:38:00,14:38,10161925,10045175,-116750,SELL
2020-10-14 14:39:00,14:39,10045275,10019275,-26000,SELL
2020-10-14 14:40:00,14:40,10015650,9940275,-75375,SELL
2020-10-14 14:41:00,14:41,10015650,9795475,-220175,SELL
2020-10-14 14:42:00,14:42,10134775,9877250,-257525,SELL
2020-10-14 14:43:00,14:43,10164325,10124950,-39375,SELL
2020-10-14 14:44:00,14:44,10164325,10141225,-23100,SELL
2020-10-14 14:45:00,14:45,9970000,10229200,259200,BUY
2020-10-14 14:46:00,14:46,9928750,10148225,219475,BUY
2020-10-14 14:47:00,14:47,9932750,10173175,240425,BUY
2020-10-14 14:48:00,14:48,9994750,10028200,33450,BUY
2020-10-14 14:49:00,14:49,9951850,10089925,138075,BUY
2020-10-14 14:50:00,14:50,9994750,9905075,-89675,SELL
2020-10-14 14:51:00,14:51,9988100,10087025,98925,BUY
2020-10-14 14:52:00,14:52,9963250,9613600,-349650,SELL
2020-10-14 14:53:00,14:53,9996225,10089375,93150,BUY
2020-10-14 14:54:00,14:54,9993200,10079950,86750,BUY
2020-10-14 14:55:00,14:55,10040325,10152800,112475,BUY
2020-10-14 14:56:00,14:56,10043900,10159175,115275,BUY
2020-10-14 14:57:00,14:57,9560125,9997225,437100,BUY
2020-10-14 14:58:00,14:58,9584875,9994950,410075,BUY
2020-10-14 14:59:00,14:59,9584875,10000625,415750,BUY
2020-10-14 15:00:00,15:00,9316500,9886600,570100,BUY
2020-10-14 15:01:00,15:01,9320450,9878750,558300,BUY
2020-10-14 15:02:00,15:02,9317125,9862450,545325,BUY
2020-10-14 15:03:00,15:03,9156225,9869325,713100,BUY
2020-10-14 15:04:00,15:04,9163625,9908450,744825,BUY
2020-10-14 15:05:00,15:05,9163625,9921775,758150,BUY
2020-10-14 15:06:00,15:06,9108950,9942275,833325,BUY
2020-10-14 15:07:00,15:07,9115175,9974175,859000,BUY
2020-10-14 15:08:00,15:08,9071650,9971425,899775,BUY
2020-10-14 15:09:00,15:09,9082350,10077350,995000,BUY
2020-10-14 15:10:00,15:10,9102225,10102425,1000200,BUY
2020-10-14 15:11:00,15:11,9074175,10053100,978925,BUY
2020-10-14 15:12:00,15:12,8856075,10083650,1227575,BUY
2020-10-14 15:13:00,15:13,8848675,10043275,1194600,BUY
2020-10-14 15:14:00,15:14,8831300,10026725,1195425,BUY
2020-10-14 15:15:00,15:15,8798675,9952575,1153900,BUY
2020-10-14 15:16:00,15:16,8784675,9927325,1142650,BUY
2020-10-14 15:17:00,15:17,8789100,9978150,1189050,BUY
2020-10-14 15:18:00,15:18,8358325,9803050,1444725,BUY
2020-10-14 15:19:00,15:19,8350250,9789825,1439575,BUY
2020-10-14 15:20:00,15:20,8371700,9788600,1416900,BUY
2020-10-14 15:21:00,15:21,8011000,9575325,1564325,BUY
2020-10-14 15:22:00,15:22,7999975,9576500,1576525,BUY
2020-10-14 15:23:00,15:23,8008300,9588625,1580325,BUY
2020-10-14 15:24:00,15:24,7865100,9450150,1585050,BUY
2020-10-14 15:25:00,15:25,7905500,9457325,1551825,BUY
2020-10-14 15:26:00,15:26,7850675,9476400,1625725,BUY
2020-10-14 15:27:00,15:27,7920525,9476450,1555925,BUY
2020-10-14 15:28:00,15:28,7900825,9482725,1581900,BUY
2020-10-14 15:29:00,15:29,7915800,9482925,1567125,BUY
2020-10-15 09:15:00,09:15,7379350,8246825,867475,BUY
2020-10-15 09:16:00,09:16,7434750,8288650,853900,BUY
2020-10-15 09:17:00,09:17,8512250,10081150,1568900,BUY
2020-10-15 09:18:00,09:18,8536625,10086725,1550100,BUY
2020-10-15 09:19:00,09:19,8531625,10067825,1536200,BUY
2020-10-15 09:20:00,09:20,10104450,11077375,972925,BUY
2020-10-15 09:21:00,09:21,10066775,11059275,992500,BUY
2020-10-15 09:22:00,09:22,10089500,11058475,968975,BUY
2020-10-15 09:23:00,09:23,11160650,11541350,380700,BUY
2020-10-15 09:24:00,09:24,11174325,11686225,511900,BUY
2020-10-15 09:25:00,09:25,11153375,11704200,550825,BUY
2020-10-15 09:26:00,09:26,11882925,12377950,495025,BUY
2020-10-15 09:27:00,09:27,11896125,12416275,520150,BUY
2020-10-15 09:28:00,09:28,11867975,12276425,408450,BUY
2020-10-15 09:29:00,09:29,12424400,12787375,362975,BUY
2020-10-15 09:30:00,09:30,12442000,12709950,267950,BUY
2020-10-15 09:31:00,09:31,12427000,12770025,343025,BUY
2020-10-15 09:32:00,09:32,13016200,13104775,88575,BUY
2020-10-15 09:33:00,09:33,13037975,12760725,-277250,SELL
2020-10-15 09:34:00,09:34,13008075,13120300,112225,BUY
2020-10-15 09:35:00,09:35,13227775,13572000,344225,BUY
2020-10-15 09:36:00,09:36,13278100,13578600,300500,BUY
2020-10-15 09:37:00,09:37,13286750,13510200,223450,BUY
2020-10-15 09:38:00,09:38,13114175,14047700,933525,BUY
2020-10-15 09:39:00,09:39,13112600,14039975,927375,BUY
2020-10-15 09:40:00,09:40,13093300,14036825,943525,BUY
2020-10-15 09:41:00,09:41,13008975,14453725,1444750,BUY
2020-10-15 09:42:00,09:42,12997875,14448575,1450700,BUY
2020-10-15 09:43:00,09:43,12970600,14265425,1294825,BUY
2020-10-15 09:44:00,09:44,13411025,14571225,1160200,BUY
2020-10-15 09:45:00,09:45,13425775,14571600,1145825,BUY
2020-10-15 09:46:00,09:46,13417250,14355100,937850,BUY
2020-10-15 09:47:00,09:47,13690250,14885825,1195575,BUY
2020-10-15 09:48:00,09:48,13690775,14739750,1048975,BUY
2020-10-15 09:49:00,09:49,13688075,14526150,838075,BUY
2020-10-15 09:50:00,09:50,12485025,15446175,2961150,BUY
2020-10-15 09:51:00,09:51,12502875,15256725,2753850,BUY
2020-10-15 09:52:00,09:52,12484425,15393775,2909350,BUY
2020-10-15 09:53:00,09:53,12161650,16009000,3847350,BUY
2020-10-15 09:54:00,09:54,12189825,15834175,3644350,BUY
2020-10-15 09:55:00,09:55,12163600,15758350,3594750,BUY
2020-10-15 09:56:00,09:56,12183575,16304425,4120850,BUY
2020-10-15 09:57:00,09:57,12180625,16253975,4073350,BUY
2020-10-15 09:58:00,09:58,12180625,16087150,3906525,BUY
2020-10-15 09:59:00,09:59,12513725,16367125,3853400,BUY
2020-10-15 10:00:00,10:00,12578375,16330150,3751775,BUY
2020-10-15 10:01:00,10:01,12547675,16392850,3845175,BUY
2020-10-15 10:02:00,10:02,13136500,16537225,3400725,BUY
2020-10-15 10:03:00,10:03,13106125,16812000,3705875,BUY
2020-10-15 10:04:00,10:04,13112275,16600375,3488100,BUY
2020-10-15 10:05:00,10:05,13578200,17106575,3528375,BUY
2020-10-15 10:06:00,10:06,13546250,16507725,2961475,BUY
2020-10-15 10:07:00,10:07,13508350,17236425,3728075,BUY
2020-10-15 10:08:00,10:08,13926475,17412400,3485925,BUY
2020-10-15 10:09:00,10:09,13919225,17400700,3481475,BUY
2020-10-15 10:10:00,10:10,13922700,17415275,3492575,BUY
2020-10-15 10:11:00,10:11,14295550,17405400,3109850,BUY
2020-10-15 10:12:00,10:12,14255250,17764050,3508800,BUY
2020-10-15 10:13:00,10:13,14278975,17735925,3456950,BUY
2020-10-15 10:14:00,10:14,14498075,17631225,3133150,BUY
2020-10-15 10:15:00,10:15,14511775,16988075,2476300,BUY
2020-10-15 10:16:00,10:16,14523475,17641850,3118375,BUY
2020-10-15 10:17:00,10:17,14781250,18076775,3295525,BUY
2020-10-15 10:18:00,10:18,14747925,17864150,3116225,BUY
2020-10-15 10:19:00,10:19,14740000,18187775,3447775,BUY
2020-10-15 10:20:00,10:20,15033425,18334750,3301325,BUY
2020-10-15 10:21:00,10:21,15032175,18340850,3308675,BUY
2020-10-15 10:22:00,10:22,15045475,17876100,2830625,BUY
2020-10-15 10:23:00,10:23,15300125,18627925,3327800,BUY
2020-10-15 10:24:00,10:24,15262025,18308825,3046800,BUY
2020-10-15 10:25:00,10:25,15248275,18479600,3231325,BUY
2020-10-15 10:26:00,10:26,15286075,17858100,2572025,BUY
2020-10-15 10:27:00,10:27,15261775,17716025,2454250,BUY
2020-10-15 10:28:00,10:28,15240750,18018200,2777450,BUY
2020-10-15 10:29:00,10:29,15523875,17819900,2296025,BUY
2020-10-15 10:30:00,10:30,15550475,17930150,2379675,BUY
2020-10-15 10:31:00,10:31,15464425,17896775,2432350,BUY
2020-10-15 10:32:00,10:32,15619850,17327800,1707950,BUY
2020-10-15 10:33:00,10:33,15720550,17686475,1965925,BUY
2020-10-15 10:34:00,10:34,15692200,17353650,1661450,BUY
2020-10-15 10:35:00,10:35,15777200,17909925,2132725,BUY
2020-10-15 10:36:00,10:36,15794300,17902125,2107825,BUY
2020-10-15 10:37:00,10:37,15809175,17365875,1556700,BUY
2020-10-15 10:38:00,10:38,16000750,17897925,1897175,BUY
2020-10-15 10:39:00,10:39,16021550,18128000,2106450,BUY
2020-10-15 10:40:00,10:40,16014975,18116550,2101575,BUY
2020-10-15 10:41:00,10:41,16177175,18270275,2093100,BUY
2020-10-15 10:42:00,10:42,16159325,18261175,2101850,BUY
2020-10-15 10:43:00,10:43,16190475,18101125,1910650,BUY
2020-10-15 10:44:00,10:44,16431475,18159600,1728125,BUY
2020-10-15 10:45:00,10:45,16441175,17327250,886075,BUY
2020-10-15 10:46:00,10:46,16430800,18215375,1784575,BUY
2020-10-15 10:47:00,10:47,16509975,18331850,1821875,BUY
2020-10-15 10:48:00,10:48,16469150,18341725,1872575,BUY
2020-10-15 10:49:00,10:49,16539675,18568675,2029000,BUY
2020-10-15 10:50:00,10:50,16758625,18563675,1805050,BUY
2020-10-15 10:51:00,10:51,16737100,18393525,1656425,BUY
2020-10-15 10:52:00,10:52,16686400,18722300,2035900,BUY
2020-10-15 10:53:00,10:53,16844625,18567400,1722775,BUY
2020-10-15 10:54:00,10:54,16734275,18602700,1868425,BUY
2020-10-15 10:55:00,10:55,16857150,18771850,1914700,BUY
2020-10-15 10:56:00,10:56,16643975,18489250,1845275,BUY
2020-10-15 10:57:00,10:57,16649250,18818650,2169400,BUY
2020-10-15 10:58:00,10:58,16615700,18026625,1410925,BUY
2020-10-15 10:59:00,10:59,16775300,18408750,1633450,BUY
2020-10-15 11:00:00,11:00,16776000,18796825,2020825,BUY
2020-10-15 11:01:00,11:01,16751150,18397725,1646575,BUY
2020-10-15 11:02:00,11:02,16814225,18238075,1423850,BUY
2020-10-15 11:03:00,11:03,16916700,18636875,1720175,BUY
2020-10-15 11:04:00,11:04,16770150,18899675,2129525,BUY
2020-10-15 11:05:00,11:05,16903750,18811450,1907700,BUY
2020-10-15 11:06:00,11:06,16925600,19258475,2332875,BUY
2020-10-15 11:07:00,11:07,16939250,19085925,2146675,BUY
2020-10-15 11:08:00,11:08,16978950,19251375,2272425,BUY
2020-10-15 11:09:00,11:09,16941150,19173475,2232325,BUY
2020-10-15 11:10:00,11:10,16952200,18318525,1366325,BUY
2020-10-15 11:11:00,11:11,17014325,19461650,2447325,BUY
2020-10-15 11:12:00,11:12,17045175,19092450,2047275,BUY
2020-10-15 11:13:00,11:13,17053375,18227275,1173900,BUY
2020-10-15 11:14:00,11:14,17043225,19449525,2406300,BUY
2020-10-15 11:15:00,11:15,17132350,19110750,1978400,BUY
2020-10-15 11:16:00,11:16,17103450,19062150,1958700,BUY
2020-10-15 11:17:00,11:17,17185875,18726950,1541075,BUY
2020-10-15 11:18:00,11:18,17187125,19401550,2214425,BUY
2020-10-15 11:19:00,11:19,17204975,18202325,997350,BUY
2020-10-15 11:20:00,11:20,17284000,18739725,1455725,BUY
2020-10-15 11:21:00,11:21,17134825,18912575,1777750,BUY
2020-10-15 11:22:00,11:22,17287250,19720350,2433100,BUY
2020-10-15 11:23:00,11:23,17434900,19433075,1998175,BUY
2020-10-15 11:24:00,11:24,17381475,19166075,1784600,BUY
2020-10-15 11:25:00,11:25,17449250,19394050,1944800,BUY
2020-10-15 11:26:00,11:26,17514600,18749825,1235225,BUY
2020-10-15 11:27:00,11:27,17499700,19541075,2041375,BUY
2020-10-15 11:28:00,11:28,17447825,19264575,1816750,BUY
2020-10-15 11:29:00,11:29,17561850,18815175,1253325,BUY
2020-10-15 11:30:00,11:30,17681975,19084975,1403000,BUY
2020-10-15 11:31:00,11:31,17619850,18924350,1304500,BUY
2020-10-15 11:32:00,11:32,17823625,19564225,1740600,BUY
2020-10-15 11:33:00,11:33,17795600,19565950,1770350,BUY
2020-10-15 11:34:00,11:34,17762800,19438750,1675950,BUY
2020-10-15 11:35:00,11:35,17821450,18860250,1038800,BUY
2020-10-15 11:36:00,11:36,17805200,18870650,1065450,BUY
2020-10-15 11:37:00,11:37,17833600,19059425,1225825,BUY
2020-10-15 11:38:00,11:38,17986000,18961825,975825,BUY
2020-10-15 11:39:00,11:39,17953650,18687075,733425,BUY
2020-10-15 11:40:00,11:40,17951850,18741150,789300,BUY
2020-10-15 11:41:00,11:41,17999675,18395525,395850,BUY
2020-10-15 11:42:00,11:42,18002300,18955550,953250,BUY
2020-10-15 11:43:00,11:43,17999325,17634825,-364500,SELL
2020-10-15 11:44:00,11:44,17989400,18388150,398750,BUY
2020-10-15 11:45:00,11:45,18016925,19011450,994525,BUY
2020-10-15 11:46:00,11:46,17971275,18695975,724700,BUY
2020-10-15 11:47:00,11:47,18093725,18226950,133225,BUY
2020-10-15 11:48:00,11:48,18143875,18917250,773375,BUY
2020-10-15 11:49:00,11:49,18120250,18204050,83800,BUY
2020-10-15 11:50:00,11:50,18037775,19238475,1200700,BUY
2020-10-15 11:51:00,11:51,18006750,17996150,-10600,SELL
2020-10-15 11:52:00,11:52,18115925,18642675,526750,BUY
2020-10-15 11:53:00,11:53,18197000,19490950,1293950,BUY
2020-10-15 11:54:00,11:54,18168975,18361250,192275,BUY
2020-10-15 11:55:00,11:55,18165075,18174100,9025,BUY
2020-10-15 11:56:00,11:56,18187050,18159600,-27450,SELL
2020-10-15 11:57:00,11:57,18191550,19408800,1217250,BUY
2020-10-15 11:58:00,11:58,18152825,19157700,1004875,BUY
2020-10-15 11:59:00,11:59,18103800,18255375,151575,BUY
2020-10-15 12:00:00,12:00,18186925,19233475,1046550,BUY
2020-10-15 12:01:00,12:01,18145550,18902200,756650,BUY
2020-10-15 12:02:00,12:02,18263650,19302900,1039250,BUY
2020-10-15 12:03:00,12:03,18295650,18319900,24250,BUY
2020-10-15 12:04:00,12:04,18276700,18895625,618925,BUY
2020-10-15 12:05:00,12:05,18387025,19433375,1046350,BUY
2020-10-15 12:06:00,12:06,18339500,19156675,817175,BUY
2020-10-15 12:07:00,12:07,18212275,19400050,1187775,BUY
2020-10-15 12:08:00,12:08,18487275,18983275,496000,BUY
2020-10-15 12:09:00,12:09,18487050,19078700,591650,BUY
2020-10-15 12:10:00,12:10,18406250,18835575,429325,BUY
2020-10-15 12:11:00,12:11,18468600,19803725,1335125,BUY
2020-10-15 12:12:00,12:12,18407850,19743025,1335175,BUY
2020-10-15 12:13:00,12:13,18407850,19169625,761775,BUY
2020-10-15 12:14:00,12:14,18568200,17823850,-744350,SELL
2020-10-15 12:15:00,12:15,18622175,19676350,1054175,BUY
2020-10-15 12:16:00,12:16,18585550,19635675,1050125,BUY
2020-10-15 12:17:00,12:17,18678875,19423350,744475,BUY
2020-10-15 12:18:00,12:18,18695675,19564050,868375,BUY
2020-10-15 12:19:00,12:19,18732700,19422275,689575,BUY
2020-10-15 12:20:00,12:20,18733325,18842700,109375,BUY
2020-10-15 12:21:00,12:21,18753350,19180175,426825,BUY
2020-10-15 12:22:00,12:22,18569850,18762525,192675,BUY
2020-10-15 12:23:00,12:23,18724950,19231900,506950,BUY
2020-10-15 12:24:00,12:24,18654925,18852125,197200,BUY
2020-10-15 12:25:00,12:25,18764900,18914825,149925,BUY
2020-10-15 12:26:00,12:26,18761375,18665950,-95425,SELL
2020-10-15 12:27:00,12:27,18718525,19883825,1165300,BUY
2020-10-15 12:28:00,12:28,18737175,19766725,1029550,BUY
2020-10-15 12:29:00,12:29,18692250,19791775,1099525,BUY
2020-10-15 12:30:00,12:30,18726500,19671475,944975,BUY
2020-10-15 12:31:00,12:31,18715400,19455975,740575,BUY
2020-10-15 12:32:00,12:32,18772950,20009550,1236600,BUY
2020-10-15 12:33:00,12:33,18696025,19571450,875425,BUY
2020-10-15 12:34:00,12:34,18821125,19342425,521300,BUY
2020-10-15 12:35:00,12:35,18867150,19517425,650275,BUY
2020-10-15 12:36:00,12:36,18887975,19801450,913475,BUY
2020-10-15 12:37:00,12:37,18913200,19988250,1075050,BUY
2020-10-15 12:38:00,12:38,18956725,19951125,994400,BUY
2020-10-15 12:39:00,12:39,19005075,19674225,669150,BUY
2020-10-15 12:40:00,12:40,18898100,19509025,610925,BUY
2020-10-15 12:41:00,12:41,19016400,19852050,835650,BUY
2020-10-15 12:42:00,12:42,19004100,18858050,-146050,SELL
2020-10-15 12:43:00,12:43,18995900,19030875,34975,BUY
2020-10-15 12:44:00,12:44,18931450,19712175,780725,BUY
2020-10-15 12:45:00,12:45,18873225,20151575,1278350,BUY
2020-10-15 12:46:00,12:46,18931725,19085975,154250,BUY
2020-10-15 12:47:00,12:47,18887700,19567575,679875,BUY
2020-10-15 12:48:00,12:48,19041550,19557925,516375,BUY
2020-10-15 12:49:00,12:49,19016325,19172775,156450,BUY
2020-10-15 12:50:00,12:50,18948775,19585275,636500,BUY
2020-10-15 12:51:00,12:51,18914550,20112125,1197575,BUY
2020-10-15 12:52:00,12:52,18906125,20455000,1548875,BUY
2020-10-15 12:53:00,12:53,19128750,20093975,965225,BUY
2020-10-15 12:54:00,12:54,19039250,20081450,1042200,BUY
2020-10-15 12:55:00,12:55,19116400,19752125,635725,BUY
2020-10-15 12:56:00,12:56,18979925,20143300,1163375,BUY
2020-10-15 12:57:00,12:57,19077450,20071575,994125,BUY
2020-10-15 12:58:00,12:58,19071425,19242725,171300,BUY
2020-10-15 12:59:00,12:59,19172600,20202575,1029975,BUY
2020-10-15 13:00:00,13:00,19070675,19724900,654225,BUY
2020-10-15 13:01:00,13:01,19110175,19926625,816450,BUY
2020-10-15 13:02:00,13:02,19417250,20118450,701200,BUY
2020-10-15 13:03:00,13:03,19471675,20509975,1038300,BUY
2020-10-15 13:04:00,13:04,19407575,20365975,958400,BUY
2020-10-15 13:05:00,13:05,19445725,17991950,-1453775,SELL
2020-10-15 13:06:00,13:06,19419200,18380100,-1039100,SELL
2020-10-15 13:07:00,13:07,19413775,18331850,-1081925,SELL
2020-10-15 13:08:00,13:08,19832400,17540475,-2291925,SELL
2020-10-15 13:09:00,13:09,19806400,17963450,-1842950,SELL
2020-10-15 13:10:00,13:10,19793575,17796700,-1996875,SELL
2020-10-15 13:11:00,13:11,19763900,18119925,-1643975,SELL
2020-10-15 13:12:00,13:12,20173400,17821325,-2352075,SELL
2020-10-15 13:13:00,13:13,20129500,17746350,-2383150,SELL
2020-10-15 13:14:00,13:14,20160550,17317950,-2842600,SELL
2020-10-15 13:15:00,13:15,20673525,17399575,-3273950,SELL
2020-10-15 13:16:00,13:16,20631100,17756500,-2874600,SELL
2020-10-15 13:17:00,13:17,20674725,16813450,-3861275,SELL
2020-10-15 13:18:00,13:18,20795225,17612725,-3182500,SELL
2020-10-15 13:19:00,13:19,20817525,17730500,-3087025,SELL
2020-10-15 13:20:00,13:20,20807900,17565050,-3242850,SELL
2020-10-15 13:21:00,13:21,20840325,17264325,-3576000,SELL
2020-10-15 13:22:00,13:22,20833850,17460175,-3373675,SELL
2020-10-15 13:23:00,13:23,20885500,17141925,-3743575,SELL
2020-10-15 13:24:00,13:24,20829200,17492525,-3336675,SELL
2020-10-15 13:25:00,13:25,20869150,17462050,-3407100,SELL
2020-10-15 13:26:00,13:26,20885825,17250675,-3635150,SELL
2020-10-15 13:27:00,13:27,21048500,16836800,-4211700,SELL
2020-10-15 13:28:00,13:28,21000400,17530850,-3469550,SELL
2020-10-15 13:29:00,13:29,21004725,17091825,-3912900,SELL
2020-10-15 13:30:00,13:30,21235350,17208325,-4027025,SELL
2020-10-15 13:31:00,13:31,21213625,17063225,-4150400,SELL
2020-10-15 13:32:00,13:32,21215375,16876375,-4339000,SELL
2020-10-15 13:33:00,13:33,21334325,17034450,-4299875,SELL
2020-10-15 13:34:00,13:34,21430975,16933425,-4497550,SELL
2020-10-15 13:35:00,13:35,21381600,17145475,-4236125,SELL
2020-10-15 13:36:00,13:36,21613750,16764525,-4849225,SELL
2020-10-15 13:37:00,13:37,21621550,16755000,-4866550,SELL
2020-10-15 13:38:00,13:38,21630325,16687225,-4943100,SELL
2020-10-15 13:39:00,13:39,21412250,16827350,-4584900,SELL
2020-10-15 13:40:00,13:40,21431725,16552925,-4878800,SELL
2020-10-15 13:41:00,13:41,21424575,16594700,-4829875,SELL
2020-10-15 13:42:00,13:42,21470525,16878725,-4591800,SELL
2020-10-15 13:43:00,13:43,21498025,16622175,-4875850,SELL
2020-10-15 13:44:00,13:44,21531975,16636900,-4895075,SELL
2020-10-15 13:45:00,13:45,21797950,16810600,-4987350,SELL
2020-10-15 13:46:00,13:46,21795150,16809425,-4985725,SELL
2020-10-15 13:47:00,13:47,21790275,16487475,-5302800,SELL
2020-10-15 13:48:00,13:48,21655275,15667150,-5988125,SELL
2020-10-15 13:49:00,13:49,21639475,15683400,-5956075,SELL
2020-10-15 13:50:00,13:50,21681075,15511425,-6169650,SELL
2020-10-15 13:51:00,13:51,21554525,14662950,-6891575,SELL
2020-10-15 13:52:00,13:52,21528125,15136700,-6391425,SELL
2020-10-15 13:53:00,13:53,21584775,14998525,-6586250,SELL
2020-10-15 13:54:00,13:54,21392900,13759300,-7633600,SELL
2020-10-15 13:55:00,13:55,21410725,14126875,-7283850,SELL
2020-10-15 13:56:00,13:56,21399225,14051275,-7347950,SELL
2020-10-15 13:57:00,13:57,21501425,13603925,-7897500,SELL
2020-10-15 13:58:00,13:58,21524100,13822050,-7702050,SELL
2020-10-15 13:59:00,13:59,21520425,13830825,-7689600,SELL
2020-10-15 14:00:00,14:00,21543325,13878375,-7664950,SELL
2020-10-15 14:01:00,14:01,21564250,14231425,-7332825,SELL
2020-10-15 14:02:00,14:02,21562550,14192050,-7370500,SELL
2020-10-15 14:03:00,14:03,21643150,13611550,-8031600,SELL
2020-10-15 14:04:00,14:04,21677700,14327250,-7350450,SELL
2020-10-15 14:05:00,14:05,21662175,14394800,-7267375,SELL
2020-10-15 14:06:00,14:06,21910575,14129525,-7781050,SELL
2020-10-15 14:07:00,14:07,21925125,14423550,-7501575,SELL
2020-10-15 14:08:00,14:08,21909775,14249375,-7660400,SELL
2020-10-15 14:09:00,14:09,21798200,13317400,-8480800,SELL
2020-10-15 14:10:00,14:10,21806075,13515400,-8290675,SELL
2020-10-15 14:11:00,14:11,21784200,13465350,-8318850,SELL
2020-10-15 14:12:00,14:12,21603075,12250550,-9352525,SELL
2020-10-15 14:13:00,14:13,21650625,12182375,-9468250,SELL
2020-10-15 14:14:00,14:14,21645225,12296525,-9348700,SELL
2020-10-15 14:15:00,14:15,21255475,11925600,-9329875,SELL
2020-10-15 14:16:00,14:16,21257850,11824325,-9433525,SELL
2020-10-15 14:17:00,14:17,21257850,11937275,-9320575,SELL
2020-10-15 14:18:00,14:18,20844550,11371975,-9472575,SELL
2020-10-15 14:19:00,14:19,20849900,10653175,-10196725,SELL
2020-10-15 14:20:00,14:20,20854850,10501300,-10353550,SELL
2020-10-15 14:21:00,14:21,20984200,11518275,-9465925,SELL
2020-10-15 14:22:00,14:22,20962525,11668200,-9294325,SELL
2020-10-15 14:23:00,14:23,20964725,11595750,-9368975,SELL
2020-10-15 14:24:00,14:24,21237075,11858975,-9378100,SELL
2020-10-15 14:25:00,14:25,21206400,11713125,-9493275,SELL
2020-10-15 14:26:00,14:26,21219775,11569575,-9650200,SELL
2020-10-15 14:27:00,14:27,21385075,11934075,-9451000,SELL
2020-10-15 14:28:00,14:28,21401575,11565950,-9835625,SELL
2020-10-15 14:29:00,14:29,21382225,11951000,-9431225,SELL
2020-10-15 14:30:00,14:30,21341275,11960925,-9380350,SELL
2020-10-15 14:31:00,14:31,21365100,12129950,-9235150,SELL
2020-10-15 14:32:00,14:32,21346075,11888950,-9457125,SELL
2020-10-15 14:33:00,14:33,21631925,12356725,-9275200,SELL
2020-10-15 14:34:00,14:34,21632350,12511550,-9120800,SELL
2020-10-15 14:35:00,14:35,21637125,12093425,-9543700,SELL
2020-10-15 14:36:00,14:36,21762250,12502875,-9259375,SELL
2020-10-15 14:37:00,14:37,21764850,12544875,-9219975,SELL
2020-10-15 14:38:00,14:38,21738850,12385625,-9353225,SELL
2020-10-15 14:39:00,14:39,21659350,11941775,-9717575,SELL
2020-10-15 14:40:00,14:40,21617875,11977500,-9640375,SELL
2020-10-15 14:41:00,14:41,21654875,11869400,-9785475,SELL
2020-10-15 14:42:00,14:42,21454250,11627425,-9826825,SELL
2020-10-15 14:43:00,14:43,21431675,11123675,-10308000,SELL
2020-10-15 14:44:00,14:44,21455550,11709700,-9745850,SELL
2020-10-15 14:45:00,14:45,21400025,11654300,-9745725,SELL
2020-10-15 14:46:00,14:46,21396100,11753725,-9642375,SELL
2020-10-15 14:47:00,14:47,21412725,11824050,-9588675,SELL
2020-10-15 14:48:00,14:48,21250925,11916250,-9334675,SELL
2020-10-15 14:49:00,14:49,21263125,11698850,-9564275,SELL
2020-10-15 14:50:00,14:50,21248275,11784425,-9463850,SELL
2020-10-15 14:51:00,14:51,21197500,11583350,-9614150,SELL
2020-10-15 14:52:00,14:52,21205850,11959650,-9246200,SELL
2020-10-15 14:53:00,14:53,21183075,12138450,-9044625,SELL
2020-10-15 14:54:00,14:54,20937350,11933675,-9003675,SELL
2020-10-15 14:55:00,14:55,20944625,11965175,-8979450,SELL
2020-10-15 14:56:00,14:56,20948275,11040600,-9907675,SELL
2020-10-15 14:57:00,14:57,20340200,11556325,-8783875,SELL
2020-10-15 14:58:00,14:58,20345375,11797950,-8547425,SELL
2020-10-15 14:59:00,14:59,20347050,11720475,-8626575,SELL
2020-10-15 15:00:00,15:00,19695050,11516000,-8179050,SELL
2020-10-15 15:01:00,15:01,19692700,11609450,-8083250,SELL
2020-10-15 15:02:00,15:02,19686925,11867225,-7819700,SELL
2020-10-15 15:03:00,15:03,19771500,11478175,-8293325,SELL
2020-10-15 15:04:00,15:04,19773250,11482025,-8291225,SELL
2020-10-15 15:05:00,15:05,19790225,11685600,-8104625,SELL
2020-10-15 15:06:00,15:06,19485750,10824325,-8661425,SELL
2020-10-15 15:07:00,15:07,19479950,10958950,-8521000,SELL
2020-10-15 15:08:00,15:08,19483275,11114950,-8368325,SELL
2020-10-15 15:09:00,15:09,18819175,10388025,-8431150,SELL
2020-10-15 15:10:00,15:10,18813200,10358050,-8455150,SELL
2020-10-15 15:11:00,15:11,18829325,10433475,-8395850,SELL
2020-10-15 15:12:00,15:12,17941350,10057775,-7883575,SELL
2020-10-15 15:13:00,15:13,17954800,9920225,-8034575,SELL
2020-10-15 15:14:00,15:14,17937325,9744075,-8193250,SELL
2020-10-15 15:15:00,15:15,17333000,9525000,-7808000,SELL
2020-10-15 15:16:00,15:16,17328425,9333400,-7995025,SELL
2020-10-15 15:17:00,15:17,17325775,8311750,-9014025,SELL
2020-10-15 15:18:00,15:18,16471800,9101700,-7370100,SELL
2020-10-15 15:19:00,15:19,16461450,8768850,-7692600,SELL
2020-10-15 15:20:00,15:20,16477500,8808050,-7669450,SELL
2020-10-15 15:21:00,15:21,15610550,8482400,-7128150,SELL
2020-10-15 15:22:00,15:22,15607500,8683325,-6924175,SELL
2020-10-15 15:23:00,15:23,15596600,8535000,-7061600,SELL
2020-10-15 15:24:00,15:24,14720300,7634300,-7086000,SELL
2020-10-15 15:25:00,15:25,14733000,8730725,-6002275,SELL
2020-10-15 15:26:00,15:26,14704950,8604475,-6100475,SELL
2020-10-15 15:27:00,15:27,12731600,7094700,-5636900,SELL
2020-10-15 15:28:00,15:28,12734450,6536050,-6198400,SELL
2020-10-15 15:29:00,15:29,0,91175,91175,BUY
