,timestamp,call,put,diff,sellOrBuy
2020-11-13 09:15:00,09:15,2963200,2752450,-210750,SELL
2020-11-13 09:16:00,09:16,2964550,2752750,-211800,SELL
2020-11-13 09:17:00,09:17,3109500,2873025,-236475,SELL
2020-11-13 09:18:00,09:18,3108475,2863925,-244550,SELL
2020-11-13 09:19:00,09:19,3108675,2860000,-248675,SELL
2020-11-13 09:20:00,09:20,3327700,3180050,-147650,SELL
2020-11-13 09:21:00,09:21,3314850,3175600,-139250,SELL
2020-11-13 09:22:00,09:22,3309475,3162975,-146500,SELL
2020-11-13 09:23:00,09:23,3568700,3496425,-72275,SELL
2020-11-13 09:24:00,09:24,3570325,3496700,-73625,SELL
2020-11-13 09:25:00,09:25,3584625,3492075,-92550,SELL
2020-11-13 09:26:00,09:26,3810450,3828200,17750,BUY
2020-11-13 09:27:00,09:27,3783950,3808675,24725,BUY
2020-11-13 09:28:00,09:28,3798750,3812575,13825,BUY
2020-11-13 09:29:00,09:29,4024475,4019425,-5050,SELL
2020-11-13 09:30:00,09:30,4013625,4006875,-6750,SELL
2020-11-13 09:31:00,09:31,4019400,4024200,4800,BUY
2020-11-13 09:32:00,09:32,4279500,4333275,53775,BUY
2020-11-13 09:33:00,09:33,4282200,4330025,47825,BUY
2020-11-13 09:34:00,09:34,4257550,4336800,79250,BUY
2020-11-13 09:35:00,09:35,4398675,4441400,42725,BUY
2020-11-13 09:36:00,09:36,4397775,4435500,37725,BUY
2020-11-13 09:37:00,09:37,4398725,4434025,35300,BUY
2020-11-13 09:38:00,09:38,4462625,4320100,-142525,SELL
2020-11-13 09:39:00,09:39,4473925,4305625,-168300,SELL
2020-11-13 09:40:00,09:40,4489075,4327575,-161500,SELL
2020-11-13 09:41:00,09:41,4544350,4430950,-113400,SELL
2020-11-13 09:42:00,09:42,4541325,4415000,-126325,SELL
2020-11-13 09:43:00,09:43,4531600,4433075,-98525,SELL
2020-11-13 09:44:00,09:44,4635900,4468875,-167025,SELL
2020-11-13 09:45:00,09:45,4616950,4467575,-149375,SELL
2020-11-13 09:46:00,09:46,4626875,4488200,-138675,SELL
2020-11-13 09:47:00,09:47,4707525,4628250,-79275,SELL
2020-11-13 09:48:00,09:48,4720725,4599050,-121675,SELL
2020-11-13 09:49:00,09:49,4722850,4611600,-111250,SELL
2020-11-13 09:50:00,09:50,4784625,4709275,-75350,SELL
2020-11-13 09:51:00,09:51,4779825,4709875,-69950,SELL
2020-11-13 09:52:00,09:52,4795350,4616900,-178450,SELL
2020-11-13 09:53:00,09:53,4838350,4795050,-43300,SELL
2020-11-13 09:54:00,09:54,4780150,4788450,8300,BUY
2020-11-13 09:55:00,09:55,4805175,4797000,-8175,SELL
2020-11-13 09:56:00,09:56,4848900,4848450,-450,SELL
2020-11-13 09:57:00,09:57,4881075,4868150,-12925,SELL
2020-11-13 09:58:00,09:58,4850125,4867225,17100,BUY
2020-11-13 09:59:00,09:59,4933800,4874025,-59775,SELL
2020-11-13 10:00:00,10:00,4950575,4919550,-31025,SELL
2020-11-13 10:01:00,10:01,4940425,4930325,-10100,SELL
2020-11-13 10:02:00,10:02,4938025,4942500,4475,BUY
2020-11-13 10:03:00,10:03,4963900,4945625,-18275,SELL
2020-11-13 10:04:00,10:04,4985050,4866725,-118325,SELL
2020-11-13 10:05:00,10:05,5053025,5023800,-29225,SELL
2020-11-13 10:06:00,10:06,5027000,5022250,-4750,SELL
2020-11-13 10:07:00,10:07,5051600,4976100,-75500,SELL
2020-11-13 10:08:00,10:08,5051575,4977300,-74275,SELL
2020-11-13 10:09:00,10:09,5051025,4981800,-69225,SELL
2020-11-13 10:10:00,10:10,5080775,5013100,-67675,SELL
2020-11-13 10:11:00,10:11,5114675,5022150,-92525,SELL
2020-11-13 10:12:00,10:12,5132000,5059500,-72500,SELL
2020-11-13 10:13:00,10:13,5121750,5077475,-44275,SELL
2020-11-13 10:14:00,10:14,5109700,5079350,-30350,SELL
2020-11-13 10:15:00,10:15,5132475,5072200,-60275,SELL
2020-11-13 10:16:00,10:16,5135125,5097550,-37575,SELL
2020-11-13 10:17:00,10:17,5103825,5125350,21525,BUY
2020-11-13 10:18:00,10:18,5114750,5172550,57800,BUY
2020-11-13 10:19:00,10:19,5112775,5164075,51300,BUY
2020-11-13 10:20:00,10:20,5045175,5156500,111325,BUY
2020-11-13 10:21:00,10:21,5035075,5154025,118950,BUY
2020-11-13 10:22:00,10:22,5041325,5155175,113850,BUY
2020-11-13 10:23:00,10:23,5009775,5221575,211800,BUY
2020-11-13 10:24:00,10:24,5011550,5239550,228000,BUY
2020-11-13 10:25:00,10:25,5018575,5243275,224700,BUY
2020-11-13 10:26:00,10:26,4751425,5317550,566125,BUY
2020-11-13 10:27:00,10:27,4741025,5302925,561900,BUY
2020-11-13 10:28:00,10:28,4733350,5307300,573950,BUY
2020-11-13 10:29:00,10:29,4693700,5369700,676000,BUY
2020-11-13 10:30:00,10:30,4698100,5353900,655800,BUY
2020-11-13 10:31:00,10:31,4691950,5370150,678200,BUY
2020-11-13 10:32:00,10:32,4906525,5448850,542325,BUY
2020-11-13 10:33:00,10:33,4908425,5454250,545825,BUY
2020-11-13 10:34:00,10:34,4908625,5438975,530350,BUY
2020-11-13 10:35:00,10:35,4952325,5433075,480750,BUY
2020-11-13 10:36:00,10:36,4933625,5458975,525350,BUY
2020-11-13 10:37:00,10:37,4971675,5457600,485925,BUY
2020-11-13 10:38:00,10:38,4984750,5395225,410475,BUY
2020-11-13 10:39:00,10:39,4990950,5386950,396000,BUY
2020-11-13 10:40:00,10:40,4970125,5396550,426425,BUY
2020-11-13 10:41:00,10:41,4959100,5386975,427875,BUY
2020-11-13 10:42:00,10:42,4992625,5434625,442000,BUY
2020-11-13 10:43:00,10:43,5023075,5427375,404300,BUY
2020-11-13 10:44:00,10:44,4984700,5463550,478850,BUY
2020-11-13 10:45:00,10:45,5042825,5471725,428900,BUY
2020-11-13 10:46:00,10:46,5054525,5475650,421125,BUY
2020-11-13 10:47:00,10:47,4981475,5470100,488625,BUY
2020-11-13 10:48:00,10:48,4977125,5434000,456875,BUY
2020-11-13 10:49:00,10:49,4972025,5457025,485000,BUY
2020-11-13 10:50:00,10:50,5050375,5489225,438850,BUY
2020-11-13 10:51:00,10:51,5074150,5482250,408100,BUY
2020-11-13 10:52:00,10:52,5072000,5499575,427575,BUY
2020-11-13 10:53:00,10:53,5123450,5498575,375125,BUY
2020-11-13 10:54:00,10:54,5109450,5509225,399775,BUY
2020-11-13 10:55:00,10:55,5121850,5504100,382250,BUY
2020-11-13 10:56:00,10:56,5165575,5528700,363125,BUY
2020-11-13 10:57:00,10:57,5124950,5507675,382725,BUY
2020-11-13 10:58:00,10:58,5108500,5454325,345825,BUY
2020-11-13 10:59:00,10:59,5169175,5562675,393500,BUY
2020-11-13 11:00:00,11:00,5153275,5553725,400450,BUY
2020-11-13 11:01:00,11:01,5186175,5576275,390100,BUY
2020-11-13 11:02:00,11:02,5185075,5500150,315075,BUY
2020-11-13 11:03:00,11:03,5206475,5594500,388025,BUY
2020-11-13 11:04:00,11:04,5199600,5602175,402575,BUY
2020-11-13 11:05:00,11:05,5175200,5581650,406450,BUY
2020-11-13 11:06:00,11:06,5190150,5578575,388425,BUY
2020-11-13 11:07:00,11:07,5138925,5601125,462200,BUY
2020-11-13 11:08:00,11:08,5227000,5629500,402500,BUY
2020-11-13 11:09:00,11:09,5201875,5517550,315675,BUY
2020-11-13 11:10:00,11:10,5225250,5560275,335025,BUY
2020-11-13 11:11:00,11:11,5293600,5549225,255625,BUY
2020-11-13 11:12:00,11:12,5282925,5578600,295675,BUY
2020-11-13 11:13:00,11:13,5235375,5580350,344975,BUY
2020-11-13 11:14:00,11:14,5233175,5630050,396875,BUY
2020-11-13 11:15:00,11:15,5243050,5618250,375200,BUY
2020-11-13 11:16:00,11:16,5259050,5593400,334350,BUY
2020-11-13 11:17:00,11:17,5275700,5658325,382625,BUY
2020-11-13 11:18:00,11:18,5280925,5610275,329350,BUY
2020-11-13 11:19:00,11:19,5266900,5570550,303650,BUY
2020-11-13 11:20:00,11:20,5175700,5562700,387000,BUY
2020-11-13 11:21:00,11:21,5280250,5576075,295825,BUY
2020-11-13 11:22:00,11:22,5259725,5597425,337700,BUY
2020-11-13 11:23:00,11:23,5225900,5622700,396800,BUY
2020-11-13 11:24:00,11:24,5212000,5572450,360450,BUY
2020-11-13 11:25:00,11:25,5295800,5711475,415675,BUY
2020-11-13 11:26:00,11:26,5267800,5710725,442925,BUY
2020-11-13 11:27:00,11:27,5307550,5690625,383075,BUY
2020-11-13 11:28:00,11:28,5352425,5662650,310225,BUY
2020-11-13 11:29:00,11:29,5391300,5727850,336550,BUY
2020-11-13 11:30:00,11:30,5403325,5738975,335650,BUY
2020-11-13 11:31:00,11:31,5346275,5720150,373875,BUY
2020-11-13 11:32:00,11:32,5326975,5704450,377475,BUY
2020-11-13 11:33:00,11:33,5262675,5662775,400100,BUY
2020-11-13 11:34:00,11:34,5331475,5501950,170475,BUY
2020-11-13 11:35:00,11:35,5352475,5724775,372300,BUY
2020-11-13 11:36:00,11:36,5305575,5768925,463350,BUY
2020-11-13 11:37:00,11:37,5308800,5745975,437175,BUY
2020-11-13 11:38:00,11:38,5294450,5749050,454600,BUY
2020-11-13 11:39:00,11:39,5294925,5792400,497475,BUY
2020-11-13 11:40:00,11:40,5349675,5742200,392525,BUY
2020-11-13 11:41:00,11:41,5384450,5717675,333225,BUY
2020-11-13 11:42:00,11:42,5388725,5732725,344000,BUY
2020-11-13 11:43:00,11:43,5414400,5822300,407900,BUY
2020-11-13 11:44:00,11:44,5393875,5724025,330150,BUY
2020-11-13 11:45:00,11:45,5345250,5837800,492550,BUY
2020-11-13 11:46:00,11:46,5393600,5671725,278125,BUY
2020-11-13 11:47:00,11:47,5418150,5742825,324675,BUY
2020-11-13 11:48:00,11:48,5441325,5882825,441500,BUY
2020-11-13 11:49:00,11:49,5344125,5837925,493800,BUY
2020-11-13 11:50:00,11:50,5433500,5931300,497800,BUY
2020-11-13 11:51:00,11:51,5439375,5904775,465400,BUY
2020-11-13 11:52:00,11:52,5419325,5804475,385150,BUY
2020-11-13 11:53:00,11:53,5423850,5900725,476875,BUY
2020-11-13 11:54:00,11:54,5423750,5919650,495900,BUY
2020-11-13 11:55:00,11:55,5452675,5935450,482775,BUY
2020-11-13 11:56:00,11:56,5438125,5947000,508875,BUY
2020-11-13 11:57:00,11:57,5408700,5627525,218825,BUY
2020-11-13 11:58:00,11:58,5423075,5842950,419875,BUY
2020-11-13 11:59:00,11:59,5491900,5915400,423500,BUY
2020-11-13 12:00:00,12:00,5511375,6015775,504400,BUY
2020-11-13 12:01:00,12:01,5436800,5995250,558450,BUY
2020-11-13 12:02:00,12:02,5407075,5982975,575900,BUY
2020-11-13 12:03:00,12:03,5493100,5984650,491550,BUY
2020-11-13 12:04:00,12:04,5452600,5958775,506175,BUY
2020-11-13 12:05:00,12:05,5480125,5947700,467575,BUY
2020-11-13 12:06:00,12:06,5483775,5953275,469500,BUY
2020-11-13 12:07:00,12:07,5430650,5852900,422250,BUY
2020-11-13 12:08:00,12:08,5457300,5997850,540550,BUY
2020-11-13 12:09:00,12:09,5501850,6057525,555675,BUY
2020-11-13 12:10:00,12:10,5489425,6046775,557350,BUY
2020-11-13 12:11:00,12:11,5481575,6029625,548050,BUY
2020-11-13 12:12:00,12:12,5409700,6009250,599550,BUY
2020-11-13 12:13:00,12:13,5470150,6054650,584500,BUY
2020-11-13 12:14:00,12:14,5482150,6102675,620525,BUY
2020-11-13 12:15:00,12:15,5461850,5995900,534050,BUY
2020-11-13 12:16:00,12:16,5557600,6076725,519125,BUY
2020-11-13 12:17:00,12:17,5509625,6086900,577275,BUY
2020-11-13 12:18:00,12:18,5556125,6107525,551400,BUY
2020-11-13 12:19:00,12:19,5494450,6063800,569350,BUY
2020-11-13 12:20:00,12:20,5546050,6050700,504650,BUY
2020-11-13 12:21:00,12:21,5507925,6055925,548000,BUY
2020-11-13 12:22:00,12:22,5502425,6040900,538475,BUY
2020-11-13 12:23:00,12:23,5532875,6052150,519275,BUY
2020-11-13 12:24:00,12:24,5503325,6041225,537900,BUY
2020-11-13 12:25:00,12:25,5472250,5967600,495350,BUY
2020-11-13 12:26:00,12:26,5501175,6020125,518950,BUY
2020-11-13 12:27:00,12:27,5569675,6007725,438050,BUY
2020-11-13 12:28:00,12:28,5534075,5988400,454325,BUY
2020-11-13 12:29:00,12:29,5548225,5967800,419575,BUY
2020-11-13 12:30:00,12:30,5353425,6066400,712975,BUY
2020-11-13 12:31:00,12:31,5556650,6077600,520950,BUY
2020-11-13 12:32:00,12:32,5564225,6096875,532650,BUY
2020-11-13 12:33:00,12:33,5528050,6073850,545800,BUY
2020-11-13 12:34:00,12:34,5536450,6079950,543500,BUY
2020-11-13 12:35:00,12:35,5557750,6027425,469675,BUY
2020-11-13 12:36:00,12:36,5555350,6038000,482650,BUY
2020-11-13 12:37:00,12:37,5564400,6091550,527150,BUY
2020-11-13 12:38:00,12:38,5579950,6053800,473850,BUY
2020-11-13 12:39:00,12:39,5597700,6079025,481325,BUY
2020-11-13 12:40:00,12:40,5604150,6093875,489725,BUY
2020-11-13 12:41:00,12:41,5618250,6080525,462275,BUY
2020-11-13 12:42:00,12:42,5499075,6016625,517550,BUY
2020-11-13 12:43:00,12:43,5597425,6052325,454900,BUY
2020-11-13 12:44:00,12:44,5596725,6051625,454900,BUY
2020-11-13 12:45:00,12:45,5667450,6104750,437300,BUY
2020-11-13 12:46:00,12:46,5637000,6111300,474300,BUY
2020-11-13 12:47:00,12:47,5675025,5986000,310975,BUY
2020-11-13 12:48:00,12:48,5648825,6038100,389275,BUY
2020-11-13 12:49:00,12:49,5659050,6140375,481325,BUY
2020-11-13 12:50:00,12:50,5638000,6114100,476100,BUY
2020-11-13 12:51:00,12:51,5651375,6165525,514150,BUY
2020-11-13 12:52:00,12:52,5644250,6155375,511125,BUY
2020-11-13 12:53:00,12:53,5557950,6083875,525925,BUY
2020-11-13 12:54:00,12:54,5565825,6085200,519375,BUY
2020-11-13 12:55:00,12:55,5586025,6103825,517800,BUY
2020-11-13 12:56:00,12:56,5535050,6089925,554875,BUY
2020-11-13 12:57:00,12:57,5501975,6118025,616050,BUY
2020-11-13 12:58:00,12:58,5535750,6084375,548625,BUY
2020-11-13 12:59:00,12:59,5415350,6067300,651950,BUY
2020-11-13 13:00:00,13:00,5465750,6047750,582000,BUY
2020-11-13 13:01:00,13:01,5425375,6119300,693925,BUY
2020-11-13 13:02:00,13:02,5499850,6147725,647875,BUY
2020-11-13 13:03:00,13:03,5504700,6157025,652325,BUY
2020-11-13 13:04:00,13:04,5490325,6087550,597225,BUY
2020-11-13 13:05:00,13:05,5441550,6123375,681825,BUY
2020-11-13 13:06:00,13:06,5465100,6102150,637050,BUY
2020-11-13 13:07:00,13:07,5424325,6079450,655125,BUY
2020-11-13 13:08:00,13:08,5465900,6120150,654250,BUY
2020-11-13 13:09:00,13:09,5459400,6113000,653600,BUY
2020-11-13 13:10:00,13:10,5419075,6069575,650500,BUY
2020-11-13 13:11:00,13:11,5427700,6075575,647875,BUY
2020-11-13 13:12:00,13:12,5386650,6086500,699850,BUY
2020-11-13 13:13:00,13:13,5403725,6152925,749200,BUY
2020-11-13 13:14:00,13:14,5442075,6046200,604125,BUY
2020-11-13 13:15:00,13:15,5393275,6182800,789525,BUY
2020-11-13 13:16:00,13:16,5432350,6145075,712725,BUY
2020-11-13 13:17:00,13:17,5448800,6156625,707825,BUY
2020-11-13 13:18:00,13:18,5455375,6123700,668325,BUY
2020-11-13 13:19:00,13:19,5416025,6155200,739175,BUY
2020-11-13 13:20:00,13:20,5403150,6184100,780950,BUY
2020-11-13 13:21:00,13:21,5396200,6093750,697550,BUY
2020-11-13 13:22:00,13:22,5394425,6134325,739900,BUY
2020-11-13 13:23:00,13:23,5414775,6104400,689625,BUY
2020-11-13 13:24:00,13:24,5434225,5973325,539100,BUY
2020-11-13 13:25:00,13:25,5434575,6123400,688825,BUY
2020-11-13 13:26:00,13:26,5448500,6150550,702050,BUY
2020-11-13 13:27:00,13:27,5466525,6180075,713550,BUY
2020-11-13 13:28:00,13:28,5458925,6091150,632225,BUY
2020-11-13 13:29:00,13:29,5461750,6191725,729975,BUY
2020-11-13 13:30:00,13:30,5477675,6194425,716750,BUY
2020-11-13 13:31:00,13:31,5457050,6186825,729775,BUY
2020-11-13 13:32:00,13:32,5471875,6210700,738825,BUY
2020-11-13 13:33:00,13:33,5455425,6202325,746900,BUY
2020-11-13 13:34:00,13:34,5488875,6173600,684725,BUY
2020-11-13 13:35:00,13:35,5482125,6154150,672025,BUY
2020-11-13 13:36:00,13:36,5529375,6245225,715850,BUY
2020-11-13 13:37:00,13:37,5449125,6200125,751000,BUY
2020-11-13 13:38:00,13:38,5517900,6247875,729975,BUY
2020-11-13 13:39:00,13:39,5496425,6152750,656325,BUY
2020-11-13 13:40:00,13:40,5473400,6174225,700825,BUY
2020-11-13 13:41:00,13:41,5506625,6128400,621775,BUY
2020-11-13 13:42:00,13:42,5500150,6114750,614600,BUY
2020-11-13 13:43:00,13:43,5524650,6155600,630950,BUY
2020-11-13 13:44:00,13:44,5430075,6275150,845075,BUY
2020-11-13 13:45:00,13:45,5449150,6310700,861550,BUY
2020-11-13 13:46:00,13:46,5452425,6276700,824275,BUY
2020-11-13 13:47:00,13:47,5512450,6259575,747125,BUY
2020-11-13 13:48:00,13:48,5517075,6346250,829175,BUY
2020-11-13 13:49:00,13:49,5524175,6370150,845975,BUY
2020-11-13 13:50:00,13:50,5516125,6368500,852375,BUY
2020-11-13 13:51:00,13:51,5310125,6307225,997100,BUY
2020-11-13 13:52:00,13:52,5292525,6275125,982600,BUY
2020-11-13 13:53:00,13:53,5295000,6294275,999275,BUY
2020-11-13 13:54:00,13:54,5378600,6319175,940575,BUY
2020-11-13 13:55:00,13:55,5388625,6348250,959625,BUY
2020-11-13 13:56:00,13:56,5373025,6307000,933975,BUY
2020-11-13 13:57:00,13:57,5266925,6365775,1098850,BUY
2020-11-13 13:58:00,13:58,5264150,6322625,1058475,BUY
2020-11-13 13:59:00,13:59,5265725,6365475,1099750,BUY
2020-11-13 14:00:00,14:00,5314475,6285225,970750,BUY
2020-11-13 14:01:00,14:01,5304425,6270825,966400,BUY
2020-11-13 14:02:00,14:02,5261225,6385725,1124500,BUY
2020-11-13 14:03:00,14:03,5374750,6449400,1074650,BUY
2020-11-13 14:04:00,14:04,5397750,6436950,1039200,BUY
2020-11-13 14:05:00,14:05,5374325,6443750,1069425,BUY
2020-11-13 14:06:00,14:06,5229075,6336275,1107200,BUY
2020-11-13 14:07:00,14:07,5267350,6393850,1126500,BUY
2020-11-13 14:08:00,14:08,5246175,6342875,1096700,BUY
2020-11-13 14:09:00,14:09,5348200,6260725,912525,BUY
2020-11-13 14:10:00,14:10,5343950,6391325,1047375,BUY
2020-11-13 14:11:00,14:11,5331675,6391400,1059725,BUY
2020-11-13 14:12:00,14:12,5318100,6447550,1129450,BUY
2020-11-13 14:13:00,14:13,5309325,6445475,1136150,BUY
2020-11-13 14:14:00,14:14,5338350,6409875,1071525,BUY
2020-11-13 14:15:00,14:15,5361675,6386150,1024475,BUY
2020-11-13 14:16:00,14:16,5339875,6463875,1124000,BUY
2020-11-13 14:17:00,14:17,5329475,6436675,1107200,BUY
2020-11-13 14:18:00,14:18,5453725,6490950,1037225,BUY
2020-11-13 14:19:00,14:19,5427000,6503550,1076550,BUY
2020-11-13 14:20:00,14:20,5463875,6506250,1042375,BUY
2020-11-13 14:21:00,14:21,5543350,6521550,978200,BUY
2020-11-13 14:22:00,14:22,5520650,6495650,975000,BUY
2020-11-13 14:23:00,14:23,5528675,6536550,1007875,BUY
2020-11-13 14:24:00,14:24,5441175,6513900,1072725,BUY
2020-11-13 14:25:00,14:25,5450575,6467950,1017375,BUY
2020-11-13 14:26:00,14:26,5410800,6485150,1074350,BUY
2020-11-13 14:27:00,14:27,5442625,6524500,1081875,BUY
2020-11-13 14:28:00,14:28,5393725,6403625,1009900,BUY
2020-11-13 14:29:00,14:29,5457300,6435150,977850,BUY
2020-11-13 14:30:00,14:30,5466800,6540375,1073575,BUY
2020-11-13 14:31:00,14:31,5461000,6483275,1022275,BUY
2020-11-13 14:32:00,14:32,5448975,6443375,994400,BUY
2020-11-13 14:33:00,14:33,5439900,6486850,1046950,BUY
2020-11-13 14:34:00,14:34,5463425,6563200,1099775,BUY
2020-11-13 14:35:00,14:35,5464450,6532575,1068125,BUY
2020-11-13 14:36:00,14:36,5489500,6454200,964700,BUY
2020-11-13 14:37:00,14:37,5502075,6467150,965075,BUY
2020-11-13 14:38:00,14:38,5483300,6482575,999275,BUY
2020-11-13 14:39:00,14:39,5435375,6390800,955425,BUY
2020-11-13 14:40:00,14:40,5396300,6404050,1007750,BUY
2020-11-13 14:41:00,14:41,5445675,6441150,995475,BUY
2020-11-13 14:42:00,14:42,5435900,6414400,978500,BUY
2020-11-13 14:43:00,14:43,5394700,6424625,1029925,BUY
2020-11-13 14:44:00,14:44,5442625,6445600,1002975,BUY
2020-11-13 14:45:00,14:45,5470000,6461225,991225,BUY
2020-11-13 14:46:00,14:46,5509850,6348625,838775,BUY
2020-11-13 14:47:00,14:47,5536625,6464775,928150,BUY
2020-11-13 14:48:00,14:48,5462625,6276200,813575,BUY
2020-11-13 14:49:00,14:49,5463750,6393200,929450,BUY
2020-11-13 14:50:00,14:50,5461925,6372350,910425,BUY
2020-11-13 14:51:00,14:51,5429500,6369575,940075,BUY
2020-11-13 14:52:00,14:52,5438250,6364550,926300,BUY
2020-11-13 14:53:00,14:53,5432275,6336475,904200,BUY
2020-11-13 14:54:00,14:54,5244625,6199675,955050,BUY
2020-11-13 14:55:00,14:55,5279775,6235450,955675,BUY
2020-11-13 14:56:00,14:56,5282925,6247325,964400,BUY
2020-11-13 14:57:00,14:57,5208075,6209100,1001025,BUY
2020-11-13 14:58:00,14:58,5215075,6190850,975775,BUY
2020-11-13 14:59:00,14:59,5231100,6214400,983300,BUY
2020-11-13 15:00:00,15:00,5233525,6209725,976200,BUY
2020-11-13 15:01:00,15:01,5228700,6182650,953950,BUY
2020-11-13 15:02:00,15:02,5176375,6192975,1016600,BUY
2020-11-13 15:03:00,15:03,5181025,6132600,951575,BUY
2020-11-13 15:04:00,15:04,5154300,6108950,954650,BUY
2020-11-13 15:05:00,15:05,5181200,6136000,954800,BUY
2020-11-13 15:06:00,15:06,5107700,6070450,962750,BUY
2020-11-13 15:07:00,15:07,5132500,6128400,995900,BUY
2020-11-13 15:08:00,15:08,5121300,6107275,985975,BUY
2020-11-13 15:09:00,15:09,5055200,6102550,1047350,BUY
2020-11-13 15:10:00,15:10,5089075,6095400,1006325,BUY
2020-11-13 15:11:00,15:11,5051425,6084000,1032575,BUY
2020-11-13 15:12:00,15:12,5010275,6094750,1084475,BUY
2020-11-13 15:13:00,15:13,5057300,6092025,1034725,BUY
2020-11-13 15:14:00,15:14,5051275,6067450,1016175,BUY
2020-11-13 15:15:00,15:15,5031200,6025825,994625,BUY
2020-11-13 15:16:00,15:16,5030875,6039525,1008650,BUY
2020-11-13 15:17:00,15:17,5027475,6018075,990600,BUY
2020-11-13 15:18:00,15:18,4973275,5962675,989400,BUY
2020-11-13 15:19:00,15:19,4964100,5972875,1008775,BUY
2020-11-13 15:20:00,15:20,4974050,5982400,1008350,BUY
2020-11-13 15:21:00,15:21,4895500,5901125,1005625,BUY
2020-11-13 15:22:00,15:22,4872875,5880350,1007475,BUY
2020-11-13 15:23:00,15:23,4824800,5876625,1051825,BUY
2020-11-13 15:24:00,15:24,4753550,5754875,1001325,BUY
2020-11-13 15:25:00,15:25,4787175,5766675,979500,BUY
2020-11-13 15:26:00,15:26,4773400,5765275,991875,BUY
2020-11-13 15:27:00,15:27,4750200,5795250,1045050,BUY
2020-11-13 15:28:00,15:28,4754175,5786200,1032025,BUY
2020-11-13 15:29:00,15:29,4762750,5792100,1029350,BUY
2020-11-14 18:15:00,18:15,4657475,5600050,942575,BUY
2020-11-14 18:16:00,18:16,4615550,5612225,996675,BUY
2020-11-14 18:17:00,18:17,5092725,5802925,710200,BUY
2020-11-14 18:18:00,18:18,5086200,5867075,780875,BUY
2020-11-14 18:19:00,18:19,5098925,5861725,762800,BUY
2020-11-14 18:20:00,18:20,5399900,6035400,635500,BUY
2020-11-14 18:21:00,18:21,5402200,6152000,749800,BUY
2020-11-14 18:22:00,18:22,5397925,6122625,724700,BUY
2020-11-14 18:23:00,18:23,5509875,6191600,681725,BUY
2020-11-14 18:24:00,18:24,5521300,6178825,657525,BUY
2020-11-14 18:25:00,18:25,5501000,6213325,712325,BUY
2020-11-14 18:26:00,18:26,5651725,6311875,660150,BUY
2020-11-14 18:27:00,18:27,5560850,6303150,742300,BUY
2020-11-14 18:28:00,18:28,5646425,6283050,636625,BUY
2020-11-14 18:29:00,18:29,5761075,6361275,600200,BUY
2020-11-14 18:30:00,18:30,5760550,6349475,588925,BUY
2020-11-14 18:31:00,18:31,5669950,6316050,646100,BUY
2020-11-14 18:32:00,18:32,5840350,6377450,537100,BUY
2020-11-14 18:33:00,18:33,5778025,6237850,459825,BUY
2020-11-14 18:34:00,18:34,5892900,6361175,468275,BUY
2020-11-14 18:35:00,18:35,5984675,6410275,425600,BUY
2020-11-14 18:36:00,18:36,5894375,6387175,492800,BUY
2020-11-14 18:37:00,18:37,5963800,6379750,415950,BUY
2020-11-14 18:38:00,18:38,6005100,6447025,441925,BUY
2020-11-14 18:39:00,18:39,5929175,6414450,485275,BUY
2020-11-14 18:40:00,18:40,5867025,6294000,426975,BUY
2020-11-14 18:41:00,18:41,5961575,6418375,456800,BUY
2020-11-14 18:42:00,18:42,5982250,6473775,491525,BUY
2020-11-14 18:43:00,18:43,6059200,6487825,428625,BUY
2020-11-14 18:44:00,18:44,6034400,6488575,454175,BUY
2020-11-14 18:45:00,18:45,6028200,6468550,440350,BUY
2020-11-14 18:46:00,18:46,6012750,6480900,468150,BUY
2020-11-14 18:47:00,18:47,5975750,6459650,483900,BUY
2020-11-14 18:48:00,18:48,5966050,6509775,543725,BUY
2020-11-14 18:49:00,18:49,5916350,6471475,555125,BUY
2020-11-14 18:50:00,18:50,6042600,6495725,453125,BUY
2020-11-14 18:51:00,18:51,6087825,6515550,427725,BUY
2020-11-14 18:52:00,18:52,6038650,6511825,473175,BUY
2020-11-14 18:53:00,18:53,6037775,6516075,478300,BUY
2020-11-14 18:54:00,18:54,6041275,6507650,466375,BUY
2020-11-14 18:55:00,18:55,6092875,6502425,409550,BUY
2020-11-14 18:56:00,18:56,6030700,6475475,444775,BUY
2020-11-14 18:57:00,18:57,6052500,6445400,392900,BUY
2020-11-14 18:58:00,18:58,6026450,6554450,528000,BUY
2020-11-14 18:59:00,18:59,5922100,6493700,571600,BUY
2020-11-14 19:00:00,19:00,5884875,6521675,636800,BUY
2020-11-14 19:01:00,19:01,5931725,6538550,606825,BUY
2020-11-14 19:02:00,19:02,5858225,6544200,685975,BUY
2020-11-14 19:03:00,19:03,5858500,6550150,691650,BUY
2020-11-14 19:04:00,19:04,5867250,6488250,621000,BUY
2020-11-14 19:05:00,19:05,5928550,6489900,561350,BUY
2020-11-14 19:06:00,19:06,5929175,6493075,563900,BUY
2020-11-14 19:07:00,19:07,5930725,6500025,569300,BUY
2020-11-14 19:08:00,19:08,5836250,6363925,527675,BUY
2020-11-14 19:09:00,19:09,5790650,6370150,579500,BUY
2020-11-14 19:10:00,19:10,5801750,6333650,531900,BUY
2020-11-14 19:11:00,19:11,5729950,6296525,566575,BUY
2020-11-14 19:12:00,19:12,5735775,6287725,551950,BUY
2020-11-14 19:13:00,19:13,5763425,6289400,525975,BUY
2020-11-14 19:14:00,19:14,5784150,6262150,478000,BUY
2020-11-17 09:15:00,09:15,3428725,2827600,-601125,SELL
2020-11-17 09:16:00,09:16,3711175,4215050,503875,BUY
2020-11-17 09:17:00,09:17,3835050,4696075,861025,BUY
2020-11-17 09:18:00,09:18,4708800,5238775,529975,BUY
2020-11-17 09:19:00,09:19,5723225,5337550,-385675,SELL
2020-11-17 09:20:00,09:20,5715225,5991300,276075,BUY
2020-11-17 09:21:00,09:21,5728300,6096000,367700,BUY
2020-11-17 09:22:00,09:22,5727025,6112825,385800,BUY
2020-11-17 09:23:00,09:23,5729700,6241650,511950,BUY
2020-11-17 09:24:00,09:24,5710300,6251500,541200,BUY
2020-11-17 09:25:00,09:25,5681675,6214500,532825,BUY
2020-11-17 09:26:00,09:26,5749250,6272150,522900,BUY
2020-11-17 09:27:00,09:27,5711425,6243800,532375,BUY
2020-11-17 09:28:00,09:28,5709325,6237650,528325,BUY
2020-11-17 09:29:00,09:29,5855900,6271125,415225,BUY
2020-11-17 09:30:00,09:30,5832600,6269450,436850,BUY
2020-11-17 09:31:00,09:31,5799550,6279025,479475,BUY
2020-11-17 09:32:00,09:32,5864675,6409475,544800,BUY
2020-11-17 09:33:00,09:33,5811075,6348925,537850,BUY
2020-11-17 09:34:00,09:34,5856775,6391075,534300,BUY
2020-11-17 09:35:00,09:35,6229175,6927525,698350,BUY
2020-11-17 09:36:00,09:36,6240575,6844000,603425,BUY
2020-11-17 09:37:00,09:37,6280525,6823250,542725,BUY
2020-11-17 09:38:00,09:38,6360775,7379075,1018300,BUY
2020-11-17 09:39:00,09:39,6407275,7397950,990675,BUY
2020-11-17 09:40:00,09:40,6425650,7346450,920800,BUY
2020-11-17 09:41:00,09:41,6305925,7552600,1246675,BUY
2020-11-17 09:42:00,09:42,6320700,7601300,1280600,BUY
2020-11-17 09:43:00,09:43,6304225,7553725,1249500,BUY
2020-11-17 09:44:00,09:44,6500325,7714600,1214275,BUY
2020-11-17 09:45:00,09:45,6514575,7793350,1278775,BUY
2020-11-17 09:46:00,09:46,6487975,7697600,1209625,BUY
2020-11-17 09:47:00,09:47,6553800,8122475,1568675,BUY
2020-11-17 09:48:00,09:48,6518700,8034600,1515900,BUY
2020-11-17 09:49:00,09:49,6543200,8135850,1592650,BUY
2020-11-17 09:50:00,09:50,6432200,8352575,1920375,BUY
2020-11-17 09:51:00,09:51,6416750,8431675,2014925,BUY
2020-11-17 09:52:00,09:52,6412700,8429250,2016550,BUY
2020-11-17 09:53:00,09:53,6362625,8619750,2257125,BUY
2020-11-17 09:54:00,09:54,6416400,8586350,2169950,BUY
2020-11-17 09:55:00,09:55,6400350,8621875,2221525,BUY
2020-11-17 09:56:00,09:56,6319000,8772750,2453750,BUY
2020-11-17 09:57:00,09:57,6210750,8753100,2542350,BUY
2020-11-17 09:58:00,09:58,6326100,8803950,2477850,BUY
2020-11-17 09:59:00,09:59,6423375,9022700,2599325,BUY
2020-11-17 10:00:00,10:00,6394100,8980675,2586575,BUY
2020-11-17 10:01:00,10:01,6407800,8925200,2517400,BUY
2020-11-17 10:02:00,10:02,6560275,9080650,2520375,BUY
2020-11-17 10:03:00,10:03,6501750,9126350,2624600,BUY
2020-11-17 10:04:00,10:04,6582125,9118300,2536175,BUY
2020-11-17 10:05:00,10:05,6651100,9121925,2470825,BUY
2020-11-17 10:06:00,10:06,6724775,9151325,2426550,BUY
2020-11-17 10:07:00,10:07,6724450,9199175,2474725,BUY
2020-11-17 10:08:00,10:08,6726750,9195350,2468600,BUY
2020-11-17 10:09:00,10:09,6815275,9276700,2461425,BUY
2020-11-17 10:10:00,10:10,6795150,9136100,2340950,BUY
2020-11-17 10:11:00,10:11,6846075,9342525,2496450,BUY
2020-11-17 10:12:00,10:12,6839325,9354250,2514925,BUY
2020-11-17 10:13:00,10:13,6835450,9324450,2489000,BUY
2020-11-17 10:14:00,10:14,6937125,9386850,2449725,BUY
2020-11-17 10:15:00,10:15,6976350,9420725,2444375,BUY
2020-11-17 10:16:00,10:16,6962700,9434900,2472200,BUY
2020-11-17 10:17:00,10:17,6904075,9321425,2417350,BUY
2020-11-17 10:18:00,10:18,7013050,9393925,2380875,BUY
2020-11-17 10:19:00,10:19,7021775,9407450,2385675,BUY
2020-11-17 10:20:00,10:20,7061875,9444650,2382775,BUY
2020-11-17 10:21:00,10:21,7206175,9435800,2229625,BUY
2020-11-17 10:22:00,10:22,7184750,9409000,2224250,BUY
2020-11-17 10:23:00,10:23,7231750,9322275,2090525,BUY
2020-11-17 10:24:00,10:24,7245400,9304800,2059400,BUY
2020-11-17 10:25:00,10:25,7261100,9379125,2118025,BUY
2020-11-17 10:26:00,10:26,7302450,9496350,2193900,BUY
2020-11-17 10:27:00,10:27,7366700,9480000,2113300,BUY
2020-11-17 10:28:00,10:28,7364975,9409075,2044100,BUY
2020-11-17 10:29:00,10:29,7440650,9649650,2209000,BUY
2020-11-17 10:30:00,10:30,7460950,9661975,2201025,BUY
2020-11-17 10:31:00,10:31,7360175,9605300,2245125,BUY
2020-11-17 10:32:00,10:32,7553750,9539975,1986225,BUY
2020-11-17 10:33:00,10:33,7503600,9631850,2128250,BUY
2020-11-17 10:34:00,10:34,7544400,9406025,1861625,BUY
2020-11-17 10:35:00,10:35,7658450,9488200,1829750,BUY
2020-11-17 10:36:00,10:36,7603175,9566050,1962875,BUY
2020-11-17 10:37:00,10:37,7588975,9507800,1918825,BUY
2020-11-17 10:38:00,10:38,7758175,9474200,1716025,BUY
2020-11-17 10:39:00,10:39,7701350,9452750,1751400,BUY
2020-11-17 10:40:00,10:40,7747450,9469200,1721750,BUY
2020-11-17 10:41:00,10:41,7815400,9247075,1431675,BUY
2020-11-17 10:42:00,10:42,7743025,9241075,1498050,BUY
2020-11-17 10:43:00,10:43,7734075,9229700,1495625,BUY
2020-11-17 10:44:00,10:44,7831450,9360725,1529275,BUY
2020-11-17 10:45:00,10:45,7840625,9234625,1394000,BUY
2020-11-17 10:46:00,10:46,7814700,9209200,1394500,BUY
2020-11-17 10:47:00,10:47,7895450,9335775,1440325,BUY
2020-11-17 10:48:00,10:48,7904575,9335625,1431050,BUY
2020-11-17 10:49:00,10:49,7776125,9134600,1358475,BUY
2020-11-17 10:50:00,10:50,7908450,9082150,1173700,BUY
2020-11-17 10:51:00,10:51,7941400,9313000,1371600,BUY
2020-11-17 10:52:00,10:52,8003650,9249925,1246275,BUY
2020-11-17 10:53:00,10:53,7931150,9165400,1234250,BUY
2020-11-17 10:54:00,10:54,8031750,9313950,1282200,BUY
2020-11-17 10:55:00,10:55,7990500,9212975,1222475,BUY
2020-11-17 10:56:00,10:56,8004250,9198425,1194175,BUY
2020-11-17 10:57:00,10:57,7934650,9239125,1304475,BUY
2020-11-17 10:58:00,10:58,7943900,9076925,1133025,BUY
2020-11-17 10:59:00,10:59,7821200,9183500,1362300,BUY
2020-11-17 11:00:00,11:00,7860825,9195450,1334625,BUY
2020-11-17 11:01:00,11:01,7811150,9156475,1345325,BUY
2020-11-17 11:02:00,11:02,7846300,9252750,1406450,BUY
2020-11-17 11:03:00,11:03,7792500,9235825,1443325,BUY
2020-11-17 11:04:00,11:04,7912375,9254200,1341825,BUY
2020-11-17 11:05:00,11:05,7839725,9184825,1345100,BUY
2020-11-17 11:06:00,11:06,7859600,9111775,1252175,BUY
2020-11-17 11:07:00,11:07,7925325,9283800,1358475,BUY
2020-11-17 11:08:00,11:08,7881125,9352500,1471375,BUY
2020-11-17 11:09:00,11:09,7897375,9293475,1396100,BUY
2020-11-17 11:10:00,11:10,7916350,9292150,1375800,BUY
2020-11-17 11:11:00,11:11,7906625,9319550,1412925,BUY
2020-11-17 11:12:00,11:12,7867775,9340150,1472375,BUY
2020-11-17 11:13:00,11:13,7867775,9393325,1525550,BUY
2020-11-17 11:14:00,11:14,7877050,9259925,1382875,BUY
2020-11-17 11:15:00,11:15,8004300,9337625,1333325,BUY
2020-11-17 11:16:00,11:16,8092800,9391200,1298400,BUY
2020-11-17 11:17:00,11:17,7896575,9430075,1533500,BUY
2020-11-17 11:18:00,11:18,7993375,9456800,1463425,BUY
2020-11-17 11:19:00,11:19,8078350,9358450,1280100,BUY
2020-11-17 11:20:00,11:20,8038775,9506325,1467550,BUY
2020-11-17 11:21:00,11:21,8112250,9463400,1351150,BUY
2020-11-17 11:22:00,11:22,7997925,9470925,1473000,BUY
2020-11-17 11:23:00,11:23,8032675,9473375,1440700,BUY
2020-11-17 11:24:00,11:24,7972925,9453375,1480450,BUY
2020-11-17 11:25:00,11:25,8051000,9485675,1434675,BUY
2020-11-17 11:26:00,11:26,8043750,9289050,1245300,BUY
2020-11-17 11:27:00,11:27,8028500,9259075,1230575,BUY
2020-11-17 11:28:00,11:28,7977625,9455225,1477600,BUY
2020-11-17 11:29:00,11:29,7976450,9539675,1563225,BUY
2020-11-17 11:30:00,11:30,7996575,9483625,1487050,BUY
2020-11-17 11:31:00,11:31,7996575,9458650,1462075,BUY
2020-11-17 11:32:00,11:32,7930400,9501075,1570675,BUY
2020-11-17 11:33:00,11:33,7918550,9488500,1569950,BUY
2020-11-17 11:34:00,11:34,8062450,9610650,1548200,BUY
2020-11-17 11:35:00,11:35,8109500,9533200,1423700,BUY
2020-11-17 11:36:00,11:36,8092650,9529675,1437025,BUY
2020-11-17 11:37:00,11:37,8030650,9564250,1533600,BUY
2020-11-17 11:38:00,11:38,8040925,9403075,1362150,BUY
2020-11-17 11:39:00,11:39,8028675,9611725,1583050,BUY
2020-11-17 11:40:00,11:40,8040650,9304975,1264325,BUY
2020-11-17 11:41:00,11:41,8074000,9487050,1413050,BUY
2020-11-17 11:42:00,11:42,8212025,9581825,1369800,BUY
2020-11-17 11:43:00,11:43,8139900,9563200,1423300,BUY
2020-11-17 11:44:00,11:44,8089550,9640125,1550575,BUY
2020-11-17 11:45:00,11:45,8098375,9632825,1534450,BUY
2020-11-17 11:46:00,11:46,7972350,9435400,1463050,BUY
2020-11-17 11:47:00,11:47,8089950,9480175,1390225,BUY
2020-11-17 11:48:00,11:48,8020225,9445100,1424875,BUY
2020-11-17 11:49:00,11:49,7996450,9649950,1653500,BUY
2020-11-17 11:50:00,11:50,7978600,9650300,1671700,BUY
2020-11-17 11:51:00,11:51,8093225,9669875,1576650,BUY
2020-11-17 11:52:00,11:52,8064125,9691950,1627825,BUY
2020-11-17 11:53:00,11:53,8073950,9374225,1300275,BUY
2020-11-17 11:54:00,11:54,8099250,9095950,996700,BUY
2020-11-17 11:55:00,11:55,8096550,9653875,1557325,BUY
2020-11-17 11:56:00,11:56,8084150,9687825,1603675,BUY
2020-11-17 11:57:00,11:57,8008275,9412075,1403800,BUY
2020-11-17 11:58:00,11:58,8043675,9635925,1592250,BUY
2020-11-17 11:59:00,11:59,8133050,9577700,1444650,BUY
2020-11-17 12:00:00,12:00,7999275,9560275,1561000,BUY
2020-11-17 12:01:00,12:01,7874475,9215650,1341175,BUY
2020-11-17 12:02:00,12:02,8104950,9626275,1521325,BUY
2020-11-17 12:03:00,12:03,8101575,9525550,1423975,BUY
2020-11-17 12:04:00,12:04,8132925,9394000,1261075,BUY
2020-11-17 12:05:00,12:05,8190350,9473900,1283550,BUY
2020-11-17 12:06:00,12:06,8119875,9411925,1292050,BUY
2020-11-17 12:07:00,12:07,7913125,9629125,1716000,BUY
2020-11-17 12:08:00,12:08,8034925,9310925,1276000,BUY
2020-11-17 12:09:00,12:09,8068025,9506575,1438550,BUY
2020-11-17 12:10:00,12:10,8178225,9418825,1240600,BUY
2020-11-17 12:11:00,12:11,8092225,9603075,1510850,BUY
2020-11-17 12:12:00,12:12,8177250,9651475,1474225,BUY
2020-11-17 12:13:00,12:13,8162850,9748875,1586025,BUY
2020-11-17 12:14:00,12:14,8169275,9257625,1088350,BUY
2020-11-17 12:15:00,12:15,8234300,9757375,1523075,BUY
2020-11-17 12:16:00,12:16,8141375,9583625,1442250,BUY
2020-11-17 12:17:00,12:17,8304125,9447700,1143575,BUY
2020-11-17 12:18:00,12:18,8199650,9544000,1344350,BUY
2020-11-17 12:19:00,12:19,8300375,9638800,1338425,BUY
2020-11-17 12:20:00,12:20,8295875,9648325,1352450,BUY
2020-11-17 12:21:00,12:21,8215525,9718375,1502850,BUY
2020-11-17 12:22:00,12:22,8257650,9578475,1320825,BUY
2020-11-17 12:23:00,12:23,8183925,9632600,1448675,BUY
2020-11-17 12:24:00,12:24,8342450,9470850,1128400,BUY
2020-11-17 12:25:00,12:25,8187000,9324300,1137300,BUY
2020-11-17 12:26:00,12:26,8287250,9602475,1315225,BUY
2020-11-17 12:27:00,12:27,8290600,9731150,1440550,BUY
2020-11-17 12:28:00,12:28,8303325,9605900,1302575,BUY
2020-11-17 12:29:00,12:29,8408325,9826025,1417700,BUY
2020-11-17 12:30:00,12:30,8392200,9755775,1363575,BUY
2020-11-17 12:31:00,12:31,8377800,9795350,1417550,BUY
2020-11-17 12:32:00,12:32,8242350,9537150,1294800,BUY
2020-11-17 12:33:00,12:33,8127650,9234075,1106425,BUY
2020-11-17 12:34:00,12:34,8243625,9578425,1334800,BUY
2020-11-17 12:35:00,12:35,8346875,9699600,1352725,BUY
2020-11-17 12:36:00,12:36,8331325,9598525,1267200,BUY
2020-11-17 12:37:00,12:37,8204200,9607100,1402900,BUY
2020-11-17 12:38:00,12:38,8472375,9802600,1330225,BUY
2020-11-17 12:39:00,12:39,8423275,9649350,1226075,BUY
2020-11-17 12:40:00,12:40,8405075,9754500,1349425,BUY
2020-11-17 12:41:00,12:41,8241400,9469550,1228150,BUY
2020-11-17 12:42:00,12:42,8277600,9404625,1127025,BUY
2020-11-17 12:43:00,12:43,8230775,9549650,1318875,BUY
2020-11-17 12:44:00,12:44,8401950,9213825,811875,BUY
2020-11-17 12:45:00,12:45,8418650,9578425,1159775,BUY
2020-11-17 12:46:00,12:46,8318825,9586075,1267250,BUY
2020-11-17 12:47:00,12:47,8482000,9633950,1151950,BUY
2020-11-17 12:48:00,12:48,8375575,9629200,1253625,BUY
2020-11-17 12:49:00,12:49,8343075,9464175,1121100,BUY
2020-11-17 12:50:00,12:50,8408300,9575625,1167325,BUY
2020-11-17 12:51:00,12:51,8458200,9510600,1052400,BUY
2020-11-17 12:52:00,12:52,8403625,9632300,1228675,BUY
2020-11-17 12:53:00,12:53,8465200,9239250,774050,BUY
2020-11-17 12:54:00,12:54,8466500,9693200,1226700,BUY
2020-11-17 12:55:00,12:55,8431200,9741500,1310300,BUY
2020-11-17 12:56:00,12:56,8474525,9676550,1202025,BUY
2020-11-17 12:57:00,12:57,8540325,9590625,1050300,BUY
2020-11-17 12:58:00,12:58,8411575,9849000,1437425,BUY
2020-11-17 12:59:00,12:59,8499500,9756175,1256675,BUY
2020-11-17 13:00:00,13:00,8447250,9819025,1371775,BUY
2020-11-17 13:01:00,13:01,8629350,9862700,1233350,BUY
2020-11-17 13:02:00,13:02,8546225,9860100,1313875,BUY
2020-11-17 13:03:00,13:03,8481475,9854275,1372800,BUY
2020-11-17 13:04:00,13:04,8535075,9714750,1179675,BUY
2020-11-17 13:05:00,13:05,8571625,9963150,1391525,BUY
2020-11-17 13:06:00,13:06,8434550,9922050,1487500,BUY
2020-11-17 13:07:00,13:07,8624750,9993350,1368600,BUY
2020-11-17 13:08:00,13:08,8466525,9873700,1407175,BUY
2020-11-17 13:09:00,13:09,8596875,9968300,1371425,BUY
2020-11-17 13:10:00,13:10,8607050,9831425,1224375,BUY
2020-11-17 13:11:00,13:11,8580325,9880675,1300350,BUY
2020-11-17 13:12:00,13:12,8479200,9458200,979000,BUY
2020-11-17 13:13:00,13:13,8518525,9790525,1272000,BUY
2020-11-17 13:14:00,13:14,8409025,9721150,1312125,BUY
2020-11-17 13:15:00,13:15,8554550,9863825,1309275,BUY
2020-11-17 13:16:00,13:16,8601025,9936600,1335575,BUY
2020-11-17 13:17:00,13:17,8564575,10000550,1435975,BUY
2020-11-17 13:18:00,13:18,8530725,9792225,1261500,BUY
2020-11-17 13:19:00,13:19,8627925,10087375,1459450,BUY
2020-11-17 13:20:00,13:20,8667800,9684450,1016650,BUY
2020-11-17 13:21:00,13:21,8637300,10140750,1503450,BUY
2020-11-17 13:22:00,13:22,8584800,9977050,1392250,BUY
2020-11-17 13:23:00,13:23,8639200,10010500,1371300,BUY
2020-11-17 13:24:00,13:24,8485075,9764900,1279825,BUY
2020-11-17 13:25:00,13:25,8596475,9774225,1177750,BUY
2020-11-17 13:26:00,13:26,8600475,9928250,1327775,BUY
2020-11-17 13:27:00,13:27,8484700,9783150,1298450,BUY
2020-11-17 13:28:00,13:28,8556050,9866175,1310125,BUY
2020-11-17 13:29:00,13:29,8613925,9835100,1221175,BUY
2020-11-17 13:30:00,13:30,8656750,10225150,1568400,BUY
2020-11-17 13:31:00,13:31,8628325,10284850,1656525,BUY
2020-11-17 13:32:00,13:32,8706825,10252325,1545500,BUY
2020-11-17 13:33:00,13:33,8586750,10240850,1654100,BUY
2020-11-17 13:34:00,13:34,8528175,10166525,1638350,BUY
2020-11-17 13:35:00,13:35,8628025,10271400,1643375,BUY
2020-11-17 13:36:00,13:36,8592525,10283225,1690700,BUY
2020-11-17 13:37:00,13:37,8506200,10090500,1584300,BUY
2020-11-17 13:38:00,13:38,8483775,10184075,1700300,BUY
2020-11-17 13:39:00,13:39,8538425,10302075,1763650,BUY
2020-11-17 13:40:00,13:40,8562725,10380000,1817275,BUY
2020-11-17 13:41:00,13:41,8392975,10406000,2013025,BUY
2020-11-17 13:42:00,13:42,8486500,10410450,1923950,BUY
2020-11-17 13:43:00,13:43,8450650,10004375,1553725,BUY
2020-11-17 13:44:00,13:44,8491625,10398625,1907000,BUY
2020-11-17 13:45:00,13:45,8561550,10400550,1839000,BUY
2020-11-17 13:46:00,13:46,8475300,10171950,1696650,BUY
2020-11-17 13:47:00,13:47,8478650,10272975,1794325,BUY
2020-11-17 13:48:00,13:48,8488700,10364950,1876250,BUY
2020-11-17 13:49:00,13:49,8532450,9937075,1404625,BUY
2020-11-17 13:50:00,13:50,8624775,10495675,1870900,BUY
2020-11-17 13:51:00,13:51,8570950,10493400,1922450,BUY
2020-11-17 13:52:00,13:52,8525400,10496475,1971075,BUY
2020-11-17 13:53:00,13:53,8478825,9946575,1467750,BUY
2020-11-17 13:54:00,13:54,8394850,10089175,1694325,BUY
2020-11-17 13:55:00,13:55,8579075,10328200,1749125,BUY
2020-11-17 13:56:00,13:56,8492925,10074800,1581875,BUY
2020-11-17 13:57:00,13:57,8465525,10323225,1857700,BUY
2020-11-17 13:58:00,13:58,8414025,10284600,1870575,BUY
2020-11-17 13:59:00,13:59,8541300,10532350,1991050,BUY
2020-11-17 14:00:00,14:00,8646125,10597550,1951425,BUY
2020-11-17 14:01:00,14:01,8611775,10568325,1956550,BUY
2020-11-17 14:02:00,14:02,8588075,10581125,1993050,BUY
2020-11-17 14:03:00,14:03,8307550,10516325,2208775,BUY
2020-11-17 14:04:00,14:04,8340200,10268700,1928500,BUY
2020-11-17 14:05:00,14:05,8271100,10500650,2229550,BUY
2020-11-17 14:06:00,14:06,8351150,10578750,2227600,BUY
2020-11-17 14:07:00,14:07,8280950,10646725,2365775,BUY
2020-11-17 14:08:00,14:08,8271275,10588925,2317650,BUY
2020-11-17 14:09:00,14:09,8295050,10013625,1718575,BUY
2020-11-17 14:10:00,14:10,8445275,10588700,2143425,BUY
2020-11-17 14:11:00,14:11,8440175,10744825,2304650,BUY
2020-11-17 14:12:00,14:12,8322425,10523725,2201300,BUY
2020-11-17 14:13:00,14:13,8280125,10429900,2149775,BUY
2020-11-17 14:14:00,14:14,8347825,10598850,2251025,BUY
2020-11-17 14:15:00,14:15,8321050,10717075,2396025,BUY
2020-11-17 14:16:00,14:16,8309875,10754875,2445000,BUY
2020-11-17 14:17:00,14:17,8270775,10689925,2419150,BUY
2020-11-17 14:18:00,14:18,8309000,10419950,2110950,BUY
2020-11-17 14:19:00,14:19,8321550,10637200,2315650,BUY
2020-11-17 14:20:00,14:20,8337275,10522200,2184925,BUY
2020-11-17 14:21:00,14:21,8354575,10670600,2316025,BUY
2020-11-17 14:22:00,14:22,8267375,10159375,1892000,BUY
2020-11-17 14:23:00,14:23,8362650,10254325,1891675,BUY
2020-11-17 14:24:00,14:24,8304125,10785350,2481225,BUY
2020-11-17 14:25:00,14:25,8319150,10817800,2498650,BUY
2020-11-17 14:26:00,14:26,8311850,10732500,2420650,BUY
2020-11-17 14:27:00,14:27,8346325,10797875,2451550,BUY
2020-11-17 14:28:00,14:28,8346100,10828800,2482700,BUY
2020-11-17 14:29:00,14:29,8240600,10735375,2494775,BUY
2020-11-17 14:30:00,14:30,8322175,10787625,2465450,BUY
2020-11-17 14:31:00,14:31,8318400,10742800,2424400,BUY
2020-11-17 14:32:00,14:32,8344675,10759100,2414425,BUY
2020-11-17 14:33:00,14:33,8324575,10763575,2439000,BUY
2020-11-17 14:34:00,14:34,8350775,10842875,2492100,BUY
2020-11-17 14:35:00,14:35,8324575,10828800,2504225,BUY
2020-11-17 14:36:00,14:36,8391750,10954225,2562475,BUY
2020-11-17 14:37:00,14:37,8465550,10918950,2453400,BUY
2020-11-17 14:38:00,14:38,8496200,10941050,2444850,BUY
2020-11-17 14:39:00,14:39,8550300,10977100,2426800,BUY
2020-11-17 14:40:00,14:40,8448800,10963000,2514200,BUY
2020-11-17 14:41:00,14:41,8491475,10886775,2395300,BUY
2020-11-17 14:42:00,14:42,8268425,10833075,2564650,BUY
2020-11-17 14:43:00,14:43,8277000,10875250,2598250,BUY
2020-11-17 14:44:00,14:44,8279225,10870700,2591475,BUY
2020-11-17 14:45:00,14:45,8338675,10977300,2638625,BUY
2020-11-17 14:46:00,14:46,8267500,10962675,2695175,BUY
2020-11-17 14:47:00,14:47,8361075,10974900,2613825,BUY
2020-11-17 14:48:00,14:48,8196225,11012700,2816475,BUY
2020-11-17 14:49:00,14:49,8281050,11010550,2729500,BUY
2020-11-17 14:50:00,14:50,8270225,10895125,2624900,BUY
2020-11-17 14:51:00,14:51,8263775,10666750,2402975,BUY
2020-11-17 14:52:00,14:52,8263875,10781300,2517425,BUY
2020-11-17 14:53:00,14:53,8217850,10605075,2387225,BUY
2020-11-17 14:54:00,14:54,8177350,10776750,2599400,BUY
2020-11-17 14:55:00,14:55,8281650,10610325,2328675,BUY
2020-11-17 14:56:00,14:56,8241575,10672875,2431300,BUY
2020-11-17 14:57:00,14:57,8316475,10784425,2467950,BUY
2020-11-17 14:58:00,14:58,8279200,10800500,2521300,BUY
2020-11-17 14:59:00,14:59,8255325,10738775,2483450,BUY
2020-11-17 15:00:00,15:00,7904975,10671050,2766075,BUY
2020-11-17 15:01:00,15:01,7906875,10674575,2767700,BUY
2020-11-17 15:02:00,15:02,7891875,10700075,2808200,BUY
2020-11-17 15:03:00,15:03,7727750,10643925,2916175,BUY
2020-11-17 15:04:00,15:04,7774525,10701325,2926800,BUY
2020-11-17 15:05:00,15:05,7781825,10675775,2893950,BUY
2020-11-17 15:06:00,15:06,7659050,10557450,2898400,BUY
2020-11-17 15:07:00,15:07,7695825,10551300,2855475,BUY
2020-11-17 15:08:00,15:08,7739650,10500900,2761250,BUY
2020-11-17 15:09:00,15:09,7584250,10339475,2755225,BUY
2020-11-17 15:10:00,15:10,7587250,10430250,2843000,BUY
2020-11-17 15:11:00,15:11,7618250,10424225,2805975,BUY
2020-11-17 15:12:00,15:12,7566075,10386325,2820250,BUY
2020-11-17 15:13:00,15:13,7602650,10383975,2781325,BUY
2020-11-17 15:14:00,15:14,7521750,10391375,2869625,BUY
2020-11-17 15:15:00,15:15,7506025,10376875,2870850,BUY
2020-11-17 15:16:00,15:16,7483525,10399225,2915700,BUY
2020-11-17 15:17:00,15:17,7443450,10396575,2953125,BUY
2020-11-17 15:18:00,15:18,7264475,10017625,2753150,BUY
2020-11-17 15:19:00,15:19,7272400,10117250,2844850,BUY
2020-11-17 15:20:00,15:20,7253775,10116900,2863125,BUY
2020-11-17 15:21:00,15:21,7161050,9905625,2744575,BUY
2020-11-17 15:22:00,15:22,7155000,9902500,2747500,BUY
2020-11-17 15:23:00,15:23,7122400,9725925,2603525,BUY
2020-11-17 15:24:00,15:24,6905875,9820000,2914125,BUY
2020-11-17 15:25:00,15:25,6934600,9759950,2825350,BUY
2020-11-17 15:26:00,15:26,6913125,9787200,2874075,BUY
2020-11-17 15:27:00,15:27,6870575,9769525,2898950,BUY
2020-11-17 15:28:00,15:28,6865675,9789125,2923450,BUY
2020-11-17 15:29:00,15:29,6908675,9786475,2877800,BUY
2020-11-18 09:15:00,09:15,6726450,9473725,2747275,BUY
2020-11-18 09:16:00,09:16,6688050,9501875,2813825,BUY
2020-11-18 09:17:00,09:17,6829325,9628875,2799550,BUY
2020-11-18 09:18:00,09:18,6832425,9631475,2799050,BUY
2020-11-18 09:19:00,09:19,6824700,9617925,2793225,BUY
2020-11-18 09:20:00,09:20,6936975,9780850,2843875,BUY
2020-11-18 09:21:00,09:21,6994600,9840950,2846350,BUY
2020-11-18 09:22:00,09:22,6990025,9798150,2808125,BUY
2020-11-18 09:23:00,09:23,7181875,9934325,2752450,BUY
2020-11-18 09:24:00,09:24,7038825,9946900,2908075,BUY
2020-11-18 09:25:00,09:25,7172500,9841325,2668825,BUY
2020-11-18 09:26:00,09:26,7445250,10154875,2709625,BUY
2020-11-18 09:27:00,09:27,7534925,10110400,2575475,BUY
2020-11-18 09:28:00,09:28,7523275,10099775,2576500,BUY
2020-11-18 09:29:00,09:29,7908750,10533750,2625000,BUY
2020-11-18 09:30:00,09:30,7874100,10401950,2527850,BUY
2020-11-18 09:31:00,09:31,7923750,10524550,2600800,BUY
2020-11-18 09:32:00,09:32,7998300,10850775,2852475,BUY
2020-11-18 09:33:00,09:33,8018650,10829500,2810850,BUY
2020-11-18 09:34:00,09:34,8025750,10820200,2794450,BUY
2020-11-18 09:35:00,09:35,8243075,11139150,2896075,BUY
2020-11-18 09:36:00,09:36,8231225,11324900,3093675,BUY
2020-11-18 09:37:00,09:37,8137575,11288675,3151100,BUY
2020-11-18 09:38:00,09:38,8324325,11562750,3238425,BUY
2020-11-18 09:39:00,09:39,8459650,11557400,3097750,BUY
2020-11-18 09:40:00,09:40,8346925,11581100,3234175,BUY
2020-11-18 09:41:00,09:41,8518550,11774250,3255700,BUY
2020-11-18 09:42:00,09:42,8582600,11731700,3149100,BUY
2020-11-18 09:43:00,09:43,8475875,11758825,3282950,BUY
2020-11-18 09:44:00,09:44,8839975,11730425,2890450,BUY
2020-11-18 09:45:00,09:45,8851500,11857700,3006200,BUY
2020-11-18 09:46:00,09:46,8847350,11718550,2871200,BUY
2020-11-18 09:47:00,09:47,8810275,11652100,2841825,BUY
2020-11-18 09:48:00,09:48,8758075,11710050,2951975,BUY
2020-11-18 09:49:00,09:49,8930075,11711925,2781850,BUY
2020-11-18 09:50:00,09:50,9028650,12062400,3033750,BUY
2020-11-18 09:51:00,09:51,9083050,12134725,3051675,BUY
2020-11-18 09:52:00,09:52,8990225,12114575,3124350,BUY
2020-11-18 09:53:00,09:53,8830925,11986725,3155800,BUY
2020-11-18 09:54:00,09:54,8874925,12210625,3335700,BUY
2020-11-18 09:55:00,09:55,8906075,12215550,3309475,BUY
2020-11-18 09:56:00,09:56,8818025,12014025,3196000,BUY
2020-11-18 09:57:00,09:57,8862825,12248200,3385375,BUY
2020-11-18 09:58:00,09:58,8901600,12399100,3497500,BUY
2020-11-18 09:59:00,09:59,9025150,12449325,3424175,BUY
2020-11-18 10:00:00,10:00,9000600,12489675,3489075,BUY
2020-11-18 10:01:00,10:01,9158150,12484600,3326450,BUY
2020-11-18 10:02:00,10:02,8994850,12580450,3585600,BUY
2020-11-18 10:03:00,10:03,8931225,12523050,3591825,BUY
2020-11-18 10:04:00,10:04,9033175,12426300,3393125,BUY
2020-11-18 10:05:00,10:05,9120850,12478550,3357700,BUY
2020-11-18 10:06:00,10:06,9032475,12154600,3122125,BUY
2020-11-18 10:07:00,10:07,9079725,12653400,3573675,BUY
2020-11-18 10:08:00,10:08,9250975,12732650,3481675,BUY
2020-11-18 10:09:00,10:09,9196650,12604950,3408300,BUY
2020-11-18 10:10:00,10:10,9225600,12647550,3421950,BUY
2020-11-18 10:11:00,10:11,9202000,12700600,3498600,BUY
2020-11-18 10:12:00,10:12,9243575,12743125,3499550,BUY
2020-11-18 10:13:00,10:13,9241800,12763025,3521225,BUY
2020-11-18 10:14:00,10:14,9333925,12841975,3508050,BUY
2020-11-18 10:15:00,10:15,9399200,12873200,3474000,BUY
2020-11-18 10:16:00,10:16,9148225,12551825,3403600,BUY
2020-11-18 10:17:00,10:17,9353075,12881325,3528250,BUY
2020-11-18 10:18:00,10:18,9316300,12770325,3454025,BUY
2020-11-18 10:19:00,10:19,9346375,12848875,3502500,BUY
2020-11-18 10:20:00,10:20,9483850,12758200,3274350,BUY
2020-11-18 10:21:00,10:21,9396850,12385050,2988200,BUY
2020-11-18 10:22:00,10:22,9457300,12698550,3241250,BUY
2020-11-18 10:23:00,10:23,9184300,12809225,3624925,BUY
2020-11-18 10:24:00,10:24,9284525,12634875,3350350,BUY
2020-11-18 10:25:00,10:25,9332450,12964500,3632050,BUY
2020-11-18 10:26:00,10:26,9395000,12953050,3558050,BUY
2020-11-18 10:27:00,10:27,9480675,12804500,3323825,BUY
2020-11-18 10:28:00,10:28,9396900,12742250,3345350,BUY
2020-11-18 10:29:00,10:29,9265000,12674600,3409600,BUY
2020-11-18 10:30:00,10:30,9161800,12502300,3340500,BUY
2020-11-18 10:31:00,10:31,9364250,12694875,3330625,BUY
2020-11-18 10:32:00,10:32,9428550,13009325,3580775,BUY
2020-11-18 10:33:00,10:33,9462750,12802650,3339900,BUY
2020-11-18 10:34:00,10:34,9386050,12710200,3324150,BUY
2020-11-18 10:35:00,10:35,9520650,12904175,3383525,BUY
2020-11-18 10:36:00,10:36,9526200,12804100,3277900,BUY
2020-11-18 10:37:00,10:37,9472425,12969100,3496675,BUY
2020-11-18 10:38:00,10:38,9506650,13038950,3532300,BUY
2020-11-18 10:39:00,10:39,9427125,12755000,3327875,BUY
2020-11-18 10:40:00,10:40,9398575,12747050,3348475,BUY
2020-11-18 10:41:00,10:41,9548750,13078975,3530225,BUY
2020-11-18 10:42:00,10:42,9553200,13070625,3517425,BUY
2020-11-18 10:43:00,10:43,9441250,12857850,3416600,BUY
2020-11-18 10:44:00,10:44,9474775,12990825,3516050,BUY
2020-11-18 10:45:00,10:45,9447950,13084975,3637025,BUY
2020-11-18 10:46:00,10:46,9399125,13142225,3743100,BUY
2020-11-18 10:47:00,10:47,9361650,12615525,3253875,BUY
2020-11-18 10:48:00,10:48,9488725,12206225,2717500,BUY
2020-11-18 10:49:00,10:49,9430450,13094950,3664500,BUY
2020-11-18 10:50:00,10:50,9370575,13068525,3697950,BUY
2020-11-18 10:51:00,10:51,9410525,12969000,3558475,BUY
2020-11-18 10:52:00,10:52,9436800,13077800,3641000,BUY
2020-11-18 10:53:00,10:53,9481000,12872350,3391350,BUY
2020-11-18 10:54:00,10:54,9441275,12906525,3465250,BUY
2020-11-18 10:55:00,10:55,9472150,13039550,3567400,BUY
2020-11-18 10:56:00,10:56,9519225,12978375,3459150,BUY
2020-11-18 10:57:00,10:57,9577200,12713275,3136075,BUY
2020-11-18 10:58:00,10:58,9466175,13042000,3575825,BUY
2020-11-18 10:59:00,10:59,9423775,12792325,3368550,BUY
2020-11-18 11:00:00,11:00,9450925,12870575,3419650,BUY
2020-11-18 11:01:00,11:01,9635425,12490600,2855175,BUY
2020-11-18 11:02:00,11:02,9647125,12569500,2922375,BUY
2020-11-18 11:03:00,11:03,9677950,12302800,2624850,BUY
2020-11-18 11:04:00,11:04,9753200,12963850,3210650,BUY
2020-11-18 11:05:00,11:05,9786500,13202175,3415675,BUY
2020-11-18 11:06:00,11:06,9799675,13120200,3320525,BUY
2020-11-18 11:07:00,11:07,9827925,13142225,3314300,BUY
2020-11-18 11:08:00,11:08,9757300,12662050,2904750,BUY
2020-11-18 11:09:00,11:09,9838200,13229400,3391200,BUY
2020-11-18 11:10:00,11:10,9888525,13154975,3266450,BUY
2020-11-18 11:11:00,11:11,9706125,12951550,3245425,BUY
2020-11-18 11:12:00,11:12,9780375,13158825,3378450,BUY
2020-11-18 11:13:00,11:13,9756850,12835700,3078850,BUY
2020-11-18 11:14:00,11:14,9734650,12943425,3208775,BUY
2020-11-18 11:15:00,11:15,9792250,12981200,3188950,BUY
2020-11-18 11:16:00,11:16,9680100,12956125,3276025,BUY
2020-11-18 11:17:00,11:17,9831075,12835925,3004850,BUY
2020-11-18 11:18:00,11:18,9933575,12820500,2886925,BUY
2020-11-18 11:19:00,11:19,9912100,12839975,2927875,BUY
2020-11-18 11:20:00,11:20,10012075,12840050,2827975,BUY
2020-11-18 11:21:00,11:21,9950875,13020500,3069625,BUY
2020-11-18 11:22:00,11:22,9975200,12786575,2811375,BUY
2020-11-18 11:23:00,11:23,9845100,12820150,2975050,BUY
2020-11-18 11:24:00,11:24,9852375,12931850,3079475,BUY
2020-11-18 11:25:00,11:25,9824025,12853025,3029000,BUY
2020-11-18 11:26:00,11:26,9804775,12591650,2786875,BUY
2020-11-18 11:27:00,11:27,9912950,12837025,2924075,BUY
2020-11-18 11:28:00,11:28,9837400,12966300,3128900,BUY
2020-11-18 11:29:00,11:29,9876475,12868450,2991975,BUY
2020-11-18 11:30:00,11:30,9887475,12760550,2873075,BUY
2020-11-18 11:31:00,11:31,9829075,12734625,2905550,BUY
2020-11-18 11:32:00,11:32,9894000,12942400,3048400,BUY
2020-11-18 11:33:00,11:33,9990300,12827425,2837125,BUY
2020-11-18 11:34:00,11:34,10044925,12724900,2679975,BUY
2020-11-18 11:35:00,11:35,10019375,12720550,2701175,BUY
2020-11-18 11:36:00,11:36,9934675,12572000,2637325,BUY
2020-11-18 11:37:00,11:37,9934675,12535275,2600600,BUY
2020-11-18 11:38:00,11:38,9795075,12827225,3032150,BUY
2020-11-18 11:39:00,11:39,10093525,12996575,2903050,BUY
2020-11-18 11:40:00,11:40,10033000,13041200,3008200,BUY
2020-11-18 11:41:00,11:41,9808475,12809325,3000850,BUY
2020-11-18 11:42:00,11:42,9969175,13002075,3032900,BUY
2020-11-18 11:43:00,11:43,9920200,11999925,2079725,BUY
2020-11-18 11:44:00,11:44,10014475,12813450,2798975,BUY
2020-11-18 11:45:00,11:45,10155925,12879050,2723125,BUY
2020-11-18 11:46:00,11:46,10120275,12692025,2571750,BUY
2020-11-18 11:47:00,11:47,9905025,12952450,3047425,BUY
2020-11-18 11:48:00,11:48,10010200,12797650,2787450,BUY
2020-11-18 11:49:00,11:49,9855525,12824625,2969100,BUY
2020-11-18 11:50:00,11:50,9877000,12638275,2761275,BUY
2020-11-18 11:51:00,11:51,9830375,13098800,3268425,BUY
2020-11-18 11:52:00,11:52,9914175,12729450,2815275,BUY
2020-11-18 11:53:00,11:53,9974050,12820375,2846325,BUY
2020-11-18 11:54:00,11:54,9898525,12931725,3033200,BUY
2020-11-18 11:55:00,11:55,9925300,12710125,2784825,BUY
2020-11-18 11:56:00,11:56,9997850,12788150,2790300,BUY
2020-11-18 11:57:00,11:57,10083275,13033650,2950375,BUY
2020-11-18 11:58:00,11:58,9949275,12838450,2889175,BUY
2020-11-18 11:59:00,11:59,9891825,13032775,3140950,BUY
2020-11-18 12:00:00,12:00,10022100,12943425,2921325,BUY
2020-11-18 12:01:00,12:01,9981350,13024425,3043075,BUY
2020-11-18 12:02:00,12:02,10025825,13028400,3002575,BUY
2020-11-18 12:03:00,12:03,10081525,12952450,2870925,BUY
2020-11-18 12:04:00,12:04,9749375,12921700,3172325,BUY
2020-11-18 12:05:00,12:05,9931525,13060675,3129150,BUY
2020-11-18 12:06:00,12:06,10073450,13042250,2968800,BUY
2020-11-18 12:07:00,12:07,9932825,13028875,3096050,BUY
2020-11-18 12:08:00,12:08,9965725,12620925,2655200,BUY
2020-11-18 12:09:00,12:09,10075575,12527625,2452050,BUY
2020-11-18 12:10:00,12:10,9783300,12464475,2681175,BUY
2020-11-18 12:11:00,12:11,9933375,13243675,3310300,BUY
2020-11-18 12:12:00,12:12,9967650,12478825,2511175,BUY
2020-11-18 12:13:00,12:13,9983700,12712475,2728775,BUY
2020-11-18 12:14:00,12:14,10049300,12867675,2818375,BUY
2020-11-18 12:15:00,12:15,9993250,12278875,2285625,BUY
2020-11-18 12:16:00,12:16,10018075,12832350,2814275,BUY
2020-11-18 12:17:00,12:17,10011425,12503150,2491725,BUY
2020-11-18 12:18:00,12:18,9974350,13004125,3029775,BUY
2020-11-18 12:19:00,12:19,9826725,12757850,2931125,BUY
2020-11-18 12:20:00,12:20,10074375,13171800,3097425,BUY
2020-11-18 12:21:00,12:21,9994775,12639425,2644650,BUY
2020-11-18 12:22:00,12:22,9866850,12629375,2762525,BUY
2020-11-18 12:23:00,12:23,9794100,13109225,3315125,BUY
2020-11-18 12:24:00,12:24,10012475,13136350,3123875,BUY
2020-11-18 12:25:00,12:25,9932250,13161125,3228875,BUY
2020-11-18 12:26:00,12:26,9913375,12859125,2945750,BUY
2020-11-18 12:27:00,12:27,9962350,12883325,2920975,BUY
2020-11-18 12:28:00,12:28,9876675,12889425,3012750,BUY
2020-11-18 12:29:00,12:29,9849400,12867700,3018300,BUY
2020-11-18 12:30:00,12:30,9780575,12914775,3134200,BUY
2020-11-18 12:31:00,12:31,9912025,12925525,3013500,BUY
2020-11-18 12:32:00,12:32,9730325,12467750,2737425,BUY
2020-11-18 12:33:00,12:33,9732650,13004850,3272200,BUY
2020-11-18 12:34:00,12:34,10014075,12994725,2980650,BUY
2020-11-18 12:35:00,12:35,9852325,12966350,3114025,BUY
2020-11-18 12:36:00,12:36,9853950,12757050,2903100,BUY
2020-11-18 12:37:00,12:37,9954850,12879250,2924400,BUY
2020-11-18 12:38:00,12:38,10087550,13092650,3005100,BUY
2020-11-18 12:39:00,12:39,10071125,13060725,2989600,BUY
2020-11-18 12:40:00,12:40,9903575,12948350,3044775,BUY
2020-11-18 12:41:00,12:41,10111400,13150925,3039525,BUY
2020-11-18 12:42:00,12:42,10003125,13187225,3184100,BUY
2020-11-18 12:43:00,12:43,9975250,13084525,3109275,BUY
2020-11-18 12:44:00,12:44,9892850,13192775,3299925,BUY
2020-11-18 12:45:00,12:45,10087650,13187925,3100275,BUY
2020-11-18 12:46:00,12:46,9897400,12874250,2976850,BUY
2020-11-18 12:47:00,12:47,9804100,13060925,3256825,BUY
2020-11-18 12:48:00,12:48,9934000,12345150,2411150,BUY
2020-11-18 12:49:00,12:49,9841800,13198575,3356775,BUY
2020-11-18 12:50:00,12:50,10083775,13294500,3210725,BUY
2020-11-18 12:51:00,12:51,10111175,13269100,3157925,BUY
2020-11-18 12:52:00,12:52,10083100,13299325,3216225,BUY
2020-11-18 12:53:00,12:53,10070925,13207225,3136300,BUY
2020-11-18 12:54:00,12:54,9680075,12827350,3147275,BUY
2020-11-18 12:55:00,12:55,9683125,12981700,3298575,BUY
2020-11-18 12:56:00,12:56,9590750,13136650,3545900,BUY
2020-11-18 12:57:00,12:57,9614400,13114300,3499900,BUY
2020-11-18 12:58:00,12:58,9521325,13062175,3540850,BUY
2020-11-18 12:59:00,12:59,9665650,13155200,3489550,BUY
2020-11-18 13:00:00,13:00,9753150,13027950,3274800,BUY
2020-11-18 13:01:00,13:01,9683875,13078400,3394525,BUY
2020-11-18 13:02:00,13:02,9755225,13260775,3505550,BUY
2020-11-18 13:03:00,13:03,9781725,13306575,3524850,BUY
2020-11-18 13:04:00,13:04,9823025,13199925,3376900,BUY
2020-11-18 13:05:00,13:05,9857225,13304150,3446925,BUY
2020-11-18 13:06:00,13:06,9517425,13083475,3566050,BUY
2020-11-18 13:07:00,13:07,9537375,12779300,3241925,BUY
2020-11-18 13:08:00,13:08,9491950,12909200,3417250,BUY
2020-11-18 13:09:00,13:09,9544725,12880250,3335525,BUY
2020-11-18 13:10:00,13:10,9543525,12978625,3435100,BUY
2020-11-18 13:11:00,13:11,9513900,12875275,3361375,BUY
2020-11-18 13:12:00,13:12,9464350,12503850,3039500,BUY
2020-11-18 13:13:00,13:13,9440900,12476200,3035300,BUY
2020-11-18 13:14:00,13:14,9362325,12703375,3341050,BUY
2020-11-18 13:15:00,13:15,9534025,12515175,2981150,BUY
2020-11-18 13:16:00,13:16,9480850,12914625,3433775,BUY
2020-11-18 13:17:00,13:17,9454025,12730625,3276600,BUY
2020-11-18 13:18:00,13:18,9410800,12892400,3481600,BUY
2020-11-18 13:19:00,13:19,9420775,12635525,3214750,BUY
2020-11-18 13:20:00,13:20,9446125,12306000,2859875,BUY
2020-11-18 13:21:00,13:21,9411700,12715175,3303475,BUY
2020-11-18 13:22:00,13:22,9468375,12665275,3196900,BUY
2020-11-18 13:23:00,13:23,9566875,12865550,3298675,BUY
2020-11-18 13:24:00,13:24,9416250,12777575,3361325,BUY
2020-11-18 13:25:00,13:25,9368750,12390325,3021575,BUY
2020-11-18 13:26:00,13:26,9451700,12694100,3242400,BUY
2020-11-18 13:27:00,13:27,9360650,12625175,3264525,BUY
2020-11-18 13:28:00,13:28,9458875,12676625,3217750,BUY
2020-11-18 13:29:00,13:29,9466925,12410425,2943500,BUY
2020-11-18 13:30:00,13:30,9333900,12789000,3455100,BUY
2020-11-18 13:31:00,13:31,9283950,12747175,3463225,BUY
2020-11-18 13:32:00,13:32,9150700,12748700,3598000,BUY
2020-11-18 13:33:00,13:33,9130100,12304775,3174675,BUY
2020-11-18 13:34:00,13:34,9260025,12418425,3158400,BUY
2020-11-18 13:35:00,13:35,9288450,12644750,3356300,BUY
2020-11-18 13:36:00,13:36,9409350,12383600,2974250,BUY
2020-11-18 13:37:00,13:37,9305550,12630100,3324550,BUY
2020-11-18 13:38:00,13:38,9436375,12563175,3126800,BUY
2020-11-18 13:39:00,13:39,9036925,12472900,3435975,BUY
2020-11-18 13:40:00,13:40,9195575,12698075,3502500,BUY
2020-11-18 13:41:00,13:41,9134850,12788025,3653175,BUY
2020-11-18 13:42:00,13:42,8489000,12587750,4098750,BUY
2020-11-18 13:43:00,13:43,8479075,12730450,4251375,BUY
2020-11-18 13:44:00,13:44,8455000,12686900,4231900,BUY
2020-11-18 13:45:00,13:45,8544775,12580800,4036025,BUY
2020-11-18 13:46:00,13:46,8528975,12608225,4079250,BUY
2020-11-18 13:47:00,13:47,8560350,12556950,3996600,BUY
2020-11-18 13:48:00,13:48,8180850,12660250,4479400,BUY
2020-11-18 13:49:00,13:49,8211025,12442625,4231600,BUY
2020-11-18 13:50:00,13:50,8178300,12577425,4399125,BUY
2020-11-18 13:51:00,13:51,8147125,12613825,4466700,BUY
2020-11-18 13:52:00,13:52,8089325,12157375,4068050,BUY
2020-11-18 13:53:00,13:53,8182900,12537950,4355050,BUY
2020-11-18 13:54:00,13:54,8121125,12306200,4185075,BUY
2020-11-18 13:55:00,13:55,8149475,12443200,4293725,BUY
2020-11-18 13:56:00,13:56,8084425,12574225,4489800,BUY
2020-11-18 13:57:00,13:57,8096050,12349800,4253750,BUY
2020-11-18 13:58:00,13:58,8133650,12562725,4429075,BUY
2020-11-18 13:59:00,13:59,8165950,12521950,4356000,BUY
2020-11-18 14:00:00,14:00,7982275,12635875,4653600,BUY
2020-11-18 14:01:00,14:01,7930050,12601725,4671675,BUY
2020-11-18 14:02:00,14:02,8010800,12636950,4626150,BUY
2020-11-18 14:03:00,14:03,7700650,12434050,4733400,BUY
2020-11-18 14:04:00,14:04,7656525,12365775,4709250,BUY
2020-11-18 14:05:00,14:05,7603900,12358300,4754400,BUY
2020-11-18 14:06:00,14:06,7698725,12138050,4439325,BUY
2020-11-18 14:07:00,14:07,7797850,12180200,4382350,BUY
2020-11-18 14:08:00,14:08,7775950,12186575,4410625,BUY
2020-11-18 14:09:00,14:09,7815950,12090125,4274175,BUY
2020-11-18 14:10:00,14:10,7889700,12154600,4264900,BUY
2020-11-18 14:11:00,14:11,7892100,12121900,4229800,BUY
2020-11-18 14:12:00,14:12,7724100,12060825,4336725,BUY
2020-11-18 14:13:00,14:13,7803250,12087675,4284425,BUY
2020-11-18 14:14:00,14:14,7803250,11942900,4139650,BUY
2020-11-18 14:15:00,14:15,7779650,11855625,4075975,BUY
2020-11-18 14:16:00,14:16,7787250,11766625,3979375,BUY
2020-11-18 14:17:00,14:17,7825700,11988450,4162750,BUY
2020-11-18 14:18:00,14:18,7848150,11739000,3890850,BUY
2020-11-18 14:19:00,14:19,7902800,11759275,3856475,BUY
2020-11-18 14:20:00,14:20,7905700,11717950,3812250,BUY
2020-11-18 14:21:00,14:21,8013875,11593175,3579300,BUY
2020-11-18 14:22:00,14:22,8006500,11572675,3566175,BUY
2020-11-18 14:23:00,14:23,8036450,11648350,3611900,BUY
2020-11-18 14:24:00,14:24,7890375,11448450,3558075,BUY
2020-11-18 14:25:00,14:25,7998225,11611275,3613050,BUY
2020-11-18 14:26:00,14:26,7872125,11533100,3660975,BUY
2020-11-18 14:27:00,14:27,7812725,11463875,3651150,BUY
2020-11-18 14:28:00,14:28,7978150,11524050,3545900,BUY
2020-11-18 14:29:00,14:29,7863275,11286975,3423700,BUY
2020-11-18 14:30:00,14:30,7991350,11210400,3219050,BUY
2020-11-18 14:31:00,14:31,7976625,11438575,3461950,BUY
2020-11-18 14:32:00,14:32,8066725,11528400,3461675,BUY
2020-11-18 14:33:00,14:33,8030775,11555925,3525150,BUY
2020-11-18 14:34:00,14:34,7944025,11475325,3531300,BUY
2020-11-18 14:35:00,14:35,7956000,11605900,3649900,BUY
2020-11-18 14:36:00,14:36,8011550,11532000,3520450,BUY
2020-11-18 14:37:00,14:37,8085575,11571500,3485925,BUY
2020-11-18 14:38:00,14:38,8048400,11284300,3235900,BUY
2020-11-18 14:39:00,14:39,7831125,11198750,3367625,BUY
2020-11-18 14:40:00,14:40,7854750,11341250,3486500,BUY
2020-11-18 14:41:00,14:41,7872200,11586425,3714225,BUY
2020-11-18 14:42:00,14:42,7739925,11385025,3645100,BUY
2020-11-18 14:43:00,14:43,7843875,11396975,3553100,BUY
2020-11-18 14:44:00,14:44,7817700,11493625,3675925,BUY
2020-11-18 14:45:00,14:45,7752300,11370775,3618475,BUY
2020-11-18 14:46:00,14:46,7769475,11416025,3646550,BUY
2020-11-18 14:47:00,14:47,7778325,11472600,3694275,BUY
2020-11-18 14:48:00,14:48,7885200,11244250,3359050,BUY
2020-11-18 14:49:00,14:49,7840625,11435900,3595275,BUY
2020-11-18 14:50:00,14:50,7852025,11122100,3270075,BUY
2020-11-18 14:51:00,14:51,7774400,11365250,3590850,BUY
2020-11-18 14:52:00,14:52,7794925,11227200,3432275,BUY
2020-11-18 14:53:00,14:53,7753100,11422225,3669125,BUY
2020-11-18 14:54:00,14:54,7626950,11269200,3642250,BUY
2020-11-18 14:55:00,14:55,7587500,11456050,3868550,BUY
2020-11-18 14:56:00,14:56,7679075,11305425,3626350,BUY
2020-11-18 14:57:00,14:57,7517975,11374300,3856325,BUY
2020-11-18 14:58:00,14:58,7631200,11461900,3830700,BUY
2020-11-18 14:59:00,14:59,7628875,11005900,3377025,BUY
2020-11-18 15:00:00,15:00,7501700,11606250,4104550,BUY
2020-11-18 15:01:00,15:01,7526325,11406200,3879875,BUY
2020-11-18 15:02:00,15:02,7557900,11512025,3954125,BUY
2020-11-18 15:03:00,15:03,7500050,11522925,4022875,BUY
2020-11-18 15:04:00,15:04,7490875,11443325,3952450,BUY
2020-11-18 15:05:00,15:05,7459475,11500725,4041250,BUY
2020-11-18 15:06:00,15:06,7123600,10998925,3875325,BUY
2020-11-18 15:07:00,15:07,7177350,11034900,3857550,BUY
2020-11-18 15:08:00,15:08,7115500,11046250,3930750,BUY
2020-11-18 15:09:00,15:09,7189000,10931575,3742575,BUY
2020-11-18 15:10:00,15:10,7029600,10905725,3876125,BUY
2020-11-18 15:11:00,15:11,7026900,10901950,3875050,BUY
2020-11-18 15:12:00,15:12,7068675,10508225,3439550,BUY
2020-11-18 15:13:00,15:13,6924475,10764500,3840025,BUY
2020-11-18 15:14:00,15:14,7053475,10870800,3817325,BUY
2020-11-18 15:15:00,15:15,6969475,10628150,3658675,BUY
2020-11-18 15:16:00,15:16,7000050,10692625,3692575,BUY
2020-11-18 15:17:00,15:17,6954250,10726425,3772175,BUY
2020-11-18 15:18:00,15:18,6861325,10546900,3685575,BUY
2020-11-18 15:19:00,15:19,6817550,10578825,3761275,BUY
2020-11-18 15:20:00,15:20,6869750,10516775,3647025,BUY
2020-11-18 15:21:00,15:21,6657925,10269500,3611575,BUY
2020-11-18 15:22:00,15:22,6689850,10259550,3569700,BUY
2020-11-18 15:23:00,15:23,6626900,10169900,3543000,BUY
2020-11-18 15:24:00,15:24,6657875,10189725,3531850,BUY
2020-11-18 15:25:00,15:25,6645200,9984825,3339625,BUY
2020-11-18 15:26:00,15:26,6543825,10148900,3605075,BUY
2020-11-18 15:27:00,15:27,6496775,10071150,3574375,BUY
2020-11-18 15:28:00,15:28,6526275,10042925,3516650,BUY
2020-11-18 15:29:00,15:29,6537675,10083775,3546100,BUY
2020-11-19 09:15:00,09:15,6340725,9530875,3190150,BUY
2020-11-19 09:16:00,09:16,6290900,9768350,3477450,BUY
2020-11-19 09:17:00,09:17,6449025,9798925,3349900,BUY
2020-11-19 09:18:00,09:18,6451000,9785825,3334825,BUY
2020-11-19 09:19:00,09:19,6484075,9771650,3287575,BUY
2020-11-19 09:20:00,09:20,6687525,9857350,3169825,BUY
2020-11-19 09:21:00,09:21,6721625,9755425,3033800,BUY
2020-11-19 09:22:00,09:22,6726100,9861725,3135625,BUY
2020-11-19 09:23:00,09:23,6811725,9979025,3167300,BUY
2020-11-19 09:24:00,09:24,6847325,10041675,3194350,BUY
2020-11-19 09:25:00,09:25,6820075,9931200,3111125,BUY
2020-11-19 09:26:00,09:26,7144075,10156150,3012075,BUY
2020-11-19 09:27:00,09:27,7178700,10193275,3014575,BUY
2020-11-19 09:28:00,09:28,7075375,10153025,3077650,BUY
2020-11-19 09:29:00,09:29,7544025,10493450,2949425,BUY
2020-11-19 09:30:00,09:30,7550550,10394125,2843575,BUY
2020-11-19 09:31:00,09:31,7468050,10319475,2851425,BUY
2020-11-19 09:32:00,09:32,8232150,10598900,2366750,BUY
2020-11-19 09:33:00,09:33,8106150,10571575,2465425,BUY
2020-11-19 09:34:00,09:34,8038725,10554950,2516225,BUY
2020-11-19 09:35:00,09:35,8812450,10894775,2082325,BUY
2020-11-19 09:36:00,09:36,8761700,10869375,2107675,BUY
2020-11-19 09:37:00,09:37,8676750,10870650,2193900,BUY
2020-11-19 09:38:00,09:38,9057675,11148325,2090650,BUY
2020-11-19 09:39:00,09:39,9068250,11256175,2187925,BUY
2020-11-19 09:40:00,09:40,9091625,10868675,1777050,BUY
2020-11-19 09:41:00,09:41,9553000,11417450,1864450,BUY
2020-11-19 09:42:00,09:42,9529750,11339875,1810125,BUY
2020-11-19 09:43:00,09:43,9536750,11326175,1789425,BUY
2020-11-19 09:44:00,09:44,9710675,11864075,2153400,BUY
2020-11-19 09:45:00,09:45,9799875,11356325,1556450,BUY
2020-11-19 09:46:00,09:46,9789675,11637925,1848250,BUY
2020-11-19 09:47:00,09:47,9911825,12173675,2261850,BUY
2020-11-19 09:48:00,09:48,9976925,12183050,2206125,BUY
2020-11-19 09:49:00,09:49,8523675,9969950,1446275,BUY
2020-11-19 09:50:00,09:50,10275275,12462025,2186750,BUY
2020-11-19 09:51:00,09:51,10223100,12305300,2082200,BUY
2020-11-19 09:52:00,09:52,10223050,12596975,2373925,BUY
2020-11-19 09:53:00,09:53,10608000,12537625,1929625,BUY
2020-11-19 09:54:00,09:54,10608075,12447500,1839425,BUY
2020-11-19 09:55:00,09:55,10465525,12849175,2383650,BUY
2020-11-19 09:56:00,09:56,10878275,12726050,1847775,BUY
2020-11-19 09:57:00,09:57,11048950,12886875,1837925,BUY
2020-11-19 09:58:00,09:58,10887550,13013950,2126400,BUY
2020-11-19 09:59:00,09:59,11236575,13336250,2099675,BUY
2020-11-19 10:00:00,10:00,11168650,13230500,2061850,BUY
2020-11-19 10:01:00,10:01,11402850,13090175,1687325,BUY
2020-11-19 10:02:00,10:02,10898525,13678825,2780300,BUY
2020-11-19 10:03:00,10:03,10872225,13588175,2715950,BUY
2020-11-19 10:04:00,10:04,10863850,13642250,2778400,BUY
2020-11-19 10:05:00,10:05,11210250,13230475,2020225,BUY
2020-11-19 10:06:00,10:06,11088425,13808150,2719725,BUY
2020-11-19 10:07:00,10:07,11121675,13980975,2859300,BUY
2020-11-19 10:08:00,10:08,10947675,14046275,3098600,BUY
2020-11-19 10:09:00,10:09,10896375,13537750,2641375,BUY
2020-11-19 10:10:00,10:10,11074750,13768325,2693575,BUY
2020-11-19 10:11:00,10:11,11251375,14416000,3164625,BUY
2020-11-19 10:12:00,10:12,11112025,13806750,2694725,BUY
2020-11-19 10:13:00,10:13,11024025,14253275,3229250,BUY
2020-11-19 10:14:00,10:14,11184325,13873600,2689275,BUY
2020-11-19 10:15:00,10:15,11219450,14538975,3319525,BUY
2020-11-19 10:16:00,10:16,11179900,14444125,3264225,BUY
2020-11-19 10:17:00,10:17,11525900,14904300,3378400,BUY
2020-11-19 10:18:00,10:18,11573275,14451300,2878025,BUY
2020-11-19 10:19:00,10:19,11554025,14221500,2667475,BUY
2020-11-19 10:20:00,10:20,11933425,15278150,3344725,BUY
2020-11-19 10:21:00,10:21,11882350,15209300,3326950,BUY
2020-11-19 10:22:00,10:22,11502875,14324550,2821675,BUY
2020-11-19 10:23:00,10:23,12135200,14525900,2390700,BUY
2020-11-19 10:24:00,10:24,12137600,15315400,3177800,BUY
2020-11-19 10:25:00,10:25,12004275,14973375,2969100,BUY
2020-11-19 10:26:00,10:26,12897250,15498575,2601325,BUY
2020-11-19 10:27:00,10:27,12737500,15391475,2653975,BUY
2020-11-19 10:28:00,10:28,12897900,15479425,2581525,BUY
2020-11-19 10:29:00,10:29,12819725,16123275,3303550,BUY
2020-11-19 10:30:00,10:30,13001750,16065675,3063925,BUY
2020-11-19 10:31:00,10:31,12899525,16007525,3108000,BUY
2020-11-19 10:32:00,10:32,13308125,16038350,2730225,BUY
2020-11-19 10:33:00,10:33,13320975,15421125,2100150,BUY
2020-11-19 10:34:00,10:34,13392900,16115125,2722225,BUY
2020-11-19 10:35:00,10:35,13526950,16155650,2628700,BUY
2020-11-19 10:36:00,10:36,13218450,15975600,2757150,BUY
2020-11-19 10:37:00,10:37,13492025,16805550,3313525,BUY
2020-11-19 10:38:00,10:38,13901800,17071150,3169350,BUY
2020-11-19 10:39:00,10:39,13776400,15836475,2060075,BUY
2020-11-19 10:40:00,10:40,14165075,16716175,2551100,BUY
2020-11-19 10:41:00,10:41,14212225,16893600,2681375,BUY
2020-11-19 10:42:00,10:42,14192725,16287075,2094350,BUY
2020-11-19 10:43:00,10:43,14322800,16404575,2081775,BUY
2020-11-19 10:44:00,10:44,14288850,16824150,2535300,BUY
2020-11-19 10:45:00,10:45,14322725,16915550,2592825,BUY
2020-11-19 10:46:00,10:46,14319475,16716125,2396650,BUY
2020-11-19 10:47:00,10:47,14176375,16699550,2523175,BUY
2020-11-19 10:48:00,10:48,14267000,16070150,1803150,BUY
2020-11-19 10:49:00,10:49,14214750,16703225,2488475,BUY
2020-11-19 10:50:00,10:50,14611625,16900375,2288750,BUY
2020-11-19 10:51:00,10:51,14658525,16456175,1797650,BUY
2020-11-19 10:52:00,10:52,14652100,16835300,2183200,BUY
2020-11-19 10:53:00,10:53,14757325,16835675,2078350,BUY
2020-11-19 10:54:00,10:54,14724700,15946700,1222000,BUY
2020-11-19 10:55:00,10:55,14730975,16615650,1884675,BUY
2020-11-19 10:56:00,10:56,14391625,15867250,1475625,BUY
2020-11-19 10:57:00,10:57,14614700,15901250,1286550,BUY
2020-11-19 10:58:00,10:58,14761325,16061650,1300325,BUY
2020-11-19 10:59:00,10:59,15021375,16533525,1512150,BUY
2020-11-19 11:00:00,11:00,14915825,16184875,1269050,BUY
2020-11-19 11:01:00,11:01,14911700,15931075,1019375,BUY
2020-11-19 11:02:00,11:02,15202050,15683300,481250,BUY
2020-11-19 11:03:00,11:03,15355000,15493400,138400,BUY
2020-11-19 11:04:00,11:04,15267500,15759200,491700,BUY
2020-11-19 11:05:00,11:05,15220575,15231975,11400,BUY
2020-11-19 11:06:00,11:06,15247225,15949075,701850,BUY
2020-11-19 11:07:00,11:07,15444475,16205500,761025,BUY
2020-11-19 11:08:00,11:08,15708300,16492375,784075,BUY
2020-11-19 11:09:00,11:09,15672050,15958300,286250,BUY
2020-11-19 11:10:00,11:10,15399575,15586225,186650,BUY
2020-11-19 11:11:00,11:11,15884275,15934625,50350,BUY
2020-11-19 11:12:00,11:12,16031100,15410900,-620200,SELL
2020-11-19 11:13:00,11:13,15898900,15253850,-645050,SELL
2020-11-19 11:14:00,11:14,16181625,16092000,-89625,SELL
2020-11-19 11:15:00,11:15,16316600,15877300,-439300,SELL
2020-11-19 11:16:00,11:16,16203350,16018700,-184650,SELL
2020-11-19 11:17:00,11:17,16022650,15938800,-83850,SELL
2020-11-19 11:18:00,11:18,16252400,15703550,-548850,SELL
2020-11-19 11:19:00,11:19,16109675,15230000,-879675,SELL
2020-11-19 11:20:00,11:20,16508725,16508850,125,BUY
2020-11-19 11:21:00,11:21,16628825,16585550,-43275,SELL
2020-11-19 11:22:00,11:22,16646625,16107775,-538850,SELL
2020-11-19 11:23:00,11:23,16684250,15893750,-790500,SELL
2020-11-19 11:24:00,11:24,16718075,15725175,-992900,SELL
2020-11-19 11:25:00,11:25,16519350,16434725,-84625,SELL
2020-11-19 11:26:00,11:26,16801800,16403825,-397975,SELL
2020-11-19 11:27:00,11:27,16827925,16434350,-393575,SELL
2020-11-19 11:28:00,11:28,16690250,16396800,-293450,SELL
2020-11-19 11:29:00,11:29,16838025,16816750,-21275,SELL
2020-11-19 11:30:00,11:30,17010125,15837825,-1172300,SELL
2020-11-19 11:31:00,11:31,16745825,16721200,-24625,SELL
2020-11-19 11:32:00,11:32,16804175,16788550,-15625,SELL
2020-11-19 11:33:00,11:33,16923400,16264025,-659375,SELL
2020-11-19 11:34:00,11:34,16867600,16335075,-532525,SELL
2020-11-19 11:35:00,11:35,17129750,17062800,-66950,SELL
2020-11-19 11:36:00,11:36,16850750,17133000,282250,BUY
2020-11-19 11:37:00,11:37,17148525,16695725,-452800,SELL
2020-11-19 11:38:00,11:38,17164350,17131975,-32375,SELL
2020-11-19 11:39:00,11:39,17150400,16804325,-346075,SELL
2020-11-19 11:40:00,11:40,17115975,17262925,146950,BUY
2020-11-19 11:41:00,11:41,16776950,15949125,-827825,SELL
2020-11-19 11:42:00,11:42,16776175,17568400,792225,BUY
2020-11-19 11:43:00,11:43,16706650,16744900,38250,BUY
2020-11-19 11:44:00,11:44,16863525,16770275,-93250,SELL
2020-11-19 11:45:00,11:45,16783000,17819425,1036425,BUY
2020-11-19 11:46:00,11:46,16852900,17383550,530650,BUY
2020-11-19 11:47:00,11:47,16902200,16609875,-292325,SELL
2020-11-19 11:48:00,11:48,16897225,17739650,842425,BUY
2020-11-19 11:49:00,11:49,16868525,17665550,797025,BUY
2020-11-19 11:50:00,11:50,17185825,16815250,-370575,SELL
2020-11-19 11:51:00,11:51,16985675,16832325,-153350,SELL
2020-11-19 11:52:00,11:52,16896600,17245375,348775,BUY
2020-11-19 11:53:00,11:53,17155850,17548700,392850,BUY
2020-11-19 11:54:00,11:54,17018650,16718375,-300275,SELL
2020-11-19 11:55:00,11:55,17154525,16853425,-301100,SELL
2020-11-19 11:56:00,11:56,17533375,16950950,-582425,SELL
2020-11-19 11:57:00,11:57,17013400,17449425,436025,BUY
2020-11-19 11:58:00,11:58,16986225,17028600,42375,BUY
2020-11-19 11:59:00,11:59,17347450,17165975,-181475,SELL
2020-11-19 12:00:00,12:00,17294675,16747525,-547150,SELL
2020-11-19 12:01:00,12:01,17556725,17632725,76000,BUY
2020-11-19 12:02:00,12:02,17481625,16831575,-650050,SELL
2020-11-19 12:03:00,12:03,17618575,17359050,-259525,SELL
2020-11-19 12:04:00,12:04,17577350,17430575,-146775,SELL
2020-11-19 12:05:00,12:05,17584950,17906625,321675,BUY
2020-11-19 12:06:00,12:06,17470175,17414600,-55575,SELL
2020-11-19 12:07:00,12:07,17030875,18067600,1036725,BUY
2020-11-19 12:08:00,12:08,17431250,18229075,797825,BUY
2020-11-19 12:09:00,12:09,17333300,18088500,755200,BUY
2020-11-19 12:10:00,12:10,17320900,17732300,411400,BUY
2020-11-19 12:11:00,12:11,17372475,17303525,-68950,SELL
2020-11-19 12:12:00,12:12,17558375,18073825,515450,BUY
2020-11-19 12:13:00,12:13,17243300,17159025,-84275,SELL
2020-11-19 12:14:00,12:14,17537650,17584425,46775,BUY
2020-11-19 12:15:00,12:15,17588425,17784450,196025,BUY
2020-11-19 12:16:00,12:16,17657925,17297375,-360550,SELL
2020-11-19 12:17:00,12:17,17523850,18133125,609275,BUY
2020-11-19 12:18:00,12:18,17489800,17201950,-287850,SELL
2020-11-19 12:19:00,12:19,17479975,17775275,295300,BUY
2020-11-19 12:20:00,12:20,17291875,18300000,1008125,BUY
2020-11-19 12:21:00,12:21,17609250,17541625,-67625,SELL
2020-11-19 12:22:00,12:22,17331175,17725500,394325,BUY
2020-11-19 12:23:00,12:23,17381350,17867950,486600,BUY
2020-11-19 12:24:00,12:24,17560200,17051525,-508675,SELL
2020-11-19 12:25:00,12:25,17084775,17120625,35850,BUY
2020-11-19 12:26:00,12:26,17513950,17415725,-98225,SELL
2020-11-19 12:27:00,12:27,17358450,17059700,-298750,SELL
2020-11-19 12:28:00,12:28,17544375,17563875,19500,BUY
2020-11-19 12:29:00,12:29,17288575,18051875,763300,BUY
2020-11-19 12:30:00,12:30,17284925,18374750,1089825,BUY
2020-11-19 12:31:00,12:31,17462400,18329775,867375,BUY
2020-11-19 12:32:00,12:32,17058350,18044200,985850,BUY
2020-11-19 12:33:00,12:33,17710700,18192650,481950,BUY
2020-11-19 12:34:00,12:34,17542975,17914750,371775,BUY
2020-11-19 12:35:00,12:35,17760050,17512250,-247800,SELL
2020-11-19 12:36:00,12:36,17598300,17679450,81150,BUY
2020-11-19 12:37:00,12:37,17598300,17774525,176225,BUY
2020-11-19 12:38:00,12:38,17530600,18145825,615225,BUY
2020-11-19 12:39:00,12:39,17476350,18028350,552000,BUY
2020-11-19 12:40:00,12:40,17340825,18127950,787125,BUY
2020-11-19 12:41:00,12:41,17545050,17651450,106400,BUY
2020-11-19 12:42:00,12:42,17423050,18107375,684325,BUY
2020-11-19 12:43:00,12:43,17199500,17570575,371075,BUY
2020-11-19 12:44:00,12:44,17548950,18329800,780850,BUY
2020-11-19 12:45:00,12:45,17409575,18119475,709900,BUY
2020-11-19 12:46:00,12:46,17622025,17534300,-87725,SELL
2020-11-19 12:47:00,12:47,17512300,18420325,908025,BUY
2020-11-19 12:48:00,12:48,17507400,18609700,1102300,BUY
2020-11-19 12:49:00,12:49,17508550,18226500,717950,BUY
2020-11-19 12:50:00,12:50,17465500,18260375,794875,BUY
2020-11-19 12:51:00,12:51,17206425,18231925,1025500,BUY
2020-11-19 12:52:00,12:52,17806500,18297425,490925,BUY
2020-11-19 12:53:00,12:53,17844525,18147000,302475,BUY
2020-11-19 12:54:00,12:54,17802725,17720150,-82575,SELL
2020-11-19 12:55:00,12:55,17758175,17987150,228975,BUY
2020-11-19 12:56:00,12:56,17800025,18239150,439125,BUY
2020-11-19 12:57:00,12:57,17693150,18339550,646400,BUY
2020-11-19 12:58:00,12:58,17735550,18307350,571800,BUY
2020-11-19 12:59:00,12:59,17836700,18077450,240750,BUY
2020-11-19 13:00:00,13:00,17967625,18424650,457025,BUY
2020-11-19 13:01:00,13:01,17989400,18243775,254375,BUY
2020-11-19 13:02:00,13:02,17809875,18435750,625875,BUY
2020-11-19 13:03:00,13:03,17798025,18123075,325050,BUY
2020-11-19 13:04:00,13:04,17695950,18156550,460600,BUY
2020-11-19 13:05:00,13:05,17798625,17837625,39000,BUY
2020-11-19 13:06:00,13:06,17667525,16985400,-682125,SELL
2020-11-19 13:07:00,13:07,17511225,17308150,-203075,SELL
2020-11-19 13:08:00,13:08,17582000,16740900,-841100,SELL
2020-11-19 13:09:00,13:09,17739500,17571875,-167625,SELL
2020-11-19 13:10:00,13:10,17973175,17382400,-590775,SELL
2020-11-19 13:11:00,13:11,17861350,17431900,-429450,SELL
2020-11-19 13:12:00,13:12,18083100,17183750,-899350,SELL
2020-11-19 13:13:00,13:13,17998750,17948775,-49975,SELL
2020-11-19 13:14:00,13:14,17788550,17566775,-221775,SELL
2020-11-19 13:15:00,13:15,18002025,17708350,-293675,SELL
2020-11-19 13:16:00,13:16,18110525,17796200,-314325,SELL
2020-11-19 13:17:00,13:17,18033525,17736500,-297025,SELL
2020-11-19 13:18:00,13:18,18118300,17251375,-866925,SELL
2020-11-19 13:19:00,13:19,18063500,17637425,-426075,SELL
2020-11-19 13:20:00,13:20,18253075,17746175,-506900,SELL
2020-11-19 13:21:00,13:21,17904950,17470625,-434325,SELL
2020-11-19 13:22:00,13:22,18297150,17665875,-631275,SELL
2020-11-19 13:23:00,13:23,18238975,17814075,-424900,SELL
2020-11-19 13:24:00,13:24,18415650,18197625,-218025,SELL
2020-11-19 13:25:00,13:25,18697100,17794625,-902475,SELL
2020-11-19 13:26:00,13:26,18763925,17973675,-790250,SELL
2020-11-19 13:27:00,13:27,18481925,17530600,-951325,SELL
2020-11-19 13:28:00,13:28,18565200,18118450,-446750,SELL
2020-11-19 13:29:00,13:29,18489825,17491000,-998825,SELL
2020-11-19 13:30:00,13:30,18311425,17599250,-712175,SELL
2020-11-19 13:31:00,13:31,18288675,16530225,-1758450,SELL
2020-11-19 13:32:00,13:32,18232625,16952875,-1279750,SELL
2020-11-19 13:33:00,13:33,18099175,16946125,-1153050,SELL
2020-11-19 13:34:00,13:34,18188975,16924150,-1264825,SELL
2020-11-19 13:35:00,13:35,18123425,17165050,-958375,SELL
2020-11-19 13:36:00,13:36,18465525,17093075,-1372450,SELL
2020-11-19 13:37:00,13:37,18380575,16641950,-1738625,SELL
2020-11-19 13:38:00,13:38,18342050,16826175,-1515875,SELL
2020-11-19 13:39:00,13:39,18451975,17163150,-1288825,SELL
2020-11-19 13:40:00,13:40,18523250,17504500,-1018750,SELL
2020-11-19 13:41:00,13:41,18446400,17259800,-1186600,SELL
2020-11-19 13:42:00,13:42,18456850,16556750,-1900100,SELL
2020-11-19 13:43:00,13:43,18490550,16591225,-1899325,SELL
2020-11-19 13:44:00,13:44,18339900,16517100,-1822800,SELL
2020-11-19 13:45:00,13:45,18587775,16381525,-2206250,SELL
2020-11-19 13:46:00,13:46,18478325,16210325,-2268000,SELL
2020-11-19 13:47:00,13:47,18188800,16182725,-2006075,SELL
2020-11-19 13:48:00,13:48,18530925,15193375,-3337550,SELL
2020-11-19 13:49:00,13:49,18509425,15701650,-2807775,SELL
2020-11-19 13:50:00,13:50,18471200,15003850,-3467350,SELL
2020-11-19 13:51:00,13:51,18543650,15623250,-2920400,SELL
2020-11-19 13:52:00,13:52,18604375,14969125,-3635250,SELL
2020-11-19 13:53:00,13:53,18525425,15599000,-2926425,SELL
2020-11-19 13:54:00,13:54,18508525,15497300,-3011225,SELL
2020-11-19 13:55:00,13:55,18604125,15618950,-2985175,SELL
2020-11-19 13:56:00,13:56,18557725,15439950,-3117775,SELL
2020-11-19 13:57:00,13:57,18558850,15800350,-2758500,SELL
2020-11-19 13:58:00,13:58,18564775,15070650,-3494125,SELL
2020-11-19 13:59:00,13:59,18457375,15617250,-2840125,SELL
2020-11-19 14:00:00,14:00,18638000,15116075,-3521925,SELL
2020-11-19 14:01:00,14:01,18676550,16007425,-2669125,SELL
2020-11-19 14:02:00,14:02,18794075,15785175,-3008900,SELL
2020-11-19 14:03:00,14:03,18553275,15513225,-3040050,SELL
2020-11-19 14:04:00,14:04,18797100,15427175,-3369925,SELL
2020-11-19 14:05:00,14:05,18846250,15823575,-3022675,SELL
2020-11-19 14:06:00,14:06,18674150,15435425,-3238725,SELL
2020-11-19 14:07:00,14:07,18731275,15673725,-3057550,SELL
2020-11-19 14:08:00,14:08,18822175,15733100,-3089075,SELL
2020-11-19 14:09:00,14:09,18751425,15322425,-3429000,SELL
2020-11-19 14:10:00,14:10,18756725,15131825,-3624900,SELL
2020-11-19 14:11:00,14:11,18794400,14834550,-3959850,SELL
2020-11-19 14:12:00,14:12,18837200,14637650,-4199550,SELL
2020-11-19 14:13:00,14:13,18808000,15057675,-3750325,SELL
2020-11-19 14:14:00,14:14,18822675,15418325,-3404350,SELL
2020-11-19 14:15:00,14:15,18877975,15014050,-3863925,SELL
2020-11-19 14:16:00,14:16,19041625,14976225,-4065400,SELL
2020-11-19 14:17:00,14:17,18369200,15100800,-3268400,SELL
2020-11-19 14:18:00,14:18,19220900,15136075,-4084825,SELL
2020-11-19 14:19:00,14:19,19196675,15171125,-4025550,SELL
2020-11-19 14:20:00,14:20,19209075,15315600,-3893475,SELL
2020-11-19 14:21:00,14:21,19199825,15547350,-3652475,SELL
2020-11-19 14:22:00,14:22,19136700,15507575,-3629125,SELL
2020-11-19 14:23:00,14:23,19204350,15352625,-3851725,SELL
2020-11-19 14:24:00,14:24,19205500,14949250,-4256250,SELL
2020-11-19 14:25:00,14:25,19214450,14902550,-4311900,SELL
2020-11-19 14:26:00,14:26,19147525,15040400,-4107125,SELL
2020-11-19 14:27:00,14:27,19245775,15151125,-4094650,SELL
2020-11-19 14:28:00,14:28,19275850,15275875,-3999975,SELL
2020-11-19 14:29:00,14:29,19280300,15160775,-4119525,SELL
2020-11-19 14:30:00,14:30,19268100,15512250,-3755850,SELL
2020-11-19 14:31:00,14:31,19288450,15021400,-4267050,SELL
2020-11-19 14:32:00,14:32,19215375,14928000,-4287375,SELL
2020-11-19 14:33:00,14:33,19233250,15432075,-3801175,SELL
2020-11-19 14:34:00,14:34,19259425,15258225,-4001200,SELL
2020-11-19 14:35:00,14:35,19288225,15550600,-3737625,SELL
2020-11-19 14:36:00,14:36,19147250,15282250,-3865000,SELL
2020-11-19 14:37:00,14:37,19169050,15738975,-3430075,SELL
2020-11-19 14:38:00,14:38,19176000,15358225,-3817775,SELL
2020-11-19 14:39:00,14:39,19180050,15440275,-3739775,SELL
2020-11-19 14:40:00,14:40,19238725,15430700,-3808025,SELL
2020-11-19 14:41:00,14:41,19200050,15531375,-3668675,SELL
2020-11-19 14:42:00,14:42,19121000,15430825,-3690175,SELL
2020-11-19 14:43:00,14:43,19113300,15790325,-3322975,SELL
2020-11-19 14:44:00,14:44,19120975,15319025,-3801950,SELL
2020-11-19 14:45:00,14:45,19273100,15310225,-3962875,SELL
2020-11-19 14:46:00,14:46,19348425,15256950,-4091475,SELL
2020-11-19 14:47:00,14:47,19117850,15125575,-3992275,SELL
2020-11-19 14:48:00,14:48,19119300,14494225,-4625075,SELL
2020-11-19 14:49:00,14:49,19241300,14998925,-4242375,SELL
2020-11-19 14:50:00,14:50,19180225,15229525,-3950700,SELL
2020-11-19 14:51:00,14:51,19330650,15325025,-4005625,SELL
2020-11-19 14:52:00,14:52,19174925,15449875,-3725050,SELL
2020-11-19 14:53:00,14:53,19266250,15209250,-4057000,SELL
2020-11-19 14:54:00,14:54,19105250,14251500,-4853750,SELL
2020-11-19 14:55:00,14:55,18981025,14624850,-4356175,SELL
2020-11-19 14:56:00,14:56,18838700,14597425,-4241275,SELL
2020-11-19 14:57:00,14:57,19414700,14532025,-4882675,SELL
2020-11-19 14:58:00,14:58,19431550,14443850,-4987700,SELL
2020-11-19 14:59:00,14:59,19352050,14068975,-5283075,SELL
2020-11-19 15:00:00,15:00,19456400,13340700,-6115700,SELL
2020-11-19 15:01:00,15:01,19381575,13551500,-5830075,SELL
2020-11-19 15:02:00,15:02,18995650,13454450,-5541200,SELL
2020-11-19 15:03:00,15:03,19217225,13693525,-5523700,SELL
2020-11-19 15:04:00,15:04,19401500,13496950,-5904550,SELL
2020-11-19 15:05:00,15:05,19468650,13346725,-6121925,SELL
2020-11-19 15:06:00,15:06,19156775,13377450,-5779325,SELL
2020-11-19 15:07:00,15:07,19517850,13675625,-5842225,SELL
2020-11-19 15:08:00,15:08,19329975,13618100,-5711875,SELL
2020-11-19 15:09:00,15:09,19600900,13722800,-5878100,SELL
2020-11-19 15:10:00,15:10,19677525,13293600,-6383925,SELL
2020-11-19 15:11:00,15:11,19624650,13450775,-6173875,SELL
2020-11-19 15:12:00,15:12,19780300,13140350,-6639950,SELL
2020-11-19 15:13:00,15:13,19770300,13468975,-6301325,SELL
2020-11-19 15:14:00,15:14,19677425,13432375,-6245050,SELL
2020-11-19 15:15:00,15:15,19764175,12906750,-6857425,SELL
2020-11-19 15:16:00,15:16,19772450,12159050,-7613400,SELL
2020-11-19 15:17:00,15:17,19752775,11732100,-8020675,SELL
2020-11-19 15:18:00,15:18,19993700,11300650,-8693050,SELL
2020-11-19 15:19:00,15:19,19878400,11319900,-8558500,SELL
2020-11-19 15:20:00,15:20,19946375,11864000,-8082375,SELL
2020-11-19 15:21:00,15:21,19799550,12064825,-7734725,SELL
2020-11-19 15:22:00,15:22,19745350,11320975,-8424375,SELL
2020-11-19 15:23:00,15:23,19550975,10490000,-9060975,SELL
2020-11-19 15:24:00,15:24,19424550,11400900,-8023650,SELL
2020-11-19 15:25:00,15:25,19667325,11952000,-7715325,SELL
2020-11-19 15:26:00,15:26,19584125,11559650,-8024475,SELL
2020-11-19 15:27:00,15:27,19319525,11310350,-8009175,SELL
2020-11-19 15:28:00,15:28,19382400,11497150,-7885250,SELL
2020-11-19 15:29:00,15:29,19423050,10332250,-9090800,SELL
