,timestamp,call,put,diff,sellOrBuy
2020-11-20 09:15:00,09:15,5443350,6093875,650525,BUY
2020-11-20 09:16:00,09:16,5394075,5937750,543675,BUY
2020-11-20 09:17:00,09:17,5428950,6189600,760650,BUY
2020-11-20 09:18:00,09:18,5441225,5470450,29225,BUY
2020-11-20 09:19:00,09:19,5504725,5887925,383200,BUY
2020-11-20 09:20:00,09:20,5774800,6310475,535675,BUY
2020-11-20 09:21:00,09:21,5613775,6173650,559875,BUY
2020-11-20 09:22:00,09:22,5461300,5622000,160700,BUY
2020-11-20 09:23:00,09:23,5665150,5941525,276375,BUY
2020-11-20 09:24:00,09:24,5659900,5879275,219375,BUY
2020-11-20 09:25:00,09:25,5659825,6110150,450325,BUY
2020-11-20 09:26:00,09:26,5418675,6090300,671625,BUY
2020-11-20 09:27:00,09:27,5540625,6141750,601125,BUY
2020-11-20 09:28:00,09:28,5621650,6111800,490150,BUY
2020-11-20 09:29:00,09:29,5553625,6295550,741925,BUY
2020-11-20 09:30:00,09:30,5730575,6143075,412500,BUY
2020-11-20 09:31:00,09:31,5826800,6365200,538400,BUY
2020-11-20 09:32:00,09:32,5556175,5962675,406500,BUY
2020-11-20 09:33:00,09:33,5717200,6236400,519200,BUY
2020-11-20 09:34:00,09:34,5838600,6223950,385350,BUY
2020-11-20 09:35:00,09:35,5867825,6317900,450075,BUY
2020-11-20 09:36:00,09:36,5926150,6146350,220200,BUY
2020-11-20 09:37:00,09:37,5873100,6417450,544350,BUY
2020-11-20 09:38:00,09:38,5715350,6416750,701400,BUY
2020-11-20 09:39:00,09:39,5646175,6358600,712425,BUY
2020-11-20 09:40:00,09:40,5970375,6226000,255625,BUY
2020-11-20 09:41:00,09:41,5653100,6484225,831125,BUY
2020-11-20 09:42:00,09:42,5445725,6414650,968925,BUY
2020-11-20 09:43:00,09:43,5967175,6427175,460000,BUY
2020-11-20 09:44:00,09:44,5719975,6209850,489875,BUY
2020-11-20 09:45:00,09:45,5790500,6700200,909700,BUY
2020-11-20 09:46:00,09:46,5570350,6440950,870600,BUY
2020-11-20 09:47:00,09:47,5686725,6760650,1073925,BUY
2020-11-20 09:48:00,09:48,5836200,6871800,1035600,BUY
2020-11-20 09:49:00,09:49,5818925,6533550,714625,BUY
2020-11-20 09:50:00,09:50,6197200,6806575,609375,BUY
2020-11-20 09:51:00,09:51,6147900,6601950,454050,BUY
2020-11-20 09:52:00,09:52,6306100,6770950,464850,BUY
2020-11-20 09:53:00,09:53,6460500,6795525,335025,BUY
2020-11-20 09:54:00,09:54,6477375,6856875,379500,BUY
2020-11-20 09:55:00,09:55,6578450,6823800,245350,BUY
2020-11-20 09:56:00,09:56,6928950,6731350,-197600,SELL
2020-11-20 09:57:00,09:57,7171100,7369750,198650,BUY
2020-11-20 09:58:00,09:58,6853875,7189125,335250,BUY
2020-11-20 09:59:00,09:59,7244375,7286400,42025,BUY
2020-11-20 10:00:00,10:00,7198575,7273325,74750,BUY
2020-11-20 10:01:00,10:01,7224475,7087325,-137150,SELL
2020-11-20 10:02:00,10:02,7169125,7343100,173975,BUY
2020-11-20 10:03:00,10:03,7261325,7016025,-245300,SELL
2020-11-20 10:04:00,10:04,6931725,6546350,-385375,SELL
2020-11-20 10:05:00,10:05,7175725,7178050,2325,BUY
2020-11-20 10:06:00,10:06,7192550,7427775,235225,BUY
2020-11-20 10:07:00,10:07,7180400,7118850,-61550,SELL
2020-11-20 10:08:00,10:08,7445025,7197700,-247325,SELL
2020-11-20 10:09:00,10:09,7341450,7064125,-277325,SELL
2020-11-20 10:10:00,10:10,7282850,6831125,-451725,SELL
2020-11-20 10:11:00,10:11,7475100,6686750,-788350,SELL
2020-11-20 10:12:00,10:12,7406125,7099850,-306275,SELL
2020-11-20 10:13:00,10:13,7395275,7148000,-247275,SELL
2020-11-20 10:14:00,10:14,7729775,6970850,-758925,SELL
2020-11-20 10:15:00,10:15,7436825,7588550,151725,BUY
2020-11-20 10:16:00,10:16,7923300,7171525,-751775,SELL
2020-11-20 10:17:00,10:17,8097475,7603350,-494125,SELL
2020-11-20 10:18:00,10:18,7948375,7721175,-227200,SELL
2020-11-20 10:19:00,10:19,7714925,7232550,-482375,SELL
2020-11-20 10:20:00,10:20,7914000,7968600,54600,BUY
2020-11-20 10:21:00,10:21,7722350,7870175,147825,BUY
2020-11-20 10:22:00,10:22,7911700,7827500,-84200,SELL
2020-11-20 10:23:00,10:23,8881850,8631650,-250200,SELL
2020-11-20 10:24:00,10:24,8161150,8567875,406725,BUY
2020-11-20 10:25:00,10:25,8285950,8365675,79725,BUY
2020-11-20 10:26:00,10:26,8609025,8320000,-289025,SELL
2020-11-20 10:27:00,10:27,8240600,8422225,181625,BUY
2020-11-20 10:28:00,10:28,8567375,8288650,-278725,SELL
2020-11-20 10:29:00,10:29,8128700,8352650,223950,BUY
2020-11-20 10:30:00,10:30,8356050,8133400,-222650,SELL
2020-11-20 10:31:00,10:31,8166800,7903675,-263125,SELL
2020-11-20 10:32:00,10:32,8088050,7888975,-199075,SELL
2020-11-20 10:33:00,10:33,8283125,8239200,-43925,SELL
2020-11-20 10:34:00,10:34,8133625,8367575,233950,BUY
2020-11-20 10:35:00,10:35,8326725,7983550,-343175,SELL
2020-11-20 10:36:00,10:36,8268225,8004750,-263475,SELL
2020-11-20 10:37:00,10:37,8535475,8280975,-254500,SELL
2020-11-20 10:38:00,10:38,8406300,8112675,-293625,SELL
2020-11-20 10:39:00,10:39,8771825,8498175,-273650,SELL
2020-11-20 10:40:00,10:40,8485775,8584275,98500,BUY
2020-11-20 10:41:00,10:41,8562475,8176475,-386000,SELL
2020-11-20 10:42:00,10:42,8413000,8439625,26625,BUY
2020-11-20 10:43:00,10:43,8635275,8711600,76325,BUY
2020-11-20 10:44:00,10:44,8656300,8719675,63375,BUY
2020-11-20 10:45:00,10:45,8590575,8491150,-99425,SELL
2020-11-20 10:46:00,10:46,8794600,8521675,-272925,SELL
2020-11-20 10:47:00,10:47,9118675,8462225,-656450,SELL
2020-11-20 10:48:00,10:48,8994150,8611075,-383075,SELL
2020-11-20 10:49:00,10:49,8960475,8553500,-406975,SELL
2020-11-20 10:50:00,10:50,8696475,8511225,-185250,SELL
2020-11-20 10:51:00,10:51,8895300,8362775,-532525,SELL
2020-11-20 10:52:00,10:52,9285000,8637500,-647500,SELL
2020-11-20 10:53:00,10:53,8612175,8472550,-139625,SELL
2020-11-20 10:54:00,10:54,8670925,8698450,27525,BUY
2020-11-20 10:55:00,10:55,8992200,8339950,-652250,SELL
2020-11-20 10:56:00,10:56,8799375,8517450,-281925,SELL
2020-11-20 10:57:00,10:57,9250400,8568200,-682200,SELL
2020-11-20 10:58:00,10:58,8824325,8778075,-46250,SELL
2020-11-20 10:59:00,10:59,9020825,8809100,-211725,SELL
2020-11-20 11:00:00,11:00,8737350,8788200,50850,BUY
2020-11-20 11:01:00,11:01,8705825,8509625,-196200,SELL
2020-11-20 11:02:00,11:02,8576325,8312900,-263425,SELL
2020-11-20 11:03:00,11:03,8848950,8832725,-16225,SELL
2020-11-20 11:04:00,11:04,8897000,8754600,-142400,SELL
2020-11-20 11:05:00,11:05,8813200,8327375,-485825,SELL
2020-11-20 11:06:00,11:06,8745875,8411175,-334700,SELL
2020-11-20 11:07:00,11:07,8700800,8949725,248925,BUY
2020-11-20 11:08:00,11:08,8683975,8658350,-25625,SELL
2020-11-20 11:09:00,11:09,8990100,8881050,-109050,SELL
2020-11-20 11:10:00,11:10,8842825,8527850,-314975,SELL
2020-11-20 11:11:00,11:11,8760700,8827525,66825,BUY
2020-11-20 11:12:00,11:12,8785100,8952075,166975,BUY
2020-11-20 11:13:00,11:13,8765375,9082275,316900,BUY
2020-11-20 11:14:00,11:14,9492125,8998375,-493750,SELL
2020-11-20 11:15:00,11:15,9397425,9228200,-169225,SELL
2020-11-20 11:16:00,11:16,9022750,8918625,-104125,SELL
2020-11-20 11:17:00,11:17,9057850,8847850,-210000,SELL
2020-11-20 11:18:00,11:18,8768300,9084725,316425,BUY
2020-11-20 11:19:00,11:19,8988275,9085675,97400,BUY
2020-11-20 11:20:00,11:20,9230800,8879850,-350950,SELL
2020-11-20 11:21:00,11:21,9077400,8535275,-542125,SELL
2020-11-20 11:22:00,11:22,8944425,8836000,-108425,SELL
2020-11-20 11:23:00,11:23,9103175,8720500,-382675,SELL
2020-11-20 11:24:00,11:24,9235525,8635825,-599700,SELL
2020-11-20 11:25:00,11:25,9198475,8780725,-417750,SELL
2020-11-20 11:26:00,11:26,9355175,9017925,-337250,SELL
2020-11-20 11:27:00,11:27,9290975,9357675,66700,BUY
2020-11-20 11:28:00,11:28,9270850,9092075,-178775,SELL
2020-11-20 11:29:00,11:29,8851575,8733100,-118475,SELL
2020-11-20 11:30:00,11:30,9192250,9018425,-173825,SELL
2020-11-20 11:31:00,11:31,8867775,8899825,32050,BUY
2020-11-20 11:32:00,11:32,8909700,9132600,222900,BUY
2020-11-20 11:33:00,11:33,8904375,8916900,12525,BUY
2020-11-20 11:34:00,11:34,8973925,8638800,-335125,SELL
2020-11-20 11:35:00,11:35,8875975,8894825,18850,BUY
2020-11-20 11:36:00,11:36,9200800,8670100,-530700,SELL
2020-11-20 11:37:00,11:37,9172600,9025950,-146650,SELL
2020-11-20 11:38:00,11:38,9414050,9037250,-376800,SELL
2020-11-20 11:39:00,11:39,9013900,9114900,101000,BUY
2020-11-20 11:40:00,11:40,9021600,9110300,88700,BUY
2020-11-20 11:41:00,11:41,8781625,8781775,150,BUY
2020-11-20 11:42:00,11:42,8902900,8657475,-245425,SELL
2020-11-20 11:43:00,11:43,9046875,8465600,-581275,SELL
2020-11-20 11:44:00,11:44,8837275,8910650,73375,BUY
2020-11-20 11:45:00,11:45,8936675,9245400,308725,BUY
2020-11-20 11:46:00,11:46,8854725,8952375,97650,BUY
2020-11-20 11:47:00,11:47,8841900,8793350,-48550,SELL
2020-11-20 11:48:00,11:48,8715300,8865750,150450,BUY
2020-11-20 11:49:00,11:49,8819275,9187175,367900,BUY
2020-11-20 11:50:00,11:50,9165900,8715450,-450450,SELL
2020-11-20 11:51:00,11:51,8943025,8991175,48150,BUY
2020-11-20 11:52:00,11:52,9193075,9100400,-92675,SELL
2020-11-20 11:53:00,11:53,9150450,9063950,-86500,SELL
2020-11-20 11:54:00,11:54,8945700,8769225,-176475,SELL
2020-11-20 11:55:00,11:55,8947225,8993175,45950,BUY
2020-11-20 11:56:00,11:56,9219750,9274200,54450,BUY
2020-11-20 11:57:00,11:57,9504175,9443025,-61150,SELL
2020-11-20 11:58:00,11:58,9567350,9612675,45325,BUY
2020-11-20 11:59:00,11:59,9394600,9112275,-282325,SELL
2020-11-20 12:00:00,12:00,9265950,9405300,139350,BUY
2020-11-20 12:01:00,12:01,9222075,9322475,100400,BUY
2020-11-20 12:02:00,12:02,9062425,9332000,269575,BUY
2020-11-20 12:03:00,12:03,9260275,9211675,-48600,SELL
2020-11-20 12:04:00,12:04,8743000,9292500,549500,BUY
2020-11-20 12:05:00,12:05,9264000,8953575,-310425,SELL
2020-11-20 12:06:00,12:06,8715375,9163950,448575,BUY
2020-11-20 12:07:00,12:07,8683450,8973325,289875,BUY
2020-11-20 12:08:00,12:08,9147500,9166975,19475,BUY
2020-11-20 12:09:00,12:09,8870675,9177325,306650,BUY
2020-11-20 12:10:00,12:10,8898650,9108500,209850,BUY
2020-11-20 12:11:00,12:11,8814300,9126275,311975,BUY
2020-11-20 12:12:00,12:12,8890650,9329850,439200,BUY
2020-11-20 12:13:00,12:13,9075750,9392325,316575,BUY
2020-11-20 12:14:00,12:14,8757100,9107625,350525,BUY
2020-11-20 12:15:00,12:15,8970900,9267825,296925,BUY
2020-11-20 12:16:00,12:16,9027250,8940875,-86375,SELL
2020-11-20 12:17:00,12:17,9257775,9236525,-21250,SELL
2020-11-20 12:18:00,12:18,9132500,9468075,335575,BUY
2020-11-20 12:19:00,12:19,8946800,9073375,126575,BUY
2020-11-20 12:20:00,12:20,8951225,9064150,112925,BUY
2020-11-20 12:21:00,12:21,9213975,8936475,-277500,SELL
2020-11-20 12:22:00,12:22,8907650,9121125,213475,BUY
2020-11-20 12:23:00,12:23,8865325,8736050,-129275,SELL
2020-11-20 12:24:00,12:24,9004975,8631475,-373500,SELL
2020-11-20 12:25:00,12:25,8695025,9060625,365600,BUY
2020-11-20 12:26:00,12:26,8850850,9061425,210575,BUY
2020-11-20 12:27:00,12:27,9071550,8994525,-77025,SELL
2020-11-20 12:28:00,12:28,8889350,8776800,-112550,SELL
2020-11-20 12:29:00,12:29,8940525,8328975,-611550,SELL
2020-11-20 12:30:00,12:30,8799975,8654000,-145975,SELL
2020-11-20 12:31:00,12:31,8888625,8370125,-518500,SELL
2020-11-20 12:32:00,12:32,9350600,9235950,-114650,SELL
2020-11-20 12:33:00,12:33,9331700,9223125,-108575,SELL
2020-11-20 12:34:00,12:34,8723000,9230325,507325,BUY
2020-11-20 12:35:00,12:35,8846725,8867800,21075,BUY
2020-11-20 12:36:00,12:36,9168650,8919325,-249325,SELL
2020-11-20 12:37:00,12:37,9223200,9184600,-38600,SELL
2020-11-20 12:38:00,12:38,9184600,8890275,-294325,SELL
2020-11-20 12:39:00,12:39,9273400,8858625,-414775,SELL
2020-11-20 12:40:00,12:40,8828375,9432800,604425,BUY
2020-11-20 12:41:00,12:41,9366575,9172000,-194575,SELL
2020-11-20 12:42:00,12:42,9281200,9115650,-165550,SELL
2020-11-20 12:43:00,12:43,9447725,9732300,284575,BUY
2020-11-20 12:44:00,12:44,9497250,9727575,230325,BUY
2020-11-20 12:45:00,12:45,8992375,9138675,146300,BUY
2020-11-20 12:46:00,12:46,9091500,8821650,-269850,SELL
2020-11-20 12:47:00,12:47,8836075,9092800,256725,BUY
2020-11-20 12:48:00,12:48,9025025,8978050,-46975,SELL
2020-11-20 12:49:00,12:49,8859375,9140875,281500,BUY
2020-11-20 12:50:00,12:50,9254325,9051725,-202600,SELL
2020-11-20 12:51:00,12:51,9125800,8993250,-132550,SELL
2020-11-20 12:52:00,12:52,9065700,9082200,16500,BUY
2020-11-20 12:53:00,12:53,9202400,9051325,-151075,SELL
2020-11-20 12:54:00,12:54,9053875,8541850,-512025,SELL
2020-11-20 12:55:00,12:55,9164550,9039600,-124950,SELL
2020-11-20 12:56:00,12:56,8918875,9059125,140250,BUY
2020-11-20 12:57:00,12:57,8929625,9150725,221100,BUY
2020-11-20 12:58:00,12:58,8951125,9107700,156575,BUY
2020-11-20 12:59:00,12:59,9296300,8884650,-411650,SELL
2020-11-20 13:00:00,13:00,9519675,9641125,121450,BUY
2020-11-20 13:01:00,13:01,9653025,10016675,363650,BUY
2020-11-20 13:02:00,13:02,9064325,9441025,376700,BUY
2020-11-20 13:03:00,13:03,9199700,9643125,443425,BUY
2020-11-20 13:04:00,13:04,9147600,9321250,173650,BUY
2020-11-20 13:05:00,13:05,9274800,9603450,328650,BUY
2020-11-20 13:06:00,13:06,9191950,9488975,297025,BUY
2020-11-20 13:07:00,13:07,9004125,9432500,428375,BUY
2020-11-20 13:08:00,13:08,8817825,9628175,810350,BUY
2020-11-20 13:09:00,13:09,8727200,9425150,697950,BUY
2020-11-20 13:10:00,13:10,8586225,9674275,1088050,BUY
2020-11-20 13:11:00,13:11,8668675,9268700,600025,BUY
2020-11-20 13:12:00,13:12,8603400,9052850,449450,BUY
2020-11-20 13:13:00,13:13,9014550,9278475,263925,BUY
2020-11-20 13:14:00,13:14,8640475,9523975,883500,BUY
2020-11-20 13:15:00,13:15,8859950,9753100,893150,BUY
2020-11-20 13:16:00,13:16,8726000,9689400,963400,BUY
2020-11-20 13:17:00,13:17,8797400,9471875,674475,BUY
2020-11-20 13:18:00,13:18,8621875,9503300,881425,BUY
2020-11-20 13:19:00,13:19,8951375,9616400,665025,BUY
2020-11-20 13:20:00,13:20,8742825,9148900,406075,BUY
2020-11-20 13:21:00,13:21,8623000,9284250,661250,BUY
2020-11-20 13:22:00,13:22,8680300,9392425,712125,BUY
2020-11-20 13:23:00,13:23,8633450,9279350,645900,BUY
2020-11-20 13:24:00,13:24,8778575,9528900,750325,BUY
2020-11-20 13:25:00,13:25,9219400,9586575,367175,BUY
2020-11-20 13:26:00,13:26,8587150,9419350,832200,BUY
2020-11-20 13:27:00,13:27,8625775,8872575,246800,BUY
2020-11-20 13:28:00,13:28,8650400,9056050,405650,BUY
2020-11-20 13:29:00,13:29,8478625,9422725,944100,BUY
2020-11-20 13:30:00,13:30,9109350,9387375,278025,BUY
2020-11-20 13:31:00,13:31,8804575,9878850,1074275,BUY
2020-11-20 13:32:00,13:32,8716700,9718775,1002075,BUY
2020-11-20 13:33:00,13:33,8318000,9661600,1343600,BUY
2020-11-20 13:34:00,13:34,8621150,9744875,1123725,BUY
2020-11-20 13:35:00,13:35,8530525,9213000,682475,BUY
2020-11-20 13:36:00,13:36,8584175,9437550,853375,BUY
2020-11-20 13:37:00,13:37,8717300,8934150,216850,BUY
2020-11-20 13:38:00,13:38,8589975,9075000,485025,BUY
2020-11-20 13:39:00,13:39,8494875,9361550,866675,BUY
2020-11-20 13:40:00,13:40,8509050,9432425,923375,BUY
2020-11-20 13:41:00,13:41,8608200,9405500,797300,BUY
2020-11-20 13:42:00,13:42,8198475,9022850,824375,BUY
2020-11-20 13:43:00,13:43,8892400,9420725,528325,BUY
2020-11-20 13:44:00,13:44,8718275,9388250,669975,BUY
2020-11-20 13:45:00,13:45,9116125,10052725,936600,BUY
2020-11-20 13:46:00,13:46,8694725,9794475,1099750,BUY
2020-11-20 13:47:00,13:47,8483475,9847650,1364175,BUY
2020-11-20 13:48:00,13:48,8266125,9525125,1259000,BUY
2020-11-20 13:49:00,13:49,8417725,9728050,1310325,BUY
2020-11-20 13:50:00,13:50,8350625,9588125,1237500,BUY
2020-11-20 13:51:00,13:51,8095325,9653900,1558575,BUY
2020-11-20 13:52:00,13:52,8244675,9785500,1540825,BUY
2020-11-20 13:53:00,13:53,8268725,9720675,1451950,BUY
2020-11-20 13:54:00,13:54,7908675,9737075,1828400,BUY
2020-11-20 13:55:00,13:55,8078450,9743000,1664550,BUY
2020-11-20 13:56:00,13:56,8021100,9282625,1261525,BUY
2020-11-20 13:57:00,13:57,8002350,10056575,2054225,BUY
2020-11-20 13:58:00,13:58,7865675,9064550,1198875,BUY
2020-11-20 13:59:00,13:59,7857400,9582050,1724650,BUY
2020-11-20 14:00:00,14:00,7801250,9538175,1736925,BUY
2020-11-20 14:01:00,14:01,8017600,9364050,1346450,BUY
2020-11-20 14:02:00,14:02,7711825,9309000,1597175,BUY
2020-11-20 14:03:00,14:03,7530125,9546750,2016625,BUY
2020-11-20 14:04:00,14:04,7537125,9596700,2059575,BUY
2020-11-20 14:05:00,14:05,7679375,9816350,2136975,BUY
2020-11-20 14:06:00,14:06,7735400,9625025,1889625,BUY
2020-11-20 14:07:00,14:07,7833125,9756125,1923000,BUY
2020-11-20 14:08:00,14:08,7557825,9536250,1978425,BUY
2020-11-20 14:09:00,14:09,7787025,9643250,1856225,BUY
2020-11-20 14:10:00,14:10,7718625,9786100,2067475,BUY
2020-11-20 14:11:00,14:11,7944550,9849075,1904525,BUY
2020-11-20 14:12:00,14:12,7811725,9790150,1978425,BUY
2020-11-20 14:13:00,14:13,7779750,10012500,2232750,BUY
2020-11-20 14:14:00,14:14,7738700,9961475,2222775,BUY
2020-11-20 14:15:00,14:15,7994275,9557400,1563125,BUY
2020-11-20 14:16:00,14:16,8158550,9864000,1705450,BUY
2020-11-20 14:17:00,14:17,8017600,9768350,1750750,BUY
2020-11-20 14:18:00,14:18,7917875,9797425,1879550,BUY
2020-11-20 14:19:00,14:19,7808900,10137250,2328350,BUY
2020-11-20 14:20:00,14:20,7644625,9907975,2263350,BUY
2020-11-20 14:21:00,14:21,7544025,9969925,2425900,BUY
2020-11-20 14:22:00,14:22,7678450,9886225,2207775,BUY
2020-11-20 14:23:00,14:23,7688800,9894425,2205625,BUY
2020-11-20 14:24:00,14:24,7778700,10128175,2349475,BUY
2020-11-20 14:25:00,14:25,7973200,9779900,1806700,BUY
2020-11-20 14:26:00,14:26,7778975,9630200,1851225,BUY
2020-11-20 14:27:00,14:27,7813850,9504575,1690725,BUY
2020-11-20 14:28:00,14:28,8113425,9912100,1798675,BUY
2020-11-20 14:29:00,14:29,7918475,9833150,1914675,BUY
2020-11-20 14:30:00,14:30,7774950,9903225,2128275,BUY
2020-11-20 14:31:00,14:31,7836850,9414275,1577425,BUY
2020-11-20 14:32:00,14:32,7687425,9756100,2068675,BUY
2020-11-20 14:33:00,14:33,7494250,9053475,1559225,BUY
2020-11-20 14:34:00,14:34,7694900,9711375,2016475,BUY
2020-11-20 14:35:00,14:35,7628450,9766950,2138500,BUY
2020-11-20 14:36:00,14:36,7503025,9814400,2311375,BUY
2020-11-20 14:37:00,14:37,7444725,9797925,2353200,BUY
2020-11-20 14:38:00,14:38,7706250,10017725,2311475,BUY
2020-11-20 14:39:00,14:39,7522025,9948900,2426875,BUY
2020-11-20 14:40:00,14:40,7366450,9666000,2299550,BUY
2020-11-20 14:41:00,14:41,7747750,9956550,2208800,BUY
2020-11-20 14:42:00,14:42,7542250,9711575,2169325,BUY
2020-11-20 14:43:00,14:43,7873525,9759125,1885600,BUY
2020-11-20 14:44:00,14:44,7554775,10128700,2573925,BUY
2020-11-20 14:45:00,14:45,7870625,9898025,2027400,BUY
2020-11-20 14:46:00,14:46,7958150,9898775,1940625,BUY
2020-11-20 14:47:00,14:47,7580025,9843450,2263425,BUY
2020-11-20 14:48:00,14:48,7266300,10113250,2846950,BUY
2020-11-20 14:49:00,14:49,7541825,9898475,2356650,BUY
2020-11-20 14:50:00,14:50,7638600,9764150,2125550,BUY
2020-11-20 14:51:00,14:51,7773725,9485650,1711925,BUY
2020-11-20 14:52:00,14:52,7735850,9633825,1897975,BUY
2020-11-20 14:53:00,14:53,7400025,10007475,2607450,BUY
2020-11-20 14:54:00,14:54,7409750,9530125,2120375,BUY
2020-11-20 14:55:00,14:55,7366250,9920050,2553800,BUY
2020-11-20 14:56:00,14:56,7733975,10157200,2423225,BUY
2020-11-20 14:57:00,14:57,7192575,9700300,2507725,BUY
2020-11-20 14:58:00,14:58,7470875,9828200,2357325,BUY
2020-11-20 14:59:00,14:59,7614725,9930000,2315275,BUY
2020-11-20 15:00:00,15:00,7324200,9925900,2601700,BUY
2020-11-20 15:01:00,15:01,7327125,9802150,2475025,BUY
2020-11-20 15:02:00,15:02,7612900,9557775,1944875,BUY
2020-11-20 15:03:00,15:03,7358875,10026700,2667825,BUY
2020-11-20 15:04:00,15:04,7720450,10000175,2279725,BUY
2020-11-20 15:05:00,15:05,7124125,9777500,2653375,BUY
2020-11-20 15:06:00,15:06,7350950,9945950,2595000,BUY
2020-11-20 15:07:00,15:07,7411600,9942400,2530800,BUY
2020-11-20 15:08:00,15:08,7601800,10107050,2505250,BUY
2020-11-20 15:09:00,15:09,7152325,9624675,2472350,BUY
2020-11-20 15:10:00,15:10,7226400,9696775,2470375,BUY
2020-11-20 15:11:00,15:11,7197850,9800725,2602875,BUY
2020-11-20 15:12:00,15:12,7071200,9985175,2913975,BUY
2020-11-20 15:13:00,15:13,7169825,9631600,2461775,BUY
2020-11-20 15:14:00,15:14,7389300,10083225,2693925,BUY
2020-11-20 15:15:00,15:15,7426350,9903750,2477400,BUY
2020-11-20 15:16:00,15:16,7369475,9823150,2453675,BUY
2020-11-20 15:17:00,15:17,7334750,9744475,2409725,BUY
2020-11-20 15:18:00,15:18,7069000,9833475,2764475,BUY
2020-11-20 15:19:00,15:19,7236575,9379650,2143075,BUY
2020-11-20 15:20:00,15:20,7267425,9948775,2681350,BUY
2020-11-20 15:21:00,15:21,7516700,9663550,2146850,BUY
2020-11-20 15:22:00,15:22,7238550,9525725,2287175,BUY
2020-11-20 15:23:00,15:23,7132275,9406675,2274400,BUY
2020-11-20 15:24:00,15:24,7486875,9662125,2175250,BUY
2020-11-20 15:25:00,15:25,7388075,9683925,2295850,BUY
2020-11-20 15:26:00,15:26,7050550,9721175,2670625,BUY
2020-11-20 15:27:00,15:27,6852350,9371000,2518650,BUY
2020-11-20 15:28:00,15:28,7014125,9634975,2620850,BUY
2020-11-20 15:29:00,15:29,7124600,9581850,2457250,BUY
2020-11-23 09:15:00,09:15,7094250,9253425,2159175,BUY
2020-11-23 09:16:00,09:16,6997000,9295950,2298950,BUY
2020-11-23 09:17:00,09:17,7396475,8969975,1573500,BUY
2020-11-23 09:18:00,09:18,7325575,8666175,1340600,BUY
2020-11-23 09:19:00,09:19,6964900,9041100,2076200,BUY
2020-11-23 09:20:00,09:20,7490700,8867425,1376725,BUY
2020-11-23 09:21:00,09:21,6948450,8894850,1946400,BUY
2020-11-23 09:22:00,09:22,7306000,8515950,1209950,BUY
2020-11-23 09:23:00,09:23,7090300,8344400,1254100,BUY
2020-11-23 09:24:00,09:24,7380050,8891225,1511175,BUY
2020-11-23 09:25:00,09:25,6998900,8766775,1767875,BUY
2020-11-23 09:26:00,09:26,7346175,9026300,1680125,BUY
2020-11-23 09:27:00,09:27,7203900,9360200,2156300,BUY
2020-11-23 09:28:00,09:28,6906125,9072975,2166850,BUY
2020-11-23 09:29:00,09:29,7115400,8947975,1832575,BUY
2020-11-23 09:30:00,09:30,7466675,9186950,1720275,BUY
2020-11-23 09:31:00,09:31,7349075,9416800,2067725,BUY
2020-11-23 09:32:00,09:32,7054625,9103575,2048950,BUY
2020-11-23 09:33:00,09:33,7050825,9226750,2175925,BUY
2020-11-23 09:34:00,09:34,7258725,8870300,1611575,BUY
2020-11-23 09:35:00,09:35,7160175,9116175,1956000,BUY
2020-11-23 09:36:00,09:36,7386250,8708750,1322500,BUY
2020-11-23 09:37:00,09:37,7076075,9041525,1965450,BUY
2020-11-23 09:38:00,09:38,7461100,9277375,1816275,BUY
2020-11-23 09:39:00,09:39,7415275,9400200,1984925,BUY
2020-11-23 09:40:00,09:40,7926800,9567575,1640775,BUY
2020-11-23 09:41:00,09:41,7540325,8684000,1143675,BUY
2020-11-23 09:42:00,09:42,7392975,9245700,1852725,BUY
2020-11-23 09:43:00,09:43,7687900,9255650,1567750,BUY
2020-11-23 09:44:00,09:44,7775200,9522200,1747000,BUY
2020-11-23 09:45:00,09:45,7655175,9532550,1877375,BUY
2020-11-23 09:46:00,09:46,7681125,9421900,1740775,BUY
2020-11-23 09:47:00,09:47,7552625,9404775,1852150,BUY
2020-11-23 09:48:00,09:48,7535400,9377800,1842400,BUY
2020-11-23 09:49:00,09:49,7753050,9369825,1616775,BUY
2020-11-23 09:50:00,09:50,7900000,9584675,1684675,BUY
2020-11-23 09:51:00,09:51,7787125,9611350,1824225,BUY
2020-11-23 09:52:00,09:52,7617325,9681600,2064275,BUY
2020-11-23 09:53:00,09:53,8223075,9478550,1255475,BUY
2020-11-23 09:54:00,09:54,8091650,9663125,1571475,BUY
2020-11-23 09:55:00,09:55,8131825,9476600,1344775,BUY
2020-11-23 09:56:00,09:56,8244900,9478200,1233300,BUY
2020-11-23 09:57:00,09:57,8101625,9642875,1541250,BUY
2020-11-23 09:58:00,09:58,8055700,9428050,1372350,BUY
2020-11-23 09:59:00,09:59,8085425,9623300,1537875,BUY
2020-11-23 10:00:00,10:00,8442400,9846075,1403675,BUY
2020-11-23 10:01:00,10:01,8403750,9500700,1096950,BUY
2020-11-23 10:02:00,10:02,7984525,9760700,1776175,BUY
2020-11-23 10:03:00,10:03,7824825,9659775,1834950,BUY
2020-11-23 10:04:00,10:04,7701950,9467750,1765800,BUY
2020-11-23 10:05:00,10:05,8303425,9393650,1090225,BUY
2020-11-23 10:06:00,10:06,8043075,9721150,1678075,BUY
2020-11-23 10:07:00,10:07,8256950,9733425,1476475,BUY
2020-11-23 10:08:00,10:08,8007250,9624375,1617125,BUY
2020-11-23 10:09:00,10:09,8114350,9719850,1605500,BUY
2020-11-23 10:10:00,10:10,8077875,9769575,1691700,BUY
2020-11-23 10:11:00,10:11,7977325,9034925,1057600,BUY
2020-11-23 10:12:00,10:12,8104675,9719875,1615200,BUY
2020-11-23 10:13:00,10:13,8173550,9508575,1335025,BUY
2020-11-23 10:14:00,10:14,8183400,9420500,1237100,BUY
2020-11-23 10:15:00,10:15,8041950,9498250,1456300,BUY
2020-11-23 10:16:00,10:16,8358200,9812925,1454725,BUY
2020-11-23 10:17:00,10:17,8130800,9513675,1382875,BUY
2020-11-23 10:18:00,10:18,8311175,9374175,1063000,BUY
2020-11-23 10:19:00,10:19,8313375,10126700,1813325,BUY
2020-11-23 10:20:00,10:20,8422675,9906025,1483350,BUY
2020-11-23 10:21:00,10:21,8215525,10084300,1868775,BUY
2020-11-23 10:22:00,10:22,8165175,9099300,934125,BUY
2020-11-23 10:23:00,10:23,8375900,9766475,1390575,BUY
2020-11-23 10:24:00,10:24,8199675,9545050,1345375,BUY
2020-11-23 10:25:00,10:25,8226800,9555300,1328500,BUY
2020-11-23 10:26:00,10:26,8318075,9798225,1480150,BUY
2020-11-23 10:27:00,10:27,8270875,9865575,1594700,BUY
2020-11-23 10:28:00,10:28,8486050,9237325,751275,BUY
2020-11-23 10:29:00,10:29,8135400,9838125,1702725,BUY
2020-11-23 10:30:00,10:30,8137175,9402150,1264975,BUY
2020-11-23 10:31:00,10:31,8274975,9430800,1155825,BUY
2020-11-23 10:32:00,10:32,8254950,9713600,1458650,BUY
2020-11-23 10:33:00,10:33,8015225,9499725,1484500,BUY
2020-11-23 10:34:00,10:34,8240100,9478825,1238725,BUY
2020-11-23 10:35:00,10:35,8649325,9786725,1137400,BUY
2020-11-23 10:36:00,10:36,8453950,9419000,965050,BUY
2020-11-23 10:37:00,10:37,8419525,10045050,1625525,BUY
2020-11-23 10:38:00,10:38,8170675,9318075,1147400,BUY
2020-11-23 10:39:00,10:39,8194275,9201000,1006725,BUY
2020-11-23 10:40:00,10:40,8591775,10066850,1475075,BUY
2020-11-23 10:41:00,10:41,8777950,10156225,1378275,BUY
2020-11-23 10:42:00,10:42,8435875,9853150,1417275,BUY
2020-11-23 10:43:00,10:43,8497475,9962350,1464875,BUY
2020-11-23 10:44:00,10:44,8583625,10098625,1515000,BUY
2020-11-23 10:45:00,10:45,8865050,10560200,1695150,BUY
2020-11-23 10:46:00,10:46,9167825,10745150,1577325,BUY
2020-11-23 10:47:00,10:47,8631000,10446550,1815550,BUY
2020-11-23 10:48:00,10:48,8481550,10194850,1713300,BUY
2020-11-23 10:49:00,10:49,8877975,9986825,1108850,BUY
2020-11-23 10:50:00,10:50,8513850,9996400,1482550,BUY
2020-11-23 10:51:00,10:51,8434450,10516400,2081950,BUY
2020-11-23 10:52:00,10:52,8887400,10339300,1451900,BUY
2020-11-23 10:53:00,10:53,8443350,10133875,1690525,BUY
2020-11-23 10:54:00,10:54,8828050,10014600,1186550,BUY
2020-11-23 10:55:00,10:55,8731925,10083975,1352050,BUY
2020-11-23 10:56:00,10:56,8819550,10556325,1736775,BUY
2020-11-23 10:57:00,10:57,8762550,10561550,1799000,BUY
2020-11-23 10:58:00,10:58,8769100,10187075,1417975,BUY
2020-11-23 10:59:00,10:59,8972225,10169550,1197325,BUY
2020-11-23 11:00:00,11:00,8632250,9699325,1067075,BUY
2020-11-23 11:01:00,11:01,8726100,10472875,1746775,BUY
2020-11-23 11:02:00,11:02,8923650,10046300,1122650,BUY
2020-11-23 11:03:00,11:03,8499350,9985575,1486225,BUY
2020-11-23 11:04:00,11:04,8734475,10203100,1468625,BUY
2020-11-23 11:05:00,11:05,8646325,9968125,1321800,BUY
2020-11-23 11:06:00,11:06,8741200,10062350,1321150,BUY
2020-11-23 11:07:00,11:07,8619925,9877100,1257175,BUY
2020-11-23 11:08:00,11:08,8922825,10133600,1210775,BUY
2020-11-23 11:09:00,11:09,9077250,10419850,1342600,BUY
2020-11-23 11:10:00,11:10,8978100,9483575,505475,BUY
2020-11-23 11:11:00,11:11,8853200,9879775,1026575,BUY
2020-11-23 11:12:00,11:12,8821000,9540875,719875,BUY
2020-11-23 11:13:00,11:13,8926225,9765625,839400,BUY
2020-11-23 11:14:00,11:14,8796875,9112125,315250,BUY
2020-11-23 11:15:00,11:15,8821925,9874175,1052250,BUY
2020-11-23 11:16:00,11:16,9018675,10021350,1002675,BUY
2020-11-23 11:17:00,11:17,8985550,9858750,873200,BUY
2020-11-23 11:18:00,11:18,9083225,9466325,383100,BUY
2020-11-23 11:19:00,11:19,9225100,9709250,484150,BUY
2020-11-23 11:20:00,11:20,9792800,10398225,605425,BUY
2020-11-23 11:21:00,11:21,9327700,10178100,850400,BUY
2020-11-23 11:22:00,11:22,9597575,9721600,124025,BUY
2020-11-23 11:23:00,11:23,9352075,10073000,720925,BUY
2020-11-23 11:24:00,11:24,9690625,9948375,257750,BUY
2020-11-23 11:25:00,11:25,9306625,10047500,740875,BUY
2020-11-23 11:26:00,11:26,9093700,10078700,985000,BUY
2020-11-23 11:27:00,11:27,9309250,10543100,1233850,BUY
2020-11-23 11:28:00,11:28,9975675,10338600,362925,BUY
2020-11-23 11:29:00,11:29,9418500,10688975,1270475,BUY
2020-11-23 11:30:00,11:30,9379300,10760425,1381125,BUY
2020-11-23 11:31:00,11:31,10159900,10662275,502375,BUY
2020-11-23 11:32:00,11:32,9230200,10511625,1281425,BUY
2020-11-23 11:33:00,11:33,9427525,10197375,769850,BUY
2020-11-23 11:34:00,11:34,9441700,10397675,955975,BUY
2020-11-23 11:35:00,11:35,9569700,9676950,107250,BUY
2020-11-23 11:36:00,11:36,9285400,9870800,585400,BUY
2020-11-23 11:37:00,11:37,9399000,9832450,433450,BUY
2020-11-23 11:38:00,11:38,9250725,9895750,645025,BUY
2020-11-23 11:39:00,11:39,9694375,10058400,364025,BUY
2020-11-23 11:40:00,11:40,9605575,10035500,429925,BUY
2020-11-23 11:41:00,11:41,9373375,9380475,7100,BUY
2020-11-23 11:42:00,11:42,9342550,10019300,676750,BUY
2020-11-23 11:43:00,11:43,9824000,9871700,47700,BUY
2020-11-23 11:44:00,11:44,9755050,10082725,327675,BUY
2020-11-23 11:45:00,11:45,9851025,9995075,144050,BUY
2020-11-23 11:46:00,11:46,9871950,9940575,68625,BUY
2020-11-23 11:47:00,11:47,9905175,9481250,-423925,SELL
2020-11-23 11:48:00,11:48,10108400,9871625,-236775,SELL
2020-11-23 11:49:00,11:49,10401075,9606000,-795075,SELL
2020-11-23 11:50:00,11:50,10157800,9812225,-345575,SELL
2020-11-23 11:51:00,11:51,9842925,9870150,27225,BUY
2020-11-23 11:52:00,11:52,10037675,9780350,-257325,SELL
2020-11-23 11:53:00,11:53,9959650,9724275,-235375,SELL
2020-11-23 11:54:00,11:54,10009575,9682800,-326775,SELL
2020-11-23 11:55:00,11:55,10365575,9856550,-509025,SELL
2020-11-23 11:56:00,11:56,10686800,9401000,-1285800,SELL
2020-11-23 11:57:00,11:57,10430225,9310500,-1119725,SELL
2020-11-23 11:58:00,11:58,10418700,9694275,-724425,SELL
2020-11-23 11:59:00,11:59,11050850,9619325,-1431525,SELL
2020-11-23 12:00:00,12:00,10722800,9989425,-733375,SELL
2020-11-23 12:01:00,12:01,11028050,10118400,-909650,SELL
2020-11-23 12:02:00,12:02,11057850,9586275,-1471575,SELL
2020-11-23 12:03:00,12:03,11283650,10048975,-1234675,SELL
2020-11-23 12:04:00,12:04,11489750,9686675,-1803075,SELL
2020-11-23 12:05:00,12:05,11445125,10109400,-1335725,SELL
2020-11-23 12:06:00,12:06,11070875,10013700,-1057175,SELL
2020-11-23 12:07:00,12:07,11167700,10286950,-880750,SELL
2020-11-23 12:08:00,12:08,11734975,10591100,-1143875,SELL
2020-11-23 12:09:00,12:09,11638325,9797550,-1840775,SELL
2020-11-23 12:10:00,12:10,11334525,10073425,-1261100,SELL
2020-11-23 12:11:00,12:11,11452825,10502575,-950250,SELL
2020-11-23 12:12:00,12:12,11479900,10519325,-960575,SELL
2020-11-23 12:13:00,12:13,11653950,10474775,-1179175,SELL
2020-11-23 12:14:00,12:14,11566975,10566400,-1000575,SELL
2020-11-23 12:15:00,12:15,12066975,10758350,-1308625,SELL
2020-11-23 12:16:00,12:16,11614550,10399225,-1215325,SELL
2020-11-23 12:17:00,12:17,11515025,10345650,-1169375,SELL
2020-11-23 12:18:00,12:18,11867975,10096550,-1771425,SELL
2020-11-23 12:19:00,12:19,11678800,9961350,-1717450,SELL
2020-11-23 12:20:00,12:20,11545375,10689050,-856325,SELL
2020-11-23 12:21:00,12:21,11668625,10722600,-946025,SELL
2020-11-23 12:22:00,12:22,11759700,10297450,-1462250,SELL
2020-11-23 12:23:00,12:23,11798450,10346925,-1451525,SELL
2020-11-23 12:24:00,12:24,11760125,10972800,-787325,SELL
2020-11-23 12:25:00,12:25,11811225,10577475,-1233750,SELL
2020-11-23 12:26:00,12:26,11682175,10607275,-1074900,SELL
2020-11-23 12:27:00,12:27,12202550,10736050,-1466500,SELL
2020-11-23 12:28:00,12:28,11826925,10868100,-958825,SELL
2020-11-23 12:29:00,12:29,12657550,11077300,-1580250,SELL
2020-11-23 12:30:00,12:30,12304625,10808775,-1495850,SELL
2020-11-23 12:31:00,12:31,12196200,10852050,-1344150,SELL
2020-11-23 12:32:00,12:32,12235350,10858850,-1376500,SELL
2020-11-23 12:33:00,12:33,12095450,10843600,-1251850,SELL
2020-11-23 12:34:00,12:34,12443900,11212425,-1231475,SELL
2020-11-23 12:35:00,12:35,12585775,11589425,-996350,SELL
2020-11-23 12:36:00,12:36,11965475,11244775,-720700,SELL
2020-11-23 12:37:00,12:37,12122225,11440350,-681875,SELL
2020-11-23 12:38:00,12:38,12041300,11393425,-647875,SELL
2020-11-23 12:39:00,12:39,12074325,11280875,-793450,SELL
2020-11-23 12:40:00,12:40,12013650,11087975,-925675,SELL
2020-11-23 12:41:00,12:41,12119200,11071375,-1047825,SELL
2020-11-23 12:42:00,12:42,12081200,11124850,-956350,SELL
2020-11-23 12:43:00,12:43,12224800,11376650,-848150,SELL
2020-11-23 12:44:00,12:44,12128900,10601500,-1527400,SELL
2020-11-23 12:45:00,12:45,12251975,11511600,-740375,SELL
2020-11-23 12:46:00,12:46,12150200,10816725,-1333475,SELL
2020-11-23 12:47:00,12:47,12178925,11177825,-1001100,SELL
2020-11-23 12:48:00,12:48,12243025,11041600,-1201425,SELL
2020-11-23 12:49:00,12:49,12512875,11232775,-1280100,SELL
2020-11-23 12:50:00,12:50,12500475,11407750,-1092725,SELL
2020-11-23 12:51:00,12:51,12623900,11554500,-1069400,SELL
2020-11-23 12:52:00,12:52,12517975,11398800,-1119175,SELL
2020-11-23 12:53:00,12:53,12136050,11072900,-1063150,SELL
2020-11-23 12:54:00,12:54,12421075,11222675,-1198400,SELL
2020-11-23 12:55:00,12:55,12058375,11130700,-927675,SELL
2020-11-23 12:56:00,12:56,11984150,11023100,-961050,SELL
2020-11-23 12:57:00,12:57,11975225,10853250,-1121975,SELL
2020-11-23 12:58:00,12:58,11845125,10436750,-1408375,SELL
2020-11-23 12:59:00,12:59,12017350,10232475,-1784875,SELL
2020-11-23 13:00:00,13:00,11955500,10964700,-990800,SELL
2020-11-23 13:01:00,13:01,12297100,10704025,-1593075,SELL
2020-11-23 13:02:00,13:02,12032975,10483875,-1549100,SELL
2020-11-23 13:03:00,13:03,12051200,10920275,-1130925,SELL
2020-11-23 13:04:00,13:04,11979475,10490600,-1488875,SELL
2020-11-23 13:05:00,13:05,12482550,10887600,-1594950,SELL
2020-11-23 13:06:00,13:06,12105550,11390975,-714575,SELL
2020-11-23 13:07:00,13:07,12121350,11086775,-1034575,SELL
2020-11-23 13:08:00,13:08,12117700,10698650,-1419050,SELL
2020-11-23 13:09:00,13:09,12053350,10796800,-1256550,SELL
2020-11-23 13:10:00,13:10,12072550,11294475,-778075,SELL
2020-11-23 13:11:00,13:11,12880675,11235500,-1645175,SELL
2020-11-23 13:12:00,13:12,12641225,11152200,-1489025,SELL
2020-11-23 13:13:00,13:13,12164625,11139050,-1025575,SELL
2020-11-23 13:14:00,13:14,12125775,11140950,-984825,SELL
2020-11-23 13:15:00,13:15,12112225,10983850,-1128375,SELL
2020-11-23 13:16:00,13:16,12045925,10799800,-1246125,SELL
2020-11-23 13:17:00,13:17,12115800,11045175,-1070625,SELL
2020-11-23 13:18:00,13:18,12401025,10621050,-1779975,SELL
2020-11-23 13:19:00,13:19,12115250,10986475,-1128775,SELL
2020-11-23 13:20:00,13:20,12181600,10777975,-1403625,SELL
2020-11-23 13:21:00,13:21,12074925,10350300,-1724625,SELL
2020-11-23 13:22:00,13:22,12236925,11337550,-899375,SELL
2020-11-23 13:23:00,13:23,11920100,11072725,-847375,SELL
2020-11-23 13:24:00,13:24,11954400,10926725,-1027675,SELL
2020-11-23 13:25:00,13:25,11953200,10522800,-1430400,SELL
2020-11-23 13:26:00,13:26,11962375,10806575,-1155800,SELL
2020-11-23 13:27:00,13:27,11889075,11175850,-713225,SELL
2020-11-23 13:28:00,13:28,12039525,10567725,-1471800,SELL
2020-11-23 13:29:00,13:29,12066900,11059525,-1007375,SELL
2020-11-23 13:30:00,13:30,12158075,11253850,-904225,SELL
2020-11-23 13:31:00,13:31,12112550,10871225,-1241325,SELL
2020-11-23 13:32:00,13:32,12296100,10879725,-1416375,SELL
2020-11-23 13:33:00,13:33,11881925,10599250,-1282675,SELL
2020-11-23 13:34:00,13:34,11948925,10640975,-1307950,SELL
2020-11-23 13:35:00,13:35,11918000,10280725,-1637275,SELL
2020-11-23 13:36:00,13:36,12165050,11312350,-852700,SELL
2020-11-23 13:37:00,13:37,12413975,11383425,-1030550,SELL
2020-11-23 13:38:00,13:38,12286750,11496250,-790500,SELL
2020-11-23 13:39:00,13:39,11823850,11094750,-729100,SELL
2020-11-23 13:40:00,13:40,11797000,11336025,-460975,SELL
2020-11-23 13:41:00,13:41,11866850,10960775,-906075,SELL
2020-11-23 13:42:00,13:42,11785125,10848200,-936925,SELL
2020-11-23 13:43:00,13:43,11570925,10979825,-591100,SELL
2020-11-23 13:44:00,13:44,11568675,10776050,-792625,SELL
2020-11-23 13:45:00,13:45,11671200,10570000,-1101200,SELL
2020-11-23 13:46:00,13:46,11695575,10705650,-989925,SELL
2020-11-23 13:47:00,13:47,11779975,10869125,-910850,SELL
2020-11-23 13:48:00,13:48,11711650,11199875,-511775,SELL
2020-11-23 13:49:00,13:49,11655625,10970400,-685225,SELL
2020-11-23 13:50:00,13:50,11578350,10892550,-685800,SELL
2020-11-23 13:51:00,13:51,11571275,10883100,-688175,SELL
2020-11-23 13:52:00,13:52,11931475,10784650,-1146825,SELL
2020-11-23 13:53:00,13:53,11598500,11210625,-387875,SELL
2020-11-23 13:54:00,13:54,11707675,10989275,-718400,SELL
2020-11-23 13:55:00,13:55,11647450,11305475,-341975,SELL
2020-11-23 13:56:00,13:56,11570350,11029150,-541200,SELL
2020-11-23 13:57:00,13:57,11912175,10151575,-1760600,SELL
2020-11-23 13:58:00,13:58,11736050,11076550,-659500,SELL
2020-11-23 13:59:00,13:59,11468250,10782000,-686250,SELL
2020-11-23 14:00:00,14:00,11752600,11284600,-468000,SELL
2020-11-23 14:01:00,14:01,11503650,10573250,-930400,SELL
2020-11-23 14:02:00,14:02,11594900,10716125,-878775,SELL
2020-11-23 14:03:00,14:03,11518125,10642875,-875250,SELL
2020-11-23 14:04:00,14:04,11193800,10538275,-655525,SELL
2020-11-23 14:05:00,14:05,11868625,11014200,-854425,SELL
2020-11-23 14:06:00,14:06,11276475,11431450,154975,BUY
2020-11-23 14:07:00,14:07,11537825,10892600,-645225,SELL
2020-11-23 14:08:00,14:08,11624400,11046925,-577475,SELL
2020-11-23 14:09:00,14:09,11167450,10857275,-310175,SELL
2020-11-23 14:10:00,14:10,11217275,11061175,-156100,SELL
2020-11-23 14:11:00,14:11,11314500,10785750,-528750,SELL
2020-11-23 14:12:00,14:12,11375975,10971550,-404425,SELL
2020-11-23 14:13:00,14:13,11327025,10960150,-366875,SELL
2020-11-23 14:14:00,14:14,11253350,10919375,-333975,SELL
2020-11-23 14:15:00,14:15,10981725,10879350,-102375,SELL
2020-11-23 14:16:00,14:16,11665825,10689975,-975850,SELL
2020-11-23 14:17:00,14:17,11054600,10584500,-470100,SELL
2020-11-23 14:18:00,14:18,11093700,10955950,-137750,SELL
2020-11-23 14:19:00,14:19,11009675,10555300,-454375,SELL
2020-11-23 14:20:00,14:20,11659675,10870275,-789400,SELL
2020-11-23 14:21:00,14:21,10952775,10153250,-799525,SELL
2020-11-23 14:22:00,14:22,11187550,10541100,-646450,SELL
2020-11-23 14:23:00,14:23,11217750,10751150,-466600,SELL
2020-11-23 14:24:00,14:24,11066075,11108125,42050,BUY
2020-11-23 14:25:00,14:25,11068325,10907175,-161150,SELL
2020-11-23 14:26:00,14:26,11175950,10840475,-335475,SELL
2020-11-23 14:27:00,14:27,11032125,11045350,13225,BUY
2020-11-23 14:28:00,14:28,10939600,10807750,-131850,SELL
2020-11-23 14:29:00,14:29,10952000,10987600,35600,BUY
2020-11-23 14:30:00,14:30,11214900,10708025,-506875,SELL
2020-11-23 14:31:00,14:31,11175425,10752500,-422925,SELL
2020-11-23 14:32:00,14:32,11340100,10713800,-626300,SELL
2020-11-23 14:33:00,14:33,10955175,10980325,25150,BUY
2020-11-23 14:34:00,14:34,10953525,10668600,-284925,SELL
2020-11-23 14:35:00,14:35,10963450,10650825,-312625,SELL
2020-11-23 14:36:00,14:36,10878700,10230600,-648100,SELL
2020-11-23 14:37:00,14:37,10823125,10690100,-133025,SELL
2020-11-23 14:38:00,14:38,11044625,10368150,-676475,SELL
2020-11-23 14:39:00,14:39,11240850,11055250,-185600,SELL
2020-11-23 14:40:00,14:40,11484400,11531450,47050,BUY
2020-11-23 14:41:00,14:41,11420075,11391725,-28350,SELL
2020-11-23 14:42:00,14:42,11093500,11022000,-71500,SELL
2020-11-23 14:43:00,14:43,11100725,11228725,128000,BUY
2020-11-23 14:44:00,14:44,10994225,11128925,134700,BUY
2020-11-23 14:45:00,14:45,11173500,10920775,-252725,SELL
2020-11-23 14:46:00,14:46,10916475,11175650,259175,BUY
2020-11-23 14:47:00,14:47,11242150,11208850,-33300,SELL
2020-11-23 14:48:00,14:48,11357850,10782375,-575475,SELL
2020-11-23 14:49:00,14:49,11275450,10727450,-548000,SELL
2020-11-23 14:50:00,14:50,11246525,11137225,-109300,SELL
2020-11-23 14:51:00,14:51,11088375,10917275,-171100,SELL
2020-11-23 14:52:00,14:52,11335700,11187125,-148575,SELL
2020-11-23 14:53:00,14:53,11390325,11448975,58650,BUY
2020-11-23 14:54:00,14:54,11370375,11193700,-176675,SELL
2020-11-23 14:55:00,14:55,11234850,10711375,-523475,SELL
2020-11-23 14:56:00,14:56,11121950,10294625,-827325,SELL
2020-11-23 14:57:00,14:57,11417600,11242200,-175400,SELL
2020-11-23 14:58:00,14:58,11189025,11025575,-163450,SELL
2020-11-23 14:59:00,14:59,11349025,11287725,-61300,SELL
2020-11-23 15:00:00,15:00,11247475,10873850,-373625,SELL
2020-11-23 15:01:00,15:01,11151400,11195725,44325,BUY
2020-11-23 15:02:00,15:02,11291450,10707600,-583850,SELL
2020-11-23 15:03:00,15:03,11237075,11030275,-206800,SELL
2020-11-23 15:04:00,15:04,11009525,11111150,101625,BUY
2020-11-23 15:05:00,15:05,11194075,11079050,-115025,SELL
2020-11-23 15:06:00,15:06,11149550,10928800,-220750,SELL
2020-11-23 15:07:00,15:07,11156050,10926950,-229100,SELL
2020-11-23 15:08:00,15:08,11409800,10824975,-584825,SELL
2020-11-23 15:09:00,15:09,11145650,10202875,-942775,SELL
2020-11-23 15:10:00,15:10,11125125,10890225,-234900,SELL
2020-11-23 15:11:00,15:11,11097100,11008500,-88600,SELL
2020-11-23 15:12:00,15:12,11081200,10708850,-372350,SELL
2020-11-23 15:13:00,15:13,11139425,10905975,-233450,SELL
2020-11-23 15:14:00,15:14,10984700,10927875,-56825,SELL
2020-11-23 15:15:00,15:15,11143225,10925100,-218125,SELL
2020-11-23 15:16:00,15:16,11039475,10980950,-58525,SELL
2020-11-23 15:17:00,15:17,11138425,10715575,-422850,SELL
2020-11-23 15:18:00,15:18,11061675,10639650,-422025,SELL
2020-11-23 15:19:00,15:19,10864025,10518600,-345425,SELL
2020-11-23 15:20:00,15:20,11442350,10885300,-557050,SELL
2020-11-23 15:21:00,15:21,11055500,9958625,-1096875,SELL
2020-11-23 15:22:00,15:22,11084775,10569150,-515625,SELL
2020-11-23 15:23:00,15:23,11089150,10630900,-458250,SELL
2020-11-23 15:24:00,15:24,10792900,10522725,-270175,SELL
2020-11-23 15:25:00,15:25,11089400,10384725,-704675,SELL
2020-11-23 15:26:00,15:26,11088925,10467250,-621675,SELL
2020-11-23 15:27:00,15:27,11121425,10438925,-682500,SELL
2020-11-23 15:28:00,15:28,11069100,10440050,-629050,SELL
2020-11-23 15:29:00,15:29,10925700,10615850,-309850,SELL
2020-11-24 09:15:00,09:15,10720950,9580525,-1140425,SELL
2020-11-24 09:16:00,09:16,10747350,9755425,-991925,SELL
2020-11-24 09:17:00,09:17,10862125,9665925,-1196200,SELL
2020-11-24 09:18:00,09:18,11193775,9873850,-1319925,SELL
2020-11-24 09:19:00,09:19,10727625,10344575,-383050,SELL
2020-11-24 09:20:00,09:20,11409950,10370225,-1039725,SELL
2020-11-24 09:21:00,09:21,11162400,10441275,-721125,SELL
2020-11-24 09:22:00,09:22,11079675,10493575,-586100,SELL
2020-11-24 09:23:00,09:23,11106175,10832550,-273625,SELL
2020-11-24 09:24:00,09:24,11254825,11018450,-236375,SELL
2020-11-24 09:25:00,09:25,11196575,11163775,-32800,SELL
2020-11-24 09:26:00,09:26,11045350,11348100,302750,BUY
2020-11-24 09:27:00,09:27,11269350,11503875,234525,BUY
2020-11-24 09:28:00,09:28,11244700,11033075,-211625,SELL
2020-11-24 09:29:00,09:29,11268800,11559150,290350,BUY
2020-11-24 09:30:00,09:30,11244575,11734550,489975,BUY
2020-11-24 09:31:00,09:31,11219450,11814250,594800,BUY
2020-11-24 09:32:00,09:32,11039475,11659250,619775,BUY
2020-11-24 09:33:00,09:33,11039500,12056700,1017200,BUY
2020-11-24 09:34:00,09:34,10913800,11978325,1064525,BUY
2020-11-24 09:35:00,09:35,11227250,12166475,939225,BUY
2020-11-24 09:36:00,09:36,11459675,12330500,870825,BUY
2020-11-24 09:37:00,09:37,10950700,12211525,1260825,BUY
2020-11-24 09:38:00,09:38,10760125,12118250,1358125,BUY
2020-11-24 09:39:00,09:39,11004750,11880100,875350,BUY
2020-11-24 09:40:00,09:40,11163000,12128975,965975,BUY
2020-11-24 09:41:00,09:41,10875225,12494200,1618975,BUY
2020-11-24 09:42:00,09:42,10858150,11970775,1112625,BUY
2020-11-24 09:43:00,09:43,11098275,12356750,1258475,BUY
2020-11-24 09:44:00,09:44,11040150,12471225,1431075,BUY
2020-11-24 09:45:00,09:45,11001700,12304950,1303250,BUY
2020-11-24 09:46:00,09:46,10883925,12198275,1314350,BUY
2020-11-24 09:47:00,09:47,11057425,12241050,1183625,BUY
2020-11-24 09:48:00,09:48,11027800,11909350,881550,BUY
2020-11-24 09:49:00,09:49,11066950,12312625,1245675,BUY
2020-11-24 09:50:00,09:50,11128375,11779400,651025,BUY
2020-11-24 09:51:00,09:51,11144575,11880325,735750,BUY
2020-11-24 09:52:00,09:52,11133125,12239300,1106175,BUY
2020-11-24 09:53:00,09:53,11085650,12259750,1174100,BUY
2020-11-24 09:54:00,09:54,10824725,12580700,1755975,BUY
2020-11-24 09:55:00,09:55,11410275,12417350,1007075,BUY
2020-11-24 09:56:00,09:56,11055875,12395525,1339650,BUY
2020-11-24 09:57:00,09:57,11348775,12332350,983575,BUY
2020-11-24 09:58:00,09:58,11407675,12465700,1058025,BUY
2020-11-24 09:59:00,09:59,10956050,12061975,1105925,BUY
2020-11-24 10:00:00,10:00,11253725,12213600,959875,BUY
2020-11-24 10:01:00,10:01,10873225,12163925,1290700,BUY
2020-11-24 10:02:00,10:02,10880075,12374950,1494875,BUY
2020-11-24 10:03:00,10:03,10861675,12248100,1386425,BUY
2020-11-24 10:04:00,10:04,10700275,12533775,1833500,BUY
2020-11-24 10:05:00,10:05,10928175,12568800,1640625,BUY
2020-11-24 10:06:00,10:06,10819050,12344825,1525775,BUY
2020-11-24 10:07:00,10:07,10941375,12520275,1578900,BUY
2020-11-24 10:08:00,10:08,10831325,12529250,1697925,BUY
2020-11-24 10:09:00,10:09,10648600,12306700,1658100,BUY
2020-11-24 10:10:00,10:10,11081075,12591550,1510475,BUY
2020-11-24 10:11:00,10:11,10859400,12559250,1699850,BUY
2020-11-24 10:12:00,10:12,10876900,12287100,1410200,BUY
2020-11-24 10:13:00,10:13,10655750,12418875,1763125,BUY
2020-11-24 10:14:00,10:14,11141625,12551400,1409775,BUY
2020-11-24 10:15:00,10:15,11004350,12746600,1742250,BUY
2020-11-24 10:16:00,10:16,10876775,12322725,1445950,BUY
2020-11-24 10:17:00,10:17,10804050,12634925,1830875,BUY
2020-11-24 10:18:00,10:18,10789375,12424125,1634750,BUY
2020-11-24 10:19:00,10:19,10815525,12681350,1865825,BUY
2020-11-24 10:20:00,10:20,10596775,12152025,1555250,BUY
2020-11-24 10:21:00,10:21,10692400,12656350,1963950,BUY
2020-11-24 10:22:00,10:22,10781675,12417925,1636250,BUY
2020-11-24 10:23:00,10:23,10767575,12494550,1726975,BUY
2020-11-24 10:24:00,10:24,10614625,12307625,1693000,BUY
2020-11-24 10:25:00,10:25,11059975,13400925,2340950,BUY
2020-11-24 10:26:00,10:26,10463950,12714875,2250925,BUY
2020-11-24 10:27:00,10:27,10507250,12871275,2364025,BUY
2020-11-24 10:28:00,10:28,10805150,12791700,1986550,BUY
2020-11-24 10:29:00,10:29,10419300,12946675,2527375,BUY
2020-11-24 10:30:00,10:30,10627525,12562575,1935050,BUY
2020-11-24 10:31:00,10:31,10807475,13120500,2313025,BUY
2020-11-24 10:32:00,10:32,11106425,13455700,2349275,BUY
2020-11-24 10:33:00,10:33,11137400,13393450,2256050,BUY
2020-11-24 10:34:00,10:34,10557100,12911000,2353900,BUY
2020-11-24 10:35:00,10:35,10877000,13194525,2317525,BUY
2020-11-24 10:36:00,10:36,10701925,12771500,2069575,BUY
2020-11-24 10:37:00,10:37,10868450,12844700,1976250,BUY
2020-11-24 10:38:00,10:38,10618050,12774325,2156275,BUY
2020-11-24 10:39:00,10:39,10917850,13265075,2347225,BUY
2020-11-24 10:40:00,10:40,10830575,13054325,2223750,BUY
2020-11-24 10:41:00,10:41,10756150,12979475,2223325,BUY
2020-11-24 10:42:00,10:42,10812775,13289900,2477125,BUY
2020-11-24 10:43:00,10:43,10702025,12955100,2253075,BUY
2020-11-24 10:44:00,10:44,10949575,12829150,1879575,BUY
2020-11-24 10:45:00,10:45,10648600,13552600,2904000,BUY
2020-11-24 10:46:00,10:46,10701675,12807475,2105800,BUY
2020-11-24 10:47:00,10:47,10809175,12844775,2035600,BUY
2020-11-24 10:48:00,10:48,10894725,13097150,2202425,BUY
2020-11-24 10:49:00,10:49,11143775,13793625,2649850,BUY
2020-11-24 10:50:00,10:50,10732075,13437675,2705600,BUY
2020-11-24 10:51:00,10:51,10466225,12556125,2089900,BUY
2020-11-24 10:52:00,10:52,10860500,13353700,2493200,BUY
2020-11-24 10:53:00,10:53,10614050,13148850,2534800,BUY
2020-11-24 10:54:00,10:54,10302675,13077700,2775025,BUY
2020-11-24 10:55:00,10:55,10872900,13639000,2766100,BUY
2020-11-24 10:56:00,10:56,10424600,13028850,2604250,BUY
2020-11-24 10:57:00,10:57,10618350,13625475,3007125,BUY
2020-11-24 10:58:00,10:58,10657075,13563125,2906050,BUY
2020-11-24 10:59:00,10:59,10434975,13427825,2992850,BUY
2020-11-24 11:00:00,11:00,10879575,13190350,2310775,BUY
2020-11-24 11:01:00,11:01,10388225,12965375,2577150,BUY
2020-11-24 11:02:00,11:02,10748025,13890850,3142825,BUY
2020-11-24 11:03:00,11:03,10675775,13597775,2922000,BUY
2020-11-24 11:04:00,11:04,10719525,13037775,2318250,BUY
2020-11-24 11:05:00,11:05,10513600,13105475,2591875,BUY
2020-11-24 11:06:00,11:06,10421500,12214850,1793350,BUY
2020-11-24 11:07:00,11:07,10165025,13022825,2857800,BUY
2020-11-24 11:08:00,11:08,10949500,13714525,2765025,BUY
2020-11-24 11:09:00,11:09,10539200,12555350,2016150,BUY
2020-11-24 11:10:00,11:10,10447225,11973500,1526275,BUY
2020-11-24 11:11:00,11:11,10481150,12898700,2417550,BUY
2020-11-24 11:12:00,11:12,10818725,13504525,2685800,BUY
2020-11-24 11:13:00,11:13,10409400,13350450,2941050,BUY
2020-11-24 11:14:00,11:14,10239325,13147425,2908100,BUY
2020-11-24 11:15:00,11:15,10469375,13345700,2876325,BUY
2020-11-24 11:16:00,11:16,10641900,13162550,2520650,BUY
2020-11-24 11:17:00,11:17,10908575,13201500,2292925,BUY
2020-11-24 11:18:00,11:18,10848575,13189525,2340950,BUY
2020-11-24 11:19:00,11:19,10458600,13141325,2682725,BUY
2020-11-24 11:20:00,11:20,10675575,13215875,2540300,BUY
2020-11-24 11:21:00,11:21,10766425,13577850,2811425,BUY
2020-11-24 11:22:00,11:22,10572600,13156300,2583700,BUY
2020-11-24 11:23:00,11:23,10889650,13524125,2634475,BUY
2020-11-24 11:24:00,11:24,10683925,13177225,2493300,BUY
2020-11-24 11:25:00,11:25,10611450,13145300,2533850,BUY
2020-11-24 11:26:00,11:26,10654625,13432500,2777875,BUY
2020-11-24 11:27:00,11:27,11079050,12554825,1475775,BUY
2020-11-24 11:28:00,11:28,10782500,12236825,1454325,BUY
2020-11-24 11:29:00,11:29,11377575,13484925,2107350,BUY
2020-11-24 11:30:00,11:30,10794425,13414250,2619825,BUY
2020-11-24 11:31:00,11:31,11154450,13922250,2767800,BUY
2020-11-24 11:32:00,11:32,10751375,13749525,2998150,BUY
2020-11-24 11:33:00,11:33,11066250,13735125,2668875,BUY
2020-11-24 11:34:00,11:34,10726050,13792225,3066175,BUY
2020-11-24 11:35:00,11:35,11084800,13743350,2658550,BUY
2020-11-24 11:36:00,11:36,10915650,13774275,2858625,BUY
2020-11-24 11:37:00,11:37,10927825,13821725,2893900,BUY
2020-11-24 11:38:00,11:38,10560200,13564125,3003925,BUY
2020-11-24 11:39:00,11:39,10586425,13483750,2897325,BUY
2020-11-24 11:40:00,11:40,10351650,13334850,2983200,BUY
2020-11-24 11:41:00,11:41,11164275,13872850,2708575,BUY
2020-11-24 11:42:00,11:42,10978400,13720250,2741850,BUY
2020-11-24 11:43:00,11:43,10520800,13830000,3309200,BUY
2020-11-24 11:44:00,11:44,10533550,13841125,3307575,BUY
2020-11-24 11:45:00,11:45,9884250,13770425,3886175,BUY
2020-11-24 11:46:00,11:46,10470950,13633750,3162800,BUY
2020-11-24 11:47:00,11:47,9904950,13642275,3737325,BUY
2020-11-24 11:48:00,11:48,10982050,13518775,2536725,BUY
2020-11-24 11:49:00,11:49,10622975,13554525,2931550,BUY
2020-11-24 11:50:00,11:50,10720525,13811250,3090725,BUY
2020-11-24 11:51:00,11:51,10673150,13193950,2520800,BUY
2020-11-24 11:52:00,11:52,10966575,13909950,2943375,BUY
2020-11-24 11:53:00,11:53,10765525,13756900,2991375,BUY
2020-11-24 11:54:00,11:54,10971250,13854550,2883300,BUY
2020-11-24 11:55:00,11:55,11495550,14328325,2832775,BUY
2020-11-24 11:56:00,11:56,10547975,13742325,3194350,BUY
2020-11-24 11:57:00,11:57,10608800,13955150,3346350,BUY
2020-11-24 11:58:00,11:58,10457500,13483650,3026150,BUY
2020-11-24 11:59:00,11:59,10900075,13572650,2672575,BUY
2020-11-24 12:00:00,12:00,10800900,13963400,3162500,BUY
2020-11-24 12:01:00,12:01,10866000,14148700,3282700,BUY
2020-11-24 12:02:00,12:02,10698500,14325150,3626650,BUY
2020-11-24 12:03:00,12:03,10761225,14139775,3378550,BUY
2020-11-24 12:04:00,12:04,10797750,14177375,3379625,BUY
2020-11-24 12:05:00,12:05,10730900,13841175,3110275,BUY
2020-11-24 12:06:00,12:06,10958525,14008625,3050100,BUY
2020-11-24 12:07:00,12:07,11216225,14248475,3032250,BUY
2020-11-24 12:08:00,12:08,10523650,14113450,3589800,BUY
2020-11-24 12:09:00,12:09,10738250,13890125,3151875,BUY
2020-11-24 12:10:00,12:10,10612725,13935100,3322375,BUY
2020-11-24 12:11:00,12:11,10974075,13797500,2823425,BUY
2020-11-24 12:12:00,12:12,10955600,13922800,2967200,BUY
2020-11-24 12:13:00,12:13,10655525,13620625,2965100,BUY
2020-11-24 12:14:00,12:14,10383875,13730425,3346550,BUY
2020-11-24 12:15:00,12:15,10699300,13545650,2846350,BUY
2020-11-24 12:16:00,12:16,10596500,13629075,3032575,BUY
2020-11-24 12:17:00,12:17,10422700,13797675,3374975,BUY
2020-11-24 12:18:00,12:18,11223075,14520800,3297725,BUY
2020-11-24 12:19:00,12:19,10540225,13660350,3120125,BUY
2020-11-24 12:20:00,12:20,10597250,13714325,3117075,BUY
2020-11-24 12:21:00,12:21,10408150,13883000,3474850,BUY
2020-11-24 12:22:00,12:22,10553150,13712925,3159775,BUY
2020-11-24 12:23:00,12:23,10658425,13440750,2782325,BUY
2020-11-24 12:24:00,12:24,10869350,14009650,3140300,BUY
2020-11-24 12:25:00,12:25,10254100,13239100,2985000,BUY
2020-11-24 12:26:00,12:26,11031450,14258500,3227050,BUY
2020-11-24 12:27:00,12:27,10473625,13840250,3366625,BUY
2020-11-24 12:28:00,12:28,10406700,13522650,3115950,BUY
2020-11-24 12:29:00,12:29,10462575,13651075,3188500,BUY
2020-11-24 12:30:00,12:30,10950225,13503175,2552950,BUY
2020-11-24 12:31:00,12:31,11471750,14298300,2826550,BUY
2020-11-24 12:32:00,12:32,10829550,13650325,2820775,BUY
2020-11-24 12:33:00,12:33,10818600,14003975,3185375,BUY
2020-11-24 12:34:00,12:34,10682950,14113725,3430775,BUY
2020-11-24 12:35:00,12:35,10738000,14169125,3431125,BUY
2020-11-24 12:36:00,12:36,10759800,14217400,3457600,BUY
2020-11-24 12:37:00,12:37,10759800,14532225,3772425,BUY
2020-11-24 12:38:00,12:38,10745625,13981125,3235500,BUY
2020-11-24 12:39:00,12:39,10972725,13890250,2917525,BUY
2020-11-24 12:40:00,12:40,10863175,13658825,2795650,BUY
2020-11-24 12:41:00,12:41,10526850,13781850,3255000,BUY
2020-11-24 12:42:00,12:42,10641550,13863125,3221575,BUY
2020-11-24 12:43:00,12:43,10615975,13011900,2395925,BUY
2020-11-24 12:44:00,12:44,11516175,14326125,2809950,BUY
2020-11-24 12:45:00,12:45,11109525,13749750,2640225,BUY
2020-11-24 12:46:00,12:46,10918925,13785350,2866425,BUY
2020-11-24 12:47:00,12:47,10914550,13616100,2701550,BUY
2020-11-24 12:48:00,12:48,10736625,13181925,2445300,BUY
2020-11-24 12:49:00,12:49,10856750,13852525,2995775,BUY
2020-11-24 12:50:00,12:50,11124650,13869150,2744500,BUY
2020-11-24 12:51:00,12:51,11048800,13351700,2302900,BUY
2020-11-24 12:52:00,12:52,10948300,13656925,2708625,BUY
2020-11-24 12:53:00,12:53,10899750,13385000,2485250,BUY
2020-11-24 12:54:00,12:54,10760825,13383975,2623150,BUY
2020-11-24 12:55:00,12:55,10973625,13777525,2803900,BUY
2020-11-24 12:56:00,12:56,10820125,13840450,3020325,BUY
2020-11-24 12:57:00,12:57,11271525,13732950,2461425,BUY
2020-11-24 12:58:00,12:58,10881750,13246850,2365100,BUY
2020-11-24 12:59:00,12:59,10929350,13498425,2569075,BUY
2020-11-24 13:00:00,13:00,10997625,13739425,2741800,BUY
2020-11-24 13:01:00,13:01,11145025,14298525,3153500,BUY
2020-11-24 13:02:00,13:02,10895225,13403975,2508750,BUY
2020-11-24 13:03:00,13:03,10717975,13464050,2746075,BUY
2020-11-24 13:04:00,13:04,10804175,13451400,2647225,BUY
2020-11-24 13:05:00,13:05,10918900,13779600,2860700,BUY
2020-11-24 13:06:00,13:06,11172025,13806600,2634575,BUY
2020-11-24 13:07:00,13:07,10844075,13621425,2777350,BUY
2020-11-24 13:08:00,13:08,10907525,13639075,2731550,BUY
2020-11-24 13:09:00,13:09,10824375,13112850,2288475,BUY
2020-11-24 13:10:00,13:10,10707475,12562550,1855075,BUY
2020-11-24 13:11:00,13:11,10721050,13290175,2569125,BUY
2020-11-24 13:12:00,13:12,11364650,13239775,1875125,BUY
2020-11-24 13:13:00,13:13,10866450,13245750,2379300,BUY
2020-11-24 13:14:00,13:14,10895975,13347950,2451975,BUY
2020-11-24 13:15:00,13:15,10745450,13294650,2549200,BUY
2020-11-24 13:16:00,13:16,11145450,13070725,1925275,BUY
2020-11-24 13:17:00,13:17,11407775,13687175,2279400,BUY
2020-11-24 13:18:00,13:18,11045600,13951575,2905975,BUY
2020-11-24 13:19:00,13:19,11297625,13650975,2353350,BUY
2020-11-24 13:20:00,13:20,10868125,13571425,2703300,BUY
2020-11-24 13:21:00,13:21,11375375,13131125,1755750,BUY
2020-11-24 13:22:00,13:22,10818250,12763700,1945450,BUY
2020-11-24 13:23:00,13:23,10973650,13219650,2246000,BUY
2020-11-24 13:24:00,13:24,10840650,12922575,2081925,BUY
2020-11-24 13:25:00,13:25,10965700,13162850,2197150,BUY
2020-11-24 13:26:00,13:26,11422600,13558325,2135725,BUY
2020-11-24 13:27:00,13:27,11108625,13725550,2616925,BUY
2020-11-24 13:28:00,13:28,10928450,13269225,2340775,BUY
2020-11-24 13:29:00,13:29,11289325,13193275,1903950,BUY
2020-11-24 13:30:00,13:30,11470650,13363150,1892500,BUY
2020-11-24 13:31:00,13:31,11017550,13277550,2260000,BUY
2020-11-24 13:32:00,13:32,11097750,13618350,2520600,BUY
2020-11-24 13:33:00,13:33,11085975,13495225,2409250,BUY
2020-11-24 13:34:00,13:34,10892150,13504775,2612625,BUY
2020-11-24 13:35:00,13:35,11127800,13685325,2557525,BUY
2020-11-24 13:36:00,13:36,11079650,13614650,2535000,BUY
2020-11-24 13:37:00,13:37,11135600,13638050,2502450,BUY
2020-11-24 13:38:00,13:38,10927025,13373275,2446250,BUY
2020-11-24 13:39:00,13:39,10935950,13757550,2821600,BUY
2020-11-24 13:40:00,13:40,11062950,13763900,2700950,BUY
2020-11-24 13:41:00,13:41,11133650,13131300,1997650,BUY
2020-11-24 13:42:00,13:42,11188700,13022800,1834100,BUY
2020-11-24 13:43:00,13:43,10847775,13677575,2829800,BUY
2020-11-24 13:44:00,13:44,11254725,13318150,2063425,BUY
2020-11-24 13:45:00,13:45,11365075,13520875,2155800,BUY
2020-11-24 13:46:00,13:46,11115450,13309975,2194525,BUY
2020-11-24 13:47:00,13:47,11350300,13506775,2156475,BUY
2020-11-24 13:48:00,13:48,11074000,12815525,1741525,BUY
2020-11-24 13:49:00,13:49,10712600,12879975,2167375,BUY
2020-11-24 13:50:00,13:50,11134025,13537075,2403050,BUY
2020-11-24 13:51:00,13:51,11110075,13745600,2635525,BUY
2020-11-24 13:52:00,13:52,11011425,13221900,2210475,BUY
2020-11-24 13:53:00,13:53,11169600,13116775,1947175,BUY
2020-11-24 13:54:00,13:54,11591925,13853150,2261225,BUY
2020-11-24 13:55:00,13:55,11493125,13426475,1933350,BUY
2020-11-24 13:56:00,13:56,10940500,13080775,2140275,BUY
2020-11-24 13:57:00,13:57,11038825,13478475,2439650,BUY
2020-11-24 13:58:00,13:58,11008825,13340075,2331250,BUY
2020-11-24 13:59:00,13:59,11312075,13986450,2674375,BUY
2020-11-24 14:00:00,14:00,11003550,13454725,2451175,BUY
2020-11-24 14:01:00,14:01,11376700,13721600,2344900,BUY
2020-11-24 14:02:00,14:02,11268050,13513750,2245700,BUY
2020-11-24 14:03:00,14:03,11109275,13294325,2185050,BUY
2020-11-24 14:04:00,14:04,10999450,13388850,2389400,BUY
2020-11-24 14:05:00,14:05,11459075,13293000,1833925,BUY
2020-11-24 14:06:00,14:06,11261275,13402525,2141250,BUY
2020-11-24 14:07:00,14:07,11110525,13281050,2170525,BUY
2020-11-24 14:08:00,14:08,11306125,13599475,2293350,BUY
2020-11-24 14:09:00,14:09,10876375,12622500,1746125,BUY
2020-11-24 14:10:00,14:10,11168250,13331850,2163600,BUY
2020-11-24 14:11:00,14:11,11187550,13147000,1959450,BUY
2020-11-24 14:12:00,14:12,11622300,13539000,1916700,BUY
2020-11-24 14:13:00,14:13,11231300,12335600,1104300,BUY
2020-11-24 14:14:00,14:14,11182650,13731875,2549225,BUY
2020-11-24 14:15:00,14:15,11061550,12795575,1734025,BUY
2020-11-24 14:16:00,14:16,10922150,12976300,2054150,BUY
2020-11-24 14:17:00,14:17,11179825,12893975,1714150,BUY
2020-11-24 14:18:00,14:18,11495100,14055100,2560000,BUY
2020-11-24 14:19:00,14:19,11178700,13095800,1917100,BUY
2020-11-24 14:20:00,14:20,11724775,13642325,1917550,BUY
2020-11-24 14:21:00,14:21,10889975,13655875,2765900,BUY
2020-11-24 14:22:00,14:22,10768100,13419150,2651050,BUY
2020-11-24 14:23:00,14:23,10727025,13536225,2809200,BUY
2020-11-24 14:24:00,14:24,10784800,13130525,2345725,BUY
2020-11-24 14:25:00,14:25,10676475,13371000,2694525,BUY
2020-11-24 14:26:00,14:26,10855125,13374950,2519825,BUY
2020-11-24 14:27:00,14:27,10865925,13300675,2434750,BUY
2020-11-24 14:28:00,14:28,10553975,13117175,2563200,BUY
2020-11-24 14:29:00,14:29,11011575,13257575,2246000,BUY
2020-11-24 14:30:00,14:30,11042450,13668550,2626100,BUY
2020-11-24 14:31:00,14:31,10999800,13139975,2140175,BUY
2020-11-24 14:32:00,14:32,10532450,13161375,2628925,BUY
2020-11-24 14:33:00,14:33,10727125,13658900,2931775,BUY
2020-11-24 14:34:00,14:34,10721525,13458700,2737175,BUY
2020-11-24 14:35:00,14:35,10990500,13716100,2725600,BUY
2020-11-24 14:36:00,14:36,10250875,13896275,3645400,BUY
2020-11-24 14:37:00,14:37,10094600,13176000,3081400,BUY
2020-11-24 14:38:00,14:38,10123575,13227100,3103525,BUY
2020-11-24 14:39:00,14:39,10041425,12714100,2672675,BUY
2020-11-24 14:40:00,14:40,9930225,13475550,3545325,BUY
2020-11-24 14:41:00,14:41,9884650,13176725,3292075,BUY
2020-11-24 14:42:00,14:42,10024850,13363050,3338200,BUY
2020-11-24 14:43:00,14:43,9826450,13366925,3540475,BUY
2020-11-24 14:44:00,14:44,10298800,13220550,2921750,BUY
2020-11-24 14:45:00,14:45,9842050,13277725,3435675,BUY
2020-11-24 14:46:00,14:46,10336825,13550550,3213725,BUY
2020-11-24 14:47:00,14:47,9909025,13482625,3573600,BUY
2020-11-24 14:48:00,14:48,9758650,13957975,4199325,BUY
2020-11-24 14:49:00,14:49,9730275,13422300,3692025,BUY
2020-11-24 14:50:00,14:50,9769650,13503000,3733350,BUY
2020-11-24 14:51:00,14:51,9813200,13448675,3635475,BUY
2020-11-24 14:52:00,14:52,9846700,13576725,3730025,BUY
2020-11-24 14:53:00,14:53,9744875,13607850,3862975,BUY
2020-11-24 14:54:00,14:54,10022100,13349850,3327750,BUY
2020-11-24 14:55:00,14:55,9676375,13356675,3680300,BUY
2020-11-24 14:56:00,14:56,9728125,13251850,3523725,BUY
2020-11-24 14:57:00,14:57,9740450,13203050,3462600,BUY
2020-11-24 14:58:00,14:58,9669025,13324900,3655875,BUY
2020-11-24 14:59:00,14:59,9759875,13326700,3566825,BUY
2020-11-24 15:00:00,15:00,9598375,13256700,3658325,BUY
2020-11-24 15:01:00,15:01,9264150,13320000,4055850,BUY
2020-11-24 15:02:00,15:02,9583550,12932400,3348850,BUY
2020-11-24 15:03:00,15:03,9479675,13156000,3676325,BUY
2020-11-24 15:04:00,15:04,9464325,13177600,3713275,BUY
2020-11-24 15:05:00,15:05,9355050,13153775,3798725,BUY
2020-11-24 15:06:00,15:06,9477050,12664900,3187850,BUY
2020-11-24 15:07:00,15:07,9399825,12474650,3074825,BUY
2020-11-24 15:08:00,15:08,9318500,12962525,3644025,BUY
2020-11-24 15:09:00,15:09,9142250,13386650,4244400,BUY
2020-11-24 15:10:00,15:10,9441100,13186100,3745000,BUY
2020-11-24 15:11:00,15:11,8915700,13052450,4136750,BUY
2020-11-24 15:12:00,15:12,9152925,12927575,3774650,BUY
2020-11-24 15:13:00,15:13,9351475,13216725,3865250,BUY
2020-11-24 15:14:00,15:14,9525175,13079575,3554400,BUY
2020-11-24 15:15:00,15:15,8914025,12973750,4059725,BUY
2020-11-24 15:16:00,15:16,8995900,13378150,4382250,BUY
2020-11-24 15:17:00,15:17,9283025,13187025,3904000,BUY
2020-11-24 15:18:00,15:18,9089225,13045550,3956325,BUY
2020-11-24 15:19:00,15:19,9116350,12732125,3615775,BUY
2020-11-24 15:20:00,15:20,9434950,13208300,3773350,BUY
2020-11-24 15:21:00,15:21,8936025,12282150,3346125,BUY
2020-11-24 15:22:00,15:22,8697300,12721775,4024475,BUY
2020-11-24 15:23:00,15:23,8518275,12768525,4250250,BUY
2020-11-24 15:24:00,15:24,8653025,12522300,3869275,BUY
2020-11-24 15:25:00,15:25,8762375,12704900,3942525,BUY
2020-11-24 15:26:00,15:26,8297150,12606025,4308875,BUY
2020-11-24 15:27:00,15:27,8595150,12379375,3784225,BUY
2020-11-24 15:28:00,15:28,8305125,12174700,3869575,BUY
2020-11-24 15:29:00,15:29,8274075,12723000,4448925,BUY
2020-11-25 09:15:00,09:15,8219175,10968050,2748875,BUY
2020-11-25 09:16:00,09:16,7987200,11492075,3504875,BUY
2020-11-25 09:17:00,09:17,8453050,11850250,3397200,BUY
2020-11-25 09:18:00,09:18,8199525,12089925,3890400,BUY
2020-11-25 09:19:00,09:19,8388675,11949325,3560650,BUY
2020-11-25 09:20:00,09:20,8907125,12495325,3588200,BUY
2020-11-25 09:21:00,09:21,9065700,12879800,3814100,BUY
2020-11-25 09:22:00,09:22,9043000,12648025,3605025,BUY
2020-11-25 09:23:00,09:23,9402475,13176775,3774300,BUY
2020-11-25 09:24:00,09:24,9190275,13129975,3939700,BUY
2020-11-25 09:25:00,09:25,9484850,13003150,3518300,BUY
2020-11-25 09:26:00,09:26,9787500,13609950,3822450,BUY
2020-11-25 09:27:00,09:27,9445850,13755650,4309800,BUY
2020-11-25 09:28:00,09:28,9789950,13642925,3852975,BUY
2020-11-25 09:29:00,09:29,10114700,13750450,3635750,BUY
2020-11-25 09:30:00,09:30,9995275,13149475,3154200,BUY
2020-11-25 09:31:00,09:31,10156550,13660850,3504300,BUY
2020-11-25 09:32:00,09:32,10144250,13605450,3461200,BUY
2020-11-25 09:33:00,09:33,10500650,13719350,3218700,BUY
2020-11-25 09:34:00,09:34,10422550,13162975,2740425,BUY
2020-11-25 09:35:00,09:35,10419950,13421450,3001500,BUY
2020-11-25 09:36:00,09:36,10551725,13388075,2836350,BUY
2020-11-25 09:37:00,09:37,10532025,13612075,3080050,BUY
2020-11-25 09:38:00,09:38,10730175,13769050,3038875,BUY
2020-11-25 09:39:00,09:39,10368225,14313150,3944925,BUY
2020-11-25 09:40:00,09:40,10593500,13934675,3341175,BUY
2020-11-25 09:41:00,09:41,10666975,13881825,3214850,BUY
2020-11-25 09:42:00,09:42,10630550,14231775,3601225,BUY
2020-11-25 09:43:00,09:43,10554575,13861225,3306650,BUY
2020-11-25 09:44:00,09:44,10922000,14410150,3488150,BUY
2020-11-25 09:45:00,09:45,10832850,14290450,3457600,BUY
2020-11-25 09:46:00,09:46,10732375,14181000,3448625,BUY
2020-11-25 09:47:00,09:47,10261200,14352850,4091650,BUY
2020-11-25 09:48:00,09:48,10401025,14536425,4135400,BUY
2020-11-25 09:49:00,09:49,10422450,14235425,3812975,BUY
2020-11-25 09:50:00,09:50,10236450,14467075,4230625,BUY
2020-11-25 09:51:00,09:51,10644350,14685725,4041375,BUY
2020-11-25 09:52:00,09:52,10699400,15130400,4431000,BUY
2020-11-25 09:53:00,09:53,10691350,14696175,4004825,BUY
2020-11-25 09:54:00,09:54,10615600,14823250,4207650,BUY
2020-11-25 09:55:00,09:55,10518000,14534250,4016250,BUY
2020-11-25 09:56:00,09:56,10722025,14884375,4162350,BUY
2020-11-25 09:57:00,09:57,10395550,14770275,4374725,BUY
2020-11-25 09:58:00,09:58,10428375,14815300,4386925,BUY
2020-11-25 09:59:00,09:59,10769800,14709575,3939775,BUY
2020-11-25 10:00:00,10:00,10750250,15167550,4417300,BUY
2020-11-25 10:01:00,10:01,10587200,14773625,4186425,BUY
2020-11-25 10:02:00,10:02,10673450,15032125,4358675,BUY
2020-11-25 10:03:00,10:03,10661575,14818425,4156850,BUY
2020-11-25 10:04:00,10:04,10786900,14850300,4063400,BUY
2020-11-25 10:05:00,10:05,11063675,15218950,4155275,BUY
2020-11-25 10:06:00,10:06,10804450,15297100,4492650,BUY
2020-11-25 10:07:00,10:07,11165050,14429500,3264450,BUY
2020-11-25 10:08:00,10:08,11302525,15176250,3873725,BUY
2020-11-25 10:09:00,10:09,10914500,15173250,4258750,BUY
2020-11-25 10:10:00,10:10,10908425,14791925,3883500,BUY
2020-11-25 10:11:00,10:11,11459050,15040650,3581600,BUY
2020-11-25 10:12:00,10:12,11027950,14695025,3667075,BUY
2020-11-25 10:13:00,10:13,11224875,15095075,3870200,BUY
2020-11-25 10:14:00,10:14,11201200,15200175,3998975,BUY
2020-11-25 10:15:00,10:15,10927775,14934450,4006675,BUY
2020-11-25 10:16:00,10:16,11080575,15299175,4218600,BUY
2020-11-25 10:17:00,10:17,11060225,15293275,4233050,BUY
2020-11-25 10:18:00,10:18,11028950,14836200,3807250,BUY
2020-11-25 10:19:00,10:19,11060550,14986150,3925600,BUY
2020-11-25 10:20:00,10:20,11386850,14900250,3513400,BUY
2020-11-25 10:21:00,10:21,11335950,15105575,3769625,BUY
2020-11-25 10:22:00,10:22,11448425,14521800,3073375,BUY
2020-11-25 10:26:00,10:26,11828150,15333300,3505150,BUY
2020-11-25 10:27:00,10:27,11707575,15285825,3578250,BUY
2020-11-25 10:28:00,10:28,11934925,15268800,3333875,BUY
2020-11-25 10:29:00,10:29,12513100,14978825,2465725,BUY
2020-11-25 10:30:00,10:30,12288950,14777600,2488650,BUY
2020-11-25 10:31:00,10:31,12035425,14924750,2889325,BUY
2020-11-25 10:32:00,10:32,12065825,14550875,2485050,BUY
2020-11-25 10:33:00,10:33,11955475,14731000,2775525,BUY
2020-11-25 10:34:00,10:34,11941400,14579750,2638350,BUY
2020-11-25 10:35:00,10:35,11696650,14198825,2502175,BUY
2020-11-25 10:36:00,10:36,11812550,14774750,2962200,BUY
2020-11-25 10:37:00,10:37,12001125,14800300,2799175,BUY
2020-11-25 10:38:00,10:38,12361025,14655225,2294200,BUY
2020-11-25 10:39:00,10:39,11884875,14564025,2679150,BUY
2020-11-25 10:40:00,10:40,12421125,14746225,2325100,BUY
2020-11-25 10:41:00,10:41,12040675,14453425,2412750,BUY
2020-11-25 10:42:00,10:42,12354550,14803500,2448950,BUY
2020-11-25 10:43:00,10:43,12569150,14689850,2120700,BUY
2020-11-25 10:44:00,10:44,12443100,14300575,1857475,BUY
2020-11-25 10:45:00,10:45,12977025,14766000,1788975,BUY
2020-11-25 10:46:00,10:46,12576625,14377200,1800575,BUY
2020-11-25 10:47:00,10:47,12308425,14302325,1993900,BUY
2020-11-25 10:48:00,10:48,12183500,14470075,2286575,BUY
2020-11-25 10:49:00,10:49,12264675,14556175,2291500,BUY
2020-11-25 10:50:00,10:50,12411050,14446975,2035925,BUY
2020-11-25 10:51:00,10:51,12284325,14175125,1890800,BUY
2020-11-25 10:52:00,10:52,12385150,14009200,1624050,BUY
2020-11-25 10:53:00,10:53,12496250,14115950,1619700,BUY
2020-11-25 10:54:00,10:54,12574600,14962025,2387425,BUY
2020-11-25 10:55:00,10:55,12537125,14883450,2346325,BUY
2020-11-25 10:56:00,10:56,12681425,14654575,1973150,BUY
2020-11-25 10:57:00,10:57,12401700,14251950,1850250,BUY
2020-11-25 10:58:00,10:58,12332800,14121025,1788225,BUY
2020-11-25 10:59:00,10:59,12591950,14177075,1585125,BUY
2020-11-25 11:00:00,11:00,12838325,14363600,1525275,BUY
2020-11-25 11:01:00,11:01,12899350,14669475,1770125,BUY
2020-11-25 11:02:00,11:02,13342475,14610650,1268175,BUY
2020-11-25 11:03:00,11:03,12810150,14839975,2029825,BUY
2020-11-25 11:04:00,11:04,12829475,14146550,1317075,BUY
2020-11-25 11:05:00,11:05,13043250,14682350,1639100,BUY
2020-11-25 11:06:00,11:06,12922225,14510150,1587925,BUY
2020-11-25 11:07:00,11:07,12705850,14772850,2067000,BUY
2020-11-25 11:08:00,11:08,13069925,14215675,1145750,BUY
2020-11-25 11:09:00,11:09,13120100,14455950,1335850,BUY
2020-11-25 11:10:00,11:10,13128975,14297150,1168175,BUY
2020-11-25 11:11:00,11:11,13612500,14677500,1065000,BUY
2020-11-25 11:12:00,11:12,12954575,15138775,2184200,BUY
2020-11-25 11:13:00,11:13,12798650,14733150,1934500,BUY
2020-11-25 11:14:00,11:14,13167475,14525325,1357850,BUY
2020-11-25 11:15:00,11:15,13224225,14292950,1068725,BUY
2020-11-25 11:16:00,11:16,13415550,14905100,1489550,BUY
2020-11-25 11:17:00,11:17,13411000,14487825,1076825,BUY
2020-11-25 11:18:00,11:18,13026675,14535000,1508325,BUY
2020-11-25 11:19:00,11:19,13177850,14529075,1351225,BUY
2020-11-25 11:20:00,11:20,13123975,14328400,1204425,BUY
2020-11-25 11:21:00,11:21,13352575,14142975,790400,BUY
2020-11-25 11:22:00,11:22,12957225,13816825,859600,BUY
2020-11-25 11:23:00,11:23,13519325,13971975,452650,BUY
2020-11-25 11:24:00,11:24,13768175,14637625,869450,BUY
2020-11-25 11:25:00,11:25,13135575,13700850,565275,BUY
2020-11-25 11:26:00,11:26,13520575,14443875,923300,BUY
2020-11-25 11:27:00,11:27,13173950,13336250,162300,BUY
2020-11-25 11:28:00,11:28,13317175,13968500,651325,BUY
2020-11-25 11:29:00,11:29,13604675,13985175,380500,BUY
2020-11-25 11:30:00,11:30,13506825,14595125,1088300,BUY
2020-11-25 11:31:00,11:31,13688925,14511400,822475,BUY
2020-11-25 11:32:00,11:32,13756100,14010500,254400,BUY
2020-11-25 11:33:00,11:33,13270550,14861250,1590700,BUY
2020-11-25 11:34:00,11:34,13505750,14332200,826450,BUY
2020-11-25 11:35:00,11:35,13507425,13953725,446300,BUY
2020-11-25 11:36:00,11:36,13543400,14218575,675175,BUY
2020-11-25 11:37:00,11:37,13576575,14169375,592800,BUY
2020-11-25 11:38:00,11:38,13533300,14018625,485325,BUY
2020-11-25 11:39:00,11:39,13604325,14302400,698075,BUY
2020-11-25 11:40:00,11:40,13962650,14916775,954125,BUY
2020-11-25 11:41:00,11:41,13647875,14322525,674650,BUY
2020-11-25 11:42:00,11:42,13581650,13962625,380975,BUY
2020-11-25 11:43:00,11:43,13689700,14119250,429550,BUY
2020-11-25 11:44:00,11:44,13641325,13998400,357075,BUY
2020-11-25 11:45:00,11:45,13722250,13796325,74075,BUY
2020-11-25 11:46:00,11:46,13780675,13772700,-7975,SELL
2020-11-25 11:47:00,11:47,13859550,14268425,408875,BUY
2020-11-25 11:48:00,11:48,13797000,13829275,32275,BUY
2020-11-25 11:49:00,11:49,13846825,13939425,92600,BUY
2020-11-25 11:50:00,11:50,14121050,14370475,249425,BUY
2020-11-25 11:51:00,11:51,14005350,14413625,408275,BUY
2020-11-25 11:52:00,11:52,14144350,13627325,-517025,SELL
2020-11-25 11:53:00,11:53,13845150,13737500,-107650,SELL
2020-11-25 11:54:00,11:54,13811475,14245775,434300,BUY
2020-11-25 11:55:00,11:55,14202400,13836525,-365875,SELL
2020-11-25 11:56:00,11:56,14103600,13938650,-164950,SELL
2020-11-25 11:57:00,11:57,13985725,13905025,-80700,SELL
2020-11-25 11:58:00,11:58,13918225,13676450,-241775,SELL
2020-11-25 11:59:00,11:59,14190575,13705050,-485525,SELL
2020-11-25 12:00:00,12:00,14003575,14185325,181750,BUY
2020-11-25 12:01:00,12:01,14492250,13897700,-594550,SELL
2020-11-25 12:02:00,12:02,14001300,13774100,-227200,SELL
2020-11-25 12:03:00,12:03,13868350,14242275,373925,BUY
2020-11-25 12:04:00,12:04,14027125,14388925,361800,BUY
2020-11-25 12:05:00,12:05,14099075,13617000,-482075,SELL
2020-11-25 12:06:00,12:06,14155325,14443950,288625,BUY
2020-11-25 12:07:00,12:07,14117375,13883250,-234125,SELL
2020-11-25 12:08:00,12:08,13727225,13697925,-29300,SELL
2020-11-25 12:09:00,12:09,13702550,13427250,-275300,SELL
2020-11-25 12:10:00,12:10,14297175,14809800,512625,BUY
2020-11-25 12:11:00,12:11,14468475,14112750,-355725,SELL
2020-11-25 12:12:00,12:12,14198675,14584300,385625,BUY
2020-11-25 12:13:00,12:13,14044000,14677875,633875,BUY
2020-11-25 12:14:00,12:14,14319000,14547250,228250,BUY
2020-11-25 12:15:00,12:15,13950425,14416025,465600,BUY
2020-11-25 12:16:00,12:16,14089225,14338600,249375,BUY
2020-11-25 12:17:00,12:17,14549425,14586075,36650,BUY
2020-11-25 12:18:00,12:18,14186075,14592175,406100,BUY
2020-11-25 12:19:00,12:19,14782550,14765425,-17125,SELL
2020-11-25 12:20:00,12:20,14903000,14245575,-657425,SELL
2020-11-25 12:21:00,12:21,14753900,14223725,-530175,SELL
2020-11-25 12:22:00,12:22,14432375,13833825,-598550,SELL
2020-11-25 12:23:00,12:23,14614300,13923375,-690925,SELL
2020-11-25 12:24:00,12:24,14230750,13740150,-490600,SELL
2020-11-25 12:25:00,12:25,14737600,14325700,-411900,SELL
2020-11-25 12:26:00,12:26,14499350,14561725,62375,BUY
2020-11-25 12:27:00,12:27,14280100,14258675,-21425,SELL
2020-11-25 12:28:00,12:28,14368575,14420650,52075,BUY
2020-11-25 12:29:00,12:29,14462475,14141850,-320625,SELL
2020-11-25 12:30:00,12:30,14200350,14350075,149725,BUY
2020-11-25 12:31:00,12:31,14511525,14027350,-484175,SELL
2020-11-25 12:32:00,12:32,14306725,14154850,-151875,SELL
2020-11-25 12:33:00,12:33,14562300,14057900,-504400,SELL
2020-11-25 12:34:00,12:34,14378800,13973375,-405425,SELL
2020-11-25 12:35:00,12:35,14020225,14331750,311525,BUY
2020-11-25 12:36:00,12:36,14569875,14247050,-322825,SELL
2020-11-25 12:37:00,12:37,14394200,14498725,104525,BUY
2020-11-25 12:38:00,12:38,14185950,14044575,-141375,SELL
2020-11-25 12:39:00,12:39,13966900,14158250,191350,BUY
2020-11-25 12:40:00,12:40,14387125,13991625,-395500,SELL
2020-11-25 12:41:00,12:41,14376125,13730675,-645450,SELL
2020-11-25 12:42:00,12:42,14304475,13994650,-309825,SELL
2020-11-25 12:43:00,12:43,14947225,14812025,-135200,SELL
2020-11-25 12:44:00,12:44,14113025,14028575,-84450,SELL
2020-11-25 12:45:00,12:45,14040600,13920750,-119850,SELL
2020-11-25 12:46:00,12:46,14133275,13933675,-199600,SELL
2020-11-25 12:47:00,12:47,14065350,14467550,402200,BUY
2020-11-25 12:48:00,12:48,14212825,14063525,-149300,SELL
2020-11-25 12:49:00,12:49,13965250,14121925,156675,BUY
2020-11-25 12:50:00,12:50,14280850,14176625,-104225,SELL
2020-11-25 12:51:00,12:51,14675275,14248425,-426850,SELL
2020-11-25 12:52:00,12:52,14405450,14226075,-179375,SELL
2020-11-25 12:53:00,12:53,14052275,13449225,-603050,SELL
2020-11-25 12:54:00,12:54,14462425,13735450,-726975,SELL
2020-11-25 12:55:00,12:55,14562400,14365050,-197350,SELL
2020-11-25 12:56:00,12:56,14326225,13782600,-543625,SELL
2020-11-25 12:57:00,12:57,14291475,14231600,-59875,SELL
2020-11-25 12:58:00,12:58,14564375,14173525,-390850,SELL
2020-11-25 12:59:00,12:59,14479100,13527250,-951850,SELL
2020-11-25 13:00:00,13:00,14188525,13720850,-467675,SELL
2020-11-25 13:01:00,13:01,14391425,14147700,-243725,SELL
2020-11-25 13:02:00,13:02,14355925,14616775,260850,BUY
2020-11-25 13:03:00,13:03,14427300,14496225,68925,BUY
2020-11-25 13:04:00,13:04,14605425,14879450,274025,BUY
2020-11-25 13:05:00,13:05,14430075,14703675,273600,BUY
2020-11-25 13:06:00,13:06,14158150,14055850,-102300,SELL
2020-11-25 13:07:00,13:07,14336250,14321150,-15100,SELL
2020-11-25 13:08:00,13:08,14298850,13708375,-590475,SELL
2020-11-25 13:09:00,13:09,14632200,14791950,159750,BUY
2020-11-25 13:10:00,13:10,14530850,14233625,-297225,SELL
2020-11-25 13:11:00,13:11,14643525,14054550,-588975,SELL
2020-11-25 13:12:00,13:12,14492725,14206525,-286200,SELL
2020-11-25 13:13:00,13:13,14516775,14181725,-335050,SELL
2020-11-25 13:14:00,13:14,14165950,13691875,-474075,SELL
2020-11-25 13:15:00,13:15,14472350,14246700,-225650,SELL
2020-11-25 13:16:00,13:16,14419350,14373775,-45575,SELL
2020-11-25 13:17:00,13:17,14703475,13893850,-809625,SELL
2020-11-25 13:18:00,13:18,14865000,14188400,-676600,SELL
2020-11-25 13:19:00,13:19,15179750,14473450,-706300,SELL
2020-11-25 13:20:00,13:20,14895225,14953400,58175,BUY
2020-11-25 13:21:00,13:21,14398550,14211650,-186900,SELL
2020-11-25 13:22:00,13:22,14452225,13922600,-529625,SELL
2020-11-25 13:23:00,13:23,14348875,14079025,-269850,SELL
2020-11-25 13:24:00,13:24,14568700,14241950,-326750,SELL
2020-11-25 13:25:00,13:25,14433475,14324800,-108675,SELL
2020-11-25 13:26:00,13:26,14462350,13789925,-672425,SELL
2020-11-25 13:27:00,13:27,14329300,13674425,-654875,SELL
2020-11-25 13:28:00,13:28,14376100,13784325,-591775,SELL
2020-11-25 13:29:00,13:29,14308000,14476900,168900,BUY
2020-11-25 13:30:00,13:30,14509425,14121375,-388050,SELL
2020-11-25 13:31:00,13:31,14401925,14118000,-283925,SELL
2020-11-25 13:32:00,13:32,14623000,14156075,-466925,SELL
2020-11-25 13:33:00,13:33,14495875,14437125,-58750,SELL
2020-11-25 13:34:00,13:34,14435650,14162925,-272725,SELL
2020-11-25 13:35:00,13:35,14692100,14173450,-518650,SELL
2020-11-25 13:36:00,13:36,14798550,14333425,-465125,SELL
2020-11-25 13:37:00,13:37,14714675,13773925,-940750,SELL
2020-11-25 13:38:00,13:38,14633250,14139250,-494000,SELL
2020-11-25 13:39:00,13:39,14724525,14046375,-678150,SELL
2020-11-25 13:40:00,13:40,14729400,14426400,-303000,SELL
2020-11-25 13:41:00,13:41,14469825,13835475,-634350,SELL
2020-11-25 13:42:00,13:42,14675225,14010100,-665125,SELL
2020-11-25 13:43:00,13:43,14784625,14273100,-511525,SELL
2020-11-25 13:44:00,13:44,14819775,13981950,-837825,SELL
2020-11-25 13:45:00,13:45,14604850,14240450,-364400,SELL
2020-11-25 13:46:00,13:46,14347700,14269000,-78700,SELL
2020-11-25 13:47:00,13:47,14507800,14452550,-55250,SELL
2020-11-25 13:48:00,13:48,14600925,14454350,-146575,SELL
2020-11-25 13:49:00,13:49,14819900,14080650,-739250,SELL
2020-11-25 13:50:00,13:50,14858500,13963200,-895300,SELL
2020-11-25 13:51:00,13:51,15256600,15029400,-227200,SELL
2020-11-25 13:52:00,13:52,15199950,14481825,-718125,SELL
2020-11-25 13:53:00,13:53,15387325,14549975,-837350,SELL
2020-11-25 13:54:00,13:54,15126900,13743075,-1383825,SELL
2020-11-25 13:55:00,13:55,15310500,14209900,-1100600,SELL
2020-11-25 13:56:00,13:56,15085250,14010000,-1075250,SELL
2020-11-25 13:57:00,13:57,15109000,13468175,-1640825,SELL
2020-11-25 13:58:00,13:58,15344750,13993175,-1351575,SELL
2020-11-25 13:59:00,13:59,15208475,13593700,-1614775,SELL
2020-11-25 14:00:00,14:00,15220775,13622300,-1598475,SELL
2020-11-25 14:01:00,14:01,15147625,13234775,-1912850,SELL
2020-11-25 14:02:00,14:02,15121200,13399200,-1722000,SELL
2020-11-25 14:03:00,14:03,15028750,13261625,-1767125,SELL
2020-11-25 14:04:00,14:04,15063950,13459075,-1604875,SELL
2020-11-25 14:05:00,14:05,15358500,13671600,-1686900,SELL
2020-11-25 14:06:00,14:06,15200050,12777600,-2422450,SELL
2020-11-25 14:07:00,14:07,15212275,13711625,-1500650,SELL
2020-11-25 14:08:00,14:08,15113750,13051075,-2062675,SELL
2020-11-25 14:09:00,14:09,15432050,13176575,-2255475,SELL
2020-11-25 14:10:00,14:10,15329550,13401350,-1928200,SELL
2020-11-25 14:11:00,14:11,15137325,12967450,-2169875,SELL
2020-11-25 14:12:00,14:12,15097575,12778000,-2319575,SELL
2020-11-25 14:13:00,14:13,15084925,12946500,-2138425,SELL
2020-11-25 14:14:00,14:14,14979725,13287750,-1691975,SELL
2020-11-25 14:15:00,14:15,15365700,13319900,-2045800,SELL
2020-11-25 14:16:00,14:16,15328950,12531850,-2797100,SELL
2020-11-25 14:17:00,14:17,15623250,12970800,-2652450,SELL
2020-11-25 14:18:00,14:18,15146775,12923450,-2223325,SELL
2020-11-25 14:19:00,14:19,15538975,13230775,-2308200,SELL
2020-11-25 14:20:00,14:20,15427475,13100825,-2326650,SELL
2020-11-25 14:21:00,14:21,15522625,13054775,-2467850,SELL
2020-11-25 14:22:00,14:22,15322200,13247225,-2074975,SELL
2020-11-25 14:23:00,14:23,15353575,13272375,-2081200,SELL
2020-11-25 14:24:00,14:24,15194775,13282825,-1911950,SELL
2020-11-25 14:25:00,14:25,15337075,13129550,-2207525,SELL
2020-11-25 14:26:00,14:26,15304850,13368675,-1936175,SELL
2020-11-25 14:27:00,14:27,15518425,13253525,-2264900,SELL
2020-11-25 14:28:00,14:28,15498050,13293350,-2204700,SELL
2020-11-25 14:29:00,14:29,15279775,12927825,-2351950,SELL
2020-11-25 14:30:00,14:30,15830350,12938325,-2892025,SELL
2020-11-25 14:31:00,14:31,15605775,13218800,-2386975,SELL
2020-11-25 14:32:00,14:32,15192275,13465350,-1726925,SELL
2020-11-25 14:33:00,14:33,15382700,13345125,-2037575,SELL
2020-11-25 14:34:00,14:34,15481575,13572375,-1909200,SELL
2020-11-25 14:35:00,14:35,15248675,12786300,-2462375,SELL
2020-11-25 14:36:00,14:36,15258550,13008925,-2249625,SELL
2020-11-25 14:37:00,14:37,15302575,12617000,-2685575,SELL
2020-11-25 14:38:00,14:38,15001850,13091175,-1910675,SELL
2020-11-25 14:39:00,14:39,15267575,13311175,-1956400,SELL
2020-11-25 14:40:00,14:40,15323200,13478300,-1844900,SELL
2020-11-25 14:41:00,14:41,15599400,12974925,-2624475,SELL
2020-11-25 14:42:00,14:42,14665400,12491600,-2173800,SELL
2020-11-25 14:43:00,14:43,14858200,13180450,-1677750,SELL
2020-11-25 14:44:00,14:44,14915950,12976325,-1939625,SELL
2020-11-25 14:45:00,14:45,14761450,13074100,-1687350,SELL
2020-11-25 14:46:00,14:46,14838800,13099700,-1739100,SELL
2020-11-25 14:47:00,14:47,14765275,13004425,-1760850,SELL
2020-11-25 14:48:00,14:48,14562825,12933225,-1629600,SELL
2020-11-25 14:49:00,14:49,14445350,12483225,-1962125,SELL
2020-11-25 14:50:00,14:50,14408725,12386225,-2022500,SELL
2020-11-25 14:51:00,14:51,14164175,12591225,-1572950,SELL
2020-11-25 14:52:00,14:52,14266200,11987825,-2278375,SELL
2020-11-25 14:53:00,14:53,14224875,12672500,-1552375,SELL
2020-11-25 14:54:00,14:54,14319025,12181400,-2137625,SELL
2020-11-25 14:55:00,14:55,14101575,12193225,-1908350,SELL
2020-11-25 14:56:00,14:56,14248700,12632075,-1616625,SELL
2020-11-25 14:57:00,14:57,14127700,12093825,-2033875,SELL
2020-11-25 14:58:00,14:58,14056950,12131750,-1925200,SELL
2020-11-25 14:59:00,14:59,13964875,12566300,-1398575,SELL
2020-11-25 15:00:00,15:00,14199450,12622500,-1576950,SELL
2020-11-25 15:01:00,15:01,14050875,12369950,-1680925,SELL
2020-11-25 15:02:00,15:02,13875700,12435950,-1439750,SELL
2020-11-25 15:03:00,15:03,14270650,12514850,-1755800,SELL
2020-11-25 15:04:00,15:04,14438000,12565475,-1872525,SELL
2020-11-25 15:05:00,15:05,13865775,12706525,-1159250,SELL
2020-11-25 15:06:00,15:06,14058025,12020500,-2037525,SELL
2020-11-25 15:07:00,15:07,14032950,11981600,-2051350,SELL
2020-11-25 15:08:00,15:08,13883550,11716025,-2167525,SELL
2020-11-25 15:09:00,15:09,13625025,11526925,-2098100,SELL
2020-11-25 15:10:00,15:10,13885425,11549775,-2335650,SELL
2020-11-25 15:11:00,15:11,14061275,11869425,-2191850,SELL
2020-11-25 15:12:00,15:12,13625950,11556525,-2069425,SELL
2020-11-25 15:13:00,15:13,13760075,11838250,-1921825,SELL
2020-11-25 15:14:00,15:14,13757200,11804325,-1952875,SELL
2020-11-25 15:15:00,15:15,13512450,11745525,-1766925,SELL
2020-11-25 15:16:00,15:16,13558550,11567200,-1991350,SELL
2020-11-25 15:17:00,15:17,13784500,11684875,-2099625,SELL
2020-11-25 15:18:00,15:18,13352775,11477700,-1875075,SELL
2020-11-25 15:19:00,15:19,13681200,11189575,-2491625,SELL
2020-11-25 15:20:00,15:20,13709200,11952400,-1756800,SELL
2020-11-25 15:21:00,15:21,13779075,11421175,-2357900,SELL
2020-11-25 15:22:00,15:22,13455700,11189775,-2265925,SELL
2020-11-25 15:23:00,15:23,13127725,11296550,-1831175,SELL
2020-11-25 15:24:00,15:24,13095950,11064500,-2031450,SELL
2020-11-25 15:25:00,15:25,13328650,11219525,-2109125,SELL
2020-11-25 15:26:00,15:26,12929125,11077100,-1852025,SELL
2020-11-25 15:27:00,15:27,12926575,11143475,-1783100,SELL
2020-11-25 15:28:00,15:28,12976475,11087900,-1888575,SELL
2020-11-25 15:29:00,15:29,13095700,11339725,-1755975,SELL
2020-11-26 09:15:00,09:15,12665150,10660175,-2004975,SELL
2020-11-26 09:16:00,09:16,12837500,10255075,-2582425,SELL
2020-11-26 09:17:00,09:17,13790650,11130925,-2659725,SELL
2020-11-26 09:18:00,09:18,13438325,11725425,-1712900,SELL
2020-11-26 09:19:00,09:19,13900300,11782775,-2117525,SELL
2020-11-26 09:20:00,09:20,15262175,12627850,-2634325,SELL
2020-11-26 09:21:00,09:21,15161350,12691775,-2469575,SELL
2020-11-26 09:22:00,09:22,15158075,12608350,-2549725,SELL
2020-11-26 09:23:00,09:23,15496250,13176625,-2319625,SELL
2020-11-26 09:24:00,09:24,15390100,13058200,-2331900,SELL
2020-11-26 09:25:00,09:25,15558025,13177350,-2380675,SELL
2020-11-26 09:26:00,09:26,16353150,13728150,-2625000,SELL
2020-11-26 09:27:00,09:27,16144150,13802900,-2341250,SELL
2020-11-26 09:28:00,09:28,16259650,13594975,-2664675,SELL
2020-11-26 09:29:00,09:29,17315125,14844300,-2470825,SELL
2020-11-26 09:30:00,09:30,17577375,14758775,-2818600,SELL
2020-11-26 09:31:00,09:31,17738850,14737625,-3001225,SELL
2020-11-26 09:32:00,09:32,17351175,15486350,-1864825,SELL
2020-11-26 09:33:00,09:33,17381400,15087875,-2293525,SELL
2020-11-26 09:34:00,09:34,17232350,15360475,-1871875,SELL
2020-11-26 09:35:00,09:35,17776575,15636725,-2139850,SELL
2020-11-26 09:36:00,09:36,17757175,15867525,-1889650,SELL
2020-11-26 09:37:00,09:37,17856975,15727175,-2129800,SELL
2020-11-26 09:38:00,09:38,18149925,15898650,-2251275,SELL
2020-11-26 09:39:00,09:39,18336025,15992425,-2343600,SELL
2020-11-26 09:40:00,09:40,18055325,16132550,-1922775,SELL
2020-11-26 09:41:00,09:41,19188975,16228375,-2960600,SELL
2020-11-26 09:42:00,09:42,18747725,15477350,-3270375,SELL
2020-11-26 09:43:00,09:43,18958750,16356025,-2602725,SELL
2020-11-26 09:44:00,09:44,19287375,16482350,-2805025,SELL
2020-11-26 09:45:00,09:45,19760000,16585075,-3174925,SELL
2020-11-26 09:46:00,09:46,19520200,16238525,-3281675,SELL
2020-11-26 09:47:00,09:47,19611775,16043000,-3568775,SELL
2020-11-26 09:48:00,09:48,20031800,16035725,-3996075,SELL
2020-11-26 09:49:00,09:49,19718775,14849275,-4869500,SELL
2020-11-26 09:50:00,09:50,20276175,16236775,-4039400,SELL
2020-11-26 09:51:00,09:51,20285750,16186000,-4099750,SELL
2020-11-26 09:52:00,09:52,20408700,16047850,-4360850,SELL
2020-11-26 09:53:00,09:53,20450025,16297875,-4152150,SELL
2020-11-26 09:54:00,09:54,20737125,16317050,-4420075,SELL
2020-11-26 09:55:00,09:55,20556275,16174825,-4381450,SELL
2020-11-26 09:56:00,09:56,20724700,16369175,-4355525,SELL
2020-11-26 09:57:00,09:57,20939350,16129850,-4809500,SELL
2020-11-26 09:58:00,09:58,20968575,16150775,-4817800,SELL
2020-11-26 09:59:00,09:59,21242550,16161050,-5081500,SELL
2020-11-26 10:00:00,10:00,21361300,16703075,-4658225,SELL
2020-11-26 10:01:00,10:01,21059025,15876550,-5182475,SELL
2020-11-26 10:02:00,10:02,21222025,16433675,-4788350,SELL
2020-11-26 10:03:00,10:03,21160525,15951975,-5208550,SELL
2020-11-26 10:04:00,10:04,21319075,16545700,-4773375,SELL
2020-11-26 10:05:00,10:05,21242675,17254275,-3988400,SELL
2020-11-26 10:06:00,10:06,21280175,16798375,-4481800,SELL
2020-11-26 10:07:00,10:07,21558400,16148125,-5410275,SELL
2020-11-26 10:08:00,10:08,21649075,17150100,-4498975,SELL
2020-11-26 10:09:00,10:09,21446925,17190550,-4256375,SELL
2020-11-26 10:10:00,10:10,21451225,16500475,-4950750,SELL
2020-11-26 10:11:00,10:11,21558775,17164275,-4394500,SELL
2020-11-26 10:12:00,10:12,21368825,17282825,-4086000,SELL
2020-11-26 10:13:00,10:13,21733475,16298350,-5435125,SELL
2020-11-26 10:14:00,10:14,21637675,17128500,-4509175,SELL
2020-11-26 10:15:00,10:15,21944550,17597775,-4346775,SELL
2020-11-26 10:16:00,10:16,21774775,17146775,-4628000,SELL
2020-11-26 10:17:00,10:17,21693700,17237225,-4456475,SELL
2020-11-26 10:18:00,10:18,22038050,17578350,-4459700,SELL
2020-11-26 10:19:00,10:19,21650075,16642075,-5008000,SELL
2020-11-26 10:20:00,10:20,21342000,17849475,-3492525,SELL
2020-11-26 10:21:00,10:21,20666275,17577000,-3089275,SELL
2020-11-26 10:22:00,10:22,21507750,17728925,-3778825,SELL
2020-11-26 10:23:00,10:23,21789775,18120125,-3669650,SELL
2020-11-26 10:24:00,10:24,21674600,17368875,-4305725,SELL
2020-11-26 10:25:00,10:25,21765000,17205475,-4559525,SELL
2020-11-26 10:26:00,10:26,21801450,17300525,-4500925,SELL
2020-11-26 10:27:00,10:27,21807250,17693275,-4113975,SELL
2020-11-26 10:28:00,10:28,21761225,17802575,-3958650,SELL
2020-11-26 10:29:00,10:29,22381225,18227675,-4153550,SELL
2020-11-26 10:30:00,10:30,22286525,17414250,-4872275,SELL
2020-11-26 10:31:00,10:31,22370625,18015375,-4355250,SELL
2020-11-26 10:32:00,10:32,22393400,17644825,-4748575,SELL
2020-11-26 10:33:00,10:33,22355075,17396350,-4958725,SELL
2020-11-26 10:34:00,10:34,22327475,17467350,-4860125,SELL
2020-11-26 10:35:00,10:35,21886250,16903525,-4982725,SELL
2020-11-26 10:36:00,10:36,22462975,17691650,-4771325,SELL
2020-11-26 10:37:00,10:37,22369850,17594350,-4775500,SELL
2020-11-26 10:38:00,10:38,22367950,18013950,-4354000,SELL
2020-11-26 10:39:00,10:39,22481150,18244250,-4236900,SELL
2020-11-26 10:40:00,10:40,22530125,17491275,-5038850,SELL
2020-11-26 10:41:00,10:41,22695050,18163275,-4531775,SELL
2020-11-26 10:42:00,10:42,21535275,17790325,-3744950,SELL
2020-11-26 10:43:00,10:43,22382950,18099175,-4283775,SELL
2020-11-26 10:44:00,10:44,22510450,18528225,-3982225,SELL
2020-11-26 10:45:00,10:45,22617650,18672675,-3944975,SELL
2020-11-26 10:46:00,10:46,22347350,18047900,-4299450,SELL
2020-11-26 10:47:00,10:47,22735450,18422100,-4313350,SELL
2020-11-26 10:48:00,10:48,22561900,18589475,-3972425,SELL
2020-11-26 10:49:00,10:49,22839800,18250275,-4589525,SELL
2020-11-26 10:50:00,10:50,22460575,18525825,-3934750,SELL
2020-11-26 10:51:00,10:51,22251650,18473900,-3777750,SELL
2020-11-26 10:52:00,10:52,22307425,18621975,-3685450,SELL
2020-11-26 10:53:00,10:53,22587675,18798675,-3789000,SELL
2020-11-26 10:54:00,10:54,22429275,19103875,-3325400,SELL
2020-11-26 10:55:00,10:55,22795125,18954875,-3840250,SELL
2020-11-26 10:56:00,10:56,22510975,18963800,-3547175,SELL
2020-11-26 10:57:00,10:57,21544550,19126875,-2417675,SELL
2020-11-26 10:58:00,10:58,22710400,19294325,-3416075,SELL
2020-11-26 10:59:00,10:59,22483625,18677175,-3806450,SELL
2020-11-26 11:00:00,11:00,22725600,18966975,-3758625,SELL
2020-11-26 11:01:00,11:01,22413400,18582175,-3831225,SELL
2020-11-26 11:02:00,11:02,22741325,19122475,-3618850,SELL
2020-11-26 11:03:00,11:03,22804700,19602825,-3201875,SELL
2020-11-26 11:04:00,11:04,22819825,18841875,-3977950,SELL
2020-11-26 11:05:00,11:05,22845375,18490075,-4355300,SELL
2020-11-26 11:06:00,11:06,22649775,18954875,-3694900,SELL
2020-11-26 11:07:00,11:07,21949225,18383200,-3566025,SELL
2020-11-26 11:08:00,11:08,22726650,19328275,-3398375,SELL
2020-11-26 11:09:00,11:09,22875625,18425075,-4450550,SELL
2020-11-26 11:10:00,11:10,22794975,18835100,-3959875,SELL
2020-11-26 11:11:00,11:11,22897025,19066775,-3830250,SELL
2020-11-26 11:12:00,11:12,22952550,19320775,-3631775,SELL
2020-11-26 11:13:00,11:13,22910050,19184325,-3725725,SELL
2020-11-26 11:14:00,11:14,22550000,18553325,-3996675,SELL
2020-11-26 11:15:00,11:15,23181725,18987650,-4194075,SELL
2020-11-26 11:16:00,11:16,23087625,18825575,-4262050,SELL
2020-11-26 11:17:00,11:17,22894050,18968600,-3925450,SELL
2020-11-26 11:18:00,11:18,22929950,19246400,-3683550,SELL
2020-11-26 11:19:00,11:19,23379800,19555450,-3824350,SELL
2020-11-26 11:20:00,11:20,23033050,19000525,-4032525,SELL
2020-11-26 11:21:00,11:21,23007300,19051725,-3955575,SELL
2020-11-26 11:22:00,11:22,23282175,18754350,-4527825,SELL
2020-11-26 11:23:00,11:23,23308225,19742375,-3565850,SELL
2020-11-26 11:24:00,11:24,23017575,18473950,-4543625,SELL
2020-11-26 11:25:00,11:25,23090325,18462200,-4628125,SELL
2020-11-26 11:26:00,11:26,23208800,19092475,-4116325,SELL
2020-11-26 11:27:00,11:27,23272025,18850025,-4422000,SELL
2020-11-26 11:28:00,11:28,23559550,19122125,-4437425,SELL
2020-11-26 11:29:00,11:29,23188925,18672200,-4516725,SELL
2020-11-26 11:30:00,11:30,23221800,18565425,-4656375,SELL
2020-11-26 11:31:00,11:31,23391200,19134950,-4256250,SELL
2020-11-26 11:32:00,11:32,23909975,18920975,-4989000,SELL
2020-11-26 11:33:00,11:33,23373225,19585525,-3787700,SELL
2020-11-26 11:34:00,11:34,23315025,18982925,-4332100,SELL
2020-11-26 11:35:00,11:35,23568100,19282100,-4286000,SELL
2020-11-26 11:36:00,11:36,23707175,18373325,-5333850,SELL
2020-11-26 11:37:00,11:37,23797650,19991300,-3806350,SELL
2020-11-26 11:38:00,11:38,23644950,18839400,-4805550,SELL
2020-11-26 11:39:00,11:39,23585250,19119150,-4466100,SELL
2020-11-26 11:40:00,11:40,23335150,18708975,-4626175,SELL
2020-11-26 11:41:00,11:41,23528050,18976650,-4551400,SELL
2020-11-26 11:42:00,11:42,23457600,19191025,-4266575,SELL
2020-11-26 11:43:00,11:43,23406175,19372875,-4033300,SELL
2020-11-26 11:44:00,11:44,23467150,18599575,-4867575,SELL
2020-11-26 11:45:00,11:45,23732900,19396100,-4336800,SELL
2020-11-26 11:46:00,11:46,23530825,18122250,-5408575,SELL
2020-11-26 11:47:00,11:47,22849550,19723175,-3126375,SELL
2020-11-26 11:48:00,11:48,23757525,19981500,-3776025,SELL
2020-11-26 11:49:00,11:49,23515575,19636100,-3879475,SELL
2020-11-26 11:50:00,11:50,23765650,19414200,-4351450,SELL
2020-11-26 11:51:00,11:51,23761625,19838950,-3922675,SELL
2020-11-26 11:52:00,11:52,23567125,18933150,-4633975,SELL
2020-11-26 11:53:00,11:53,23989850,19247500,-4742350,SELL
2020-11-26 11:54:00,11:54,23396150,18465100,-4931050,SELL
2020-11-26 11:55:00,11:55,23604725,18816750,-4787975,SELL
2020-11-26 11:56:00,11:56,23613800,19624950,-3988850,SELL
2020-11-26 11:57:00,11:57,24158800,20069525,-4089275,SELL
2020-11-26 11:58:00,11:58,23833825,19455250,-4378575,SELL
2020-11-26 11:59:00,11:59,23755625,17975225,-5780400,SELL
2020-11-26 12:00:00,12:00,23890650,19621100,-4269550,SELL
2020-11-26 12:01:00,12:01,24144500,20151050,-3993450,SELL
2020-11-26 12:02:00,12:02,23938000,19623400,-4314600,SELL
2020-11-26 12:03:00,12:03,23994250,19707025,-4287225,SELL
2020-11-26 12:04:00,12:04,24444350,20390350,-4054000,SELL
2020-11-26 12:05:00,12:05,24381250,19043500,-5337750,SELL
2020-11-26 12:06:00,12:06,24390750,18759600,-5631150,SELL
2020-11-26 12:07:00,12:07,24378975,18800700,-5578275,SELL
2020-11-26 12:08:00,12:08,24199775,18521975,-5677800,SELL
2020-11-26 12:09:00,12:09,24367750,18927250,-5440500,SELL
2020-11-26 12:10:00,12:10,24498250,18922875,-5575375,SELL
2020-11-26 12:11:00,12:11,24188350,18512400,-5675950,SELL
2020-11-26 12:12:00,12:12,24177175,17860875,-6316300,SELL
2020-11-26 12:13:00,12:13,24210650,18842650,-5368000,SELL
2020-11-26 12:14:00,12:14,24615425,18741550,-5873875,SELL
2020-11-26 12:15:00,12:15,24409475,17761250,-6648225,SELL
2020-11-26 12:16:00,12:16,24484800,18669350,-5815450,SELL
2020-11-26 12:17:00,12:17,24518075,18388675,-6129400,SELL
2020-11-26 12:18:00,12:18,24498200,17640825,-6857375,SELL
2020-11-26 12:19:00,12:19,24407100,17424425,-6982675,SELL
2020-11-26 12:20:00,12:20,24515425,18732625,-5782800,SELL
2020-11-26 12:21:00,12:21,24265250,18536325,-5728925,SELL
2020-11-26 12:22:00,12:22,24206050,18287225,-5918825,SELL
2020-11-26 12:23:00,12:23,24249650,18549200,-5700450,SELL
2020-11-26 12:24:00,12:24,24696525,18052700,-6643825,SELL
2020-11-26 12:25:00,12:25,24259925,18526100,-5733825,SELL
2020-11-26 12:26:00,12:26,23665775,19070100,-4595675,SELL
2020-11-26 12:27:00,12:27,24143225,17995725,-6147500,SELL
2020-11-26 12:28:00,12:28,24275150,17657025,-6618125,SELL
2020-11-26 12:29:00,12:29,24662125,18500875,-6161250,SELL
2020-11-26 12:30:00,12:30,24524300,19045875,-5478425,SELL
2020-11-26 12:31:00,12:31,24660325,18924675,-5735650,SELL
2020-11-26 12:32:00,12:32,24791425,18444825,-6346600,SELL
2020-11-26 12:33:00,12:33,24911800,18435200,-6476600,SELL
2020-11-26 12:34:00,12:34,24729325,18836000,-5893325,SELL
2020-11-26 12:35:00,12:35,24799925,18094925,-6705000,SELL
2020-11-26 12:36:00,12:36,24920825,18277325,-6643500,SELL
2020-11-26 12:37:00,12:37,24947025,19567275,-5379750,SELL
2020-11-26 12:38:00,12:38,24722175,18330475,-6391700,SELL
2020-11-26 12:39:00,12:39,24042750,18765800,-5276950,SELL
2020-11-26 12:40:00,12:40,24796850,19405300,-5391550,SELL
2020-11-26 12:41:00,12:41,24417475,18399325,-6018150,SELL
2020-11-26 12:42:00,12:42,23777475,19232000,-4545475,SELL
2020-11-26 12:43:00,12:43,23906725,18427825,-5478900,SELL
2020-11-26 12:44:00,12:44,23388775,19281550,-4107225,SELL
2020-11-26 12:45:00,12:45,23727375,18540600,-5186775,SELL
2020-11-26 12:46:00,12:46,24256625,18452675,-5803950,SELL
2020-11-26 12:47:00,12:47,24203800,19035775,-5168025,SELL
2020-11-26 12:48:00,12:48,24369375,19545700,-4823675,SELL
2020-11-26 12:49:00,12:49,24122150,18967150,-5155000,SELL
2020-11-26 12:50:00,12:50,24363250,19203050,-5160200,SELL
2020-11-26 12:51:00,12:51,22815250,19416175,-3399075,SELL
2020-11-26 12:52:00,12:52,22901625,19178525,-3723100,SELL
2020-11-26 12:53:00,12:53,22754775,19045625,-3709150,SELL
2020-11-26 12:54:00,12:54,22486550,19414150,-3072400,SELL
2020-11-26 12:55:00,12:55,22058450,19563600,-2494850,SELL
2020-11-26 12:56:00,12:56,22216625,19432375,-2784250,SELL
2020-11-26 12:57:00,12:57,22779900,20264950,-2514950,SELL
2020-11-26 12:58:00,12:58,22876700,20406475,-2470225,SELL
2020-11-26 12:59:00,12:59,22902725,19985150,-2917575,SELL
2020-11-26 13:00:00,13:00,22417825,19678050,-2739775,SELL
2020-11-26 13:01:00,13:01,22264925,20019975,-2244950,SELL
2020-11-26 13:02:00,13:02,22258150,19958850,-2299300,SELL
2020-11-26 13:03:00,13:03,22527250,20461875,-2065375,SELL
2020-11-26 13:04:00,13:04,22444475,20367900,-2076575,SELL
2020-11-26 13:05:00,13:05,22398125,20701200,-1696925,SELL
2020-11-26 13:06:00,13:06,21737225,21065300,-671925,SELL
2020-11-26 13:07:00,13:07,22355625,20879850,-1475775,SELL
2020-11-26 13:08:00,13:08,22224100,20673850,-1550250,SELL
2020-11-26 13:09:00,13:09,21922750,21000800,-921950,SELL
2020-11-26 13:10:00,13:10,22149275,21109200,-1040075,SELL
2020-11-26 13:11:00,13:11,22255350,21210400,-1044950,SELL
2020-11-26 13:12:00,13:12,22170150,21266475,-903675,SELL
2020-11-26 13:13:00,13:13,22022550,21456900,-565650,SELL
2020-11-26 13:14:00,13:14,21931325,21385000,-546325,SELL
2020-11-26 13:15:00,13:15,22024250,21005575,-1018675,SELL
2020-11-26 13:16:00,13:16,22021750,21166250,-855500,SELL
2020-11-26 13:17:00,13:17,22011175,21860750,-150425,SELL
2020-11-26 13:18:00,13:18,21743350,21935825,192475,BUY
2020-11-26 13:19:00,13:19,21842750,21847275,4525,BUY
2020-11-26 13:20:00,13:20,21767025,21452425,-314600,SELL
2020-11-26 13:21:00,13:21,20828100,21659625,831525,BUY
2020-11-26 13:22:00,13:22,21133325,21954700,821375,BUY
2020-11-26 13:23:00,13:23,21358925,21808500,449575,BUY
2020-11-26 13:24:00,13:24,21327250,21860150,532900,BUY
2020-11-26 13:25:00,13:25,21431425,21528425,97000,BUY
2020-11-26 13:26:00,13:26,21383550,21758250,374700,BUY
2020-11-26 13:27:00,13:27,21175300,22000375,825075,BUY
2020-11-26 13:28:00,13:28,21262150,21567825,305675,BUY
2020-11-26 13:29:00,13:29,21164150,21670925,506775,BUY
2020-11-26 13:30:00,13:30,21246000,21099350,-146650,SELL
2020-11-26 13:31:00,13:31,21810600,22166000,355400,BUY
2020-11-26 13:32:00,13:32,21277350,21653025,375675,BUY
2020-11-26 13:33:00,13:33,21677975,21760200,82225,BUY
2020-11-26 13:34:00,13:34,21276875,21778600,501725,BUY
2020-11-26 13:35:00,13:35,21423250,21690500,267250,BUY
2020-11-26 13:36:00,13:36,21368125,21468075,99950,BUY
2020-11-26 13:37:00,13:37,21259100,21715600,456500,BUY
2020-11-26 13:38:00,13:38,21397825,21821275,423450,BUY
2020-11-26 13:39:00,13:39,21740475,21640650,-99825,SELL
2020-11-26 13:40:00,13:40,21666150,21799875,133725,BUY
2020-11-26 13:41:00,13:41,21468775,21970375,501600,BUY
2020-11-26 13:42:00,13:42,21482650,20512400,-970250,SELL
2020-11-26 13:43:00,13:43,21717950,21441150,-276800,SELL
2020-11-26 13:44:00,13:44,21693150,21596725,-96425,SELL
2020-11-26 13:45:00,13:45,21869350,21911050,41700,BUY
2020-11-26 13:46:00,13:46,21738725,21790625,51900,BUY
2020-11-26 13:47:00,13:47,21885075,21836475,-48600,SELL
2020-11-26 13:48:00,13:48,22012400,22065225,52825,BUY
2020-11-26 13:49:00,13:49,21999925,21655025,-344900,SELL
2020-11-26 13:50:00,13:50,21886300,21169825,-716475,SELL
2020-11-26 13:51:00,13:51,22147450,20904450,-1243000,SELL
2020-11-26 13:52:00,13:52,22039925,21367125,-672800,SELL
2020-11-26 13:53:00,13:53,22135800,21345525,-790275,SELL
2020-11-26 13:54:00,13:54,22193325,20991175,-1202150,SELL
2020-11-26 13:55:00,13:55,22097075,21558950,-538125,SELL
2020-11-26 13:56:00,13:56,22278225,21601050,-677175,SELL
2020-11-26 13:57:00,13:57,21896400,21452000,-444400,SELL
2020-11-26 13:58:00,13:58,22362050,21745550,-616500,SELL
2020-11-26 13:59:00,13:59,22259750,21373050,-886700,SELL
2020-11-26 14:00:00,14:00,22717050,22206275,-510775,SELL
2020-11-26 14:01:00,14:01,22323900,21551075,-772825,SELL
2020-11-26 14:02:00,14:02,22616875,21477925,-1138950,SELL
2020-11-26 14:03:00,14:03,21975100,21753525,-221575,SELL
2020-11-26 14:04:00,14:04,22330150,21967350,-362800,SELL
2020-11-26 14:05:00,14:05,22256750,21733975,-522775,SELL
2020-11-26 14:06:00,14:06,20773825,20815200,41375,BUY
2020-11-26 14:07:00,14:07,21578700,21766600,187900,BUY
2020-11-26 14:08:00,14:08,21113975,21919775,805800,BUY
2020-11-26 14:09:00,14:09,20917525,21700900,783375,BUY
2020-11-26 14:10:00,14:10,20572050,21521900,949850,BUY
2020-11-26 14:11:00,14:11,21437750,22308100,870350,BUY
2020-11-26 14:12:00,14:12,21254600,22232325,977725,BUY
2020-11-26 14:13:00,14:13,21122150,22536425,1414275,BUY
2020-11-26 14:14:00,14:14,21292100,22333225,1041125,BUY
2020-11-26 14:15:00,14:15,21024575,22702025,1677450,BUY
2020-11-26 14:16:00,14:16,21042150,22289700,1247550,BUY
2020-11-26 14:17:00,14:17,20543025,22227075,1684050,BUY
2020-11-26 14:18:00,14:18,20313375,22899650,2586275,BUY
2020-11-26 14:19:00,14:19,20364600,22833300,2468700,BUY
2020-11-26 14:20:00,14:20,20238075,22660950,2422875,BUY
2020-11-26 14:21:00,14:21,20560725,22898650,2337925,BUY
2020-11-26 14:22:00,14:22,20682525,22932575,2250050,BUY
2020-11-26 14:23:00,14:23,20642100,22858775,2216675,BUY
2020-11-26 14:24:00,14:24,20397450,22743750,2346300,BUY
2020-11-26 14:25:00,14:25,21055325,22699175,1643850,BUY
2020-11-26 14:26:00,14:26,20812975,22503550,1690575,BUY
2020-11-26 14:27:00,14:27,20950750,22569275,1618525,BUY
2020-11-26 14:28:00,14:28,21079900,22757050,1677150,BUY
2020-11-26 14:29:00,14:29,20984100,22305950,1321850,BUY
2020-11-26 14:30:00,14:30,20629700,22789650,2159950,BUY
2020-11-26 14:31:00,14:31,20020175,22962250,2942075,BUY
2020-11-26 14:32:00,14:32,20538750,22255250,1716500,BUY
2020-11-26 14:33:00,14:33,20421050,22081200,1660150,BUY
2020-11-26 14:34:00,14:34,20240475,22123825,1883350,BUY
2020-11-26 14:35:00,14:35,20369425,22301925,1932500,BUY
2020-11-26 14:36:00,14:36,18998075,22038800,3040725,BUY
2020-11-26 14:37:00,14:37,20412400,21952650,1540250,BUY
2020-11-26 14:38:00,14:38,20380825,21911175,1530350,BUY
2020-11-26 14:39:00,14:39,20066100,22333300,2267200,BUY
2020-11-26 14:40:00,14:40,20246150,22464275,2218125,BUY
2020-11-26 14:41:00,14:41,20179125,21844775,1665650,BUY
2020-11-26 14:42:00,14:42,20408100,21875350,1467250,BUY
2020-11-26 14:43:00,14:43,20323425,22234675,1911250,BUY
2020-11-26 14:44:00,14:44,20158325,21431600,1273275,BUY
2020-11-26 14:45:00,14:45,20149925,21434400,1284475,BUY
2020-11-26 14:46:00,14:46,20356425,21839175,1482750,BUY
2020-11-26 14:47:00,14:47,20398900,22212850,1813950,BUY
2020-11-26 14:48:00,14:48,20123675,21353950,1230275,BUY
2020-11-26 14:49:00,14:49,20120725,21173500,1052775,BUY
2020-11-26 14:50:00,14:50,20016075,21305750,1289675,BUY
2020-11-26 14:51:00,14:51,19954850,20738950,784100,BUY
2020-11-26 14:52:00,14:52,19929700,20638775,709075,BUY
2020-11-26 14:53:00,14:53,19958725,20703375,744650,BUY
2020-11-26 14:54:00,14:54,19613925,20903925,1290000,BUY
2020-11-26 14:55:00,14:55,20120650,21863950,1743300,BUY
2020-11-26 14:56:00,14:56,20239000,20954975,715975,BUY
2020-11-26 14:57:00,14:57,19627425,20657450,1030025,BUY
2020-11-26 14:58:00,14:58,20384325,20806050,421725,BUY
2020-11-26 14:59:00,14:59,20348975,19759350,-589625,SELL
2020-11-26 15:00:00,15:00,20156725,19731925,-424800,SELL
2020-11-26 15:01:00,15:01,19934150,19808300,-125850,SELL
2020-11-26 15:02:00,15:02,19978200,19551725,-426475,SELL
2020-11-26 15:03:00,15:03,19688300,19860625,172325,BUY
2020-11-26 15:04:00,15:04,19898025,20069050,171025,BUY
2020-11-26 15:05:00,15:05,19617925,18870000,-747925,SELL
2020-11-26 15:06:00,15:06,19272775,19929600,656825,BUY
2020-11-26 15:07:00,15:07,19194225,19285550,91325,BUY
2020-11-26 15:08:00,15:08,19061675,20315975,1254300,BUY
2020-11-26 15:09:00,15:09,18543400,19951500,1408100,BUY
2020-11-26 15:10:00,15:10,18852525,19022350,169825,BUY
2020-11-26 15:11:00,15:11,18993825,19772425,778600,BUY
2020-11-26 15:12:00,15:12,17848250,18664650,816400,BUY
2020-11-26 15:13:00,15:13,17718500,19314100,1595600,BUY
2020-11-26 15:14:00,15:14,17874825,19296575,1421750,BUY
2020-11-26 15:15:00,15:15,17061075,18471400,1410325,BUY
2020-11-26 15:16:00,15:16,17183725,18936500,1752775,BUY
2020-11-26 15:17:00,15:17,17147600,18853975,1706375,BUY
2020-11-26 15:18:00,15:18,16860975,18475025,1614050,BUY
2020-11-26 15:19:00,15:19,16760575,18039500,1278925,BUY
2020-11-26 15:20:00,15:20,16901975,18310850,1408875,BUY
2020-11-26 15:21:00,15:21,15875725,17365925,1490200,BUY
2020-11-26 15:22:00,15:22,15751900,17275900,1524000,BUY
2020-11-26 15:23:00,15:23,15873725,16715925,842200,BUY
2020-11-26 15:24:00,15:24,15262200,15959025,696825,BUY
2020-11-26 15:25:00,15:25,15250375,15816900,566525,BUY
2020-11-26 15:26:00,15:26,15229450,13952450,-1277000,SELL
2020-11-26 15:27:00,15:27,13692350,13663700,-28650,SELL
2020-11-26 15:28:00,15:28,13575050,13407475,-167575,SELL
2020-11-26 15:29:00,15:29,13219750,13946350,726600,BUY
