,timestamp,call,put,diff,sellOrBuy
2020-12-11 09:15:00,09:15,3572675,2979650,-593025,SELL
2020-12-11 09:16:00,09:16,3573825,2975500,-598325,SELL
2020-12-11 09:17:00,09:17,3721225,3134575,-586650,SELL
2020-12-11 09:18:00,09:18,3721150,3142050,-579100,SELL
2020-12-11 09:19:00,09:19,3724175,3122925,-601250,SELL
2020-12-11 09:20:00,09:20,4180875,3605700,-575175,SELL
2020-12-11 09:21:00,09:21,4184400,3616450,-567950,SELL
2020-12-11 09:22:00,09:22,4177275,3612100,-565175,SELL
2020-12-11 09:23:00,09:23,4364400,3954100,-410300,SELL
2020-12-11 09:24:00,09:24,4367950,3947450,-420500,SELL
2020-12-11 09:25:00,09:25,4370050,3958650,-411400,SELL
2020-12-11 09:26:00,09:26,4470925,4188650,-282275,SELL
2020-12-11 09:27:00,09:27,4464825,4186975,-277850,SELL
2020-12-11 09:28:00,09:28,4469575,4186525,-283050,SELL
2020-12-11 09:29:00,09:29,4493450,4411775,-81675,SELL
2020-12-11 09:30:00,09:30,4471950,4415175,-56775,SELL
2020-12-11 09:31:00,09:31,4494550,4412125,-82425,SELL
2020-12-11 09:32:00,09:32,4480700,4715900,235200,BUY
2020-12-11 09:33:00,09:33,4475950,4715175,239225,BUY
2020-12-11 09:34:00,09:34,4479125,4711650,232525,BUY
2020-12-11 09:35:00,09:35,4561200,4996750,435550,BUY
2020-12-11 09:36:00,09:36,4572275,4997550,425275,BUY
2020-12-11 09:37:00,09:37,4559950,4991850,431900,BUY
2020-12-11 09:38:00,09:38,4661425,5192400,530975,BUY
2020-12-11 09:39:00,09:39,4638300,5157000,518700,BUY
2020-12-11 09:40:00,09:40,4647875,5206175,558300,BUY
2020-12-11 09:41:00,09:41,4697650,5263250,565600,BUY
2020-12-11 09:42:00,09:42,4676425,5250150,573725,BUY
2020-12-11 09:43:00,09:43,4696725,5241275,544550,BUY
2020-12-11 09:44:00,09:44,4764100,5310200,546100,BUY
2020-12-11 09:45:00,09:45,4771875,5328400,556525,BUY
2020-12-11 09:46:00,09:46,4795925,5326150,530225,BUY
2020-12-11 09:47:00,09:47,4844275,5356150,511875,BUY
2020-12-11 09:48:00,09:48,4844375,5328775,484400,BUY
2020-12-11 09:49:00,09:49,4853300,5384850,531550,BUY
2020-12-11 09:50:00,09:50,4948200,5443975,495775,BUY
2020-12-11 09:51:00,09:51,4927050,5449600,522550,BUY
2020-12-11 09:52:00,09:52,4905300,5414950,509650,BUY
2020-12-11 09:53:00,09:53,4958125,5530625,572500,BUY
2020-12-11 09:54:00,09:54,4973875,5532225,558350,BUY
2020-12-11 09:55:00,09:55,4950675,5501975,551300,BUY
2020-12-11 09:56:00,09:56,5035775,5549900,514125,BUY
2020-12-11 09:57:00,09:57,5031600,5541675,510075,BUY
2020-12-11 09:58:00,09:58,5035025,5600075,565050,BUY
2020-12-11 09:59:00,09:59,5106150,5645625,539475,BUY
2020-12-11 10:00:00,10:00,5084025,5617525,533500,BUY
2020-12-11 10:01:00,10:01,5134800,5658400,523600,BUY
2020-12-11 10:02:00,10:02,5243050,5667650,424600,BUY
2020-12-11 10:03:00,10:03,5269425,5683900,414475,BUY
2020-12-11 10:04:00,10:04,5239750,5666750,427000,BUY
2020-12-11 10:05:00,10:05,5357625,5724650,367025,BUY
2020-12-11 10:06:00,10:06,5339700,5741850,402150,BUY
2020-12-11 10:07:00,10:07,5374000,5714975,340975,BUY
2020-12-11 10:08:00,10:08,5434400,5779650,345250,BUY
2020-12-11 10:09:00,10:09,5436825,5763500,326675,BUY
2020-12-11 10:10:00,10:10,5460075,5772050,311975,BUY
2020-12-11 10:11:00,10:11,5574625,5878100,303475,BUY
2020-12-11 10:12:00,10:12,5527150,5896975,369825,BUY
2020-12-11 10:13:00,10:13,5527150,5905950,378800,BUY
2020-12-11 10:14:00,10:14,5679050,5922900,243850,BUY
2020-12-11 10:15:00,10:15,5696850,5950000,253150,BUY
2020-12-11 10:16:00,10:16,5667525,5920575,253050,BUY
2020-12-11 10:17:00,10:17,5713800,5981400,267600,BUY
2020-12-11 10:18:00,10:18,5750800,5980925,230125,BUY
2020-12-11 10:19:00,10:19,5749100,5964625,215525,BUY
2020-12-11 10:20:00,10:20,5820175,5970950,150775,BUY
2020-12-11 10:21:00,10:21,5836225,6006500,170275,BUY
2020-12-11 10:22:00,10:22,5834375,5957400,123025,BUY
2020-12-11 10:23:00,10:23,5845650,6042625,196975,BUY
2020-12-11 10:24:00,10:24,5822600,6058075,235475,BUY
2020-12-11 10:25:00,10:25,5819675,6083150,263475,BUY
2020-12-11 10:26:00,10:26,5866050,6081875,215825,BUY
2020-12-11 10:27:00,10:27,5806650,6079625,272975,BUY
2020-12-11 10:28:00,10:28,5860100,6108375,248275,BUY
2020-12-11 10:29:00,10:29,5920300,6147400,227100,BUY
2020-12-11 10:30:00,10:30,5891675,6165775,274100,BUY
2020-12-11 10:31:00,10:31,5944200,6141625,197425,BUY
2020-12-11 10:32:00,10:32,5962175,6262400,300225,BUY
2020-12-11 10:33:00,10:33,5959000,6249375,290375,BUY
2020-12-11 10:34:00,10:34,5982925,6248375,265450,BUY
2020-12-11 10:35:00,10:35,6053675,6303750,250075,BUY
2020-12-11 10:36:00,10:36,6067700,6251725,184025,BUY
2020-12-11 10:37:00,10:37,6073675,6288175,214500,BUY
2020-12-11 10:38:00,10:38,6152675,6368375,215700,BUY
2020-12-11 10:39:00,10:39,6144325,6356525,212200,BUY
2020-12-11 10:40:00,10:40,6158000,6324250,166250,BUY
2020-12-11 10:41:00,10:41,6262475,6406550,144075,BUY
2020-12-11 10:42:00,10:42,6245975,6399300,153325,BUY
2020-12-11 10:43:00,10:43,6258875,6377600,118725,BUY
2020-12-11 10:44:00,10:44,6345400,6439350,93950,BUY
2020-12-11 10:45:00,10:45,6372500,6445075,72575,BUY
2020-12-11 10:46:00,10:46,6348175,6426350,78175,BUY
2020-12-11 10:47:00,10:47,6423200,6397525,-25675,SELL
2020-12-11 10:48:00,10:48,6399275,6433825,34550,BUY
2020-12-11 10:49:00,10:49,6416225,6389150,-27075,SELL
2020-12-11 10:50:00,10:50,6498000,6461325,-36675,SELL
2020-12-11 10:51:00,10:51,6468550,6464575,-3975,SELL
2020-12-11 10:52:00,10:52,6506700,6484275,-22425,SELL
2020-12-11 10:53:00,10:53,6555275,6505550,-49725,SELL
2020-12-11 10:54:00,10:54,6529025,6517550,-11475,SELL
2020-12-11 10:55:00,10:55,6571650,6546400,-25250,SELL
2020-12-11 10:56:00,10:56,6605100,6551000,-54100,SELL
2020-12-11 10:57:00,10:57,6600475,6490175,-110300,SELL
2020-12-11 10:58:00,10:58,6600475,6548825,-51650,SELL
2020-12-11 10:59:00,10:59,6602650,6586375,-16275,SELL
2020-12-11 11:00:00,11:00,6618350,6556300,-62050,SELL
2020-12-11 11:01:00,11:01,6637875,6577275,-60600,SELL
2020-12-11 11:02:00,11:02,6640875,6570000,-70875,SELL
2020-12-11 11:03:00,11:03,6645875,6596325,-49550,SELL
2020-12-11 11:04:00,11:04,6638300,6557525,-80775,SELL
2020-12-11 11:05:00,11:05,6662600,6657975,-4625,SELL
2020-12-11 11:06:00,11:06,6647875,6654550,6675,BUY
2020-12-11 11:07:00,11:07,6628300,6667300,39000,BUY
2020-12-11 11:08:00,11:08,6731175,6600350,-130825,SELL
2020-12-11 11:09:00,11:09,6744025,6619350,-124675,SELL
2020-12-11 11:10:00,11:10,6681800,6626225,-55575,SELL
2020-12-11 11:11:00,11:11,6788500,6635200,-153300,SELL
2020-12-11 11:12:00,11:12,6795425,6710650,-84775,SELL
2020-12-11 11:13:00,11:13,6783575,6681000,-102575,SELL
2020-12-11 11:14:00,11:14,6836900,6757700,-79200,SELL
2020-12-11 11:15:00,11:15,6865950,6764250,-101700,SELL
2020-12-11 11:16:00,11:16,6868100,6737350,-130750,SELL
2020-12-11 11:17:00,11:17,6896500,6763900,-132600,SELL
2020-12-11 11:18:00,11:18,6855925,6769200,-86725,SELL
2020-12-11 11:19:00,11:19,6881175,6728325,-152850,SELL
2020-12-11 11:20:00,11:20,7027225,6750825,-276400,SELL
2020-12-11 11:21:00,11:21,7018550,6672750,-345800,SELL
2020-12-11 11:22:00,11:22,6984225,6712925,-271300,SELL
2020-12-11 11:23:00,11:23,7080950,6772000,-308950,SELL
2020-12-11 11:24:00,11:24,6992600,6730800,-261800,SELL
2020-12-11 11:25:00,11:25,7032525,6776950,-255575,SELL
2020-12-11 11:26:00,11:26,7112200,6768400,-343800,SELL
2020-12-11 11:27:00,11:27,7102250,6778050,-324200,SELL
2020-12-11 11:28:00,11:28,7113575,6747325,-366250,SELL
2020-12-11 11:29:00,11:29,7253900,6656125,-597775,SELL
2020-12-11 11:30:00,11:30,7257650,6657075,-600575,SELL
2020-12-11 11:31:00,11:31,7241475,6637675,-603800,SELL
2020-12-11 11:32:00,11:32,7393475,6664875,-728600,SELL
2020-12-11 11:33:00,11:33,7411900,6656475,-755425,SELL
2020-12-11 11:34:00,11:34,7376575,6656475,-720100,SELL
2020-12-11 11:35:00,11:35,7580850,6688550,-892300,SELL
2020-12-11 11:36:00,11:36,7587175,6700575,-886600,SELL
2020-12-11 11:37:00,11:37,7586650,6707450,-879200,SELL
2020-12-11 11:38:00,11:38,7654050,6800475,-853575,SELL
2020-12-11 11:39:00,11:39,7646525,6777300,-869225,SELL
2020-12-11 11:40:00,11:40,7683075,6797650,-885425,SELL
2020-12-11 11:41:00,11:41,7791525,6822250,-969275,SELL
2020-12-11 11:42:00,11:42,7767100,6819775,-947325,SELL
2020-12-11 11:43:00,11:43,7790475,6817400,-973075,SELL
2020-12-11 11:44:00,11:44,7789250,6871125,-918125,SELL
2020-12-11 11:45:00,11:45,7790100,6862600,-927500,SELL
2020-12-11 11:46:00,11:46,7816350,6876425,-939925,SELL
2020-12-11 11:47:00,11:47,7870450,6913750,-956700,SELL
2020-12-11 11:48:00,11:48,7864875,6903800,-961075,SELL
2020-12-11 11:49:00,11:49,7841625,6921925,-919700,SELL
2020-12-11 11:50:00,11:50,7908950,6977900,-931050,SELL
2020-12-11 11:51:00,11:51,7929975,6985725,-944250,SELL
2020-12-11 11:52:00,11:52,7900150,6982625,-917525,SELL
2020-12-11 11:53:00,11:53,7985025,7001550,-983475,SELL
2020-12-11 11:54:00,11:54,7974725,7045475,-929250,SELL
2020-12-11 11:55:00,11:55,7980450,7068150,-912300,SELL
2020-12-11 11:56:00,11:56,7972775,7023450,-949325,SELL
2020-12-11 11:57:00,11:57,7958750,7058275,-900475,SELL
2020-12-11 11:58:00,11:58,7946450,7053575,-892875,SELL
2020-12-11 11:59:00,11:59,7870675,7025175,-845500,SELL
2020-12-11 12:00:00,12:00,7885625,7028475,-857150,SELL
2020-12-11 12:01:00,12:01,7862450,7003250,-859200,SELL
2020-12-11 12:02:00,12:02,7910425,7092050,-818375,SELL
2020-12-11 12:03:00,12:03,7899400,7010275,-889125,SELL
2020-12-11 12:04:00,12:04,7900200,7093125,-807075,SELL
2020-12-11 12:05:00,12:05,7925725,7037700,-888025,SELL
2020-12-11 12:06:00,12:06,7927400,7096125,-831275,SELL
2020-12-11 12:07:00,12:07,7921675,7094500,-827175,SELL
2020-12-11 12:08:00,12:08,7939525,7092625,-846900,SELL
2020-12-11 12:09:00,12:09,7978050,7087150,-890900,SELL
2020-12-11 12:10:00,12:10,7955075,7114425,-840650,SELL
2020-12-11 12:11:00,12:11,7938750,7073400,-865350,SELL
2020-12-11 12:12:00,12:12,7942375,7095100,-847275,SELL
2020-12-11 12:13:00,12:13,7961200,7097750,-863450,SELL
2020-12-11 12:14:00,12:14,7966400,7126925,-839475,SELL
2020-12-11 12:15:00,12:15,8009875,7158725,-851150,SELL
2020-12-11 12:16:00,12:16,7953350,7156725,-796625,SELL
2020-12-11 12:17:00,12:17,7941000,7170600,-770400,SELL
2020-12-11 12:18:00,12:18,7967775,7133900,-833875,SELL
2020-12-11 12:19:00,12:19,7943500,7143050,-800450,SELL
2020-12-11 12:20:00,12:20,7992300,7138800,-853500,SELL
2020-12-11 12:21:00,12:21,7992975,7125525,-867450,SELL
2020-12-11 12:22:00,12:22,7984600,6876700,-1107900,SELL
2020-12-11 12:23:00,12:23,8026150,7166825,-859325,SELL
2020-12-11 12:24:00,12:24,8020125,7098800,-921325,SELL
2020-12-11 12:25:00,12:25,8064200,7194025,-870175,SELL
2020-12-11 12:26:00,12:26,8030800,7243675,-787125,SELL
2020-12-11 12:27:00,12:27,8018550,7143250,-875300,SELL
2020-12-11 12:28:00,12:28,8033525,7148225,-885300,SELL
2020-12-11 12:29:00,12:29,8031975,7125200,-906775,SELL
2020-12-11 12:30:00,12:30,8050775,7168300,-882475,SELL
2020-12-11 12:31:00,12:31,8033375,7142550,-890825,SELL
2020-12-11 12:32:00,12:32,8037675,7295475,-742200,SELL
2020-12-11 12:33:00,12:33,7985375,7279200,-706175,SELL
2020-12-11 12:34:00,12:34,7976275,7241025,-735250,SELL
2020-12-11 12:35:00,12:35,8011025,7244700,-766325,SELL
2020-12-11 12:36:00,12:36,7973675,7176800,-796875,SELL
2020-12-11 12:37:00,12:37,7987200,7151325,-835875,SELL
2020-12-11 12:38:00,12:38,7979550,7175400,-804150,SELL
2020-12-11 12:39:00,12:39,7966650,7165975,-800675,SELL
2020-12-11 12:40:00,12:40,8034075,7262425,-771650,SELL
2020-12-11 12:41:00,12:41,8002300,7281025,-721275,SELL
2020-12-11 12:42:00,12:42,7947800,7254725,-693075,SELL
2020-12-11 12:43:00,12:43,7974375,7272975,-701400,SELL
2020-12-11 12:44:00,12:44,7947900,7274850,-673050,SELL
2020-12-11 12:45:00,12:45,7923800,7236850,-686950,SELL
2020-12-11 12:46:00,12:46,7954850,7234800,-720050,SELL
2020-12-11 12:47:00,12:47,7923800,7245975,-677825,SELL
2020-12-11 12:48:00,12:48,7862525,7165075,-697450,SELL
2020-12-11 12:49:00,12:49,7910100,7169875,-740225,SELL
2020-12-11 12:50:00,12:50,7887850,7112175,-775675,SELL
2020-12-11 12:51:00,12:51,7838325,7052900,-785425,SELL
2020-12-11 12:52:00,12:52,7833875,7076175,-757700,SELL
2020-12-11 12:53:00,12:53,7833875,7048575,-785300,SELL
2020-12-11 12:54:00,12:54,7873325,7064050,-809275,SELL
2020-12-11 12:55:00,12:55,7887900,7090000,-797900,SELL
2020-12-11 12:56:00,12:56,7879100,7087100,-792000,SELL
2020-12-11 12:57:00,12:57,7856950,7172525,-684425,SELL
2020-12-11 12:58:00,12:58,7839500,7093200,-746300,SELL
2020-12-11 12:59:00,12:59,7832225,7126200,-706025,SELL
2020-12-11 13:00:00,13:00,7843025,7157350,-685675,SELL
2020-12-11 13:01:00,13:01,7831550,7130750,-700800,SELL
2020-12-11 13:02:00,13:02,7824200,7172800,-651400,SELL
2020-12-11 13:03:00,13:03,7845175,7146500,-698675,SELL
2020-12-11 13:04:00,13:04,7820300,7116000,-704300,SELL
2020-12-11 13:05:00,13:05,7848175,7151325,-696850,SELL
2020-12-11 13:06:00,13:06,7887150,7115150,-772000,SELL
2020-12-11 13:07:00,13:07,7822925,7095625,-727300,SELL
2020-12-11 13:08:00,13:08,7879025,7123525,-755500,SELL
2020-12-11 13:09:00,13:09,7912350,7223750,-688600,SELL
2020-12-11 13:10:00,13:10,7868050,7220450,-647600,SELL
2020-12-11 13:11:00,13:11,7892750,7200625,-692125,SELL
2020-12-11 13:12:00,13:12,7907550,7215675,-691875,SELL
2020-12-11 13:13:00,13:13,7938700,7219100,-719600,SELL
2020-12-11 13:14:00,13:14,7887575,7211500,-676075,SELL
2020-12-11 13:15:00,13:15,8010875,7279950,-730925,SELL
2020-12-11 13:16:00,13:16,7973875,7271850,-702025,SELL
2020-12-11 13:17:00,13:17,7992550,7263325,-729225,SELL
2020-12-11 13:18:00,13:18,8007700,7245450,-762250,SELL
2020-12-11 13:19:00,13:19,7984650,7228450,-756200,SELL
2020-12-11 13:20:00,13:20,8011975,7281950,-730025,SELL
2020-12-11 13:21:00,13:21,8020350,7308725,-711625,SELL
2020-12-11 13:22:00,13:22,8020350,7278825,-741525,SELL
2020-12-11 13:23:00,13:23,8020675,7267125,-753550,SELL
2020-12-11 13:24:00,13:24,8083925,7283525,-800400,SELL
2020-12-11 13:25:00,13:25,8065950,7249650,-816300,SELL
2020-12-11 13:26:00,13:26,8102625,7342900,-759725,SELL
2020-12-11 13:27:00,13:27,8212800,7389625,-823175,SELL
2020-12-11 13:28:00,13:28,8207000,7390275,-816725,SELL
2020-12-11 13:29:00,13:29,8213575,7373650,-839925,SELL
2020-12-11 13:30:00,13:30,8234000,7300400,-933600,SELL
2020-12-11 13:31:00,13:31,8206975,7284150,-922825,SELL
2020-12-11 13:32:00,13:32,8203750,7275000,-928750,SELL
2020-12-11 13:33:00,13:33,8229425,7289725,-939700,SELL
2020-12-11 13:34:00,13:34,8229675,7279350,-950325,SELL
2020-12-11 13:35:00,13:35,8222825,7270475,-952350,SELL
2020-12-11 13:36:00,13:36,8280475,7344950,-935525,SELL
2020-12-11 13:37:00,13:37,8278250,7309850,-968400,SELL
2020-12-11 13:38:00,13:38,8252575,7311625,-940950,SELL
2020-12-11 13:39:00,13:39,8239675,7334775,-904900,SELL
2020-12-11 13:40:00,13:40,8306425,7315375,-991050,SELL
2020-12-11 13:41:00,13:41,8283375,7270950,-1012425,SELL
2020-12-11 13:42:00,13:42,8326150,7344375,-981775,SELL
2020-12-11 13:43:00,13:43,8309925,7347500,-962425,SELL
2020-12-11 13:44:00,13:44,8300600,7356200,-944400,SELL
2020-12-11 13:45:00,13:45,8380900,7417225,-963675,SELL
2020-12-11 13:46:00,13:46,8350725,7417200,-933525,SELL
2020-12-11 13:47:00,13:47,8365500,7431925,-933575,SELL
2020-12-11 13:48:00,13:48,8369775,7430150,-939625,SELL
2020-12-11 13:49:00,13:49,8363400,7438850,-924550,SELL
2020-12-11 13:50:00,13:50,8363400,7453825,-909575,SELL
2020-12-11 13:51:00,13:51,8435775,7500725,-935050,SELL
2020-12-11 13:52:00,13:52,8400050,7498575,-901475,SELL
2020-12-11 13:53:00,13:53,8408750,7500250,-908500,SELL
2020-12-11 13:54:00,13:54,8500700,7500500,-1000200,SELL
2020-12-11 13:55:00,13:55,8530025,7512475,-1017550,SELL
2020-12-11 13:56:00,13:56,8504525,7513675,-990850,SELL
2020-12-11 13:57:00,13:57,8577050,7516850,-1060200,SELL
2020-12-11 13:58:00,13:58,8581900,7518725,-1063175,SELL
2020-12-11 13:59:00,13:59,8572800,7511150,-1061650,SELL
2020-12-11 14:00:00,14:00,8600600,7325250,-1275350,SELL
2020-12-11 14:01:00,14:01,8591500,7324650,-1266850,SELL
2020-12-11 14:02:00,14:02,8596400,7310100,-1286300,SELL
2020-12-11 14:03:00,14:03,8666500,7153850,-1512650,SELL
2020-12-11 14:04:00,14:04,8661750,7159925,-1501825,SELL
2020-12-11 14:05:00,14:05,8645125,7160625,-1484500,SELL
2020-12-11 14:06:00,14:06,8780700,7155975,-1624725,SELL
2020-12-11 14:07:00,14:07,8779050,7152400,-1626650,SELL
2020-12-11 14:08:00,14:08,8755200,7165425,-1589775,SELL
2020-12-11 14:09:00,14:09,8849600,7185000,-1664600,SELL
2020-12-11 14:10:00,14:10,8839825,7165900,-1673925,SELL
2020-12-11 14:11:00,14:11,8849725,7180725,-1669000,SELL
2020-12-11 14:12:00,14:12,8974350,7185625,-1788725,SELL
2020-12-11 14:13:00,14:13,8976600,7193250,-1783350,SELL
2020-12-11 14:14:00,14:14,8938050,7182125,-1755925,SELL
2020-12-11 14:15:00,14:15,8806500,7088200,-1718300,SELL
2020-12-11 14:16:00,14:16,8784075,7078000,-1706075,SELL
2020-12-11 14:17:00,14:17,8779900,7059800,-1720100,SELL
2020-12-11 14:18:00,14:18,8713525,7021200,-1692325,SELL
2020-12-11 14:19:00,14:19,8734675,7027350,-1707325,SELL
2020-12-11 14:20:00,14:20,8725375,7025775,-1699600,SELL
2020-12-11 14:21:00,14:21,8725125,6999675,-1725450,SELL
2020-12-11 14:22:00,14:22,8701750,6953475,-1748275,SELL
2020-12-11 14:23:00,14:23,8725675,7009800,-1715875,SELL
2020-12-11 14:24:00,14:24,8689525,6948175,-1741350,SELL
2020-12-11 14:25:00,14:25,8711150,6970250,-1740900,SELL
2020-12-11 14:26:00,14:26,8703250,6982275,-1720975,SELL
2020-12-11 14:27:00,14:27,8727325,6993450,-1733875,SELL
2020-12-11 14:28:00,14:28,8734550,6997825,-1736725,SELL
2020-12-11 14:29:00,14:29,8696275,6975525,-1720750,SELL
2020-12-11 14:30:00,14:30,8795200,7016825,-1778375,SELL
2020-12-11 14:31:00,14:31,8785700,7017525,-1768175,SELL
2020-12-11 14:32:00,14:32,8794875,6998225,-1796650,SELL
2020-12-11 14:33:00,14:33,8780300,7002675,-1777625,SELL
2020-12-11 14:34:00,14:34,8781125,6980675,-1800450,SELL
2020-12-11 14:35:00,14:35,8789850,7021925,-1767925,SELL
2020-12-11 14:36:00,14:36,8645650,7009150,-1636500,SELL
2020-12-11 14:37:00,14:37,8641175,7013525,-1627650,SELL
2020-12-11 14:38:00,14:38,8631700,6999225,-1632475,SELL
2020-12-11 14:39:00,14:39,8645150,7002800,-1642350,SELL
2020-12-11 14:40:00,14:40,8645325,6992550,-1652775,SELL
2020-12-11 14:41:00,14:41,8645150,7005375,-1639775,SELL
2020-12-11 14:42:00,14:42,8659750,7040575,-1619175,SELL
2020-12-11 14:43:00,14:43,8677350,7029950,-1647400,SELL
2020-12-11 14:44:00,14:44,8659750,7021550,-1638200,SELL
2020-12-11 14:45:00,14:45,8666575,7037150,-1629425,SELL
2020-12-11 14:46:00,14:46,8649150,7016100,-1633050,SELL
2020-12-11 14:47:00,14:47,8672525,7062000,-1610525,SELL
2020-12-11 14:48:00,14:48,8619400,7054375,-1565025,SELL
2020-12-11 14:49:00,14:49,8620675,7064250,-1556425,SELL
2020-12-11 14:50:00,14:50,8652100,7072750,-1579350,SELL
2020-12-11 14:51:00,14:51,8600225,7028100,-1572125,SELL
2020-12-11 14:52:00,14:52,8616725,7025275,-1591450,SELL
2020-12-11 14:53:00,14:53,8605000,7002300,-1602700,SELL
2020-12-11 14:54:00,14:54,8577875,7023250,-1554625,SELL
2020-12-11 14:55:00,14:55,8595475,7011600,-1583875,SELL
2020-12-11 14:56:00,14:56,8579975,6996600,-1583375,SELL
2020-12-11 14:57:00,14:57,8598975,6972975,-1626000,SELL
2020-12-11 14:58:00,14:58,8599025,6992925,-1606100,SELL
2020-12-11 14:59:00,14:59,8592025,6973075,-1618950,SELL
2020-12-11 15:00:00,15:00,8569125,6966050,-1603075,SELL
2020-12-11 15:01:00,15:01,8542150,6978925,-1563225,SELL
2020-12-11 15:02:00,15:02,8563975,6967325,-1596650,SELL
2020-12-11 15:03:00,15:03,8521550,6963125,-1558425,SELL
2020-12-11 15:04:00,15:04,8526275,6975550,-1550725,SELL
2020-12-11 15:05:00,15:05,8526275,6954300,-1571975,SELL
2020-12-11 15:06:00,15:06,8405425,6917750,-1487675,SELL
2020-12-11 15:07:00,15:07,8435050,6894450,-1540600,SELL
2020-12-11 15:08:00,15:08,8409550,6891350,-1518200,SELL
2020-12-11 15:09:00,15:09,8402175,6908550,-1493625,SELL
2020-12-11 15:10:00,15:10,8395500,6914225,-1481275,SELL
2020-12-11 15:11:00,15:11,8389175,6899975,-1489200,SELL
2020-12-11 15:12:00,15:12,8216150,6938100,-1278050,SELL
2020-12-11 15:13:00,15:13,8250775,6954275,-1296500,SELL
2020-12-11 15:14:00,15:14,8235500,6949725,-1285775,SELL
2020-12-11 15:15:00,15:15,7968675,7083350,-885325,SELL
2020-12-11 15:16:00,15:16,7977225,7083175,-894050,SELL
2020-12-11 15:17:00,15:17,7982100,7091525,-890575,SELL
2020-12-11 15:18:00,15:18,7836800,7079150,-757650,SELL
2020-12-11 15:19:00,15:19,7847525,7083525,-764000,SELL
2020-12-11 15:20:00,15:20,7834250,7096350,-737900,SELL
2020-12-11 15:21:00,15:21,7621475,7126925,-494550,SELL
2020-12-11 15:22:00,15:22,7636375,7115725,-520650,SELL
2020-12-11 15:23:00,15:23,7622800,7116800,-506000,SELL
2020-12-11 15:24:00,15:24,7518875,7118375,-400500,SELL
2020-12-11 15:25:00,15:25,7551575,7145075,-406500,SELL
2020-12-11 15:26:00,15:26,7496400,7134525,-361875,SELL
2020-12-11 15:27:00,15:27,7382150,7099600,-282550,SELL
2020-12-11 15:28:00,15:28,7386575,7094675,-291900,SELL
2020-12-11 15:29:00,15:29,7402275,7105550,-296725,SELL
2020-12-14 09:15:00,09:15,7011725,6965950,-45775,SELL
2020-12-14 09:16:00,09:16,7022600,6964450,-58150,SELL
2020-12-14 09:17:00,09:17,7146225,7045400,-100825,SELL
2020-12-14 09:18:00,09:18,7119900,7042850,-77050,SELL
2020-12-14 09:19:00,09:19,7150075,7063025,-87050,SELL
2020-12-14 09:20:00,09:20,7544100,7526625,-17475,SELL
2020-12-14 09:21:00,09:21,7552650,7535100,-17550,SELL
2020-12-14 09:22:00,09:22,7529825,7533850,4025,BUY
2020-12-14 09:23:00,09:23,7776650,7834350,57700,BUY
2020-12-14 09:24:00,09:24,7782600,7843100,60500,BUY
2020-12-14 09:25:00,09:25,7782600,7832175,49575,BUY
2020-12-14 09:26:00,09:26,7930725,7986750,56025,BUY
2020-12-14 09:27:00,09:27,7921200,7980900,59700,BUY
2020-12-14 09:28:00,09:28,7907950,7955825,47875,BUY
2020-12-14 09:29:00,09:29,7985225,8000750,15525,BUY
2020-12-14 09:30:00,09:30,7981450,8000975,19525,BUY
2020-12-14 09:31:00,09:31,7971050,7997575,26525,BUY
2020-12-14 09:32:00,09:32,8152525,8058925,-93600,SELL
2020-12-14 09:33:00,09:33,8158400,8070675,-87725,SELL
2020-12-14 09:34:00,09:34,8136550,8066100,-70450,SELL
2020-12-14 09:35:00,09:35,8241575,8067975,-173600,SELL
2020-12-14 09:36:00,09:36,8248375,8112325,-136050,SELL
2020-12-14 09:37:00,09:37,8242750,8110425,-132325,SELL
2020-12-14 09:38:00,09:38,8242375,8170375,-72000,SELL
2020-12-14 09:39:00,09:39,8264625,8182275,-82350,SELL
2020-12-14 09:40:00,09:40,8235100,8172650,-62450,SELL
2020-12-14 09:41:00,09:41,8197600,8296350,98750,BUY
2020-12-14 09:42:00,09:42,8192725,8305725,113000,BUY
2020-12-14 09:43:00,09:43,8187925,8286625,98700,BUY
2020-12-14 09:44:00,09:44,8237525,8417775,180250,BUY
2020-12-14 09:45:00,09:45,8246350,8421800,175450,BUY
2020-12-14 09:46:00,09:46,8268775,8405125,136350,BUY
2020-12-14 09:47:00,09:47,8287250,8493450,206200,BUY
2020-12-14 09:48:00,09:48,8216725,8461700,244975,BUY
2020-12-14 09:49:00,09:49,8295200,8494925,199725,BUY
2020-12-14 09:50:00,09:50,8418475,8478150,59675,BUY
2020-12-14 09:51:00,09:51,8381100,8447775,66675,BUY
2020-12-14 09:52:00,09:52,8394750,8517200,122450,BUY
2020-12-14 09:53:00,09:53,8388950,8557950,169000,BUY
2020-12-14 09:54:00,09:54,8412500,8549725,137225,BUY
2020-12-14 09:55:00,09:55,8422325,8563975,141650,BUY
2020-12-14 09:56:00,09:56,8529225,8602225,73000,BUY
2020-12-14 09:57:00,09:57,8558075,8536175,-21900,SELL
2020-12-14 09:58:00,09:58,8553900,8598650,44750,BUY
2020-12-14 09:59:00,09:59,8623250,8651650,28400,BUY
2020-12-14 10:00:00,10:00,8662775,8626575,-36200,SELL
2020-12-14 10:01:00,10:01,8642275,8597675,-44600,SELL
2020-12-14 10:02:00,10:02,8693550,8665600,-27950,SELL
2020-12-14 10:03:00,10:03,8692875,8687550,-5325,SELL
2020-12-14 10:04:00,10:04,8726900,8686850,-40050,SELL
2020-12-14 10:05:00,10:05,8758425,8701050,-57375,SELL
2020-12-14 10:06:00,10:06,8788625,8751475,-37150,SELL
2020-12-14 10:07:00,10:07,8762075,8730975,-31100,SELL
2020-12-14 10:08:00,10:08,8824700,8766900,-57800,SELL
2020-12-14 10:09:00,10:09,8821325,8706850,-114475,SELL
2020-12-14 10:10:00,10:10,8802075,8779100,-22975,SELL
2020-12-14 10:11:00,10:11,8854950,8763125,-91825,SELL
2020-12-14 10:12:00,10:12,8904675,8837925,-66750,SELL
2020-12-14 10:13:00,10:13,8646400,8854375,207975,BUY
2020-12-14 10:14:00,10:14,8924950,8838325,-86625,SELL
2020-12-14 10:15:00,10:15,8891300,8836725,-54575,SELL
2020-12-14 10:16:00,10:16,8911225,8778875,-132350,SELL
2020-12-14 10:17:00,10:17,8949425,8893550,-55875,SELL
2020-12-14 10:18:00,10:18,8994875,8883050,-111825,SELL
2020-12-14 10:19:00,10:19,8950525,8849925,-100600,SELL
2020-12-14 10:20:00,10:20,9071600,8912925,-158675,SELL
2020-12-14 10:21:00,10:21,9085200,8909350,-175850,SELL
2020-12-14 10:22:00,10:22,9086125,8926825,-159300,SELL
2020-12-14 10:23:00,10:23,9022975,8971775,-51200,SELL
2020-12-14 10:24:00,10:24,9018575,8971725,-46850,SELL
2020-12-14 10:25:00,10:25,9004350,8945150,-59200,SELL
2020-12-14 10:26:00,10:26,9004000,8988950,-15050,SELL
2020-12-14 10:27:00,10:27,8964350,9022925,58575,BUY
2020-12-14 10:28:00,10:28,8938200,9044300,106100,BUY
2020-12-14 10:29:00,10:29,9010325,9117425,107100,BUY
2020-12-14 10:30:00,10:30,9001275,9096650,95375,BUY
2020-12-14 10:31:00,10:31,8979425,9099050,119625,BUY
2020-12-14 10:32:00,10:32,9039925,9123650,83725,BUY
2020-12-14 10:33:00,10:33,9065050,9118175,53125,BUY
2020-12-14 10:34:00,10:34,9056725,9143750,87025,BUY
2020-12-14 10:35:00,10:35,9063075,9210425,147350,BUY
2020-12-14 10:36:00,10:36,9070925,9239675,168750,BUY
2020-12-14 10:37:00,10:37,9075375,9205125,129750,BUY
2020-12-14 10:38:00,10:38,9103000,9239200,136200,BUY
2020-12-14 10:39:00,10:39,9095625,9270925,175300,BUY
2020-12-14 10:40:00,10:40,9130750,9274775,144025,BUY
2020-12-14 10:41:00,10:41,9145600,9338825,193225,BUY
2020-12-14 10:42:00,10:42,9147025,9020375,-126650,SELL
2020-12-14 10:43:00,10:43,9026400,8946500,-79900,SELL
2020-12-14 10:44:00,10:44,9119500,9304600,185100,BUY
2020-12-14 10:45:00,10:45,9157525,9345100,187575,BUY
2020-12-14 10:46:00,10:46,9139875,9272825,132950,BUY
2020-12-14 10:47:00,10:47,9140075,9342450,202375,BUY
2020-12-14 10:48:00,10:48,9144625,9275350,130725,BUY
2020-12-14 10:49:00,10:49,9139950,9336275,196325,BUY
2020-12-14 10:50:00,10:50,9221600,9356850,135250,BUY
2020-12-14 10:51:00,10:51,9186675,9268550,81875,BUY
2020-12-14 10:52:00,10:52,9187225,9303700,116475,BUY
2020-12-14 10:53:00,10:53,9222675,9344500,121825,BUY
2020-12-14 10:54:00,10:54,9236575,9330400,93825,BUY
2020-12-14 10:55:00,10:55,9231725,9414550,182825,BUY
2020-12-14 10:56:00,10:56,9218225,9331400,113175,BUY
2020-12-14 10:57:00,10:57,9246675,9327950,81275,BUY
2020-12-14 10:58:00,10:58,9240175,9309300,69125,BUY
2020-12-14 10:59:00,10:59,9326600,9476825,150225,BUY
2020-12-14 11:00:00,11:00,9281925,9331350,49425,BUY
2020-12-14 11:01:00,11:01,9312325,9362250,49925,BUY
2020-12-14 11:02:00,11:02,9418500,9463950,45450,BUY
2020-12-14 11:03:00,11:03,9409275,9405875,-3400,SELL
2020-12-14 11:04:00,11:04,9420450,9484250,63800,BUY
2020-12-14 11:05:00,11:05,9542550,9463150,-79400,SELL
2020-12-14 11:06:00,11:06,9551250,9421875,-129375,SELL
2020-12-14 11:07:00,11:07,9510725,9449050,-61675,SELL
2020-12-14 11:08:00,11:08,9561650,9450375,-111275,SELL
2020-12-14 11:09:00,11:09,9571350,9434850,-136500,SELL
2020-12-14 11:10:00,11:10,9572325,9437375,-134950,SELL
2020-12-14 11:11:00,11:11,9666100,9492575,-173525,SELL
2020-12-14 11:12:00,11:12,9670925,9521175,-149750,SELL
2020-12-14 11:13:00,11:13,9664900,9399875,-265025,SELL
2020-12-14 11:14:00,11:14,9732150,9427400,-304750,SELL
2020-12-14 11:15:00,11:15,9750625,9487125,-263500,SELL
2020-12-14 11:16:00,11:16,9741125,9463325,-277800,SELL
2020-12-14 11:17:00,11:17,9766000,9376525,-389475,SELL
2020-12-14 11:18:00,11:18,9757200,9457925,-299275,SELL
2020-12-14 11:19:00,11:19,9749075,9415225,-333850,SELL
2020-12-14 11:20:00,11:20,9794050,9500325,-293725,SELL
2020-12-14 11:21:00,11:21,9821850,9536875,-284975,SELL
2020-12-14 11:22:00,11:22,9754200,9458325,-295875,SELL
2020-12-14 11:23:00,11:23,9815900,9500450,-315450,SELL
2020-12-14 11:24:00,11:24,9849650,9458000,-391650,SELL
2020-12-14 11:25:00,11:25,9824975,9567075,-257900,SELL
2020-12-14 11:26:00,11:26,9834525,9570500,-264025,SELL
2020-12-14 11:27:00,11:27,9819500,9592075,-227425,SELL
2020-12-14 11:28:00,11:28,9603100,9538675,-64425,SELL
2020-12-14 11:29:00,11:29,9878000,9543525,-334475,SELL
2020-12-14 11:30:00,11:30,9863400,9560575,-302825,SELL
2020-12-14 11:31:00,11:31,9929650,9538025,-391625,SELL
2020-12-14 11:32:00,11:32,9899575,9553275,-346300,SELL
2020-12-14 11:33:00,11:33,9954100,9654450,-299650,SELL
2020-12-14 11:34:00,11:34,9896125,9633625,-262500,SELL
2020-12-14 11:35:00,11:35,9855625,9636100,-219525,SELL
2020-12-14 11:36:00,11:36,9861775,9590800,-270975,SELL
2020-12-14 11:37:00,11:37,9865325,9562125,-303200,SELL
2020-12-14 11:38:00,11:38,9863675,9620150,-243525,SELL
2020-12-14 11:39:00,11:39,9857675,9612725,-244950,SELL
2020-12-14 11:40:00,11:40,9872000,9579250,-292750,SELL
2020-12-14 11:41:00,11:41,9846725,9535800,-310925,SELL
2020-12-14 11:42:00,11:42,9847425,9544425,-303000,SELL
2020-12-14 11:43:00,11:43,9905325,9658250,-247075,SELL
2020-12-14 11:44:00,11:44,9854425,9550250,-304175,SELL
2020-12-14 11:45:00,11:45,9899425,9672225,-227200,SELL
2020-12-14 11:46:00,11:46,9891425,9655100,-236325,SELL
2020-12-14 11:47:00,11:47,9926900,9613900,-313000,SELL
2020-12-14 11:48:00,11:48,9900450,9564650,-335800,SELL
2020-12-14 11:49:00,11:49,9919850,9740425,-179425,SELL
2020-12-14 11:50:00,11:50,9945650,9566950,-378700,SELL
2020-12-14 11:51:00,11:51,9952975,9686050,-266925,SELL
2020-12-14 11:52:00,11:52,9945700,9662875,-282825,SELL
2020-12-14 11:53:00,11:53,9950425,9645825,-304600,SELL
2020-12-14 11:54:00,11:54,10030075,9668750,-361325,SELL
2020-12-14 11:55:00,11:55,10008250,9745850,-262400,SELL
2020-12-14 11:56:00,11:56,10000575,9634900,-365675,SELL
2020-12-14 11:57:00,11:57,9965775,9668300,-297475,SELL
2020-12-14 11:58:00,11:58,9973825,9687900,-285925,SELL
2020-12-14 11:59:00,11:59,9939575,9596750,-342825,SELL
2020-12-14 12:00:00,12:00,10041000,9366200,-674800,SELL
2020-12-14 12:01:00,12:01,10027700,9751250,-276450,SELL
2020-12-14 12:02:00,12:02,9968425,9722850,-245575,SELL
2020-12-14 12:03:00,12:03,10036200,9727875,-308325,SELL
2020-12-14 12:04:00,12:04,10062700,9784150,-278550,SELL
2020-12-14 12:05:00,12:05,9994375,9727875,-266500,SELL
2020-12-14 12:06:00,12:06,10059400,9462550,-596850,SELL
2020-12-14 12:07:00,12:07,10061100,9758525,-302575,SELL
2020-12-14 12:08:00,12:08,10098275,9818650,-279625,SELL
2020-12-14 12:09:00,12:09,10022675,9825375,-197300,SELL
2020-12-14 12:10:00,12:10,10065375,9775000,-290375,SELL
2020-12-14 12:11:00,12:11,10073550,9851725,-221825,SELL
2020-12-14 12:12:00,12:12,10059100,9943025,-116075,SELL
2020-12-14 12:13:00,12:13,10006125,9927375,-78750,SELL
2020-12-14 12:14:00,12:14,10011875,9908975,-102900,SELL
2020-12-14 12:15:00,12:15,10097275,9946750,-150525,SELL
2020-12-14 12:16:00,12:16,10036250,9896300,-139950,SELL
2020-12-14 12:17:00,12:17,10036950,9935250,-101700,SELL
2020-12-14 12:18:00,12:18,10067575,9984925,-82650,SELL
2020-12-14 12:19:00,12:19,10060900,10022500,-38400,SELL
2020-12-14 12:20:00,12:20,10067900,9952725,-115175,SELL
2020-12-14 12:21:00,12:21,10062225,10027650,-34575,SELL
2020-12-14 12:22:00,12:22,10046425,10008100,-38325,SELL
2020-12-14 12:23:00,12:23,10066550,10039575,-26975,SELL
2020-12-14 12:24:00,12:24,10063800,9990100,-73700,SELL
2020-12-14 12:25:00,12:25,10058650,9992225,-66425,SELL
2020-12-14 12:26:00,12:26,10053925,10038725,-15200,SELL
2020-12-14 12:27:00,12:27,10073400,10037450,-35950,SELL
2020-12-14 12:28:00,12:28,10059175,10007225,-51950,SELL
2020-12-14 12:29:00,12:29,10086950,10017900,-69050,SELL
2020-12-14 12:30:00,12:30,10097975,10075600,-22375,SELL
2020-12-14 12:31:00,12:31,10124375,10103475,-20900,SELL
2020-12-14 12:32:00,12:32,10111050,10036000,-75050,SELL
2020-12-14 12:33:00,12:33,10080675,10090000,9325,BUY
2020-12-14 12:34:00,12:34,10071600,10100575,28975,BUY
2020-12-14 12:35:00,12:35,10081075,10104725,23650,BUY
2020-12-14 12:36:00,12:36,10135350,10113550,-21800,SELL
2020-12-14 12:37:00,12:37,10081450,10022475,-58975,SELL
2020-12-14 12:38:00,12:38,10075000,10035750,-39250,SELL
2020-12-14 12:39:00,12:39,10048950,10023475,-25475,SELL
2020-12-14 12:40:00,12:40,10053825,10003950,-49875,SELL
2020-12-14 12:41:00,12:41,10050650,9849775,-200875,SELL
2020-12-14 12:42:00,12:42,10055850,9950375,-105475,SELL
2020-12-14 12:43:00,12:43,10034325,9917975,-116350,SELL
2020-12-14 12:44:00,12:44,10073575,10027250,-46325,SELL
2020-12-14 12:45:00,12:45,10059950,9998600,-61350,SELL
2020-12-14 12:46:00,12:46,10077650,9621600,-456050,SELL
2020-12-14 12:47:00,12:47,10072550,10076850,4300,BUY
2020-12-14 12:48:00,12:48,10082975,10112925,29950,BUY
2020-12-14 12:49:00,12:49,10056175,10098025,41850,BUY
2020-12-14 12:50:00,12:50,9901200,9890075,-11125,SELL
2020-12-14 12:51:00,12:51,10089250,10134550,45300,BUY
2020-12-14 12:52:00,12:52,10140850,10117100,-23750,SELL
2020-12-14 12:53:00,12:53,10105175,10106325,1150,BUY
2020-12-14 12:54:00,12:54,10153975,10133150,-20825,SELL
2020-12-14 12:55:00,12:55,10210125,10182425,-27700,SELL
2020-12-14 12:56:00,12:56,10184575,10180225,-4350,SELL
2020-12-14 12:57:00,12:57,10128050,9925625,-202425,SELL
2020-12-14 12:58:00,12:58,10142825,9921800,-221025,SELL
2020-12-14 12:59:00,12:59,10154200,9857400,-296800,SELL
2020-12-14 13:00:00,13:00,10180425,9965550,-214875,SELL
2020-12-14 13:01:00,13:01,10165425,9904025,-261400,SELL
2020-12-14 13:02:00,13:02,10186725,9896700,-290025,SELL
2020-12-14 13:03:00,13:03,10181450,9971100,-210350,SELL
2020-12-14 13:04:00,13:04,10177775,9867100,-310675,SELL
2020-12-14 13:05:00,13:05,10170825,10018750,-152075,SELL
2020-12-14 13:06:00,13:06,10225675,10016175,-209500,SELL
2020-12-14 13:07:00,13:07,10199650,9962400,-237250,SELL
2020-12-14 13:08:00,13:08,10234975,10023550,-211425,SELL
2020-12-14 13:09:00,13:09,10024025,10020475,-3550,SELL
2020-12-14 13:10:00,13:10,10041700,9975775,-65925,SELL
2020-12-14 13:11:00,13:11,10046450,9977775,-68675,SELL
2020-12-14 13:12:00,13:12,9993100,10003625,10525,BUY
2020-12-14 13:13:00,13:13,10018650,10045825,27175,BUY
2020-12-14 13:14:00,13:14,10046825,10054175,7350,BUY
2020-12-14 13:15:00,13:15,9924150,10098600,174450,BUY
2020-12-14 13:16:00,13:16,9890150,10075550,185400,BUY
2020-12-14 13:17:00,13:17,9911525,10050000,138475,BUY
2020-12-14 13:18:00,13:18,9912150,10024400,112250,BUY
2020-12-14 13:19:00,13:19,9877675,10067450,189775,BUY
2020-12-14 13:20:00,13:20,9876700,10085200,208500,BUY
2020-12-14 13:21:00,13:21,9899250,10102600,203350,BUY
2020-12-14 13:22:00,13:22,9919075,10115675,196600,BUY
2020-12-14 13:23:00,13:23,9906075,10050650,144575,BUY
2020-12-14 13:24:00,13:24,9944300,10084225,139925,BUY
2020-12-14 13:25:00,13:25,9947400,10098275,150875,BUY
2020-12-14 13:26:00,13:26,9888950,10080550,191600,BUY
2020-12-14 13:27:00,13:27,9937175,10145000,207825,BUY
2020-12-14 13:28:00,13:28,9934225,9775975,-158250,SELL
2020-12-14 13:29:00,13:29,9932000,10067325,135325,BUY
2020-12-14 13:30:00,13:30,10000200,10171675,171475,BUY
2020-12-14 13:31:00,13:31,10027100,10239275,212175,BUY
2020-12-14 13:32:00,13:32,10006225,10126650,120425,BUY
2020-12-14 13:33:00,13:33,9880825,10084000,203175,BUY
2020-12-14 13:34:00,13:34,9908675,10146800,238125,BUY
2020-12-14 13:35:00,13:35,9895400,10074375,178975,BUY
2020-12-14 13:36:00,13:36,9893675,10088975,195300,BUY
2020-12-14 13:37:00,13:37,9863450,10025775,162325,BUY
2020-12-14 13:38:00,13:38,9865075,9950000,84925,BUY
2020-12-14 13:39:00,13:39,9808400,9939575,131175,BUY
2020-12-14 13:40:00,13:40,9821100,10145575,324475,BUY
2020-12-14 13:41:00,13:41,9812875,9842175,29300,BUY
2020-12-14 13:42:00,13:42,9847725,10132075,284350,BUY
2020-12-14 13:43:00,13:43,9821500,10099650,278150,BUY
2020-12-14 13:44:00,13:44,9812350,10148775,336425,BUY
2020-12-14 13:45:00,13:45,9856000,9935650,79650,BUY
2020-12-14 13:46:00,13:46,9878400,10200300,321900,BUY
2020-12-14 13:47:00,13:47,9852225,10079950,227725,BUY
2020-12-14 13:48:00,13:48,9869875,9943725,73850,BUY
2020-12-14 13:49:00,13:49,9891200,10164700,273500,BUY
2020-12-14 13:50:00,13:50,9860975,9909725,48750,BUY
2020-12-14 13:51:00,13:51,9899875,10066775,166900,BUY
2020-12-14 13:52:00,13:52,9895275,10216850,321575,BUY
2020-12-14 13:53:00,13:53,9868900,10156000,287100,BUY
2020-12-14 13:54:00,13:54,9877925,9855650,-22275,SELL
2020-12-14 13:55:00,13:55,9914125,10186050,271925,BUY
2020-12-14 13:56:00,13:56,9939925,10226875,286950,BUY
2020-12-14 13:57:00,13:57,9940125,10195250,255125,BUY
2020-12-14 13:58:00,13:58,9931225,10110075,178850,BUY
2020-12-14 13:59:00,13:59,9970375,9867550,-102825,SELL
2020-12-14 14:00:00,14:00,9921275,10118525,197250,BUY
2020-12-14 14:01:00,14:01,9951675,10208075,256400,BUY
2020-12-14 14:02:00,14:02,9951675,10237525,285850,BUY
2020-12-14 14:03:00,14:03,9942350,10190175,247825,BUY
2020-12-14 14:04:00,14:04,9968250,10193275,225025,BUY
2020-12-14 14:05:00,14:05,9960775,10201100,240325,BUY
2020-12-14 14:06:00,14:06,10013175,10175875,162700,BUY
2020-12-14 14:07:00,14:07,9977900,10066750,88850,BUY
2020-12-14 14:08:00,14:08,9986850,10120850,134000,BUY
2020-12-14 14:09:00,14:09,10024775,9846050,-178725,SELL
2020-12-14 14:10:00,14:10,10016675,10159900,143225,BUY
2020-12-14 14:11:00,14:11,10051500,10170025,118525,BUY
2020-12-14 14:12:00,14:12,10082825,10168450,85625,BUY
2020-12-14 14:13:00,14:13,10051625,10175000,123375,BUY
2020-12-14 14:14:00,14:14,10113575,10203600,90025,BUY
2020-12-14 14:15:00,14:15,10108125,10174800,66675,BUY
2020-12-14 14:16:00,14:16,10068400,10147325,78925,BUY
2020-12-14 14:17:00,14:17,10090150,10105325,15175,BUY
2020-12-14 14:18:00,14:18,10086475,10142500,56025,BUY
2020-12-14 14:19:00,14:19,10108875,10143175,34300,BUY
2020-12-14 14:20:00,14:20,10117125,10160700,43575,BUY
2020-12-14 14:21:00,14:21,10113425,10144300,30875,BUY
2020-12-14 14:22:00,14:22,10079400,10180400,101000,BUY
2020-12-14 14:23:00,14:23,10060825,10227775,166950,BUY
2020-12-14 14:24:00,14:24,10093725,10138250,44525,BUY
2020-12-14 14:25:00,14:25,10129625,10201825,72200,BUY
2020-12-14 14:26:00,14:26,10090575,10129050,38475,BUY
2020-12-14 14:27:00,14:27,10093000,10058400,-34600,SELL
2020-12-14 14:28:00,14:28,10083650,10128450,44800,BUY
2020-12-14 14:29:00,14:29,10083925,10144000,60075,BUY
2020-12-14 14:30:00,14:30,10096375,10251450,155075,BUY
2020-12-14 14:31:00,14:31,10140800,10283025,142225,BUY
2020-12-14 14:32:00,14:32,10083425,10234750,151325,BUY
2020-12-14 14:33:00,14:33,10075725,10205100,129375,BUY
2020-12-14 14:34:00,14:34,10135575,10248725,113150,BUY
2020-12-14 14:35:00,14:35,10088375,10161050,72675,BUY
2020-12-14 14:36:00,14:36,10087250,10148550,61300,BUY
2020-12-14 14:37:00,14:37,10073650,10226425,152775,BUY
2020-12-14 14:38:00,14:38,10078175,10108900,30725,BUY
2020-12-14 14:39:00,14:39,10097900,10241750,143850,BUY
2020-12-14 14:40:00,14:40,10108075,10059600,-48475,SELL
2020-12-14 14:41:00,14:41,10127200,10228175,100975,BUY
2020-12-14 14:42:00,14:42,10045850,10237950,192100,BUY
2020-12-14 14:43:00,14:43,10080850,10229325,148475,BUY
2020-12-14 14:44:00,14:44,10041375,10160225,118850,BUY
2020-12-14 14:45:00,14:45,10010850,10204000,193150,BUY
2020-12-14 14:46:00,14:46,10020000,10192125,172125,BUY
2020-12-14 14:47:00,14:47,10050150,10246675,196525,BUY
2020-12-14 14:48:00,14:48,10048875,10296225,247350,BUY
2020-12-14 14:49:00,14:49,9991625,10278125,286500,BUY
2020-12-14 14:50:00,14:50,10035575,10252600,217025,BUY
2020-12-14 14:51:00,14:51,10035725,10199700,163975,BUY
2020-12-14 14:52:00,14:52,10027625,10199400,171775,BUY
2020-12-14 14:53:00,14:53,9978950,10180525,201575,BUY
2020-12-14 14:54:00,14:54,9968325,10178625,210300,BUY
2020-12-14 14:55:00,14:55,10006775,10177275,170500,BUY
2020-12-14 14:56:00,14:56,9932150,10176175,244025,BUY
2020-12-14 14:57:00,14:57,9960875,10073275,112400,BUY
2020-12-14 14:58:00,14:58,9972725,10057750,85025,BUY
2020-12-14 14:59:00,14:59,9957450,10092350,134900,BUY
2020-12-14 15:00:00,15:00,9994300,10046950,52650,BUY
2020-12-14 15:01:00,15:01,9963675,10043625,79950,BUY
2020-12-14 15:02:00,15:02,9913850,10042775,128925,BUY
2020-12-14 15:03:00,15:03,9953825,9960575,6750,BUY
2020-12-14 15:04:00,15:04,9923750,9998450,74700,BUY
2020-12-14 15:05:00,15:05,9953725,9968525,14800,BUY
2020-12-14 15:06:00,15:06,9912575,9944850,32275,BUY
2020-12-14 15:07:00,15:07,9877475,9940600,63125,BUY
2020-12-14 15:08:00,15:08,9912375,9950900,38525,BUY
2020-12-14 15:09:00,15:09,9831975,9832375,400,BUY
2020-12-14 15:10:00,15:10,9825225,9844325,19100,BUY
2020-12-14 15:11:00,15:11,9834575,9856525,21950,BUY
2020-12-14 15:12:00,15:12,9673650,9720225,46575,BUY
2020-12-14 15:13:00,15:13,9673175,9742850,69675,BUY
2020-12-14 15:14:00,15:14,9695350,9702250,6900,BUY
2020-12-14 15:15:00,15:15,9586075,9639575,53500,BUY
2020-12-14 15:16:00,15:16,9584475,9604875,20400,BUY
2020-12-14 15:17:00,15:17,9609375,9619775,10400,BUY
2020-12-14 15:18:00,15:18,9432150,9447700,15550,BUY
2020-12-14 15:19:00,15:19,9461875,9422150,-39725,SELL
2020-12-14 15:20:00,15:20,9466950,9463950,-3000,SELL
2020-12-14 15:21:00,15:21,9262875,9241800,-21075,SELL
2020-12-14 15:22:00,15:22,9267275,9251500,-15775,SELL
2020-12-14 15:23:00,15:23,9265850,9247500,-18350,SELL
2020-12-14 15:24:00,15:24,9089325,9060425,-28900,SELL
2020-12-14 15:25:00,15:25,9150500,9072975,-77525,SELL
2020-12-14 15:26:00,15:26,9119625,9047575,-72050,SELL
2020-12-14 15:27:00,15:27,8958625,8915425,-43200,SELL
2020-12-14 15:28:00,15:28,8956825,8904700,-52125,SELL
2020-12-14 15:29:00,15:29,8974325,8917325,-57000,SELL
2020-12-15 09:15:00,09:15,8839950,8747850,-92100,SELL
2020-12-15 09:16:00,09:16,8786675,8746000,-40675,SELL
2020-12-15 09:17:00,09:17,8962325,8884525,-77800,SELL
2020-12-15 09:18:00,09:18,8938075,8906175,-31900,SELL
2020-12-15 09:19:00,09:19,8933700,8880175,-53525,SELL
2020-12-15 09:20:00,09:20,9329550,9358900,29350,BUY
2020-12-15 09:21:00,09:21,9348875,9301875,-47000,SELL
2020-12-15 09:22:00,09:22,9339150,9295075,-44075,SELL
2020-12-15 09:23:00,09:23,9886575,9685950,-200625,SELL
2020-12-15 09:24:00,09:24,9918275,9709650,-208625,SELL
2020-12-15 09:25:00,09:25,9893425,9689400,-204025,SELL
2020-12-15 09:26:00,09:26,10039000,9890975,-148025,SELL
2020-12-15 09:27:00,09:27,10021875,9880350,-141525,SELL
2020-12-15 09:28:00,09:28,10016025,9867700,-148325,SELL
2020-12-15 09:29:00,09:29,10150075,10040075,-110000,SELL
2020-12-15 09:30:00,09:30,10169000,10044625,-124375,SELL
2020-12-15 09:31:00,09:31,10149100,9922150,-226950,SELL
2020-12-15 09:32:00,09:32,10372400,10121350,-251050,SELL
2020-12-15 09:33:00,09:33,10407025,10123475,-283550,SELL
2020-12-15 09:34:00,09:34,10370650,10110900,-259750,SELL
2020-12-15 09:35:00,09:35,10487850,10006250,-481600,SELL
2020-12-15 09:36:00,09:36,10497550,10019525,-478025,SELL
2020-12-15 09:37:00,09:37,10516375,10006225,-510150,SELL
2020-12-15 09:38:00,09:38,10633600,10015375,-618225,SELL
2020-12-15 09:39:00,09:39,10591550,10018175,-573375,SELL
2020-12-15 09:40:00,09:40,10611150,10034200,-576950,SELL
2020-12-15 09:41:00,09:41,10661350,10031025,-630325,SELL
2020-12-15 09:42:00,09:42,10668200,9951650,-716550,SELL
2020-12-15 09:43:00,09:43,10656625,10088475,-568150,SELL
2020-12-15 09:44:00,09:44,10687275,10213275,-474000,SELL
2020-12-15 09:45:00,09:45,10676375,10204175,-472200,SELL
2020-12-15 09:46:00,09:46,10695925,10215425,-480500,SELL
2020-12-15 09:47:00,09:47,10789850,10263925,-525925,SELL
2020-12-15 09:48:00,09:48,10771450,10303500,-467950,SELL
2020-12-15 09:49:00,09:49,10812350,10304575,-507775,SELL
2020-12-15 09:50:00,09:50,10879825,10291425,-588400,SELL
2020-12-15 09:51:00,09:51,10903000,10288250,-614750,SELL
2020-12-15 09:52:00,09:52,10907600,10286650,-620950,SELL
2020-12-15 09:53:00,09:53,11013900,10223000,-790900,SELL
2020-12-15 09:54:00,09:54,10991150,10249275,-741875,SELL
2020-12-15 09:55:00,09:55,11042925,10316800,-726125,SELL
2020-12-15 09:56:00,09:56,11116650,10141175,-975475,SELL
2020-12-15 09:57:00,09:57,11101750,10133250,-968500,SELL
2020-12-15 09:58:00,09:58,11106525,10156050,-950475,SELL
2020-12-15 09:59:00,09:59,11114675,10301300,-813375,SELL
2020-12-15 10:00:00,10:00,11119825,10309650,-810175,SELL
2020-12-15 10:01:00,10:01,11141325,10269350,-871975,SELL
2020-12-15 10:02:00,10:02,11255475,10379750,-875725,SELL
2020-12-15 10:03:00,10:03,11249450,10367925,-881525,SELL
2020-12-15 10:04:00,10:04,11270725,10383800,-886925,SELL
2020-12-15 10:05:00,10:05,11401450,10204625,-1196825,SELL
2020-12-15 10:06:00,10:06,11373425,10209250,-1164175,SELL
2020-12-15 10:07:00,10:07,11377825,10188925,-1188900,SELL
2020-12-15 10:08:00,10:08,11449325,9969425,-1479900,SELL
2020-12-15 10:09:00,10:09,11471850,9960700,-1511150,SELL
2020-12-15 10:10:00,10:10,11471850,9960575,-1511275,SELL
2020-12-15 10:11:00,10:11,11520300,9728825,-1791475,SELL
2020-12-15 10:12:00,10:12,11544025,9756025,-1788000,SELL
2020-12-15 10:13:00,10:13,11547350,9757300,-1790050,SELL
2020-12-15 10:14:00,10:14,11683600,9787175,-1896425,SELL
2020-12-15 10:15:00,10:15,11695550,9870475,-1825075,SELL
2020-12-15 10:16:00,10:16,11648425,9830750,-1817675,SELL
2020-12-15 10:17:00,10:17,11796300,9874650,-1921650,SELL
2020-12-15 10:18:00,10:18,11763625,9875550,-1888075,SELL
2020-12-15 10:19:00,10:19,11777400,9845500,-1931900,SELL
2020-12-15 10:20:00,10:20,11888900,9943975,-1944925,SELL
2020-12-15 10:21:00,10:21,11906875,9959675,-1947200,SELL
2020-12-15 10:22:00,10:22,11889350,9967425,-1921925,SELL
2020-12-15 10:23:00,10:23,12018150,9967150,-2051000,SELL
2020-12-15 10:24:00,10:24,11995475,9932150,-2063325,SELL
2020-12-15 10:25:00,10:25,12006700,9934700,-2072000,SELL
2020-12-15 10:26:00,10:26,12086675,9980225,-2106450,SELL
2020-12-15 10:27:00,10:27,12092200,10023750,-2068450,SELL
2020-12-15 10:28:00,10:28,12062750,10005125,-2057625,SELL
2020-12-15 10:29:00,10:29,12102125,10037125,-2065000,SELL
2020-12-15 10:30:00,10:30,12080900,10149500,-1931400,SELL
2020-12-15 10:31:00,10:31,12099375,10118325,-1981050,SELL
2020-12-15 10:36:00,10:36,12287825,10218975,-2068850,SELL
2020-12-15 10:37:00,10:37,12298300,10215925,-2082375,SELL
2020-12-15 10:38:00,10:38,12337725,10246225,-2091500,SELL
2020-12-15 10:39:00,10:39,12332800,10207700,-2125100,SELL
2020-12-15 10:40:00,10:40,12317550,10204750,-2112800,SELL
2020-12-15 10:41:00,10:41,12365700,10226675,-2139025,SELL
2020-12-15 10:42:00,10:42,12366325,10198775,-2167550,SELL
2020-12-15 10:43:00,10:43,12345750,10128825,-2216925,SELL
2020-12-15 10:44:00,10:44,12350975,9941725,-2409250,SELL
2020-12-15 10:45:00,10:45,12353775,10206825,-2146950,SELL
2020-12-15 10:46:00,10:46,12290350,10176525,-2113825,SELL
2020-12-15 10:47:00,10:47,12393125,10259500,-2133625,SELL
2020-12-15 10:48:00,10:48,12369675,10228000,-2141675,SELL
2020-12-15 10:49:00,10:49,12402225,10280850,-2121375,SELL
2020-12-15 10:50:00,10:50,12381825,10324950,-2056875,SELL
2020-12-15 10:51:00,10:51,12381550,10345425,-2036125,SELL
2020-12-15 10:52:00,10:52,12414825,10275875,-2138950,SELL
2020-12-15 10:53:00,10:53,12505050,10324425,-2180625,SELL
2020-12-15 10:54:00,10:54,12470050,10379000,-2091050,SELL
2020-12-15 10:55:00,10:55,12526775,10415850,-2110925,SELL
2020-12-15 10:56:00,10:56,12511625,10232325,-2279300,SELL
2020-12-15 10:57:00,10:57,12513850,10271500,-2242350,SELL
2020-12-15 10:58:00,10:58,12516775,10270750,-2246025,SELL
2020-12-15 10:59:00,10:59,12475750,10279400,-2196350,SELL
2020-12-15 11:00:00,11:00,12449450,10317625,-2131825,SELL
2020-12-15 11:01:00,11:01,12496775,10384850,-2111925,SELL
2020-12-15 11:02:00,11:02,12468550,10420825,-2047725,SELL
2020-12-15 11:03:00,11:03,12444275,10360300,-2083975,SELL
2020-12-15 11:04:00,11:04,12444275,10400750,-2043525,SELL
2020-12-15 11:05:00,11:05,12504875,10415825,-2089050,SELL
2020-12-15 11:06:00,11:06,12475600,10445825,-2029775,SELL
2020-12-15 11:07:00,11:07,12476400,10403025,-2073375,SELL
2020-12-15 11:08:00,11:08,12616725,10488625,-2128100,SELL
2020-12-15 11:09:00,11:09,12602250,10379750,-2222500,SELL
2020-12-15 11:10:00,11:10,12644500,10480875,-2163625,SELL
2020-12-15 11:11:00,11:11,12659525,10458000,-2201525,SELL
2020-12-15 11:12:00,11:12,12655250,10437500,-2217750,SELL
2020-12-15 11:13:00,11:13,12690000,10478300,-2211700,SELL
2020-12-15 11:14:00,11:14,12736200,10414650,-2321550,SELL
2020-12-15 11:15:00,11:15,12694975,10482600,-2212375,SELL
2020-12-15 11:16:00,11:16,12726475,10495975,-2230500,SELL
2020-12-15 11:17:00,11:17,12806325,10581900,-2224425,SELL
2020-12-15 11:18:00,11:18,12759875,10543650,-2216225,SELL
2020-12-15 11:19:00,11:19,12759875,9861100,-2898775,SELL
2020-12-15 11:20:00,11:20,12823325,10613775,-2209550,SELL
2020-12-15 11:21:00,11:21,12803300,10606250,-2197050,SELL
2020-12-15 11:22:00,11:22,12779200,10651000,-2128200,SELL
2020-12-15 11:23:00,11:23,12857275,10717250,-2140025,SELL
2020-12-15 11:24:00,11:24,12827675,10658275,-2169400,SELL
2020-12-15 11:25:00,11:25,12857275,10748250,-2109025,SELL
2020-12-15 11:26:00,11:26,12768425,10756300,-2012125,SELL
2020-12-15 11:27:00,11:27,12774175,10757400,-2016775,SELL
2020-12-15 11:28:00,11:28,12764275,10762350,-2001925,SELL
2020-12-15 11:29:00,11:29,12738700,10543000,-2195700,SELL
2020-12-15 11:30:00,11:30,12772325,10783575,-1988750,SELL
2020-12-15 11:31:00,11:31,12769300,10792150,-1977150,SELL
2020-12-15 11:32:00,11:32,12770325,10843800,-1926525,SELL
2020-12-15 11:33:00,11:33,12772000,10853225,-1918775,SELL
2020-12-15 11:34:00,11:34,12753225,10854500,-1898725,SELL
2020-12-15 11:35:00,11:35,12730050,10855050,-1875000,SELL
2020-12-15 11:36:00,11:36,12766700,10760050,-2006650,SELL
2020-12-15 11:37:00,11:37,12793050,10626150,-2166900,SELL
2020-12-15 11:38:00,11:38,12737950,10918125,-1819825,SELL
2020-12-15 11:39:00,11:39,12750500,10799100,-1951400,SELL
2020-12-15 11:40:00,11:40,12737925,10610800,-2127125,SELL
2020-12-15 11:41:00,11:41,12795875,10912475,-1883400,SELL
2020-12-15 11:46:00,11:46,12782575,10988700,-1793875,SELL
2020-12-15 11:47:00,11:47,12788050,10649475,-2138575,SELL
2020-12-15 11:48:00,11:48,12807850,10973025,-1834825,SELL
2020-12-15 11:49:00,11:49,12816225,10897650,-1918575,SELL
2020-12-15 11:50:00,11:50,12864700,10940475,-1924225,SELL
2020-12-15 11:51:00,11:51,12916300,11005950,-1910350,SELL
2020-12-15 11:52:00,11:52,12838725,10867950,-1970775,SELL
2020-12-15 11:53:00,11:53,12866675,10833650,-2033025,SELL
2020-12-15 11:54:00,11:54,12817800,10734375,-2083425,SELL
2020-12-15 11:55:00,11:55,12859475,10862450,-1997025,SELL
2020-12-15 11:56:00,11:56,12922475,10961875,-1960600,SELL
2020-12-15 11:57:00,11:57,12902050,10838850,-2063200,SELL
2020-12-15 11:58:00,11:58,12944400,10625825,-2318575,SELL
2020-12-15 11:59:00,11:59,12898050,10897550,-2000500,SELL
2020-12-15 12:00:00,12:00,12899625,10899000,-2000625,SELL
2020-12-15 12:01:00,12:01,12848325,10704200,-2144125,SELL
2020-12-15 12:02:00,12:02,12935000,10915675,-2019325,SELL
2020-12-15 12:03:00,12:03,12878275,10156100,-2722175,SELL
2020-12-15 12:04:00,12:04,12900275,10870175,-2030100,SELL
2020-12-15 12:05:00,12:05,12916025,10878350,-2037675,SELL
2020-12-15 12:06:00,12:06,12866700,10824500,-2042200,SELL
2020-12-15 12:07:00,12:07,12932175,11008425,-1923750,SELL
2020-12-15 12:08:00,12:08,12903425,10939400,-1964025,SELL
2020-12-15 12:09:00,12:09,12910400,10987200,-1923200,SELL
2020-12-15 12:10:00,12:10,12917525,11024900,-1892625,SELL
2020-12-15 12:11:00,12:11,12888150,10985975,-1902175,SELL
2020-12-15 12:12:00,12:12,12935625,11046650,-1888975,SELL
2020-12-15 12:13:00,12:13,12906750,10970950,-1935800,SELL
2020-12-15 12:14:00,12:14,12942675,11022275,-1920400,SELL
2020-12-15 12:15:00,12:15,12932625,11033000,-1899625,SELL
2020-12-15 12:16:00,12:16,12988400,11093050,-1895350,SELL
2020-12-15 12:17:00,12:17,12959200,11077000,-1882200,SELL
2020-12-15 12:18:00,12:18,12907825,10920275,-1987550,SELL
2020-12-15 12:19:00,12:19,12926850,11028075,-1898775,SELL
2020-12-15 12:20:00,12:20,12893150,11031100,-1862050,SELL
2020-12-15 12:21:00,12:21,12926250,11086225,-1840025,SELL
2020-12-15 12:22:00,12:22,12933875,11015225,-1918650,SELL
2020-12-15 12:23:00,12:23,12918475,11041100,-1877375,SELL
2020-12-15 12:24:00,12:24,12978550,11042175,-1936375,SELL
2020-12-15 12:25:00,12:25,13001825,11096350,-1905475,SELL
2020-12-15 12:26:00,12:26,12990425,11097025,-1893400,SELL
2020-12-15 12:27:00,12:27,12956300,10992675,-1963625,SELL
2020-12-15 12:28:00,12:28,12972350,10970650,-2001700,SELL
2020-12-15 12:29:00,12:29,12939925,10937325,-2002600,SELL
2020-12-15 12:30:00,12:30,13004675,10952675,-2052000,SELL
2020-12-15 12:31:00,12:31,13017475,10994700,-2022775,SELL
2020-12-15 12:32:00,12:32,13028050,11021800,-2006250,SELL
2020-12-15 12:33:00,12:33,12994675,10974200,-2020475,SELL
2020-12-15 12:34:00,12:34,12999075,11019400,-1979675,SELL
2020-12-15 12:35:00,12:35,13020425,10943550,-2076875,SELL
2020-12-15 12:36:00,12:36,13053100,10984625,-2068475,SELL
2020-12-15 12:37:00,12:37,13011300,10912675,-2098625,SELL
2020-12-15 12:38:00,12:38,13016150,10780025,-2236125,SELL
2020-12-15 12:39:00,12:39,12993050,10948550,-2044500,SELL
2020-12-15 12:40:00,12:40,12993050,10878075,-2114975,SELL
2020-12-15 12:41:00,12:41,13006875,10932075,-2074800,SELL
2020-12-15 12:42:00,12:42,12943600,10930425,-2013175,SELL
2020-12-15 12:43:00,12:43,12941925,10926225,-2015700,SELL
2020-12-15 12:44:00,12:44,13036725,11007350,-2029375,SELL
2020-12-15 12:45:00,12:45,13015325,10840725,-2174600,SELL
2020-12-15 12:46:00,12:46,12989400,10895575,-2093825,SELL
2020-12-15 12:47:00,12:47,12998900,10900925,-2097975,SELL
2020-12-15 12:48:00,12:48,12934775,10944175,-1990600,SELL
2020-12-15 12:49:00,12:49,12935400,10819525,-2115875,SELL
2020-12-15 12:50:00,12:50,12955625,10849150,-2106475,SELL
2020-12-15 12:51:00,12:51,12935575,10990700,-1944875,SELL
2020-12-15 12:52:00,12:52,12931800,11024650,-1907150,SELL
2020-12-15 12:53:00,12:53,12921275,11041050,-1880225,SELL
2020-12-15 12:54:00,12:54,12701100,10938450,-1762650,SELL
2020-12-15 12:55:00,12:55,12704075,10943475,-1760600,SELL
2020-12-15 12:56:00,12:56,12715500,10706375,-2009125,SELL
2020-12-15 12:57:00,12:57,12582725,10863300,-1719425,SELL
2020-12-15 12:58:00,12:58,12573675,10638600,-1935075,SELL
2020-12-15 12:59:00,12:59,12550450,10848650,-1701800,SELL
2020-12-15 13:00:00,13:00,12611525,10904225,-1707300,SELL
2020-12-15 13:01:00,13:01,12550250,10880375,-1669875,SELL
2020-12-15 13:02:00,13:02,12588225,10869500,-1718725,SELL
2020-12-15 13:03:00,13:03,12549075,10688075,-1861000,SELL
2020-12-15 13:04:00,13:04,12565150,10843200,-1721950,SELL
2020-12-15 13:05:00,13:05,12546375,10705425,-1840950,SELL
2020-12-15 13:06:00,13:06,12585175,10882150,-1703025,SELL
2020-12-15 13:07:00,13:07,12624225,10962025,-1662200,SELL
2020-12-15 13:08:00,13:08,12555100,10955375,-1599725,SELL
2020-12-15 13:09:00,13:09,12389225,10866050,-1523175,SELL
2020-12-15 13:10:00,13:10,12421025,10907075,-1513950,SELL
2020-12-15 13:11:00,13:11,12389225,10902750,-1486475,SELL
2020-12-15 13:12:00,13:12,12447800,10927625,-1520175,SELL
2020-12-15 13:13:00,13:13,12404650,10687225,-1717425,SELL
2020-12-15 13:14:00,13:14,12262675,10889675,-1373000,SELL
2020-12-15 13:15:00,13:15,12383825,10976900,-1406925,SELL
2020-12-15 13:16:00,13:16,12396600,10989325,-1407275,SELL
2020-12-15 13:17:00,13:17,12384250,11035325,-1348925,SELL
2020-12-15 13:18:00,13:18,12310675,10867575,-1443100,SELL
2020-12-15 13:19:00,13:19,12299850,10773675,-1526175,SELL
2020-12-15 13:20:00,13:20,12308675,10761350,-1547325,SELL
2020-12-15 13:21:00,13:21,12279275,10816900,-1462375,SELL
2020-12-15 13:22:00,13:22,12235850,10891275,-1344575,SELL
2020-12-15 13:23:00,13:23,12342900,10854625,-1488275,SELL
2020-12-15 13:24:00,13:24,12313425,10864225,-1449200,SELL
2020-12-15 13:25:00,13:25,12295000,10474275,-1820725,SELL
2020-12-15 13:26:00,13:26,12301650,10624525,-1677125,SELL
2020-12-15 13:27:00,13:27,12257750,10781125,-1476625,SELL
2020-12-15 13:28:00,13:28,12242700,10587900,-1654800,SELL
2020-12-15 13:29:00,13:29,12274750,10854900,-1419850,SELL
2020-12-15 13:30:00,13:30,12233500,10845525,-1387975,SELL
2020-12-15 13:31:00,13:31,12232025,10870925,-1361100,SELL
2020-12-15 13:32:00,13:32,12218150,10869600,-1348550,SELL
2020-12-15 13:33:00,13:33,12254650,10851250,-1403400,SELL
2020-12-15 13:34:00,13:34,12254650,10748325,-1506325,SELL
2020-12-15 13:35:00,13:35,12184100,10777925,-1406175,SELL
2020-12-15 13:36:00,13:36,12198800,10877700,-1321100,SELL
2020-12-15 13:37:00,13:37,12162450,10872625,-1289825,SELL
2020-12-15 13:38:00,13:38,12208500,10839150,-1369350,SELL
2020-12-15 13:39:00,13:39,12216850,10874175,-1342675,SELL
2020-12-15 13:40:00,13:40,12182375,10911100,-1271275,SELL
2020-12-15 13:41:00,13:41,12224025,10864725,-1359300,SELL
2020-12-15 13:42:00,13:42,12146775,10884700,-1262075,SELL
2020-12-15 13:43:00,13:43,12139575,10616825,-1522750,SELL
2020-12-15 13:44:00,13:44,12261825,10856650,-1405175,SELL
2020-12-15 13:45:00,13:45,12269775,10775025,-1494750,SELL
2020-12-15 13:46:00,13:46,12290650,10719925,-1570725,SELL
2020-12-15 13:47:00,13:47,12301700,10595325,-1706375,SELL
2020-12-15 13:48:00,13:48,12370050,10781675,-1588375,SELL
2020-12-15 13:49:00,13:49,12307650,9842175,-2465475,SELL
2020-12-15 13:50:00,13:50,12359350,10512400,-1846950,SELL
2020-12-15 13:51:00,13:51,12305275,10509725,-1795550,SELL
2020-12-15 13:52:00,13:52,12332325,10493875,-1838450,SELL
2020-12-15 13:53:00,13:53,12305275,10773125,-1532150,SELL
2020-12-15 13:54:00,13:54,12315725,10873875,-1441850,SELL
2020-12-15 13:55:00,13:55,12301225,10685575,-1615650,SELL
2020-12-15 13:56:00,13:56,12290725,10880450,-1410275,SELL
2020-12-15 13:57:00,13:57,12106600,10691850,-1414750,SELL
2020-12-15 13:58:00,13:58,12100000,10735425,-1364575,SELL
2020-12-15 13:59:00,13:59,12058350,10697875,-1360475,SELL
2020-12-15 14:00:00,14:00,12086425,10772875,-1313550,SELL
2020-12-15 14:01:00,14:01,12082675,10763875,-1318800,SELL
2020-12-15 14:02:00,14:02,12072875,10714650,-1358225,SELL
2020-12-15 14:03:00,14:03,11457125,10517800,-939325,SELL
2020-12-15 14:04:00,14:04,11479825,10554175,-925650,SELL
2020-12-15 14:05:00,14:05,11452850,10534850,-918000,SELL
2020-12-15 14:06:00,14:06,11282175,10394275,-887900,SELL
2020-12-15 14:07:00,14:07,11276350,10346400,-929950,SELL
2020-12-15 14:08:00,14:08,11286925,10326025,-960900,SELL
2020-12-15 14:09:00,14:09,11259400,10404550,-854850,SELL
2020-12-15 14:10:00,14:10,11254275,10414875,-839400,SELL
2020-12-15 14:11:00,14:11,11230175,10401225,-828950,SELL
2020-12-15 14:12:00,14:12,11279350,10281575,-997775,SELL
2020-12-15 14:13:00,14:13,11297900,10325650,-972250,SELL
2020-12-15 14:14:00,14:14,11305950,10319725,-986225,SELL
2020-12-15 14:15:00,14:15,11412475,10370025,-1042450,SELL
2020-12-15 14:16:00,14:16,11427025,10344250,-1082775,SELL
2020-12-15 14:17:00,14:17,11399275,10341600,-1057675,SELL
2020-12-15 14:18:00,14:18,11539125,10389325,-1149800,SELL
2020-12-15 14:19:00,14:19,11514775,10377725,-1137050,SELL
2020-12-15 14:20:00,14:20,11525550,10375625,-1149925,SELL
2020-12-15 14:21:00,14:21,11438300,10424675,-1013625,SELL
2020-12-15 14:22:00,14:22,11384025,10418775,-965250,SELL
2020-12-15 14:23:00,14:23,11407275,10195675,-1211600,SELL
2020-12-15 14:24:00,14:24,11388700,10335825,-1052875,SELL
2020-12-15 14:25:00,14:25,11348275,10258175,-1090100,SELL
2020-12-15 14:26:00,14:26,11343450,10302100,-1041350,SELL
2020-12-15 14:27:00,14:27,11453775,10314075,-1139700,SELL
2020-12-15 14:28:00,14:28,11440650,10135800,-1304850,SELL
2020-12-15 14:29:00,14:29,11418650,10338575,-1080075,SELL
2020-12-15 14:30:00,14:30,11457325,10402875,-1054450,SELL
2020-12-15 14:31:00,14:31,11438900,10337125,-1101775,SELL
2020-12-15 14:32:00,14:32,11434625,10356025,-1078600,SELL
2020-12-15 14:33:00,14:33,11577525,10298125,-1279400,SELL
2020-12-15 14:34:00,14:34,11592525,10326325,-1266200,SELL
2020-12-15 14:35:00,14:35,11583750,10305625,-1278125,SELL
2020-12-15 14:36:00,14:36,11578750,10319600,-1259150,SELL
2020-12-15 14:37:00,14:37,11546225,10112250,-1433975,SELL
2020-12-15 14:38:00,14:38,11552900,10333700,-1219200,SELL
2020-12-15 14:39:00,14:39,11580750,10277550,-1303200,SELL
2020-12-15 14:40:00,14:40,11628950,10370375,-1258575,SELL
2020-12-15 14:41:00,14:41,11617250,10343600,-1273650,SELL
2020-12-15 14:42:00,14:42,11601050,10301700,-1299350,SELL
2020-12-15 14:43:00,14:43,11632075,10262375,-1369700,SELL
2020-12-15 14:44:00,14:44,11621400,10323800,-1297600,SELL
2020-12-15 14:45:00,14:45,11576300,10298300,-1278000,SELL
2020-12-15 14:46:00,14:46,11576725,10270625,-1306100,SELL
2020-12-15 14:47:00,14:47,11575975,10291250,-1284725,SELL
2020-12-15 14:48:00,14:48,11551750,10304775,-1246975,SELL
2020-12-15 14:49:00,14:49,11556125,10297625,-1258500,SELL
2020-12-15 14:50:00,14:50,11561975,10299375,-1262600,SELL
2020-12-15 14:51:00,14:51,11582250,10295300,-1286950,SELL
2020-12-15 14:52:00,14:52,11550150,10293825,-1256325,SELL
2020-12-15 14:53:00,14:53,11560650,10212875,-1347775,SELL
2020-12-15 14:54:00,14:54,11437225,10081450,-1355775,SELL
2020-12-15 14:55:00,14:55,11437225,10173850,-1263375,SELL
2020-12-15 14:56:00,14:56,11444800,10184575,-1260225,SELL
2020-12-15 14:57:00,14:57,11437425,10179700,-1257725,SELL
2020-12-15 14:58:00,14:58,11449900,10135025,-1314875,SELL
2020-12-15 14:59:00,14:59,11409950,10151225,-1258725,SELL
2020-12-15 15:00:00,15:00,11378150,10049725,-1328425,SELL
2020-12-15 15:01:00,15:01,11349175,10033775,-1315400,SELL
2020-12-15 15:02:00,15:02,11371375,10052025,-1319350,SELL
2020-12-15 15:03:00,15:03,11290475,9949600,-1340875,SELL
2020-12-15 15:04:00,15:04,11236825,9947375,-1289450,SELL
2020-12-15 15:05:00,15:05,11286775,9966025,-1320750,SELL
2020-12-15 15:06:00,15:06,11197300,9795375,-1401925,SELL
2020-12-15 15:07:00,15:07,11183475,9817100,-1366375,SELL
2020-12-15 15:08:00,15:08,11180300,9800425,-1379875,SELL
2020-12-15 15:09:00,15:09,11092850,9714850,-1378000,SELL
2020-12-15 15:10:00,15:10,11131400,9715900,-1415500,SELL
2020-12-15 15:11:00,15:11,11098425,9713375,-1385050,SELL
2020-12-15 15:12:00,15:12,10874250,9528325,-1345925,SELL
2020-12-15 15:13:00,15:13,10869250,9526425,-1342825,SELL
2020-12-15 15:14:00,15:14,10860575,9455400,-1405175,SELL
2020-12-15 15:15:00,15:15,10752475,9352500,-1399975,SELL
2020-12-15 15:16:00,15:16,10760275,9358525,-1401750,SELL
2020-12-15 15:17:00,15:17,10752450,9362425,-1390025,SELL
2020-12-15 15:18:00,15:18,10579600,9197425,-1382175,SELL
2020-12-15 15:19:00,15:19,10596675,9182700,-1413975,SELL
2020-12-15 15:20:00,15:20,10639700,9195400,-1444300,SELL
2020-12-15 15:21:00,15:21,10459900,8975300,-1484600,SELL
2020-12-15 15:22:00,15:22,10435650,8977800,-1457850,SELL
2020-12-15 15:23:00,15:23,10425325,8979300,-1446025,SELL
2020-12-15 15:24:00,15:24,10235725,8852575,-1383150,SELL
2020-12-15 15:25:00,15:25,10304700,8859625,-1445075,SELL
2020-12-15 15:26:00,15:26,10251025,8846525,-1404500,SELL
2020-12-15 15:27:00,15:27,10164600,8732625,-1431975,SELL
2020-12-15 15:28:00,15:28,10163725,8711650,-1452075,SELL
2020-12-15 15:29:00,15:29,10190025,8735000,-1455025,SELL
2020-12-16 09:15:00,09:15,9951875,8519375,-1432500,SELL
2020-12-16 09:16:00,09:16,9966425,8505400,-1461025,SELL
2020-12-16 09:17:00,09:17,10108950,8819675,-1289275,SELL
2020-12-16 09:18:00,09:18,10103600,8838150,-1265450,SELL
2020-12-16 09:19:00,09:19,10088000,8821175,-1266825,SELL
2020-12-16 09:20:00,09:20,10884900,9555050,-1329850,SELL
2020-12-16 09:21:00,09:21,10922475,9555825,-1366650,SELL
2020-12-16 09:22:00,09:22,10869350,9560225,-1309125,SELL
2020-12-16 09:23:00,09:23,11158050,9746775,-1411275,SELL
2020-12-16 09:24:00,09:24,11169050,9806775,-1362275,SELL
2020-12-16 09:25:00,09:25,11183400,9837275,-1346125,SELL
2020-12-16 09:26:00,09:26,11392225,10144125,-1248100,SELL
2020-12-16 09:27:00,09:27,11400775,10124800,-1275975,SELL
2020-12-16 09:28:00,09:28,11371675,10131375,-1240300,SELL
2020-12-16 09:29:00,09:29,11581575,10281625,-1299950,SELL
2020-12-16 09:30:00,09:30,11548850,10282025,-1266825,SELL
2020-12-16 09:31:00,09:31,11573025,10273950,-1299075,SELL
2020-12-16 09:32:00,09:32,11642150,10489900,-1152250,SELL
2020-12-16 09:33:00,09:33,11623925,10535450,-1088475,SELL
2020-12-16 09:34:00,09:34,11668275,10486900,-1181375,SELL
2020-12-16 09:35:00,09:35,11818600,10685550,-1133050,SELL
2020-12-16 09:36:00,09:36,11769000,10683175,-1085825,SELL
2020-12-16 09:37:00,09:37,11773325,10688850,-1084475,SELL
2020-12-16 09:38:00,09:38,11757275,10888725,-868550,SELL
2020-12-16 09:39:00,09:39,11779850,10904475,-875375,SELL
2020-12-16 09:40:00,09:40,11749450,10909900,-839550,SELL
2020-12-16 09:41:00,09:41,11962375,11039875,-922500,SELL
2020-12-16 09:42:00,09:42,11954600,11076475,-878125,SELL
2020-12-16 09:43:00,09:43,11948350,11000950,-947400,SELL
2020-12-16 09:44:00,09:44,11939225,11195575,-743650,SELL
2020-12-16 09:45:00,09:45,11977200,11144600,-832600,SELL
2020-12-16 09:46:00,09:46,11991250,11180625,-810625,SELL
2020-12-16 09:47:00,09:47,12039600,11270200,-769400,SELL
2020-12-16 09:48:00,09:48,12042050,11293450,-748600,SELL
2020-12-16 09:49:00,09:49,12023225,11268975,-754250,SELL
2020-12-16 09:50:00,09:50,12019850,11455600,-564250,SELL
2020-12-16 09:51:00,09:51,12001950,11414975,-586975,SELL
2020-12-16 09:52:00,09:52,11991050,11441525,-549525,SELL
2020-12-16 09:53:00,09:53,11933775,11518375,-415400,SELL
2020-12-16 09:54:00,09:54,11921175,11491225,-429950,SELL
2020-12-16 09:55:00,09:55,11955075,11545125,-409950,SELL
2020-12-16 09:56:00,09:56,12063800,11540975,-522825,SELL
2020-12-16 09:57:00,09:57,12055275,11529325,-525950,SELL
2020-12-16 09:58:00,09:58,12021325,11476175,-545150,SELL
2020-12-16 09:59:00,09:59,12113525,11477775,-635750,SELL
2020-12-16 10:00:00,10:00,12134275,11536700,-597575,SELL
2020-12-16 10:01:00,10:01,12129675,11481850,-647825,SELL
2020-12-16 10:02:00,10:02,12221275,11527875,-693400,SELL
2020-12-16 10:03:00,10:03,12177350,11542250,-635100,SELL
2020-12-16 10:04:00,10:04,12164200,11483950,-680250,SELL
2020-12-16 10:05:00,10:05,12341750,11636200,-705550,SELL
2020-12-16 10:06:00,10:06,12319175,11612400,-706775,SELL
2020-12-16 10:07:00,10:07,12361175,11651450,-709725,SELL
2020-12-16 10:08:00,10:08,12393525,11397750,-995775,SELL
2020-12-16 10:09:00,10:09,12351075,11370850,-980225,SELL
2020-12-16 10:10:00,10:10,12394675,11349425,-1045250,SELL
2020-12-16 10:11:00,10:11,12548300,11507175,-1041125,SELL
2020-12-16 10:12:00,10:12,12528400,11511925,-1016475,SELL
2020-12-16 10:13:00,10:13,12549350,11487950,-1061400,SELL
2020-12-16 10:14:00,10:14,12660675,11600800,-1059875,SELL
2020-12-16 10:15:00,10:15,12644725,11587400,-1057325,SELL
2020-12-16 10:16:00,10:16,12661925,11555250,-1106675,SELL
2020-12-16 10:17:00,10:17,12757075,11682625,-1074450,SELL
2020-12-16 10:18:00,10:18,12740425,11668025,-1072400,SELL
2020-12-16 10:19:00,10:19,12727750,11665900,-1061850,SELL
2020-12-16 10:20:00,10:20,12761275,11724050,-1037225,SELL
2020-12-16 10:21:00,10:21,12672775,11714400,-958375,SELL
2020-12-16 10:22:00,10:22,12771725,11641600,-1130125,SELL
2020-12-16 10:23:00,10:23,12788775,11800350,-988425,SELL
2020-12-16 10:24:00,10:24,12838275,11832425,-1005850,SELL
2020-12-16 10:25:00,10:25,12789025,11849575,-939450,SELL
2020-12-16 10:26:00,10:26,12849850,11895750,-954100,SELL
2020-12-16 10:27:00,10:27,12776300,11066075,-1710225,SELL
2020-12-16 10:28:00,10:28,12857075,11843425,-1013650,SELL
2020-12-16 10:29:00,10:29,12980325,11914500,-1065825,SELL
2020-12-16 10:30:00,10:30,12975000,11909825,-1065175,SELL
2020-12-16 10:31:00,10:31,12971575,11965300,-1006275,SELL
2020-12-16 10:32:00,10:32,13090100,11972025,-1118075,SELL
2020-12-16 10:33:00,10:33,13079100,11856550,-1222550,SELL
2020-12-16 10:34:00,10:34,13079850,11669850,-1410000,SELL
2020-12-16 10:35:00,10:35,13168700,11996850,-1171850,SELL
2020-12-16 10:36:00,10:36,13197900,12072500,-1125400,SELL
2020-12-16 10:37:00,10:37,13167075,12033350,-1133725,SELL
2020-12-16 10:38:00,10:38,13135700,12053175,-1082525,SELL
2020-12-16 10:39:00,10:39,13225800,12025900,-1199900,SELL
2020-12-16 10:40:00,10:40,13227525,12033975,-1193550,SELL
2020-12-16 10:41:00,10:41,13271350,12143850,-1127500,SELL
2020-12-16 10:42:00,10:42,13284225,12134850,-1149375,SELL
2020-12-16 10:43:00,10:43,13266125,12139225,-1126900,SELL
2020-12-16 10:44:00,10:44,13276525,12152700,-1123825,SELL
2020-12-16 10:45:00,10:45,13348425,12179075,-1169350,SELL
2020-12-16 10:46:00,10:46,13302750,12172000,-1130750,SELL
2020-12-16 10:47:00,10:47,13276675,12180525,-1096150,SELL
2020-12-16 10:48:00,10:48,13327200,12156275,-1170925,SELL
2020-12-16 10:49:00,10:49,13322025,12182025,-1140000,SELL
2020-12-16 10:50:00,10:50,13467875,12250475,-1217400,SELL
2020-12-16 10:51:00,10:51,13426250,12254475,-1171775,SELL
2020-12-16 10:52:00,10:52,13383250,12227925,-1155325,SELL
2020-12-16 10:53:00,10:53,13446100,12321925,-1124175,SELL
2020-12-16 10:54:00,10:54,13280975,12252150,-1028825,SELL
2020-12-16 10:55:00,10:55,13353575,12209575,-1144000,SELL
2020-12-16 10:56:00,10:56,13460925,12275575,-1185350,SELL
2020-12-16 10:57:00,10:57,13439250,12300950,-1138300,SELL
2020-12-16 10:58:00,10:58,13390150,12283550,-1106600,SELL
2020-12-16 10:59:00,10:59,13490500,12271450,-1219050,SELL
2020-12-16 11:00:00,11:00,13495500,12295500,-1200000,SELL
2020-12-16 11:01:00,11:01,13454225,12282250,-1171975,SELL
2020-12-16 11:02:00,11:02,13468225,12192450,-1275775,SELL
2020-12-16 11:03:00,11:03,13468225,12174950,-1293275,SELL
2020-12-16 11:04:00,11:04,13463275,12214700,-1248575,SELL
2020-12-16 11:05:00,11:05,13470000,12214700,-1255300,SELL
2020-12-16 11:06:00,11:06,13470350,12219525,-1250825,SELL
2020-12-16 11:07:00,11:07,13324825,12155850,-1168975,SELL
2020-12-16 11:08:00,11:08,13391300,11369800,-2021500,SELL
2020-12-16 11:09:00,11:09,13509425,12232875,-1276550,SELL
2020-12-16 11:10:00,11:10,13520500,11977850,-1542650,SELL
2020-12-16 11:11:00,11:11,13532275,12047200,-1485075,SELL
2020-12-16 11:12:00,11:12,13546750,12277725,-1269025,SELL
2020-12-16 11:13:00,11:13,13546750,12269875,-1276875,SELL
2020-12-16 11:14:00,11:14,13547800,12126675,-1421125,SELL
2020-12-16 11:15:00,11:15,13539775,12247500,-1292275,SELL
2020-12-16 11:16:00,11:16,13537100,12261725,-1275375,SELL
2020-12-16 11:17:00,11:17,13612125,12283575,-1328550,SELL
2020-12-16 11:18:00,11:18,13592800,12245725,-1347075,SELL
2020-12-16 11:19:00,11:19,13589375,12195400,-1393975,SELL
2020-12-16 11:20:00,11:20,13628275,12257100,-1371175,SELL
2020-12-16 11:21:00,11:21,13653225,12264050,-1389175,SELL
2020-12-16 11:22:00,11:22,13642625,12217875,-1424750,SELL
2020-12-16 11:23:00,11:23,13658125,12235225,-1422900,SELL
2020-12-16 11:24:00,11:24,13668200,12257875,-1410325,SELL
2020-12-16 11:25:00,11:25,13684925,12058350,-1626575,SELL
2020-12-16 11:26:00,11:26,13708925,12322225,-1386700,SELL
2020-12-16 11:27:00,11:27,13461050,12274325,-1186725,SELL
2020-12-16 11:28:00,11:28,13630300,12296925,-1333375,SELL
2020-12-16 11:29:00,11:29,13666225,12221100,-1445125,SELL
2020-12-16 11:30:00,11:30,13740725,12296725,-1444000,SELL
2020-12-16 11:31:00,11:31,13686875,12355750,-1331125,SELL
2020-12-16 11:32:00,11:32,13716925,12356225,-1360700,SELL
2020-12-16 11:33:00,11:33,13692850,12362475,-1330375,SELL
2020-12-16 11:34:00,11:34,13704375,12360625,-1343750,SELL
2020-12-16 11:35:00,11:35,13778400,12164025,-1614375,SELL
2020-12-16 11:36:00,11:36,12993775,12318350,-675425,SELL
2020-12-16 11:37:00,11:37,13745800,12341975,-1403825,SELL
2020-12-16 11:38:00,11:38,13730775,12299250,-1431525,SELL
2020-12-16 11:39:00,11:39,13739625,12320500,-1419125,SELL
2020-12-16 11:40:00,11:40,13776950,12343825,-1433125,SELL
2020-12-16 11:41:00,11:41,13736850,12372850,-1364000,SELL
2020-12-16 11:42:00,11:42,13706400,12196325,-1510075,SELL
2020-12-16 11:43:00,11:43,13598425,12324175,-1274250,SELL
2020-12-16 11:44:00,11:44,13688375,12301075,-1387300,SELL
2020-12-16 11:45:00,11:45,13772975,12305450,-1467525,SELL
2020-12-16 11:46:00,11:46,13767725,12297825,-1469900,SELL
2020-12-16 11:47:00,11:47,13792000,12166125,-1625875,SELL
2020-12-16 11:48:00,11:48,13828700,12262500,-1566200,SELL
2020-12-16 11:49:00,11:49,13825075,12296175,-1528900,SELL
2020-12-16 11:50:00,11:50,13723100,12275175,-1447925,SELL
2020-12-16 11:51:00,11:51,13782425,11609650,-2172775,SELL
2020-12-16 11:52:00,11:52,13782300,12253075,-1529225,SELL
2020-12-16 11:53:00,11:53,13811525,12343450,-1468075,SELL
2020-12-16 11:54:00,11:54,13794100,12334125,-1459975,SELL
2020-12-16 11:55:00,11:55,13719825,12390950,-1328875,SELL
2020-12-16 11:56:00,11:56,13820075,12350975,-1469100,SELL
2020-12-16 11:57:00,11:57,13851700,12295350,-1556350,SELL
2020-12-16 11:58:00,11:58,13675325,12355550,-1319775,SELL
2020-12-16 11:59:00,11:59,13648175,12308950,-1339225,SELL
2020-12-16 12:00:00,12:00,13962650,12391350,-1571300,SELL
2020-12-16 12:01:00,12:01,13962075,12406975,-1555100,SELL
2020-12-16 12:02:00,12:02,13962075,12423925,-1538150,SELL
2020-12-16 12:03:00,12:03,13946150,12407925,-1538225,SELL
2020-12-16 12:04:00,12:04,13871425,12378250,-1493175,SELL
2020-12-16 12:05:00,12:05,13910400,12336100,-1574300,SELL
2020-12-16 12:06:00,12:06,13878475,12377725,-1500750,SELL
2020-12-16 12:07:00,12:07,13915275,12362925,-1552350,SELL
2020-12-16 12:08:00,12:08,13883750,12235475,-1648275,SELL
2020-12-16 12:09:00,12:09,13893150,12261400,-1631750,SELL
2020-12-16 12:10:00,12:10,13921350,12345150,-1576200,SELL
2020-12-16 12:11:00,12:11,13923600,12324650,-1598950,SELL
2020-12-16 12:12:00,12:12,13977925,12336575,-1641350,SELL
2020-12-16 12:13:00,12:13,13894475,12111775,-1782700,SELL
2020-12-16 12:14:00,12:14,13806925,12323325,-1483600,SELL
2020-12-16 12:15:00,12:15,13978275,12332150,-1646125,SELL
2020-12-16 12:16:00,12:16,13878575,12237525,-1641050,SELL
2020-12-16 12:17:00,12:17,13969675,11690125,-2279550,SELL
2020-12-16 12:18:00,12:18,13777425,12245800,-1531625,SELL
2020-12-16 12:19:00,12:19,13935000,12366450,-1568550,SELL
2020-12-16 12:20:00,12:20,13949225,12326400,-1622825,SELL
2020-12-16 12:21:00,12:21,14000225,12392900,-1607325,SELL
2020-12-16 12:22:00,12:22,13978675,12437625,-1541050,SELL
2020-12-16 12:23:00,12:23,13878225,12376925,-1501300,SELL
2020-12-16 12:24:00,12:24,13955600,12327650,-1627950,SELL
2020-12-16 12:25:00,12:25,14044275,12391625,-1652650,SELL
2020-12-16 12:26:00,12:26,14069975,12388200,-1681775,SELL
2020-12-16 12:27:00,12:27,14044675,12292100,-1752575,SELL
2020-12-16 12:28:00,12:28,14051575,12337650,-1713925,SELL
2020-12-16 12:29:00,12:29,14068150,12231175,-1836975,SELL
2020-12-16 12:30:00,12:30,14154950,12400350,-1754600,SELL
2020-12-16 12:31:00,12:31,14118650,12442275,-1676375,SELL
2020-12-16 12:32:00,12:32,14116675,12444825,-1671850,SELL
2020-12-16 12:33:00,12:33,13971250,11480350,-2490900,SELL
2020-12-16 12:34:00,12:34,13980075,11476250,-2503825,SELL
2020-12-16 12:35:00,12:35,13959125,11487775,-2471350,SELL
2020-12-16 12:36:00,12:36,14239600,11474525,-2765075,SELL
2020-12-16 12:37:00,12:37,14246100,11408800,-2837300,SELL
2020-12-16 12:38:00,12:38,14224100,11407800,-2816300,SELL
2020-12-16 12:39:00,12:39,14347425,11577125,-2770300,SELL
2020-12-16 12:40:00,12:40,14362425,11552125,-2810300,SELL
2020-12-16 12:41:00,12:41,14339675,11561600,-2778075,SELL
2020-12-16 12:42:00,12:42,14474050,11614050,-2860000,SELL
2020-12-16 12:43:00,12:43,14448225,11654475,-2793750,SELL
2020-12-16 12:44:00,12:44,14444800,11629575,-2815225,SELL
2020-12-16 12:45:00,12:45,14606950,11628500,-2978450,SELL
2020-12-16 12:46:00,12:46,14578700,11634600,-2944100,SELL
2020-12-16 12:47:00,12:47,14591875,11635150,-2956725,SELL
2020-12-16 12:48:00,12:48,14662525,11636075,-3026450,SELL
2020-12-16 12:49:00,12:49,14645075,11534625,-3110450,SELL
2020-12-16 12:50:00,12:50,14645075,11599000,-3046075,SELL
2020-12-16 12:51:00,12:51,14725175,11574000,-3151175,SELL
2020-12-16 12:52:00,12:52,14751150,11633575,-3117575,SELL
2020-12-16 12:53:00,12:53,14703725,11572200,-3131525,SELL
2020-12-16 12:54:00,12:54,14779375,11146575,-3632800,SELL
2020-12-16 12:55:00,12:55,14760975,11160725,-3600250,SELL
2020-12-16 12:56:00,12:56,14752950,11178950,-3574000,SELL
2020-12-16 12:57:00,12:57,14833325,11274425,-3558900,SELL
2020-12-16 12:58:00,12:58,14819375,11298075,-3521300,SELL
2020-12-16 12:59:00,12:59,14827300,11286350,-3540950,SELL
2020-12-16 13:00:00,13:00,14886050,11364850,-3521200,SELL
2020-12-16 13:01:00,13:01,14898925,11440075,-3458850,SELL
2020-12-16 13:02:00,13:02,14886950,11406775,-3480175,SELL
2020-12-16 13:03:00,13:03,14824150,11436675,-3387475,SELL
2020-12-16 13:04:00,13:04,14842700,11411500,-3431200,SELL
2020-12-16 13:05:00,13:05,14798975,11419475,-3379500,SELL
2020-12-16 13:06:00,13:06,14790425,11393175,-3397250,SELL
2020-12-16 13:07:00,13:07,14802950,11379600,-3423350,SELL
2020-12-16 13:08:00,13:08,14789000,11334550,-3454450,SELL
2020-12-16 13:09:00,13:09,14812850,11524125,-3288725,SELL
2020-12-16 13:10:00,13:10,14819000,11450250,-3368750,SELL
2020-12-16 13:11:00,13:11,14810325,11476875,-3333450,SELL
2020-12-16 13:12:00,13:12,14826375,11335675,-3490700,SELL
2020-12-16 13:13:00,13:13,14808875,11313000,-3495875,SELL
2020-12-16 13:14:00,13:14,14826375,11400175,-3426200,SELL
2020-12-16 13:15:00,13:15,14883925,10835325,-4048600,SELL
2020-12-16 13:16:00,13:16,14846675,11485575,-3361100,SELL
2020-12-16 13:17:00,13:17,14767250,11366700,-3400550,SELL
2020-12-16 13:18:00,13:18,14922475,11512575,-3409900,SELL
2020-12-16 13:19:00,13:19,14918575,11424375,-3494200,SELL
2020-12-16 13:20:00,13:20,14913075,11474350,-3438725,SELL
2020-12-16 13:21:00,13:21,14859650,11449600,-3410050,SELL
2020-12-16 13:22:00,13:22,14769925,11160475,-3609450,SELL
2020-12-16 13:23:00,13:23,14850075,11541750,-3308325,SELL
2020-12-16 13:24:00,13:24,14903975,11546750,-3357225,SELL
2020-12-16 13:25:00,13:25,14884650,11613475,-3271175,SELL
2020-12-16 13:26:00,13:26,14867300,11572025,-3295275,SELL
2020-12-16 13:27:00,13:27,14853100,11374300,-3478800,SELL
2020-12-16 13:28:00,13:28,14727675,11497450,-3230225,SELL
2020-12-16 13:29:00,13:29,14842100,11540750,-3301350,SELL
2020-12-16 13:30:00,13:30,14902950,11574225,-3328725,SELL
2020-12-16 13:31:00,13:31,14899325,11532400,-3366925,SELL
2020-12-16 13:32:00,13:32,14899325,11522650,-3376675,SELL
2020-12-16 13:33:00,13:33,14808275,11208750,-3599525,SELL
2020-12-16 13:34:00,13:34,14874600,11540200,-3334400,SELL
2020-12-16 13:35:00,13:35,14871975,11570425,-3301550,SELL
2020-12-16 13:36:00,13:36,14867150,11537775,-3329375,SELL
2020-12-16 13:37:00,13:37,14869800,11532700,-3337100,SELL
2020-12-16 13:38:00,13:38,14911525,11658400,-3253125,SELL
2020-12-16 13:39:00,13:39,14911325,11648425,-3262900,SELL
2020-12-16 13:40:00,13:40,14900100,11582550,-3317550,SELL
2020-12-16 13:41:00,13:41,14877500,11649150,-3228350,SELL
2020-12-16 13:42:00,13:42,14945675,11529575,-3416100,SELL
2020-12-16 13:43:00,13:43,14939525,11555700,-3383825,SELL
2020-12-16 13:44:00,13:44,14806950,11639025,-3167925,SELL
2020-12-16 13:45:00,13:45,14885650,11769300,-3116350,SELL
2020-12-16 13:46:00,13:46,14847200,11722625,-3124575,SELL
2020-12-16 13:47:00,13:47,14847575,11708225,-3139350,SELL
2020-12-16 13:48:00,13:48,14793825,11579100,-3214725,SELL
2020-12-16 13:49:00,13:49,14727250,11687250,-3040000,SELL
2020-12-16 13:50:00,13:50,14788525,11661400,-3127125,SELL
2020-12-16 13:51:00,13:51,14821925,11739600,-3082325,SELL
2020-12-16 13:52:00,13:52,14815225,11684850,-3130375,SELL
2020-12-16 13:53:00,13:53,14805000,11724700,-3080300,SELL
2020-12-16 13:54:00,13:54,14650475,11646650,-3003825,SELL
2020-12-16 13:55:00,13:55,14667050,11624525,-3042525,SELL
2020-12-16 13:56:00,13:56,14663225,11667300,-2995925,SELL
2020-12-16 13:57:00,13:57,14670925,11695675,-2975250,SELL
2020-12-16 13:58:00,13:58,14661125,11683775,-2977350,SELL
2020-12-16 13:59:00,13:59,14655700,11669000,-2986700,SELL
2020-12-16 14:00:00,14:00,14446375,11589275,-2857100,SELL
2020-12-16 14:01:00,14:01,14437600,11619775,-2817825,SELL
2020-12-16 14:02:00,14:02,14428925,11510375,-2918550,SELL
2020-12-16 14:03:00,14:03,14397525,11494175,-2903350,SELL
2020-12-16 14:04:00,14:04,14418325,11507875,-2910450,SELL
2020-12-16 14:05:00,14:05,14403875,11501025,-2902850,SELL
2020-12-16 14:06:00,14:06,14375075,11551425,-2823650,SELL
2020-12-16 14:07:00,14:07,14366325,11499325,-2867000,SELL
2020-12-16 14:08:00,14:08,14399600,11537550,-2862050,SELL
2020-12-16 14:09:00,14:09,14268300,11507975,-2760325,SELL
2020-12-16 14:10:00,14:10,14273950,10310550,-3963400,SELL
2020-12-16 14:11:00,14:11,14270800,11487300,-2783500,SELL
2020-12-16 14:12:00,14:12,14255850,11545000,-2710850,SELL
2020-12-16 14:13:00,14:13,14275700,11383450,-2892250,SELL
2020-12-16 14:14:00,14:14,14313125,11585650,-2727475,SELL
2020-12-16 14:15:00,14:15,14305300,11569975,-2735325,SELL
2020-12-16 14:16:00,14:16,14286550,11614825,-2671725,SELL
2020-12-16 14:17:00,14:17,14285050,11629100,-2655950,SELL
2020-12-16 14:18:00,14:18,14337325,11629525,-2707800,SELL
2020-12-16 14:19:00,14:19,14338625,11647975,-2690650,SELL
2020-12-16 14:20:00,14:20,14317525,11544975,-2772550,SELL
2020-12-16 14:21:00,14:21,14362700,11555025,-2807675,SELL
2020-12-16 14:22:00,14:22,14327700,11539150,-2788550,SELL
2020-12-16 14:23:00,14:23,14327700,11325775,-3001925,SELL
2020-12-16 14:24:00,14:24,14310000,11534825,-2775175,SELL
2020-12-16 14:25:00,14:25,14303600,11582425,-2721175,SELL
2020-12-16 14:26:00,14:26,14285525,11573325,-2712200,SELL
2020-12-16 14:27:00,14:27,14308400,11661525,-2646875,SELL
2020-12-16 14:28:00,14:28,14192875,11624425,-2568450,SELL
2020-12-16 14:29:00,14:29,14296175,11536275,-2759900,SELL
2020-12-16 14:30:00,14:30,14348925,11663800,-2685125,SELL
2020-12-16 14:31:00,14:31,14317100,11622550,-2694550,SELL
2020-12-16 14:32:00,14:32,14304875,11644375,-2660500,SELL
2020-12-16 14:33:00,14:33,14078925,11182850,-2896075,SELL
2020-12-16 14:34:00,14:34,14066425,11441700,-2624725,SELL
2020-12-16 14:35:00,14:35,14066425,11391075,-2675350,SELL
2020-12-16 14:36:00,14:36,14077750,11428000,-2649750,SELL
2020-12-16 14:37:00,14:37,14070125,11496300,-2573825,SELL
2020-12-16 14:38:00,14:38,14072475,11425400,-2647075,SELL
2020-12-16 14:39:00,14:39,13942325,11410900,-2531425,SELL
2020-12-16 14:40:00,14:40,13968450,11390950,-2577500,SELL
2020-12-16 14:41:00,14:41,13962900,11195725,-2767175,SELL
2020-12-16 14:42:00,14:42,13874100,11408450,-2465650,SELL
2020-12-16 14:43:00,14:43,13869725,11340925,-2528800,SELL
2020-12-16 14:44:00,14:44,13866225,11327250,-2538975,SELL
2020-12-16 14:45:00,14:45,13914650,11209150,-2705500,SELL
2020-12-16 14:46:00,14:46,13914625,11376325,-2538300,SELL
2020-12-16 14:47:00,14:47,13906275,11335275,-2571000,SELL
2020-12-16 14:48:00,14:48,13942325,11379675,-2562650,SELL
2020-12-16 14:49:00,14:49,13929275,11346825,-2582450,SELL
2020-12-16 14:50:00,14:50,13918275,11342875,-2575400,SELL
2020-12-16 14:51:00,14:51,13892325,11317425,-2574900,SELL
2020-12-16 14:52:00,14:52,13747800,11308400,-2439400,SELL
2020-12-16 14:53:00,14:53,13888350,11327250,-2561100,SELL
2020-12-16 14:54:00,14:54,13848525,11234275,-2614250,SELL
2020-12-16 14:55:00,14:55,13864950,11203350,-2661600,SELL
2020-12-16 14:56:00,14:56,13835125,11059125,-2776000,SELL
2020-12-16 14:57:00,14:57,13702350,11066300,-2636050,SELL
2020-12-16 14:58:00,14:58,13709950,10900625,-2809325,SELL
2020-12-16 14:59:00,14:59,13686450,11115275,-2571175,SELL
2020-12-16 15:00:00,15:00,13489425,11012325,-2477100,SELL
2020-12-16 15:01:00,15:01,13459950,11037150,-2422800,SELL
2020-12-16 15:02:00,15:02,13439775,11032300,-2407475,SELL
2020-12-16 15:03:00,15:03,13336125,10925250,-2410875,SELL
2020-12-16 15:04:00,15:04,13353975,10982900,-2371075,SELL
2020-12-16 15:05:00,15:05,13330500,10981125,-2349375,SELL
2020-12-16 15:06:00,15:06,13272175,10799500,-2472675,SELL
2020-12-16 15:07:00,15:07,13301425,10901200,-2400225,SELL
2020-12-16 15:08:00,15:08,13284075,10866250,-2417825,SELL
2020-12-16 15:09:00,15:09,13151050,10671375,-2479675,SELL
2020-12-16 15:10:00,15:10,13189150,10700125,-2489025,SELL
2020-12-16 15:11:00,15:11,13161075,10677050,-2484025,SELL
2020-12-16 15:12:00,15:12,13060050,10616725,-2443325,SELL
2020-12-16 15:13:00,15:13,13024550,10642400,-2382150,SELL
2020-12-16 15:14:00,15:14,13058875,10639725,-2419150,SELL
2020-12-16 15:15:00,15:15,12904275,10400950,-2503325,SELL
2020-12-16 15:16:00,15:16,12882225,10401600,-2480625,SELL
2020-12-16 15:17:00,15:17,12900375,10417450,-2482925,SELL
2020-12-16 15:18:00,15:18,12674550,10032425,-2642125,SELL
2020-12-16 15:19:00,15:19,12647450,10060600,-2586850,SELL
2020-12-16 15:20:00,15:20,12689650,10064175,-2625475,SELL
2020-12-16 15:21:00,15:21,12413525,9846575,-2566950,SELL
2020-12-16 15:22:00,15:22,12404050,9844200,-2559850,SELL
2020-12-16 15:23:00,15:23,12400325,9851575,-2548750,SELL
2020-12-16 15:24:00,15:24,12206725,9589300,-2617425,SELL
2020-12-16 15:25:00,15:25,12239675,9627525,-2612150,SELL
2020-12-16 15:26:00,15:26,12206575,9585175,-2621400,SELL
2020-12-16 15:27:00,15:27,11993475,9275575,-2717900,SELL
2020-12-16 15:28:00,15:28,12006775,9244775,-2762000,SELL
2020-12-16 15:29:00,15:29,12017450,9268450,-2749000,SELL
2020-12-17 09:15:00,09:15,11738775,8901625,-2837150,SELL
2020-12-17 09:16:00,09:16,11714775,8885000,-2829775,SELL
2020-12-17 09:17:00,09:17,11899900,9174300,-2725600,SELL
2020-12-17 09:18:00,09:18,11879950,9164975,-2714975,SELL
2020-12-17 09:19:00,09:19,11894925,9152075,-2742850,SELL
2020-12-17 09:20:00,09:20,12372325,9750100,-2622225,SELL
2020-12-17 09:21:00,09:21,12329250,9748850,-2580400,SELL
2020-12-17 09:22:00,09:22,12321600,9749450,-2572150,SELL
2020-12-17 09:23:00,09:23,12923900,10790525,-2133375,SELL
2020-12-17 09:24:00,09:24,12928075,10772350,-2155725,SELL
2020-12-17 09:25:00,09:25,12925275,10789050,-2136225,SELL
2020-12-17 09:26:00,09:26,13746100,11675275,-2070825,SELL
2020-12-17 09:27:00,09:27,13759400,11689875,-2069525,SELL
2020-12-17 09:28:00,09:28,13772100,11702825,-2069275,SELL
2020-12-17 09:29:00,09:29,14518100,12150250,-2367850,SELL
2020-12-17 09:30:00,09:30,14535750,12145325,-2390425,SELL
2020-12-17 09:31:00,09:31,14517300,12175100,-2342200,SELL
2020-12-17 09:32:00,09:32,14934275,12639500,-2294775,SELL
2020-12-17 09:33:00,09:33,14953325,12679250,-2274075,SELL
2020-12-17 09:34:00,09:34,14969725,12603825,-2365900,SELL
2020-12-17 09:35:00,09:35,15320400,13023325,-2297075,SELL
2020-12-17 09:36:00,09:36,15339950,13019000,-2320950,SELL
2020-12-17 09:37:00,09:37,15320175,13032175,-2288000,SELL
2020-12-17 09:38:00,09:38,15615625,13394650,-2220975,SELL
2020-12-17 09:39:00,09:39,15598375,13376025,-2222350,SELL
2020-12-17 09:40:00,09:40,15584950,13241275,-2343675,SELL
2020-12-17 09:41:00,09:41,15817375,13688750,-2128625,SELL
2020-12-17 09:42:00,09:42,15790475,13672200,-2118275,SELL
2020-12-17 09:43:00,09:43,15789675,13548275,-2241400,SELL
2020-12-17 09:44:00,09:44,16008100,13856300,-2151800,SELL
2020-12-17 09:45:00,09:45,16040200,13957425,-2082775,SELL
2020-12-17 09:46:00,09:46,15762325,13957950,-1804375,SELL
2020-12-17 09:47:00,09:47,15549750,14334325,-1215425,SELL
2020-12-17 09:48:00,09:48,15399975,14187525,-1212450,SELL
2020-12-17 09:49:00,09:49,15550325,14326250,-1224075,SELL
2020-12-17 09:50:00,09:50,15537950,14555250,-982700,SELL
2020-12-17 09:51:00,09:51,15589525,14564700,-1024825,SELL
2020-12-17 09:52:00,09:52,15574225,14508800,-1065425,SELL
2020-12-17 09:53:00,09:53,15749800,14751200,-998600,SELL
2020-12-17 09:54:00,09:54,15750475,14791225,-959250,SELL
2020-12-17 09:55:00,09:55,15743300,14741000,-1002300,SELL
2020-12-17 09:56:00,09:56,15796425,14613575,-1182850,SELL
2020-12-17 09:57:00,09:57,15682700,15003125,-679575,SELL
2020-12-17 09:58:00,09:58,15788350,14975475,-812875,SELL
2020-12-17 09:59:00,09:59,15876350,15077475,-798875,SELL
2020-12-17 10:00:00,10:00,15898850,15222800,-676050,SELL
2020-12-17 10:01:00,10:01,15918900,15065275,-853625,SELL
2020-12-17 10:02:00,10:02,15824825,15473450,-351375,SELL
2020-12-17 10:03:00,10:03,15842525,15439000,-403525,SELL
2020-12-17 10:04:00,10:04,15821450,15276900,-544550,SELL
2020-12-17 10:05:00,10:05,15959875,15485675,-474200,SELL
2020-12-17 10:06:00,10:06,15950350,15504575,-445775,SELL
2020-12-17 10:07:00,10:07,15945600,15416700,-528900,SELL
2020-12-17 10:08:00,10:08,15710675,15358150,-352525,SELL
2020-12-17 10:09:00,10:09,15949600,15625725,-323875,SELL
2020-12-17 10:10:00,10:10,15799200,15675775,-123425,SELL
2020-12-17 10:11:00,10:11,15999475,15812475,-187000,SELL
2020-12-17 10:12:00,10:12,16025725,15672625,-353100,SELL
2020-12-17 10:13:00,10:13,16027525,14955400,-1072125,SELL
2020-12-17 10:14:00,10:14,16072125,15872000,-200125,SELL
2020-12-17 10:15:00,10:15,16097700,15918975,-178725,SELL
2020-12-17 10:16:00,10:16,16010325,15841050,-169275,SELL
2020-12-17 10:17:00,10:17,16160325,15734550,-425775,SELL
2020-12-17 10:18:00,10:18,16084300,15501550,-582750,SELL
2020-12-17 10:19:00,10:19,16148975,15410975,-738000,SELL
2020-12-17 10:20:00,10:20,16139400,15742375,-397025,SELL
2020-12-17 10:21:00,10:21,16164900,15913975,-250925,SELL
2020-12-17 10:22:00,10:22,16196325,15817150,-379175,SELL
2020-12-17 10:23:00,10:23,16244475,15923800,-320675,SELL
2020-12-17 10:24:00,10:24,16118125,15920700,-197425,SELL
2020-12-17 10:25:00,10:25,16245525,16096825,-148700,SELL
2020-12-17 10:26:00,10:26,16284250,16121975,-162275,SELL
2020-12-17 10:27:00,10:27,16027900,15958300,-69600,SELL
2020-12-17 10:28:00,10:28,16220600,15981175,-239425,SELL
2020-12-17 10:29:00,10:29,16268275,15657700,-610575,SELL
2020-12-17 10:30:00,10:30,16286450,16100550,-185900,SELL
2020-12-17 10:31:00,10:31,16321400,16013625,-307775,SELL
2020-12-17 10:32:00,10:32,16182700,16288850,106150,BUY
2020-12-17 10:33:00,10:33,16444025,16326425,-117600,SELL
2020-12-17 10:34:00,10:34,15112725,16311900,1199175,BUY
2020-12-17 10:35:00,10:35,16388425,16309375,-79050,SELL
2020-12-17 10:36:00,10:36,16560850,16242375,-318475,SELL
2020-12-17 10:37:00,10:37,16494900,16302000,-192900,SELL
2020-12-17 10:38:00,10:38,16717225,16360275,-356950,SELL
2020-12-17 10:39:00,10:39,16427650,16081250,-346400,SELL
2020-12-17 10:40:00,10:40,16532950,16268650,-264300,SELL
2020-12-17 10:41:00,10:41,16652475,16145450,-507025,SELL
2020-12-17 10:42:00,10:42,16686500,16161275,-525225,SELL
2020-12-17 10:43:00,10:43,16686500,16151825,-534675,SELL
2020-12-17 10:44:00,10:44,16786075,16146650,-639425,SELL
2020-12-17 10:45:00,10:45,16839375,15577425,-1261950,SELL
2020-12-17 10:46:00,10:46,16844350,16109025,-735325,SELL
2020-12-17 10:47:00,10:47,16897500,16215500,-682000,SELL
2020-12-17 10:48:00,10:48,16723575,16247950,-475625,SELL
2020-12-17 10:49:00,10:49,16774550,15675925,-1098625,SELL
2020-12-17 10:50:00,10:50,16707500,16499275,-208225,SELL
2020-12-17 10:51:00,10:51,16871125,16553650,-317475,SELL
2020-12-17 10:52:00,10:52,16705400,16276650,-428750,SELL
2020-12-17 10:53:00,10:53,16886150,16444875,-441275,SELL
2020-12-17 10:54:00,10:54,16877725,16555375,-322350,SELL
2020-12-17 10:55:00,10:55,16944750,16425500,-519250,SELL
2020-12-17 10:56:00,10:56,16668525,16880000,211475,BUY
2020-12-17 10:57:00,10:57,16920750,16766000,-154750,SELL
2020-12-17 10:58:00,10:58,16947675,16933625,-14050,SELL
2020-12-17 10:59:00,10:59,16723650,16945025,221375,BUY
2020-12-17 11:00:00,11:00,16681075,16938650,257575,BUY
2020-12-17 11:01:00,11:01,16726625,16930350,203725,BUY
2020-12-17 11:02:00,11:02,16802875,16703975,-98900,SELL
2020-12-17 11:03:00,11:03,16787475,16980525,193050,BUY
2020-12-17 11:04:00,11:04,16782725,16979125,196400,BUY
2020-12-17 11:05:00,11:05,16738200,17169100,430900,BUY
2020-12-17 11:06:00,11:06,16667100,17104750,437650,BUY
2020-12-17 11:07:00,11:07,16681100,16986375,305275,BUY
2020-12-17 11:08:00,11:08,16922850,17096300,173450,BUY
2020-12-17 11:09:00,11:09,16660300,17101950,441650,BUY
2020-12-17 11:10:00,11:10,16667550,17140075,472525,BUY
2020-12-17 11:11:00,11:11,16687800,17228800,541000,BUY
2020-12-17 11:12:00,11:12,16692950,17129525,436575,BUY
2020-12-17 11:13:00,11:13,16811550,17063900,252350,BUY
2020-12-17 11:14:00,11:14,16980475,17170000,189525,BUY
2020-12-17 11:15:00,11:15,17036200,17285475,249275,BUY
2020-12-17 11:16:00,11:16,16852850,17161000,308150,BUY
2020-12-17 11:17:00,11:17,16838400,17329425,491025,BUY
2020-12-17 11:18:00,11:18,16662400,17299400,637000,BUY
2020-12-17 11:19:00,11:19,16808000,17188175,380175,BUY
2020-12-17 11:20:00,11:20,16870100,17361850,491750,BUY
2020-12-17 11:21:00,11:21,16910700,17076925,166225,BUY
2020-12-17 11:22:00,11:22,16957625,17250450,292825,BUY
2020-12-17 11:23:00,11:23,16829250,17084475,255225,BUY
2020-12-17 11:24:00,11:24,16910325,16915975,5650,BUY
2020-12-17 11:25:00,11:25,16960025,16857000,-103025,SELL
2020-12-17 11:26:00,11:26,16891800,17324575,432775,BUY
2020-12-17 11:27:00,11:27,17025425,17512550,487125,BUY
2020-12-17 11:28:00,11:28,17009050,17477075,468025,BUY
2020-12-17 11:29:00,11:29,16960200,17452875,492675,BUY
2020-12-17 11:30:00,11:30,17036400,17490700,454300,BUY
2020-12-17 11:31:00,11:31,16732775,17328250,595475,BUY
2020-12-17 11:32:00,11:32,17048550,17487850,439300,BUY
2020-12-17 11:33:00,11:33,16919500,17435725,516225,BUY
2020-12-17 11:34:00,11:34,16741025,16108825,-632200,SELL
2020-12-17 11:35:00,11:35,16800500,17423250,622750,BUY
2020-12-17 11:36:00,11:36,16943675,17311625,367950,BUY
2020-12-17 11:37:00,11:37,17022300,17164875,142575,BUY
2020-12-17 11:38:00,11:38,17066325,17540375,474050,BUY
2020-12-17 11:39:00,11:39,17033075,17261875,228800,BUY
2020-12-17 11:40:00,11:40,16801400,17128100,326700,BUY
2020-12-17 11:41:00,11:41,17076775,17005950,-70825,SELL
2020-12-17 11:42:00,11:42,17107500,17668000,560500,BUY
2020-12-17 11:43:00,11:43,16959950,17648075,688125,BUY
2020-12-17 11:44:00,11:44,16959675,17599150,639475,BUY
2020-12-17 11:45:00,11:45,17077450,17621775,544325,BUY
2020-12-17 11:46:00,11:46,17079450,17616275,536825,BUY
2020-12-17 11:47:00,11:47,17208825,17741100,532275,BUY
2020-12-17 11:48:00,11:48,17054400,17753650,699250,BUY
2020-12-17 11:49:00,11:49,17010875,17522975,512100,BUY
2020-12-17 11:50:00,11:50,17203125,17838875,635750,BUY
2020-12-17 11:51:00,11:51,16896800,17823175,926375,BUY
2020-12-17 11:52:00,11:52,17193000,17376775,183775,BUY
2020-12-17 11:53:00,11:53,17308600,17674000,365400,BUY
2020-12-17 11:54:00,11:54,17257075,17755525,498450,BUY
2020-12-17 11:55:00,11:55,17298350,17712925,414575,BUY
2020-12-17 11:56:00,11:56,17037975,17856550,818575,BUY
2020-12-17 11:57:00,11:57,17278600,17722825,444225,BUY
2020-12-17 11:58:00,11:58,17084175,17856750,772575,BUY
2020-12-17 11:59:00,11:59,17322025,17834550,512525,BUY
2020-12-17 12:00:00,12:00,17261650,17841175,579525,BUY
2020-12-17 12:01:00,12:01,17196725,17852175,655450,BUY
2020-12-17 12:02:00,12:02,17061975,17597025,535050,BUY
2020-12-17 12:03:00,12:03,17201650,17796925,595275,BUY
2020-12-17 12:04:00,12:04,17268200,17855225,587025,BUY
2020-12-17 12:05:00,12:05,17272100,17806400,534300,BUY
2020-12-17 12:06:00,12:06,16868750,17850550,981800,BUY
2020-12-17 12:07:00,12:07,16876275,17857150,980875,BUY
2020-12-17 12:08:00,12:08,16921025,17774825,853800,BUY
2020-12-17 12:09:00,12:09,16776325,17868725,1092400,BUY
2020-12-17 12:14:00,12:14,15278950,17680500,2401550,BUY
2020-12-17 12:15:00,12:15,15091025,17643775,2552750,BUY
2020-12-17 12:16:00,12:16,15091050,17634800,2543750,BUY
2020-12-17 12:17:00,12:17,15068050,17624450,2556400,BUY
2020-12-17 12:18:00,12:18,14996375,17720775,2724400,BUY
2020-12-17 12:19:00,12:19,14989400,17852800,2863400,BUY
2020-12-17 12:20:00,12:20,15010725,17935300,2924575,BUY
2020-12-17 12:21:00,12:21,15135775,18025625,2889850,BUY
2020-12-17 12:22:00,12:22,15125375,18005400,2880025,BUY
2020-12-17 12:23:00,12:23,15114375,17839175,2724800,BUY
2020-12-17 12:24:00,12:24,15217625,17996550,2778925,BUY
2020-12-17 12:25:00,12:25,15300375,18234825,2934450,BUY
2020-12-17 12:26:00,12:26,15280975,18186050,2905075,BUY
2020-12-17 12:27:00,12:27,15220075,18489875,3269800,BUY
2020-12-17 12:28:00,12:28,15223175,18302800,3079625,BUY
2020-12-17 12:29:00,12:29,15227350,18523550,3296200,BUY
2020-12-17 12:30:00,12:30,15139650,18710000,3570350,BUY
2020-12-17 12:31:00,12:31,15139225,18699200,3559975,BUY
2020-12-17 12:32:00,12:32,15131700,18674425,3542725,BUY
2020-12-17 12:33:00,12:33,15361225,18691700,3330475,BUY
2020-12-17 12:34:00,12:34,15378125,18748475,3370350,BUY
2020-12-17 12:35:00,12:35,15387500,18773800,3386300,BUY
2020-12-17 12:36:00,12:36,15730100,18826775,3096675,BUY
2020-12-17 12:37:00,12:37,15738200,18792675,3054475,BUY
2020-12-17 12:38:00,12:38,15731000,18772850,3041850,BUY
2020-12-17 12:39:00,12:39,15822925,18898725,3075800,BUY
2020-12-17 12:40:00,12:40,15831700,18939000,3107300,BUY
2020-12-17 12:41:00,12:41,15850475,18335625,2485150,BUY
2020-12-17 12:42:00,12:42,15862975,19078850,3215875,BUY
2020-12-17 12:43:00,12:43,15908025,19025350,3117325,BUY
2020-12-17 12:44:00,12:44,15805150,18926275,3121125,BUY
2020-12-17 12:45:00,12:45,16208275,18923025,2714750,BUY
2020-12-17 12:46:00,12:46,16197175,18861300,2664125,BUY
2020-12-17 12:47:00,12:47,16033750,18241075,2207325,BUY
2020-12-17 12:48:00,12:48,16145700,18862450,2716750,BUY
2020-12-17 12:49:00,12:49,16174625,18824700,2650075,BUY
2020-12-17 12:50:00,12:50,16175225,18718675,2543450,BUY
2020-12-17 12:51:00,12:51,16304900,19036900,2732000,BUY
2020-12-17 12:52:00,12:52,16213450,18439950,2226500,BUY
2020-12-17 12:53:00,12:53,16274575,18876775,2602200,BUY
2020-12-17 12:54:00,12:54,16425225,18826100,2400875,BUY
2020-12-17 12:55:00,12:55,16400750,18979925,2579175,BUY
2020-12-17 12:56:00,12:56,16402300,18936525,2534225,BUY
2020-12-17 12:57:00,12:57,15952425,18650150,2697725,BUY
2020-12-17 12:58:00,12:58,15916800,18681375,2764575,BUY
2020-12-17 12:59:00,12:59,15818325,18684625,2866300,BUY
2020-12-17 13:00:00,13:00,16055900,18803950,2748050,BUY
2020-12-17 13:01:00,13:01,16045325,18574250,2528925,BUY
2020-12-17 13:02:00,13:02,15941075,18274350,2333275,BUY
2020-12-17 13:03:00,13:03,16168650,18925475,2756825,BUY
2020-12-17 13:04:00,13:04,16165500,18854950,2689450,BUY
2020-12-17 13:05:00,13:05,16202150,18931275,2729125,BUY
2020-12-17 13:06:00,13:06,16230225,18572425,2342200,BUY
2020-12-17 13:07:00,13:07,16220075,18602275,2382200,BUY
2020-12-17 13:08:00,13:08,16234775,18654025,2419250,BUY
2020-12-17 13:09:00,13:09,16374400,18723900,2349500,BUY
2020-12-17 13:10:00,13:10,16409450,18823775,2414325,BUY
2020-12-17 13:11:00,13:11,16269700,18622325,2352625,BUY
2020-12-17 13:12:00,13:12,16445050,18641275,2196225,BUY
2020-12-17 13:13:00,13:13,16115900,18711850,2595950,BUY
2020-12-17 13:14:00,13:14,16461525,18501525,2040000,BUY
2020-12-17 13:15:00,13:15,16409800,18698600,2288800,BUY
2020-12-17 13:16:00,13:16,16380600,18149750,1769150,BUY
2020-12-17 13:17:00,13:17,16395375,18782975,2387600,BUY
2020-12-17 13:18:00,13:18,16312300,18756950,2444650,BUY
2020-12-17 13:19:00,13:19,16335475,18815025,2479550,BUY
2020-12-17 13:20:00,13:20,16389600,18786500,2396900,BUY
2020-12-17 13:21:00,13:21,16547575,18801400,2253825,BUY
2020-12-17 13:22:00,13:22,16571600,18798025,2226425,BUY
2020-12-17 13:23:00,13:23,16539275,18802100,2262825,BUY
2020-12-17 13:24:00,13:24,16652875,18686275,2033400,BUY
2020-12-17 13:25:00,13:25,16675900,18805050,2129150,BUY
2020-12-17 13:26:00,13:26,16555975,18786075,2230100,BUY
2020-12-17 13:27:00,13:27,16618050,18629500,2011450,BUY
2020-12-17 13:28:00,13:28,16716425,18746600,2030175,BUY
2020-12-17 13:29:00,13:29,16716500,18669500,1953000,BUY
2020-12-17 13:30:00,13:30,16726325,18373450,1647125,BUY
2020-12-17 13:31:00,13:31,16695000,18374600,1679600,BUY
2020-12-17 13:32:00,13:32,16711175,18287825,1576650,BUY
2020-12-17 13:33:00,13:33,16737625,18286025,1548400,BUY
2020-12-17 13:34:00,13:34,16713750,18248225,1534475,BUY
2020-12-17 13:35:00,13:35,16718525,18275100,1556575,BUY
2020-12-17 13:36:00,13:36,16668275,17961625,1293350,BUY
2020-12-17 13:37:00,13:37,16602750,18086800,1484050,BUY
2020-12-17 13:38:00,13:38,16650025,17872150,1222125,BUY
2020-12-17 13:39:00,13:39,16673600,17975600,1302000,BUY
2020-12-17 13:40:00,13:40,16736725,17839750,1103025,BUY
2020-12-17 13:41:00,13:41,16682800,18016425,1333625,BUY
2020-12-17 13:42:00,13:42,16745200,18027075,1281875,BUY
2020-12-17 13:43:00,13:43,16953550,18097400,1143850,BUY
2020-12-17 13:44:00,13:44,16918725,17999475,1080750,BUY
2020-12-17 13:45:00,13:45,16882400,17766775,884375,BUY
2020-12-17 13:46:00,13:46,16898750,18000675,1101925,BUY
2020-12-17 13:47:00,13:47,16897275,17918650,1021375,BUY
2020-12-17 13:48:00,13:48,16983575,17992500,1008925,BUY
2020-12-17 13:49:00,13:49,16971300,17846050,874750,BUY
2020-12-17 13:50:00,13:50,16924075,17950125,1026050,BUY
2020-12-17 13:51:00,13:51,16892325,17978175,1085850,BUY
2020-12-17 13:52:00,13:52,16924025,18092500,1168475,BUY
2020-12-17 13:53:00,13:53,16912300,18177400,1265100,BUY
2020-12-17 13:54:00,13:54,16932400,18268100,1335700,BUY
2020-12-17 13:55:00,13:55,16972000,17958200,986200,BUY
2020-12-17 13:56:00,13:56,16874025,18217425,1343400,BUY
2020-12-17 13:57:00,13:57,16939850,18026750,1086900,BUY
2020-12-17 13:58:00,13:58,17045250,18205850,1160600,BUY
2020-12-17 13:59:00,13:59,17070900,18169600,1098700,BUY
2020-12-17 14:00:00,14:00,17000325,18295625,1295300,BUY
2020-12-17 14:01:00,14:01,16938125,18186125,1248000,BUY
2020-12-17 14:02:00,14:02,17001875,17430525,428650,BUY
2020-12-17 14:03:00,14:03,16900925,18145125,1244200,BUY
2020-12-17 14:04:00,14:04,16893375,17398300,504925,BUY
2020-12-17 14:05:00,14:05,16871275,17951725,1080450,BUY
2020-12-17 14:06:00,14:06,16925900,18034400,1108500,BUY
2020-12-17 14:07:00,14:07,16862050,18180525,1318475,BUY
2020-12-17 14:08:00,14:08,16813600,18154275,1340675,BUY
2020-12-17 14:09:00,14:09,16960700,17317900,357200,BUY
2020-12-17 14:10:00,14:10,16957575,17937700,980125,BUY
2020-12-17 14:11:00,14:11,16948750,17777825,829075,BUY
2020-12-17 14:12:00,14:12,17034400,17812300,777900,BUY
2020-12-17 14:13:00,14:13,17111575,17728325,616750,BUY
2020-12-17 14:14:00,14:14,17121100,17791375,670275,BUY
2020-12-17 14:15:00,14:15,16996150,17754400,758250,BUY
2020-12-17 14:16:00,14:16,17037725,17970250,932525,BUY
2020-12-17 14:17:00,14:17,17044175,17661375,617200,BUY
2020-12-17 14:18:00,14:18,17091725,17721500,629775,BUY
2020-12-17 14:19:00,14:19,17033175,17506750,473575,BUY
2020-12-17 14:20:00,14:20,17047925,17551700,503775,BUY
2020-12-17 14:21:00,14:21,16916600,17084375,167775,BUY
2020-12-17 14:22:00,14:22,16874700,17278025,403325,BUY
2020-12-17 14:23:00,14:23,16903400,17328250,424850,BUY
2020-12-17 14:24:00,14:24,16386350,16800250,413900,BUY
2020-12-17 14:25:00,14:25,16375600,16802300,426700,BUY
2020-12-17 14:26:00,14:26,16385075,16789725,404650,BUY
2020-12-17 14:27:00,14:27,16370675,16943475,572800,BUY
2020-12-17 14:28:00,14:28,16357225,16821150,463925,BUY
2020-12-17 14:29:00,14:29,16357950,16942425,584475,BUY
2020-12-17 14:30:00,14:30,16419900,16937300,517400,BUY
2020-12-17 14:31:00,14:31,16413850,17011575,597725,BUY
2020-12-17 14:32:00,14:32,16423525,16937300,513775,BUY
2020-12-17 14:33:00,14:33,16168600,16782600,614000,BUY
2020-12-17 14:34:00,14:34,16202225,16312425,110200,BUY
2020-12-17 14:35:00,14:35,16219175,16827200,608025,BUY
2020-12-17 14:36:00,14:36,16267150,17150925,883775,BUY
2020-12-17 14:37:00,14:37,16242450,17116075,873625,BUY
2020-12-17 14:38:00,14:38,16190125,17145650,955525,BUY
2020-12-17 14:39:00,14:39,16092050,17072725,980675,BUY
2020-12-17 14:40:00,14:40,16125250,17143650,1018400,BUY
2020-12-17 14:41:00,14:41,16108025,17088950,980925,BUY
2020-12-17 14:42:00,14:42,15937850,17305150,1367300,BUY
2020-12-17 14:43:00,14:43,15909925,17234800,1324875,BUY
2020-12-17 14:44:00,14:44,15943550,16891800,948250,BUY
2020-12-17 14:45:00,14:45,15684050,17021900,1337850,BUY
2020-12-17 14:46:00,14:46,15728325,17091675,1363350,BUY
2020-12-17 14:47:00,14:47,15622350,17061675,1439325,BUY
2020-12-17 14:48:00,14:48,15610100,17216100,1606000,BUY
2020-12-17 14:49:00,14:49,15598825,17194250,1595425,BUY
2020-12-17 14:50:00,14:50,15608400,17164775,1556375,BUY
2020-12-17 14:51:00,14:51,15440275,16691400,1251125,BUY
2020-12-17 14:52:00,14:52,15422925,16739025,1316100,BUY
2020-12-17 14:53:00,14:53,15440600,16724900,1284300,BUY
2020-12-17 14:54:00,14:54,15199750,16398600,1198850,BUY
2020-12-17 14:55:00,14:55,15186325,16391475,1205150,BUY
2020-12-17 14:56:00,14:56,15187000,16429525,1242525,BUY
2020-12-17 14:57:00,14:57,15006625,15985000,978375,BUY
2020-12-17 14:58:00,14:58,15045950,15836700,790750,BUY
2020-12-17 14:59:00,14:59,15013375,15296075,282700,BUY
2020-12-17 15:00:00,15:00,14703475,15862625,1159150,BUY
2020-12-17 15:01:00,15:01,14845850,15796075,950225,BUY
2020-12-17 15:02:00,15:02,14831775,15674450,842675,BUY
2020-12-17 15:03:00,15:03,14511275,15111325,600050,BUY
2020-12-17 15:04:00,15:04,14507450,15242525,735075,BUY
2020-12-17 15:05:00,15:05,14511325,15305125,793800,BUY
2020-12-17 15:06:00,15:06,13988000,14753100,765100,BUY
2020-12-17 15:07:00,15:07,13984225,14881625,897400,BUY
2020-12-17 15:08:00,15:08,13980600,14851300,870700,BUY
2020-12-17 15:09:00,15:09,13432000,14206700,774700,BUY
2020-12-17 15:10:00,15:10,13418850,14272825,853975,BUY
2020-12-17 15:11:00,15:11,13371225,14334200,962975,BUY
2020-12-17 15:12:00,15:12,12825375,13690225,864850,BUY
2020-12-17 15:13:00,15:13,12763175,13721550,958375,BUY
2020-12-17 15:14:00,15:14,12819900,13688225,868325,BUY
2020-12-17 15:15:00,15:15,12268300,13235200,966900,BUY
2020-12-17 15:16:00,15:16,12217825,13185550,967725,BUY
2020-12-17 15:17:00,15:17,12168675,13168550,999875,BUY
2020-12-17 15:18:00,15:18,11459550,12670775,1211225,BUY
2020-12-17 15:19:00,15:19,11439325,12647675,1208350,BUY
2020-12-17 15:20:00,15:20,11454825,12577350,1122525,BUY
2020-12-17 15:21:00,15:21,10656850,11786425,1129575,BUY
2020-12-17 15:22:00,15:22,10686950,11684300,997350,BUY
2020-12-17 15:23:00,15:23,10673650,11041275,367625,BUY
2020-12-17 15:24:00,15:24,9927650,10990350,1062700,BUY
2020-12-17 15:25:00,15:25,9920875,11452900,1532025,BUY
2020-12-17 15:26:00,15:26,10017975,11505025,1487050,BUY
2020-12-17 15:27:00,15:27,9396625,9893700,497075,BUY
2020-12-17 15:28:00,15:28,9385950,9922425,536475,BUY
2020-12-17 15:29:00,15:29,9379500,10001200,621700,BUY
