,timestamp,call,put,diff,sellOrBuy
2020-12-04 09:15:00,09:15,3505300,3309725,-195575,SELL
2020-12-04 09:16:00,09:16,3528975,3311125,-217850,SELL
2020-12-04 09:17:00,09:17,3900175,3623875,-276300,SELL
2020-12-04 09:18:00,09:18,3892100,3624850,-267250,SELL
2020-12-04 09:19:00,09:19,3848800,3617425,-231375,SELL
2020-12-04 09:20:00,09:20,4250950,3921850,-329100,SELL
2020-12-04 09:21:00,09:21,4250750,3920325,-330425,SELL
2020-12-04 09:22:00,09:22,4249225,3908975,-340250,SELL
2020-12-04 09:23:00,09:23,4540300,4081950,-458350,SELL
2020-12-04 09:24:00,09:24,4564225,4090675,-473550,SELL
2020-12-04 09:25:00,09:25,4563625,4091675,-471950,SELL
2020-12-04 09:26:00,09:26,4822150,4251275,-570875,SELL
2020-12-04 09:27:00,09:27,4826150,4226125,-600025,SELL
2020-12-04 09:28:00,09:28,4832125,4233600,-598525,SELL
2020-12-04 09:29:00,09:29,5113275,4413325,-699950,SELL
2020-12-04 09:30:00,09:30,5085550,4422550,-663000,SELL
2020-12-04 09:31:00,09:31,5068350,4403450,-664900,SELL
2020-12-04 09:32:00,09:32,5323725,4584875,-738850,SELL
2020-12-04 09:33:00,09:33,5326925,4565750,-761175,SELL
2020-12-04 09:34:00,09:34,5321375,4575275,-746100,SELL
2020-12-04 09:35:00,09:35,5390550,4687275,-703275,SELL
2020-12-04 09:36:00,09:36,5396925,4663800,-733125,SELL
2020-12-04 09:37:00,09:37,5392200,4680325,-711875,SELL
2020-12-04 09:38:00,09:38,5505000,4729100,-775900,SELL
2020-12-04 09:39:00,09:39,5510975,4735275,-775700,SELL
2020-12-04 09:40:00,09:40,5489100,4754425,-734675,SELL
2020-12-04 09:41:00,09:41,5621300,4835525,-785775,SELL
2020-12-04 09:42:00,09:42,5613750,4832900,-780850,SELL
2020-12-04 09:43:00,09:43,5588825,4834475,-754350,SELL
2020-12-04 09:44:00,09:44,5568750,4920675,-648075,SELL
2020-12-04 09:45:00,09:45,5542400,4919100,-623300,SELL
2020-12-04 09:46:00,09:46,5519375,4920650,-598725,SELL
2020-12-04 09:47:00,09:47,5550175,5049825,-500350,SELL
2020-12-04 09:48:00,09:48,5575550,5037025,-538525,SELL
2020-12-04 09:49:00,09:49,5567850,5049825,-518025,SELL
2020-12-04 09:50:00,09:50,5534650,5163100,-371550,SELL
2020-12-04 09:51:00,09:51,5535400,5165075,-370325,SELL
2020-12-04 09:52:00,09:52,5534650,5166200,-368450,SELL
2020-12-04 09:53:00,09:53,5479425,5234975,-244450,SELL
2020-12-04 09:54:00,09:54,5435775,5234975,-200800,SELL
2020-12-04 09:55:00,09:55,5484200,5223300,-260900,SELL
2020-12-04 09:56:00,09:56,5500250,5305000,-195250,SELL
2020-12-04 09:57:00,09:57,5543425,5315475,-227950,SELL
2020-12-04 09:58:00,09:58,5495050,5324950,-170100,SELL
2020-12-04 09:59:00,09:59,5573400,5406025,-167375,SELL
2020-12-04 10:00:00,10:00,5614075,5408050,-206025,SELL
2020-12-04 10:01:00,10:01,5624500,5408975,-215525,SELL
2020-12-04 10:02:00,10:02,5714225,5536050,-178175,SELL
2020-12-04 10:03:00,10:03,5708125,5535050,-173075,SELL
2020-12-04 10:04:00,10:04,5704250,5533175,-171075,SELL
2020-12-04 10:05:00,10:05,5799650,5683950,-115700,SELL
2020-12-04 10:06:00,10:06,5774925,5707800,-67125,SELL
2020-12-04 10:07:00,10:07,5803975,5704600,-99375,SELL
2020-12-04 10:08:00,10:08,5830200,5848975,18775,BUY
2020-12-04 10:09:00,10:09,5818450,5851050,32600,BUY
2020-12-04 10:10:00,10:10,5833525,5839425,5900,BUY
2020-12-04 10:11:00,10:11,5947100,5923950,-23150,SELL
2020-12-04 10:12:00,10:12,5960100,5923950,-36150,SELL
2020-12-04 10:13:00,10:13,5956125,5925225,-30900,SELL
2020-12-04 10:14:00,10:14,5870775,5986675,115900,BUY
2020-12-04 10:15:00,10:15,5843400,5986850,143450,BUY
2020-12-04 10:16:00,10:16,5873700,5987250,113550,BUY
2020-12-04 10:17:00,10:17,5791750,6099500,307750,BUY
2020-12-04 10:18:00,10:18,5803900,6099175,295275,BUY
2020-12-04 10:19:00,10:19,5829700,6100275,270575,BUY
2020-12-04 10:20:00,10:20,5740375,6188150,447775,BUY
2020-12-04 10:21:00,10:21,5736950,6188725,451775,BUY
2020-12-04 10:22:00,10:22,5712500,6189025,476525,BUY
2020-12-04 10:23:00,10:23,5642400,6328325,685925,BUY
2020-12-04 10:24:00,10:24,5666675,6326675,660000,BUY
2020-12-04 10:25:00,10:25,5692100,6328375,636275,BUY
2020-12-04 10:26:00,10:26,5812425,6435275,622850,BUY
2020-12-04 10:27:00,10:27,5829750,6435275,605525,BUY
2020-12-04 10:28:00,10:28,5804325,6435375,631050,BUY
2020-12-04 10:29:00,10:29,5756575,6576000,819425,BUY
2020-12-04 10:30:00,10:30,5769600,6577625,808025,BUY
2020-12-04 10:31:00,10:31,5766800,6577475,810675,BUY
2020-12-04 10:32:00,10:32,5691225,6760200,1068975,BUY
2020-12-04 10:33:00,10:33,5667975,6760075,1092100,BUY
2020-12-04 10:34:00,10:34,5663125,6760275,1097150,BUY
2020-12-04 10:35:00,10:35,5880350,6971625,1091275,BUY
2020-12-04 10:36:00,10:36,5888925,6970125,1081200,BUY
2020-12-04 10:37:00,10:37,5909750,6971575,1061825,BUY
2020-12-04 10:38:00,10:38,5992175,7087875,1095700,BUY
2020-12-04 10:39:00,10:39,5997900,7087675,1089775,BUY
2020-12-04 10:40:00,10:40,5997900,7084150,1086250,BUY
2020-12-04 10:41:00,10:41,6044575,7178675,1134100,BUY
2020-12-04 10:42:00,10:42,6074000,7180300,1106300,BUY
2020-12-04 10:43:00,10:43,6077425,7180300,1102875,BUY
2020-12-04 10:44:00,10:44,6228450,7185550,957100,BUY
2020-12-04 10:45:00,10:45,6178500,7184650,1006150,BUY
2020-12-04 10:46:00,10:46,6200525,7185375,984850,BUY
2020-12-04 10:47:00,10:47,6318925,7246750,927825,BUY
2020-12-04 10:48:00,10:48,6293450,7246750,953300,BUY
2020-12-04 10:49:00,10:49,6335050,7245400,910350,BUY
2020-12-04 10:50:00,10:50,6460875,7306100,845225,BUY
2020-12-04 10:51:00,10:51,6428250,7302925,874675,BUY
2020-12-04 10:52:00,10:52,6432825,7301225,868400,BUY
2020-12-04 10:53:00,10:53,6510475,7315400,804925,BUY
2020-12-04 10:54:00,10:54,6510700,7280000,769300,BUY
2020-12-04 10:55:00,10:55,6508700,7313550,804850,BUY
2020-12-04 10:56:00,10:56,6664700,7376400,711700,BUY
2020-12-04 10:57:00,10:57,6633625,7371975,738350,BUY
2020-12-04 10:58:00,10:58,6644175,7373700,729525,BUY
2020-12-04 10:59:00,10:59,6706750,7412800,706050,BUY
2020-12-04 11:00:00,11:00,6722850,7416350,693500,BUY
2020-12-04 11:01:00,11:01,6744225,7419275,675050,BUY
2020-12-04 11:02:00,11:02,6786475,7399275,612800,BUY
2020-12-04 11:03:00,11:03,6795575,7402850,607275,BUY
2020-12-04 11:04:00,11:04,6782350,7395100,612750,BUY
2020-12-04 11:05:00,11:05,6812050,7409150,597100,BUY
2020-12-04 11:06:00,11:06,6827900,7443575,615675,BUY
2020-12-04 11:07:00,11:07,6822725,7443775,621050,BUY
2020-12-04 11:08:00,11:08,6866350,7445775,579425,BUY
2020-12-04 11:09:00,11:09,6904700,7488500,583800,BUY
2020-12-04 11:10:00,11:10,6855225,7486200,630975,BUY
2020-12-04 11:11:00,11:11,6943375,7496100,552725,BUY
2020-12-04 11:12:00,11:12,6912275,7498600,586325,BUY
2020-12-04 11:13:00,11:13,6907025,7496825,589800,BUY
2020-12-04 11:14:00,11:14,6974750,7513325,538575,BUY
2020-12-04 11:15:00,11:15,6985950,7511975,526025,BUY
2020-12-04 11:16:00,11:16,7012925,7513200,500275,BUY
2020-12-04 11:17:00,11:17,7020200,7528100,507900,BUY
2020-12-04 11:18:00,11:18,6995425,7507750,512325,BUY
2020-12-04 11:19:00,11:19,7053175,7530875,477700,BUY
2020-12-04 11:20:00,11:20,7095625,7455150,359525,BUY
2020-12-04 11:21:00,11:21,7052475,7454075,401600,BUY
2020-12-04 11:22:00,11:22,7068450,7453350,384900,BUY
2020-12-04 11:23:00,11:23,7150350,7429100,278750,BUY
2020-12-04 11:24:00,11:24,7152325,7460025,307700,BUY
2020-12-04 11:25:00,11:25,7123325,7461325,338000,BUY
2020-12-04 11:26:00,11:26,7170175,7503800,333625,BUY
2020-12-04 11:27:00,11:27,7195500,7507050,311550,BUY
2020-12-04 11:28:00,11:28,7159850,7502325,342475,BUY
2020-12-04 11:29:00,11:29,7201975,7539125,337150,BUY
2020-12-04 11:30:00,11:30,7203475,7540250,336775,BUY
2020-12-04 11:31:00,11:31,7194075,7540250,346175,BUY
2020-12-04 11:32:00,11:32,7229375,7514050,284675,BUY
2020-12-04 11:33:00,11:33,7242525,7519175,276650,BUY
2020-12-04 11:34:00,11:34,7236575,7518500,281925,BUY
2020-12-04 11:35:00,11:35,7254500,7534725,280225,BUY
2020-12-04 11:36:00,11:36,7303400,7535375,231975,BUY
2020-12-04 11:37:00,11:37,7298425,7537125,238700,BUY
2020-12-04 11:38:00,11:38,7282100,7503750,221650,BUY
2020-12-04 11:39:00,11:39,7315350,7504500,189150,BUY
2020-12-04 11:40:00,11:40,7322325,7504500,182175,BUY
2020-12-04 11:41:00,11:41,7329275,7365875,36600,BUY
2020-12-04 11:42:00,11:42,7310850,7364100,53250,BUY
2020-12-04 11:43:00,11:43,7313200,7365975,52775,BUY
2020-12-04 11:44:00,11:44,7363725,7416125,52400,BUY
2020-12-04 11:45:00,11:45,7372100,7412975,40875,BUY
2020-12-04 11:46:00,11:46,7352300,7416125,63825,BUY
2020-12-04 11:47:00,11:47,7362575,7495575,133000,BUY
2020-12-04 11:48:00,11:48,7373325,7495975,122650,BUY
2020-12-04 11:49:00,11:49,7376675,7487375,110700,BUY
2020-12-04 11:50:00,11:50,7345800,7488150,142350,BUY
2020-12-04 11:51:00,11:51,7254425,7460475,206050,BUY
2020-12-04 11:52:00,11:52,7368950,7490675,121725,BUY
2020-12-04 11:53:00,11:53,7347950,7517725,169775,BUY
2020-12-04 11:54:00,11:54,7361950,7486100,124150,BUY
2020-12-04 11:55:00,11:55,7356100,7490175,134075,BUY
2020-12-04 11:56:00,11:56,7359350,7549025,189675,BUY
2020-12-04 11:57:00,11:57,7366550,7515450,148900,BUY
2020-12-04 11:58:00,11:58,7379725,7562600,182875,BUY
2020-12-04 11:59:00,11:59,7353250,7561325,208075,BUY
2020-12-04 12:00:00,12:00,7327650,7521425,193775,BUY
2020-12-04 12:01:00,12:01,7360900,7557000,196100,BUY
2020-12-04 12:02:00,12:02,7319375,7539125,219750,BUY
2020-12-04 12:03:00,12:03,7325050,7545425,220375,BUY
2020-12-04 12:04:00,12:04,7348950,7542100,193150,BUY
2020-12-04 12:05:00,12:05,7371750,7521225,149475,BUY
2020-12-04 12:06:00,12:06,7381050,7558475,177425,BUY
2020-12-04 12:07:00,12:07,7376950,7552650,175700,BUY
2020-12-04 12:08:00,12:08,7421550,7587350,165800,BUY
2020-12-04 12:09:00,12:09,7414100,7589800,175700,BUY
2020-12-04 12:10:00,12:10,7441100,7559050,117950,BUY
2020-12-04 12:11:00,12:11,7421425,7586400,164975,BUY
2020-12-04 12:12:00,12:12,7427150,7584500,157350,BUY
2020-12-04 12:13:00,12:13,7436450,7588500,152050,BUY
2020-12-04 12:14:00,12:14,7351025,7587200,236175,BUY
2020-12-04 12:15:00,12:15,7445575,7592075,146500,BUY
2020-12-04 12:16:00,12:16,7431750,7564275,132525,BUY
2020-12-04 12:17:00,12:17,7476000,7595450,119450,BUY
2020-12-04 12:18:00,12:18,7516725,7635275,118550,BUY
2020-12-04 12:19:00,12:19,7478175,7623475,145300,BUY
2020-12-04 12:20:00,12:20,7517375,7659325,141950,BUY
2020-12-04 12:21:00,12:21,7514125,7659900,145775,BUY
2020-12-04 12:22:00,12:22,7441325,7624250,182925,BUY
2020-12-04 12:23:00,12:23,7539325,7682875,143550,BUY
2020-12-04 12:24:00,12:24,7523200,7682800,159600,BUY
2020-12-04 12:25:00,12:25,7539675,7682800,143125,BUY
2020-12-04 12:26:00,12:26,7543700,7712900,169200,BUY
2020-12-04 12:27:00,12:27,7569075,7708025,138950,BUY
2020-12-04 12:28:00,12:28,7571225,7748300,177075,BUY
2020-12-04 12:29:00,12:29,7555750,7722650,166900,BUY
2020-12-04 12:30:00,12:30,7524275,7710300,186025,BUY
2020-12-04 12:31:00,12:31,7536125,7712475,176350,BUY
2020-12-04 12:32:00,12:32,7583125,7731325,148200,BUY
2020-12-04 12:33:00,12:33,7572075,7729625,157550,BUY
2020-12-04 12:34:00,12:34,7585625,7726425,140800,BUY
2020-12-04 12:35:00,12:35,7563725,7608625,44900,BUY
2020-12-04 12:36:00,12:36,7605925,7615350,9425,BUY
2020-12-04 12:37:00,12:37,7579025,7601125,22100,BUY
2020-12-04 12:38:00,12:38,7613625,7535975,-77650,SELL
2020-12-04 12:39:00,12:39,7607950,7502100,-105850,SELL
2020-12-04 12:40:00,12:40,7628475,7528250,-100225,SELL
2020-12-04 12:41:00,12:41,7606050,7483125,-122925,SELL
2020-12-04 12:42:00,12:42,7558975,7520925,-38050,SELL
2020-12-04 12:43:00,12:43,7557225,7516275,-40950,SELL
2020-12-04 12:44:00,12:44,7604750,7486000,-118750,SELL
2020-12-04 12:45:00,12:45,7631650,7472300,-159350,SELL
2020-12-04 12:46:00,12:46,7620925,7484425,-136500,SELL
2020-12-04 12:47:00,12:47,7613475,7496550,-116925,SELL
2020-12-04 12:48:00,12:48,7643200,7505825,-137375,SELL
2020-12-04 12:49:00,12:49,7647800,7505825,-141975,SELL
2020-12-04 12:50:00,12:50,7624950,7197625,-427325,SELL
2020-12-04 12:51:00,12:51,7620475,7197700,-422775,SELL
2020-12-04 12:52:00,12:52,7614550,7190675,-423875,SELL
2020-12-04 12:53:00,12:53,7631025,7197125,-433900,SELL
2020-12-04 12:54:00,12:54,7628475,7193750,-434725,SELL
2020-12-04 12:55:00,12:55,7668875,7205825,-463050,SELL
2020-12-04 12:56:00,12:56,7673875,6993500,-680375,SELL
2020-12-04 12:57:00,12:57,7670500,6986275,-684225,SELL
2020-12-04 12:58:00,12:58,7676225,6982125,-694100,SELL
2020-12-04 12:59:00,12:59,7680275,6983925,-696350,SELL
2020-12-04 13:00:00,13:00,7683600,6966850,-716750,SELL
2020-12-04 13:01:00,13:01,7657875,6976800,-681075,SELL
2020-12-04 13:02:00,13:02,7674300,7000875,-673425,SELL
2020-12-04 13:03:00,13:03,7678300,7006400,-671900,SELL
2020-12-04 13:04:00,13:04,7692950,7001875,-691075,SELL
2020-12-04 13:05:00,13:05,7649600,6991175,-658425,SELL
2020-12-04 13:06:00,13:06,7620425,6982600,-637825,SELL
2020-12-04 13:07:00,13:07,7611150,6979475,-631675,SELL
2020-12-04 13:08:00,13:08,7629925,6979275,-650650,SELL
2020-12-04 13:09:00,13:09,7619675,6984500,-635175,SELL
2020-12-04 13:10:00,13:10,7597800,6964375,-633425,SELL
2020-12-04 13:11:00,13:11,7572000,7026625,-545375,SELL
2020-12-04 13:12:00,13:12,7620825,7032375,-588450,SELL
2020-12-04 13:13:00,13:13,7592100,7022625,-569475,SELL
2020-12-04 13:14:00,13:14,7588275,6999425,-588850,SELL
2020-12-04 13:15:00,13:15,7610250,7006450,-603800,SELL
2020-12-04 13:16:00,13:16,7599000,6996775,-602225,SELL
2020-12-04 13:17:00,13:17,7610225,7017150,-593075,SELL
2020-12-04 13:18:00,13:18,7608800,6991150,-617650,SELL
2020-12-04 13:19:00,13:19,7608800,7012325,-596475,SELL
2020-12-04 13:20:00,13:20,7661225,7050450,-610775,SELL
2020-12-04 13:21:00,13:21,7629875,7044000,-585875,SELL
2020-12-04 13:22:00,13:22,7662850,7054350,-608500,SELL
2020-12-04 13:23:00,13:23,7551675,7036625,-515050,SELL
2020-12-04 13:24:00,13:24,7544625,7040775,-503850,SELL
2020-12-04 13:25:00,13:25,7593975,7052400,-541575,SELL
2020-12-04 13:26:00,13:26,7557075,7100325,-456750,SELL
2020-12-04 13:27:00,13:27,7555000,7087700,-467300,SELL
2020-12-04 13:28:00,13:28,7536200,7084675,-451525,SELL
2020-12-04 13:29:00,13:29,7551200,7140800,-410400,SELL
2020-12-04 13:30:00,13:30,7582750,7147575,-435175,SELL
2020-12-04 13:31:00,13:31,7538850,7143400,-395450,SELL
2020-12-04 13:32:00,13:32,7577875,7176900,-400975,SELL
2020-12-04 13:33:00,13:33,7557725,7177125,-380600,SELL
2020-12-04 13:34:00,13:34,7550875,7173125,-377750,SELL
2020-12-04 13:35:00,13:35,7550000,7213375,-336625,SELL
2020-12-04 13:36:00,13:36,7529600,7194250,-335350,SELL
2020-12-04 13:37:00,13:37,7546025,7202500,-343525,SELL
2020-12-04 13:38:00,13:38,7583450,7201075,-382375,SELL
2020-12-04 13:39:00,13:39,7574525,7219000,-355525,SELL
2020-12-04 13:40:00,13:40,7561000,7223075,-337925,SELL
2020-12-04 13:41:00,13:41,7584125,7232275,-351850,SELL
2020-12-04 13:42:00,13:42,7609625,7236925,-372700,SELL
2020-12-04 13:43:00,13:43,7604950,7232275,-372675,SELL
2020-12-04 13:44:00,13:44,7505075,7245625,-259450,SELL
2020-12-04 13:45:00,13:45,7530650,7251850,-278800,SELL
2020-12-04 13:46:00,13:46,7511400,7251675,-259725,SELL
2020-12-04 13:47:00,13:47,7573075,7302750,-270325,SELL
2020-12-04 13:48:00,13:48,7548500,7293600,-254900,SELL
2020-12-04 13:49:00,13:49,7587450,7303675,-283775,SELL
2020-12-04 13:50:00,13:50,7554975,7274700,-280275,SELL
2020-12-04 13:51:00,13:51,7461950,7232550,-229400,SELL
2020-12-04 13:52:00,13:52,7464825,7237750,-227075,SELL
2020-12-04 13:53:00,13:53,7462400,7248325,-214075,SELL
2020-12-04 13:54:00,13:54,7475450,7227925,-247525,SELL
2020-12-04 13:55:00,13:55,7475450,7236800,-238650,SELL
2020-12-04 13:56:00,13:56,7467000,7216075,-250925,SELL
2020-12-04 13:57:00,13:57,7465650,7211350,-254300,SELL
2020-12-04 13:58:00,13:58,7469625,7202550,-267075,SELL
2020-12-04 13:59:00,13:59,7472450,7204550,-267900,SELL
2020-12-04 14:00:00,14:00,7528175,7211375,-316800,SELL
2020-12-04 14:01:00,14:01,7567075,7216950,-350125,SELL
2020-12-04 14:02:00,14:02,7513200,7212625,-300575,SELL
2020-12-04 14:03:00,14:03,7564875,7198950,-365925,SELL
2020-12-04 14:04:00,14:04,7564875,7176500,-388375,SELL
2020-12-04 14:05:00,14:05,7542450,7199050,-343400,SELL
2020-12-04 14:06:00,14:06,7591050,7199975,-391075,SELL
2020-12-04 14:07:00,14:07,7588075,7176475,-411600,SELL
2020-12-04 14:08:00,14:08,7585700,7177550,-408150,SELL
2020-12-04 14:09:00,14:09,7589750,7199000,-390750,SELL
2020-12-04 14:10:00,14:10,7589750,7227450,-362300,SELL
2020-12-04 14:11:00,14:11,7618675,7242425,-376250,SELL
2020-12-04 14:12:00,14:12,7597225,7208100,-389125,SELL
2020-12-04 14:13:00,14:13,7617175,7218925,-398250,SELL
2020-12-04 14:14:00,14:14,7619600,7218850,-400750,SELL
2020-12-04 14:15:00,14:15,7602875,7248175,-354700,SELL
2020-12-04 14:16:00,14:16,7596500,7200100,-396400,SELL
2020-12-04 14:17:00,14:17,7625225,7254125,-371100,SELL
2020-12-04 14:18:00,14:18,7620900,7261150,-359750,SELL
2020-12-04 14:19:00,14:19,7614850,7246325,-368525,SELL
2020-12-04 14:20:00,14:20,7620225,7231575,-388650,SELL
2020-12-04 14:21:00,14:21,7662900,7269025,-393875,SELL
2020-12-04 14:22:00,14:22,7641675,7267975,-373700,SELL
2020-12-04 14:23:00,14:23,7634375,7268125,-366250,SELL
2020-12-04 14:24:00,14:24,7611750,7299400,-312350,SELL
2020-12-04 14:25:00,14:25,7658950,7306875,-352075,SELL
2020-12-04 14:26:00,14:26,7639325,7309350,-329975,SELL
2020-12-04 14:27:00,14:27,7622675,7318200,-304475,SELL
2020-12-04 14:28:00,14:28,7636475,7314275,-322200,SELL
2020-12-04 14:29:00,14:29,7639325,7314550,-324775,SELL
2020-12-04 14:30:00,14:30,7454050,7319875,-134175,SELL
2020-12-04 14:31:00,14:31,7463825,7320625,-143200,SELL
2020-12-04 14:32:00,14:32,7480375,7315925,-164450,SELL
2020-12-04 14:33:00,14:33,7391400,7344375,-47025,SELL
2020-12-04 14:34:00,14:34,7385425,7344825,-40600,SELL
2020-12-04 14:35:00,14:35,7412825,7337675,-75150,SELL
2020-12-04 14:36:00,14:36,7317475,7288850,-28625,SELL
2020-12-04 14:37:00,14:37,7348800,7286050,-62750,SELL
2020-12-04 14:38:00,14:38,7320425,7278575,-41850,SELL
2020-12-04 14:39:00,14:39,7276500,7304125,27625,BUY
2020-12-04 14:40:00,14:40,7279175,7305425,26250,BUY
2020-12-04 14:41:00,14:41,7283025,7304875,21850,BUY
2020-12-04 14:42:00,14:42,7115425,7293950,178525,BUY
2020-12-04 14:43:00,14:43,7101575,7294875,193300,BUY
2020-12-04 14:44:00,14:44,7131550,7295875,164325,BUY
2020-12-04 14:45:00,14:45,6981475,7285400,303925,BUY
2020-12-04 14:46:00,14:46,6982025,7285400,303375,BUY
2020-12-04 14:47:00,14:47,6961425,7283125,321700,BUY
2020-12-04 14:48:00,14:48,6899875,7339800,439925,BUY
2020-12-04 14:49:00,14:49,6941050,7340925,399875,BUY
2020-12-04 14:50:00,14:50,6918425,7339650,421225,BUY
2020-12-04 14:51:00,14:51,6822750,7412700,589950,BUY
2020-12-04 14:52:00,14:52,6828075,7413275,585200,BUY
2020-12-04 14:53:00,14:53,6823125,7413925,590800,BUY
2020-12-04 14:54:00,14:54,6767950,7375225,607275,BUY
2020-12-04 14:55:00,14:55,6749325,7375750,626425,BUY
2020-12-04 14:56:00,14:56,6743925,7374175,630250,BUY
2020-12-04 14:57:00,14:57,6693275,7376625,683350,BUY
2020-12-04 14:58:00,14:58,6693275,7379000,685725,BUY
2020-12-04 14:59:00,14:59,6711675,7379250,667575,BUY
2020-12-04 15:00:00,15:00,6639525,7402650,763125,BUY
2020-12-04 15:01:00,15:01,6592800,7403300,810500,BUY
2020-12-04 15:02:00,15:02,6629275,7403875,774600,BUY
2020-12-04 15:03:00,15:03,6546275,7422600,876325,BUY
2020-12-04 15:04:00,15:04,6512975,7412325,899350,BUY
2020-12-04 15:05:00,15:05,6528600,7423750,895150,BUY
2020-12-04 15:06:00,15:06,6506400,7419900,913500,BUY
2020-12-04 15:07:00,15:07,6536300,7422550,886250,BUY
2020-12-04 15:08:00,15:08,6527675,7419250,891575,BUY
2020-12-04 15:09:00,15:09,6489175,7449375,960200,BUY
2020-12-04 15:10:00,15:10,6516600,7450250,933650,BUY
2020-12-04 15:11:00,15:11,6531600,7444900,913300,BUY
2020-12-04 15:12:00,15:12,6490000,7369625,879625,BUY
2020-12-04 15:13:00,15:13,6482225,7367425,885200,BUY
2020-12-04 15:14:00,15:14,6503650,7368675,865025,BUY
2020-12-04 15:15:00,15:15,6395550,7229550,834000,BUY
2020-12-04 15:16:00,15:16,6386675,7229550,842875,BUY
2020-12-04 15:17:00,15:17,6411050,7227300,816250,BUY
2020-12-04 15:18:00,15:18,6289375,7158575,869200,BUY
2020-12-04 15:19:00,15:19,6293025,7167000,873975,BUY
2020-12-04 15:20:00,15:20,6319650,7172325,852675,BUY
2020-12-04 15:21:00,15:21,6139625,6972700,833075,BUY
2020-12-04 15:22:00,15:22,6130975,6969650,838675,BUY
2020-12-04 15:23:00,15:23,6111700,6973375,861675,BUY
2020-12-04 15:24:00,15:24,5968900,6883425,914525,BUY
2020-12-04 15:25:00,15:25,5971500,6883425,911925,BUY
2020-12-04 15:26:00,15:26,5918175,6883425,965250,BUY
2020-12-04 15:27:00,15:27,5878150,6763400,885250,BUY
2020-12-04 15:28:00,15:28,5884825,6763950,879125,BUY
2020-12-04 15:29:00,15:29,5878150,6761500,883350,BUY
2020-12-07 09:15:00,09:15,5618150,6497575,879425,BUY
2020-12-07 09:16:00,09:16,5643550,6497350,853800,BUY
2020-12-07 09:17:00,09:17,5720225,6611150,890925,BUY
2020-12-07 09:18:00,09:18,5700825,6612925,912100,BUY
2020-12-07 09:19:00,09:19,5703000,6614175,911175,BUY
2020-12-07 09:20:00,09:20,5888025,6924275,1036250,BUY
2020-12-07 09:21:00,09:21,5863700,6921425,1057725,BUY
2020-12-07 09:22:00,09:22,5844600,6920925,1076325,BUY
2020-12-07 09:23:00,09:23,6183700,7328825,1145125,BUY
2020-12-07 09:24:00,09:24,6204875,7332250,1127375,BUY
2020-12-07 09:25:00,09:25,6210675,7334925,1124250,BUY
2020-12-07 09:26:00,09:26,6565875,7783600,1217725,BUY
2020-12-07 09:27:00,09:27,6553800,7784875,1231075,BUY
2020-12-07 09:28:00,09:28,6575475,7782425,1206950,BUY
2020-12-07 09:29:00,09:29,6931250,8129675,1198425,BUY
2020-12-07 09:30:00,09:30,7001650,8126250,1124600,BUY
2020-12-07 09:31:00,09:31,6974925,8128775,1153850,BUY
2020-12-07 09:32:00,09:32,7262350,8262075,999725,BUY
2020-12-07 09:33:00,09:33,7272050,8261600,989550,BUY
2020-12-07 09:34:00,09:34,7264100,8260350,996250,BUY
2020-12-07 09:35:00,09:35,7314800,8341950,1027150,BUY
2020-12-07 09:36:00,09:36,7359950,8345450,985500,BUY
2020-12-07 09:37:00,09:37,7354600,8345450,990850,BUY
2020-12-07 09:38:00,09:38,7347225,8725700,1378475,BUY
2020-12-07 09:39:00,09:39,7352325,8725300,1372975,BUY
2020-12-07 09:40:00,09:40,7340050,8722075,1382025,BUY
2020-12-07 09:41:00,09:41,7510025,8943950,1433925,BUY
2020-12-07 09:42:00,09:42,7497975,8946175,1448200,BUY
2020-12-07 09:43:00,09:43,7495250,8945650,1450400,BUY
2020-12-07 09:44:00,09:44,7545900,9136725,1590825,BUY
2020-12-07 09:45:00,09:45,7602750,9137650,1534900,BUY
2020-12-07 09:46:00,09:46,7563550,9128200,1564650,BUY
2020-12-07 09:47:00,09:47,7646150,9244925,1598775,BUY
2020-12-07 09:48:00,09:48,7682500,9247600,1565100,BUY
2020-12-07 09:49:00,09:49,7616400,9246550,1630150,BUY
2020-12-07 09:50:00,09:50,7732775,9357750,1624975,BUY
2020-12-07 09:51:00,09:51,7716700,9330700,1614000,BUY
2020-12-07 09:52:00,09:52,7716925,9345975,1629050,BUY
2020-12-07 09:53:00,09:53,7833875,9468100,1634225,BUY
2020-12-07 09:54:00,09:54,7786725,9466150,1679425,BUY
2020-12-07 09:55:00,09:55,7849850,9470850,1621000,BUY
2020-12-07 09:56:00,09:56,7865625,9555975,1690350,BUY
2020-12-07 09:57:00,09:57,7921000,9559550,1638550,BUY
2020-12-07 09:58:00,09:58,7893975,9553775,1659800,BUY
2020-12-07 09:59:00,09:59,7918425,9498475,1580050,BUY
2020-12-07 10:00:00,10:00,7936700,9500950,1564250,BUY
2020-12-07 10:01:00,10:01,7903675,9496675,1593000,BUY
2020-12-07 10:02:00,10:02,7972250,9476075,1503825,BUY
2020-12-07 10:03:00,10:03,7894325,9476875,1582550,BUY
2020-12-07 10:04:00,10:04,7929275,9453725,1524450,BUY
2020-12-07 10:05:00,10:05,8082300,9516875,1434575,BUY
2020-12-07 10:06:00,10:06,8042050,9484750,1442700,BUY
2020-12-07 10:07:00,10:07,8084875,9511325,1426450,BUY
2020-12-07 10:08:00,10:08,8053025,9576500,1523475,BUY
2020-12-07 10:09:00,10:09,8104125,9597375,1493250,BUY
2020-12-07 10:10:00,10:10,8131250,9594900,1463650,BUY
2020-12-07 10:11:00,10:11,8173950,9612800,1438850,BUY
2020-12-07 10:12:00,10:12,8171750,9597700,1425950,BUY
2020-12-07 10:13:00,10:13,8187675,9622400,1434725,BUY
2020-12-07 10:14:00,10:14,8262525,9673550,1411025,BUY
2020-12-07 10:15:00,10:15,8198925,9669450,1470525,BUY
2020-12-07 10:16:00,10:16,8238275,9673475,1435200,BUY
2020-12-07 10:17:00,10:17,8282375,9647450,1365075,BUY
2020-12-07 10:18:00,10:18,8239225,9653050,1413825,BUY
2020-12-07 10:19:00,10:19,8320000,9653000,1333000,BUY
2020-12-07 10:20:00,10:20,8355225,9608075,1252850,BUY
2020-12-07 10:21:00,10:21,8313425,9602275,1288850,BUY
2020-12-07 10:22:00,10:22,8267500,9592175,1324675,BUY
2020-12-07 10:23:00,10:23,8383750,9619225,1235475,BUY
2020-12-07 10:24:00,10:24,8351775,9615100,1263325,BUY
2020-12-07 10:25:00,10:25,8388200,9622000,1233800,BUY
2020-12-07 10:26:00,10:26,8393075,9650225,1257150,BUY
2020-12-07 10:27:00,10:27,8416225,9632700,1216475,BUY
2020-12-07 10:28:00,10:28,8387025,9648225,1261200,BUY
2020-12-07 10:29:00,10:29,8445975,9662050,1216075,BUY
2020-12-07 10:30:00,10:30,8428525,9659000,1230475,BUY
2020-12-07 10:31:00,10:31,8455300,9668950,1213650,BUY
2020-12-07 10:32:00,10:32,8513250,9662850,1149600,BUY
2020-12-07 10:33:00,10:33,8477775,9659950,1182175,BUY
2020-12-07 10:34:00,10:34,8480500,9664000,1183500,BUY
2020-12-07 10:35:00,10:35,8507675,9726825,1219150,BUY
2020-12-07 10:36:00,10:36,8514800,9724725,1209925,BUY
2020-12-07 10:37:00,10:37,8501400,9714300,1212900,BUY
2020-12-07 10:38:00,10:38,8499700,9705375,1205675,BUY
2020-12-07 10:39:00,10:39,8512450,9705925,1193475,BUY
2020-12-07 10:40:00,10:40,8477325,9727075,1249750,BUY
2020-12-07 10:41:00,10:41,8513000,9737625,1224625,BUY
2020-12-07 10:42:00,10:42,8468125,9726675,1258550,BUY
2020-12-07 10:43:00,10:43,8508125,9710025,1201900,BUY
2020-12-07 10:44:00,10:44,8551625,9759050,1207425,BUY
2020-12-07 10:45:00,10:45,8531075,9773475,1242400,BUY
2020-12-07 10:46:00,10:46,8484875,9776625,1291750,BUY
2020-12-07 10:47:00,10:47,8531150,9824450,1293300,BUY
2020-12-07 10:48:00,10:48,8468550,9797000,1328450,BUY
2020-12-07 10:49:00,10:49,8480075,9815675,1335600,BUY
2020-12-07 10:50:00,10:50,8583825,9853025,1269200,BUY
2020-12-07 10:51:00,10:51,8459775,9824425,1364650,BUY
2020-12-07 10:52:00,10:52,8604500,9856250,1251750,BUY
2020-12-07 10:53:00,10:53,8603075,9874275,1271200,BUY
2020-12-07 10:54:00,10:54,8549125,9867750,1318625,BUY
2020-12-07 10:55:00,10:55,8479875,9842475,1362600,BUY
2020-12-07 10:56:00,10:56,8542225,9955150,1412925,BUY
2020-12-07 10:57:00,10:57,8582225,9971150,1388925,BUY
2020-12-07 10:58:00,10:58,8556375,9948125,1391750,BUY
2020-12-07 10:59:00,10:59,8649925,10024050,1374125,BUY
2020-12-07 11:00:00,11:00,8631825,10024050,1392225,BUY
2020-12-07 11:01:00,11:01,8624725,10024050,1399325,BUY
2020-12-07 11:02:00,11:02,8708350,10078475,1370125,BUY
2020-12-07 11:03:00,11:03,8635525,10043975,1408450,BUY
2020-12-07 11:04:00,11:04,8721525,10075550,1354025,BUY
2020-12-07 11:05:00,11:05,8700100,10098850,1398750,BUY
2020-12-07 11:06:00,11:06,8653600,10077775,1424175,BUY
2020-12-07 11:07:00,11:07,8710825,10110625,1399800,BUY
2020-12-07 11:08:00,11:08,8625550,10116725,1491175,BUY
2020-12-07 11:09:00,11:09,8631700,10110750,1479050,BUY
2020-12-07 11:10:00,11:10,8678900,10135675,1456775,BUY
2020-12-07 11:11:00,11:11,8767000,10153100,1386100,BUY
2020-12-07 11:12:00,11:12,8716025,10128525,1412500,BUY
2020-12-07 11:13:00,11:13,8671125,10135975,1464850,BUY
2020-12-07 11:14:00,11:14,8749350,10073875,1324525,BUY
2020-12-07 11:15:00,11:15,8798175,10153825,1355650,BUY
2020-12-07 11:16:00,11:16,8799850,10100850,1301000,BUY
2020-12-07 11:17:00,11:17,8776250,10161175,1384925,BUY
2020-12-07 11:18:00,11:18,8796275,10180300,1384025,BUY
2020-12-07 11:19:00,11:19,8747750,10036075,1288325,BUY
2020-12-07 11:20:00,11:20,8808075,10209575,1401500,BUY
2020-12-07 11:21:00,11:21,8754325,10213025,1458700,BUY
2020-12-07 11:22:00,11:22,8819225,10209700,1390475,BUY
2020-12-07 11:23:00,11:23,8797950,10187475,1389525,BUY
2020-12-07 11:24:00,11:24,8847525,10206475,1358950,BUY
2020-12-07 11:25:00,11:25,8813000,10159200,1346200,BUY
2020-12-07 11:26:00,11:26,8808850,10166950,1358100,BUY
2020-12-07 11:27:00,11:27,8808850,10217500,1408650,BUY
2020-12-07 11:28:00,11:28,8819800,10133725,1313925,BUY
2020-12-07 11:29:00,11:29,8869000,10254075,1385075,BUY
2020-12-07 11:30:00,11:30,8756925,10229425,1472500,BUY
2020-12-07 11:31:00,11:31,8760725,10174275,1413550,BUY
2020-12-07 11:32:00,11:32,8822175,10180500,1358325,BUY
2020-12-07 11:33:00,11:33,8891800,10244500,1352700,BUY
2020-12-07 11:34:00,11:34,8870325,10259975,1389650,BUY
2020-12-07 11:35:00,11:35,8913275,10236450,1323175,BUY
2020-12-07 11:36:00,11:36,8843100,10232100,1389000,BUY
2020-12-07 11:37:00,11:37,8798000,10207850,1409850,BUY
2020-12-07 11:38:00,11:38,8921150,10282475,1361325,BUY
2020-12-07 11:39:00,11:39,8849200,10280575,1431375,BUY
2020-12-07 11:40:00,11:40,8924300,10290900,1366600,BUY
2020-12-07 11:41:00,11:41,8955800,10257950,1302150,BUY
2020-12-07 11:42:00,11:42,8934775,10173725,1238950,BUY
2020-12-07 11:43:00,11:43,8958000,10255325,1297325,BUY
2020-12-07 11:44:00,11:44,8958075,10313200,1355125,BUY
2020-12-07 11:45:00,11:45,8976875,10284600,1307725,BUY
2020-12-07 11:46:00,11:46,8970050,10308225,1338175,BUY
2020-12-07 11:47:00,11:47,8915150,10272400,1357250,BUY
2020-12-07 11:48:00,11:48,8882350,10247200,1364850,BUY
2020-12-07 11:49:00,11:49,8933500,10299300,1365800,BUY
2020-12-07 11:50:00,11:50,8860175,10293375,1433200,BUY
2020-12-07 11:51:00,11:51,8983600,10296775,1313175,BUY
2020-12-07 11:52:00,11:52,8948775,10280450,1331675,BUY
2020-12-07 11:53:00,11:53,8953150,10310250,1357100,BUY
2020-12-07 11:54:00,11:54,8964625,10276450,1311825,BUY
2020-12-07 11:55:00,11:55,9019375,10369825,1350450,BUY
2020-12-07 11:56:00,11:56,9054700,10374550,1319850,BUY
2020-12-07 11:57:00,11:57,9026300,10288375,1262075,BUY
2020-12-07 11:58:00,11:58,9009875,10296800,1286925,BUY
2020-12-07 11:59:00,11:59,9045150,10251275,1206125,BUY
2020-12-07 12:00:00,12:00,9011150,10322275,1311125,BUY
2020-12-07 12:01:00,12:01,9087300,10360575,1273275,BUY
2020-12-07 12:02:00,12:02,9005800,10369350,1363550,BUY
2020-12-07 12:03:00,12:03,9023475,10367150,1343675,BUY
2020-12-07 12:04:00,12:04,9016475,10367425,1350950,BUY
2020-12-07 12:05:00,12:05,9044950,10374325,1329375,BUY
2020-12-07 12:06:00,12:06,8943300,10327425,1384125,BUY
2020-12-07 12:07:00,12:07,9023425,10355175,1331750,BUY
2020-12-07 12:08:00,12:08,9013025,10425425,1412400,BUY
2020-12-07 12:09:00,12:09,8982700,10424375,1441675,BUY
2020-12-07 12:10:00,12:10,8969000,10425425,1456425,BUY
2020-12-07 12:11:00,12:11,8545050,10380425,1835375,BUY
2020-12-07 12:12:00,12:12,8540775,10382350,1841575,BUY
2020-12-07 12:13:00,12:13,8502625,10376750,1874125,BUY
2020-12-07 12:14:00,12:14,8396300,10469325,2073025,BUY
2020-12-07 12:15:00,12:15,8464675,10471025,2006350,BUY
2020-12-07 12:16:00,12:16,8471400,10467700,1996300,BUY
2020-12-07 12:17:00,12:17,8058325,10521075,2462750,BUY
2020-12-07 12:18:00,12:18,8057975,10529425,2471450,BUY
2020-12-07 12:19:00,12:19,8031125,10529300,2498175,BUY
2020-12-07 12:20:00,12:20,8059575,10604875,2545300,BUY
2020-12-07 12:21:00,12:21,8054400,10602450,2548050,BUY
2020-12-07 12:22:00,12:22,7994450,10549550,2555100,BUY
2020-12-07 12:23:00,12:23,8069525,10621500,2551975,BUY
2020-12-07 12:24:00,12:24,8064650,10614200,2549550,BUY
2020-12-07 12:25:00,12:25,8106350,10619975,2513625,BUY
2020-12-07 12:26:00,12:26,8105325,10626050,2520725,BUY
2020-12-07 12:27:00,12:27,8079150,10618225,2539075,BUY
2020-12-07 12:28:00,12:28,8098900,10621600,2522700,BUY
2020-12-07 12:29:00,12:29,8101475,10667500,2566025,BUY
2020-12-07 12:30:00,12:30,8151550,10670725,2519175,BUY
2020-12-07 12:31:00,12:31,8063125,10664875,2601750,BUY
2020-12-07 12:32:00,12:32,8107725,10609450,2501725,BUY
2020-12-07 12:33:00,12:33,8090450,10600800,2510350,BUY
2020-12-07 12:34:00,12:34,8055425,10624475,2569050,BUY
2020-12-07 12:35:00,12:35,8062625,10649925,2587300,BUY
2020-12-07 12:36:00,12:36,8026025,10646875,2620850,BUY
2020-12-07 12:37:00,12:37,8026025,10646875,2620850,BUY
2020-12-07 12:38:00,12:38,8122975,10648075,2525100,BUY
2020-12-07 12:39:00,12:39,8139550,10702500,2562950,BUY
2020-12-07 12:40:00,12:40,8139150,10699450,2560300,BUY
2020-12-07 12:41:00,12:41,8095525,10710600,2615075,BUY
2020-12-07 12:42:00,12:42,8123350,10686825,2563475,BUY
2020-12-07 12:43:00,12:43,8123350,10695400,2572050,BUY
2020-12-07 12:44:00,12:44,8097800,10658750,2560950,BUY
2020-12-07 12:45:00,12:45,8175750,10710350,2534600,BUY
2020-12-07 12:46:00,12:46,8114075,10704225,2590150,BUY
2020-12-07 12:47:00,12:47,8128750,10708800,2580050,BUY
2020-12-07 12:48:00,12:48,8045850,10690100,2644250,BUY
2020-12-07 12:49:00,12:49,8060425,10731750,2671325,BUY
2020-12-07 12:50:00,12:50,8084725,10729575,2644850,BUY
2020-12-07 12:51:00,12:51,8098100,10726725,2628625,BUY
2020-12-07 12:52:00,12:52,8022600,10730075,2707475,BUY
2020-12-07 12:53:00,12:53,8073700,10726725,2653025,BUY
2020-12-07 12:54:00,12:54,8050350,10747025,2696675,BUY
2020-12-07 12:55:00,12:55,8025975,10744050,2718075,BUY
2020-12-07 12:56:00,12:56,8087625,10748500,2660875,BUY
2020-12-07 12:57:00,12:57,8101125,10750950,2649825,BUY
2020-12-07 12:58:00,12:58,8063100,10747900,2684800,BUY
2020-12-07 12:59:00,12:59,8048950,10748925,2699975,BUY
2020-12-07 13:00:00,13:00,7899250,10721575,2822325,BUY
2020-12-07 13:01:00,13:01,7886925,10720800,2833875,BUY
2020-12-07 13:02:00,13:02,7849350,10713050,2863700,BUY
2020-12-07 13:03:00,13:03,7842300,10734925,2892625,BUY
2020-12-07 13:04:00,13:04,7863450,10694425,2830975,BUY
2020-12-07 13:05:00,13:05,7796475,10733575,2937100,BUY
2020-12-07 13:06:00,13:06,7856700,10756775,2900075,BUY
2020-12-07 13:07:00,13:07,7809825,10749150,2939325,BUY
2020-12-07 13:08:00,13:08,7798900,10748825,2949925,BUY
2020-12-07 13:09:00,13:09,7855900,10700225,2844325,BUY
2020-12-07 13:10:00,13:10,7808400,10756650,2948250,BUY
2020-12-07 13:11:00,13:11,7876575,10756975,2880400,BUY
2020-12-07 13:12:00,13:12,7774525,10760025,2985500,BUY
2020-12-07 13:13:00,13:13,7782050,10764925,2982875,BUY
2020-12-07 13:14:00,13:14,7806625,10766625,2960000,BUY
2020-12-07 13:15:00,13:15,7825225,10780200,2954975,BUY
2020-12-07 13:16:00,13:16,7851700,10742700,2891000,BUY
2020-12-07 13:17:00,13:17,7851700,10660950,2809250,BUY
2020-12-07 13:18:00,13:18,7852150,10751625,2899475,BUY
2020-12-07 13:19:00,13:19,7870675,10790925,2920250,BUY
2020-12-07 13:20:00,13:20,7820000,10747950,2927950,BUY
2020-12-07 13:21:00,13:21,7827700,10839425,3011725,BUY
2020-12-07 13:22:00,13:22,7835550,10839425,3003875,BUY
2020-12-07 13:23:00,13:23,7828550,10835325,3006775,BUY
2020-12-07 13:24:00,13:24,7783725,10824300,3040575,BUY
2020-12-07 13:25:00,13:25,7810200,10815100,3004900,BUY
2020-12-07 13:26:00,13:26,7758000,10817275,3059275,BUY
2020-12-07 13:27:00,13:27,7760000,10818475,3058475,BUY
2020-12-07 13:28:00,13:28,7780175,10846500,3066325,BUY
2020-12-07 13:29:00,13:29,7760000,10846500,3086500,BUY
2020-12-07 13:30:00,13:30,7866350,10846300,2979950,BUY
2020-12-07 13:31:00,13:31,7867225,10844725,2977500,BUY
2020-12-07 13:32:00,13:32,7779525,10843275,3063750,BUY
2020-12-07 13:33:00,13:33,7708125,10691975,2983850,BUY
2020-12-07 13:34:00,13:34,7732875,10694250,2961375,BUY
2020-12-07 13:35:00,13:35,7697375,10694250,2996875,BUY
2020-12-07 13:36:00,13:36,7820425,10681575,2861150,BUY
2020-12-07 13:37:00,13:37,7833950,10678000,2844050,BUY
2020-12-07 13:38:00,13:38,7806200,10676625,2870425,BUY
2020-12-07 13:39:00,13:39,7766625,10635150,2868525,BUY
2020-12-07 13:40:00,13:40,7769250,10673675,2904425,BUY
2020-12-07 13:41:00,13:41,7809125,10679150,2870025,BUY
2020-12-07 13:42:00,13:42,7854275,10616975,2762700,BUY
2020-12-07 13:43:00,13:43,7794075,10612550,2818475,BUY
2020-12-07 13:44:00,13:44,7832475,10561175,2728700,BUY
2020-12-07 13:45:00,13:45,7933175,10617450,2684275,BUY
2020-12-07 13:46:00,13:46,7944100,10616200,2672100,BUY
2020-12-07 13:47:00,13:47,7932675,10620300,2687625,BUY
2020-12-07 13:48:00,13:48,7898425,10662275,2763850,BUY
2020-12-07 13:49:00,13:49,7950925,10613275,2662350,BUY
2020-12-07 13:50:00,13:50,7926550,10656350,2729800,BUY
2020-12-07 13:51:00,13:51,8042900,10674775,2631875,BUY
2020-12-07 13:52:00,13:52,7984625,10671225,2686600,BUY
2020-12-07 13:53:00,13:53,7998000,10636675,2638675,BUY
2020-12-07 13:54:00,13:54,8047425,10690350,2642925,BUY
2020-12-07 13:55:00,13:55,7995600,10693350,2697750,BUY
2020-12-07 13:56:00,13:56,8013450,10693800,2680350,BUY
2020-12-07 13:57:00,13:57,8091600,10718425,2626825,BUY
2020-12-07 13:58:00,13:58,8037125,10715425,2678300,BUY
2020-12-07 13:59:00,13:59,8101275,10715775,2614500,BUY
2020-12-07 14:00:00,14:00,8158250,10665375,2507125,BUY
2020-12-07 14:01:00,14:01,8115500,10659575,2544075,BUY
2020-12-07 14:02:00,14:02,8141275,10662225,2520950,BUY
2020-12-07 14:03:00,14:03,8193400,10540825,2347425,BUY
2020-12-07 14:04:00,14:04,8167650,10485525,2317875,BUY
2020-12-07 14:05:00,14:05,8197675,10544100,2346425,BUY
2020-12-07 14:06:00,14:06,8186175,10565300,2379125,BUY
2020-12-07 14:07:00,14:07,8226575,10567050,2340475,BUY
2020-12-07 14:08:00,14:08,8197050,10566075,2369025,BUY
2020-12-07 14:09:00,14:09,8235725,10579025,2343300,BUY
2020-12-07 14:10:00,14:10,8216225,10581925,2365700,BUY
2020-12-07 14:11:00,14:11,8165875,10555075,2389200,BUY
2020-12-07 14:12:00,14:12,8196975,10628025,2431050,BUY
2020-12-07 14:13:00,14:13,8360375,10657600,2297225,BUY
2020-12-07 14:14:00,14:14,8315525,10650500,2334975,BUY
2020-12-07 14:15:00,14:15,8371475,10593000,2221525,BUY
2020-12-07 14:16:00,14:16,8344950,10589800,2244850,BUY
2020-12-07 14:17:00,14:17,8292325,10589800,2297475,BUY
2020-12-07 14:18:00,14:18,8387050,10625675,2238625,BUY
2020-12-07 14:19:00,14:19,8430450,10624050,2193600,BUY
2020-12-07 14:20:00,14:20,8425825,10625400,2199575,BUY
2020-12-07 14:21:00,14:21,8448300,10632700,2184400,BUY
2020-12-07 14:22:00,14:22,8407875,10628300,2220425,BUY
2020-12-07 14:23:00,14:23,8495225,10628300,2133075,BUY
2020-12-07 14:24:00,14:24,8485675,10629275,2143600,BUY
2020-12-07 14:25:00,14:25,8490325,10638325,2148000,BUY
2020-12-07 14:26:00,14:26,8455400,10606125,2150725,BUY
2020-12-07 14:27:00,14:27,8458775,10667200,2208425,BUY
2020-12-07 14:28:00,14:28,8555350,10678200,2122850,BUY
2020-12-07 14:29:00,14:29,8525575,10672300,2146725,BUY
2020-12-07 14:30:00,14:30,8432950,10583625,2150675,BUY
2020-12-07 14:31:00,14:31,8392025,10580950,2188925,BUY
2020-12-07 14:32:00,14:32,8422225,10582875,2160650,BUY
2020-12-07 14:33:00,14:33,8480025,10620000,2139975,BUY
2020-12-07 14:34:00,14:34,8418200,10623650,2205450,BUY
2020-12-07 14:35:00,14:35,8425425,10618675,2193250,BUY
2020-12-07 14:36:00,14:36,8580850,10668750,2087900,BUY
2020-12-07 14:37:00,14:37,8590125,10668750,2078625,BUY
2020-12-07 14:38:00,14:38,8561750,10670425,2108675,BUY
2020-12-07 14:39:00,14:39,8459425,10610025,2150600,BUY
2020-12-07 14:40:00,14:40,8514575,10608825,2094250,BUY
2020-12-07 14:41:00,14:41,8464700,10607825,2143125,BUY
2020-12-07 14:42:00,14:42,8579225,10628525,2049300,BUY
2020-12-07 14:43:00,14:43,8568250,10601050,2032800,BUY
2020-12-07 14:44:00,14:44,8526975,10623700,2096725,BUY
2020-12-07 14:45:00,14:45,8584450,10637050,2052600,BUY
2020-12-07 14:46:00,14:46,8533475,10575400,2041925,BUY
2020-12-07 14:47:00,14:47,8600075,10644450,2044375,BUY
2020-12-07 14:48:00,14:48,8469625,10514100,2044475,BUY
2020-12-07 14:49:00,14:49,8429600,10509300,2079700,BUY
2020-12-07 14:50:00,14:50,8422175,10513000,2090825,BUY
2020-12-07 14:51:00,14:51,8220750,10365450,2144700,BUY
2020-12-07 14:52:00,14:52,8306950,10340250,2033300,BUY
2020-12-07 14:53:00,14:53,8321250,10369875,2048625,BUY
2020-12-07 14:54:00,14:54,8214525,10346075,2131550,BUY
2020-12-07 14:55:00,14:55,8177750,10303350,2125600,BUY
2020-12-07 14:56:00,14:56,8316175,10369000,2052825,BUY
2020-12-07 14:57:00,14:57,8233300,10294600,2061300,BUY
2020-12-07 14:58:00,14:58,8225050,10292350,2067300,BUY
2020-12-07 14:59:00,14:59,8177450,10286450,2109000,BUY
2020-12-07 15:00:00,15:00,8145700,10210025,2064325,BUY
2020-12-07 15:01:00,15:01,8222175,10240650,2018475,BUY
2020-12-07 15:02:00,15:02,8241600,10246825,2005225,BUY
2020-12-07 15:03:00,15:03,8172500,10151800,1979300,BUY
2020-12-07 15:04:00,15:04,8183225,10151575,1968350,BUY
2020-12-07 15:05:00,15:05,8153575,10151575,1998000,BUY
2020-12-07 15:06:00,15:06,8107250,10215950,2108700,BUY
2020-12-07 15:07:00,15:07,8125500,10215950,2090450,BUY
2020-12-07 15:08:00,15:08,8110575,10215950,2105375,BUY
2020-12-07 15:09:00,15:09,8100800,10283675,2182875,BUY
2020-12-07 15:10:00,15:10,8077950,10292075,2214125,BUY
2020-12-07 15:11:00,15:11,8088850,10288125,2199275,BUY
2020-12-07 15:12:00,15:12,8068225,10160475,2092250,BUY
2020-12-07 15:13:00,15:13,8055350,10184750,2129400,BUY
2020-12-07 15:14:00,15:14,8018625,10179125,2160500,BUY
2020-12-07 15:15:00,15:15,8034850,10047550,2012700,BUY
2020-12-07 15:16:00,15:16,8016825,10051900,2035075,BUY
2020-12-07 15:17:00,15:17,8034850,10048950,2014100,BUY
2020-12-07 15:18:00,15:18,7940825,9877350,1936525,BUY
2020-12-07 15:19:00,15:19,7922225,9877350,1955125,BUY
2020-12-07 15:20:00,15:20,7979325,9881900,1902575,BUY
2020-12-07 15:21:00,15:21,7772525,9637625,1865100,BUY
2020-12-07 15:22:00,15:22,7802375,9631675,1829300,BUY
2020-12-07 15:23:00,15:23,7769275,9635575,1866300,BUY
2020-12-07 15:24:00,15:24,7744550,9455875,1711325,BUY
2020-12-07 15:25:00,15:25,7780425,9455850,1675425,BUY
2020-12-07 15:26:00,15:26,7697575,9455850,1758275,BUY
2020-12-07 15:27:00,15:27,7675975,9307850,1631875,BUY
2020-12-07 15:28:00,15:28,7675000,9306200,1631200,BUY
2020-12-07 15:29:00,15:29,7677525,9304825,1627300,BUY
2020-12-08 09:15:00,09:15,7445725,9110050,1664325,BUY
2020-12-08 09:16:00,09:16,7472525,9105900,1633375,BUY
2020-12-08 09:17:00,09:17,7491025,9159950,1668925,BUY
2020-12-08 09:18:00,09:18,7510600,9164725,1654125,BUY
2020-12-08 09:19:00,09:19,7484675,9155725,1671050,BUY
2020-12-08 09:20:00,09:20,7747775,9437875,1690100,BUY
2020-12-08 09:21:00,09:21,7703050,9436225,1733175,BUY
2020-12-08 09:22:00,09:22,7743625,9437575,1693950,BUY
2020-12-08 09:23:00,09:23,8086025,9724075,1638050,BUY
2020-12-08 09:24:00,09:24,8078575,9778475,1699900,BUY
2020-12-08 09:25:00,09:25,8078575,9779050,1700475,BUY
2020-12-08 09:26:00,09:26,8407550,10206625,1799075,BUY
2020-12-08 09:27:00,09:27,8449725,10158275,1708550,BUY
2020-12-08 09:28:00,09:28,8438825,10206750,1767925,BUY
2020-12-08 09:29:00,09:29,8636250,10581925,1945675,BUY
2020-12-08 09:30:00,09:30,8647225,10581450,1934225,BUY
2020-12-08 09:31:00,09:31,8636250,10583400,1947150,BUY
2020-12-08 09:32:00,09:32,8856625,10753750,1897125,BUY
2020-12-08 09:33:00,09:33,8862225,10806050,1943825,BUY
2020-12-08 09:34:00,09:34,8862225,10804250,1942025,BUY
2020-12-08 09:35:00,09:35,8942475,10940900,1998425,BUY
2020-12-08 09:36:00,09:36,8980075,10888800,1908725,BUY
2020-12-08 09:37:00,09:37,8937025,10906025,1969000,BUY
2020-12-08 09:38:00,09:38,9084975,11048175,1963200,BUY
2020-12-08 09:39:00,09:39,9070175,11045150,1974975,BUY
2020-12-08 09:40:00,09:40,9053525,11045125,1991600,BUY
2020-12-08 09:41:00,09:41,9166800,11135275,1968475,BUY
2020-12-08 09:42:00,09:42,9244800,11139825,1895025,BUY
2020-12-08 09:43:00,09:43,9209025,11139725,1930700,BUY
2020-12-08 09:44:00,09:44,9212400,11227550,2015150,BUY
2020-12-08 09:45:00,09:45,9263900,11253900,1990000,BUY
2020-12-08 09:46:00,09:46,9276325,11201900,1925575,BUY
2020-12-08 09:47:00,09:47,9269550,11369975,2100425,BUY
2020-12-08 09:48:00,09:48,9230175,11372575,2142400,BUY
2020-12-08 09:49:00,09:49,9316275,11372575,2056300,BUY
2020-12-08 09:50:00,09:50,9451650,11477150,2025500,BUY
2020-12-08 09:51:00,09:51,9415450,11475300,2059850,BUY
2020-12-08 09:52:00,09:52,9418375,11477150,2058775,BUY
2020-12-08 09:53:00,09:53,9416375,11520900,2104525,BUY
2020-12-08 09:54:00,09:54,9382775,11521150,2138375,BUY
2020-12-08 09:55:00,09:55,9467650,11499925,2032275,BUY
2020-12-08 09:56:00,09:56,9529350,11607350,2078000,BUY
2020-12-08 09:57:00,09:57,9541975,11603100,2061125,BUY
2020-12-08 09:58:00,09:58,9478875,11602475,2123600,BUY
2020-12-08 09:59:00,09:59,9618300,11699050,2080750,BUY
2020-12-08 10:00:00,10:00,9605450,11699100,2093650,BUY
2020-12-08 10:01:00,10:01,9616275,11669425,2053150,BUY
2020-12-08 10:02:00,10:02,9479025,11760800,2281775,BUY
2020-12-08 10:03:00,10:03,9479775,11752975,2273200,BUY
2020-12-08 10:04:00,10:04,9436175,11665100,2228925,BUY
2020-12-08 10:05:00,10:05,9518625,11779375,2260750,BUY
2020-12-08 10:06:00,10:06,9604775,11774675,2169900,BUY
2020-12-08 10:07:00,10:07,9454225,11801900,2347675,BUY
2020-12-08 10:08:00,10:08,9674800,11798000,2123200,BUY
2020-12-08 10:09:00,10:09,9630400,11802450,2172050,BUY
2020-12-08 10:10:00,10:10,9679950,11773150,2093200,BUY
2020-12-08 10:11:00,10:11,9620150,11688775,2068625,BUY
2020-12-08 10:12:00,10:12,9629700,11662600,2032900,BUY
2020-12-08 10:13:00,10:13,9702450,11771950,2069500,BUY
2020-12-08 10:14:00,10:14,9763750,11743500,1979750,BUY
2020-12-08 10:15:00,10:15,9744900,11716275,1971375,BUY
2020-12-08 10:16:00,10:16,9783475,11766575,1983100,BUY
2020-12-08 10:17:00,10:17,9793825,11759625,1965800,BUY
2020-12-08 10:18:00,10:18,9731575,11704575,1973000,BUY
2020-12-08 10:19:00,10:19,9791225,11737000,1945775,BUY
2020-12-08 10:20:00,10:20,9898800,11836775,1937975,BUY
2020-12-08 10:21:00,10:21,9899000,11777125,1878125,BUY
2020-12-08 10:22:00,10:22,9861825,11712150,1850325,BUY
2020-12-08 10:23:00,10:23,9791100,11739025,1947925,BUY
2020-12-08 10:24:00,10:24,9903575,11755000,1851425,BUY
2020-12-08 10:25:00,10:25,9865375,11828350,1962975,BUY
2020-12-08 10:26:00,10:26,9901175,11663175,1762000,BUY
2020-12-08 10:27:00,10:27,9901075,11774425,1873350,BUY
2020-12-08 10:28:00,10:28,9826200,11742275,1916075,BUY
2020-12-08 10:29:00,10:29,9991275,11828325,1837050,BUY
2020-12-08 10:30:00,10:30,9987575,11828325,1840750,BUY
2020-12-08 10:31:00,10:31,9950250,11746300,1796050,BUY
2020-12-08 10:32:00,10:32,10069600,11818725,1749125,BUY
2020-12-08 10:33:00,10:33,10079825,11866800,1786975,BUY
2020-12-08 10:34:00,10:34,10033025,11867425,1834400,BUY
2020-12-08 10:35:00,10:35,10047900,11832300,1784400,BUY
2020-12-08 10:36:00,10:36,9964225,11796300,1832075,BUY
2020-12-08 10:37:00,10:37,9961950,11817775,1855825,BUY
2020-12-08 10:38:00,10:38,10129750,11867500,1737750,BUY
2020-12-08 10:39:00,10:39,10067800,11866875,1799075,BUY
2020-12-08 10:40:00,10:40,10058825,11822400,1763575,BUY
2020-12-08 10:41:00,10:41,10050025,11898125,1848100,BUY
2020-12-08 10:42:00,10:42,10093100,11892900,1799800,BUY
2020-12-08 10:43:00,10:43,10130425,11885700,1755275,BUY
2020-12-08 10:44:00,10:44,10169625,11939675,1770050,BUY
2020-12-08 10:45:00,10:45,10114200,11907600,1793400,BUY
2020-12-08 10:46:00,10:46,10103425,11812375,1708950,BUY
2020-12-08 10:47:00,10:47,10173000,11922125,1749125,BUY
2020-12-08 10:48:00,10:48,10135475,11892650,1757175,BUY
2020-12-08 10:49:00,10:49,10190250,11876550,1686300,BUY
2020-12-08 10:50:00,10:50,10177400,11875700,1698300,BUY
2020-12-08 10:51:00,10:51,10151675,11904950,1753275,BUY
2020-12-08 10:52:00,10:52,10203775,11917750,1713975,BUY
2020-12-08 10:53:00,10:53,10124025,11971875,1847850,BUY
2020-12-08 10:54:00,10:54,10074900,11977400,1902500,BUY
2020-12-08 10:55:00,10:55,10173250,11977400,1804150,BUY
2020-12-08 10:56:00,10:56,10284300,11921275,1636975,BUY
2020-12-08 10:57:00,10:57,10263875,11864000,1600125,BUY
2020-12-08 10:58:00,10:58,10226650,11881675,1655025,BUY
2020-12-08 10:59:00,10:59,10267825,11942750,1674925,BUY
2020-12-08 11:00:00,11:00,10297000,11891175,1594175,BUY
2020-12-08 11:01:00,11:01,10319225,11942750,1623525,BUY
2020-12-08 11:02:00,11:02,10272400,11828900,1556500,BUY
2020-12-08 11:03:00,11:03,10311025,11907225,1596200,BUY
2020-12-08 11:04:00,11:04,10371000,11911750,1540750,BUY
2020-12-08 11:05:00,11:05,10388400,11835900,1447500,BUY
2020-12-08 11:06:00,11:06,10387600,11832500,1444900,BUY
2020-12-08 11:07:00,11:07,10363575,11798825,1435250,BUY
2020-12-08 11:08:00,11:08,10423450,11831325,1407875,BUY
2020-12-08 11:09:00,11:09,10442625,11864300,1421675,BUY
2020-12-08 11:10:00,11:10,10427350,11817300,1389950,BUY
2020-12-08 11:11:00,11:11,10526425,11748075,1221650,BUY
2020-12-08 11:12:00,11:12,10523400,11747825,1224425,BUY
2020-12-08 11:13:00,11:13,10507275,11745600,1238325,BUY
2020-12-08 11:14:00,11:14,10538725,11805075,1266350,BUY
2020-12-08 11:15:00,11:15,10524300,11805650,1281350,BUY
2020-12-08 11:16:00,11:16,10467075,11797150,1330075,BUY
2020-12-08 11:17:00,11:17,10512925,11765000,1252075,BUY
2020-12-08 11:18:00,11:18,10468600,11774800,1306200,BUY
2020-12-08 11:19:00,11:19,10510325,11717750,1207425,BUY
2020-12-08 11:20:00,11:20,10520100,11745975,1225875,BUY
2020-12-08 11:21:00,11:21,10494650,11797825,1303175,BUY
2020-12-08 11:22:00,11:22,10519225,11750550,1231325,BUY
2020-12-08 11:23:00,11:23,10617850,11762175,1144325,BUY
2020-12-08 11:24:00,11:24,10623675,11760575,1136900,BUY
2020-12-08 11:25:00,11:25,10594375,11757600,1163225,BUY
2020-12-08 11:26:00,11:26,10711425,11637800,926375,BUY
2020-12-08 11:27:00,11:27,10683850,11638925,955075,BUY
2020-12-08 11:28:00,11:28,10619725,11632550,1012825,BUY
2020-12-08 11:29:00,11:29,10725800,11608500,882700,BUY
2020-12-08 11:30:00,11:30,10730125,11613200,883075,BUY
2020-12-08 11:31:00,11:31,10694900,11598900,904000,BUY
2020-12-08 11:32:00,11:32,10733850,11499050,765200,BUY
2020-12-08 11:33:00,11:33,10771075,11497525,726450,BUY
2020-12-08 11:34:00,11:34,10798775,11497525,698750,BUY
2020-12-08 11:35:00,11:35,10813600,11479925,666325,BUY
2020-12-08 11:36:00,11:36,10800550,11510750,710200,BUY
2020-12-08 11:37:00,11:37,10769750,11513950,744200,BUY
2020-12-08 11:38:00,11:38,10799850,11498800,698950,BUY
2020-12-08 11:39:00,11:39,10807375,11530375,723000,BUY
2020-12-08 11:40:00,11:40,10862850,11533775,670925,BUY
2020-12-08 11:41:00,11:41,10835350,11511750,676400,BUY
2020-12-08 11:42:00,11:42,10835350,11477200,641850,BUY
2020-12-08 11:43:00,11:43,10809000,11522675,713675,BUY
2020-12-08 11:44:00,11:44,10906875,11500825,593950,BUY
2020-12-08 11:45:00,11:45,10899200,11556600,657400,BUY
2020-12-08 11:46:00,11:46,10853625,11556600,702975,BUY
2020-12-08 11:47:00,11:47,10916525,11534300,617775,BUY
2020-12-08 11:48:00,11:48,10888675,11503025,614350,BUY
2020-12-08 11:49:00,11:49,10915400,11507925,592525,BUY
2020-12-08 11:50:00,11:50,10943475,11617825,674350,BUY
2020-12-08 11:51:00,11:51,10886550,11533575,647025,BUY
2020-12-08 11:52:00,11:52,10892275,11475625,583350,BUY
2020-12-08 11:53:00,11:53,10886075,11584625,698550,BUY
2020-12-08 11:54:00,11:54,10902450,11631225,728775,BUY
2020-12-08 11:55:00,11:55,11003975,11660975,657000,BUY
2020-12-08 11:56:00,11:56,10944900,11588875,643975,BUY
2020-12-08 11:57:00,11:57,10954675,11647975,693300,BUY
2020-12-08 11:58:00,11:58,10977875,11643475,665600,BUY
2020-12-08 11:59:00,11:59,10935000,11564500,629500,BUY
2020-12-08 12:00:00,12:00,10868725,11628675,759950,BUY
2020-12-08 12:01:00,12:01,10890075,11641025,750950,BUY
2020-12-08 12:02:00,12:02,10955750,11625350,669600,BUY
2020-12-08 12:03:00,12:03,10938675,11680500,741825,BUY
2020-12-08 12:04:00,12:04,10877375,11632875,755500,BUY
2020-12-08 12:05:00,12:05,10939000,11641175,702175,BUY
2020-12-08 12:06:00,12:06,10941250,11607275,666025,BUY
2020-12-08 12:07:00,12:07,10997900,11673800,675900,BUY
2020-12-08 12:08:00,12:08,10946075,11640425,694350,BUY
2020-12-08 12:09:00,12:09,10932525,11602150,669625,BUY
2020-12-08 12:10:00,12:10,10844650,11581100,736450,BUY
2020-12-08 12:11:00,12:11,11002525,11675650,673125,BUY
2020-12-08 12:12:00,12:12,10960350,11594925,634575,BUY
2020-12-08 12:13:00,12:13,10952725,11572650,619925,BUY
2020-12-08 12:14:00,12:14,11030450,11600925,570475,BUY
2020-12-08 12:15:00,12:15,11041750,11621100,579350,BUY
2020-12-08 12:16:00,12:16,10986750,11677275,690525,BUY
2020-12-08 12:17:00,12:17,11020025,11634975,614950,BUY
2020-12-08 12:18:00,12:18,11081800,11672800,591000,BUY
2020-12-08 12:19:00,12:19,11071250,11672800,601550,BUY
2020-12-08 12:20:00,12:20,11011875,11654050,642175,BUY
2020-12-08 12:21:00,12:21,11047975,11662925,614950,BUY
2020-12-08 12:22:00,12:22,11027200,11652725,625525,BUY
2020-12-08 12:23:00,12:23,11015425,11665025,649600,BUY
2020-12-08 12:24:00,12:24,11048375,11688125,639750,BUY
2020-12-08 12:25:00,12:25,11025200,11679875,654675,BUY
2020-12-08 12:26:00,12:26,11116850,11713875,597025,BUY
2020-12-08 12:27:00,12:27,11008800,11705025,696225,BUY
2020-12-08 12:28:00,12:28,10999725,11707950,708225,BUY
2020-12-08 12:29:00,12:29,11000825,11675350,674525,BUY
2020-12-08 12:30:00,12:30,11018825,11681850,663025,BUY
2020-12-08 12:31:00,12:31,10994550,11676525,681975,BUY
2020-12-08 12:32:00,12:32,10980050,11676125,696075,BUY
2020-12-08 12:33:00,12:33,10794500,11673775,879275,BUY
2020-12-08 12:34:00,12:34,10796775,11604575,807800,BUY
2020-12-08 12:35:00,12:35,10820250,11679175,858925,BUY
2020-12-08 12:36:00,12:36,10798325,11678450,880125,BUY
2020-12-08 12:37:00,12:37,10761150,11674775,913625,BUY
2020-12-08 12:38:00,12:38,10804150,11719075,914925,BUY
2020-12-08 12:39:00,12:39,10760200,11721650,961450,BUY
2020-12-08 12:40:00,12:40,10667500,11700900,1033400,BUY
2020-12-08 12:41:00,12:41,10720450,11733200,1012750,BUY
2020-12-08 12:42:00,12:42,10766800,11714400,947600,BUY
2020-12-08 12:43:00,12:43,10687450,11675175,987725,BUY
2020-12-08 12:44:00,12:44,10705625,11652600,946975,BUY
2020-12-08 12:45:00,12:45,10722150,11728850,1006700,BUY
2020-12-08 12:46:00,12:46,10695775,11693225,997450,BUY
2020-12-08 12:47:00,12:47,10708750,11701975,993225,BUY
2020-12-08 12:48:00,12:48,10705075,11618075,913000,BUY
2020-12-08 12:49:00,12:49,10761025,11768375,1007350,BUY
2020-12-08 12:50:00,12:50,10742225,11776350,1034125,BUY
2020-12-08 12:51:00,12:51,10689375,11749200,1059825,BUY
2020-12-08 12:52:00,12:52,10732400,11684550,952150,BUY
2020-12-08 12:53:00,12:53,10695250,11803950,1108700,BUY
2020-12-08 12:54:00,12:54,10775425,11851700,1076275,BUY
2020-12-08 12:55:00,12:55,10734550,11859800,1125250,BUY
2020-12-08 12:56:00,12:56,10795175,11864200,1069025,BUY
2020-12-08 12:57:00,12:57,10738300,11855475,1117175,BUY
2020-12-08 12:58:00,12:58,10694200,11894425,1200225,BUY
2020-12-08 12:59:00,12:59,10725800,11877250,1151450,BUY
2020-12-08 13:00:00,13:00,10703200,11964400,1261200,BUY
2020-12-08 13:01:00,13:01,10631500,11982275,1350775,BUY
2020-12-08 13:02:00,13:02,10687100,11980675,1293575,BUY
2020-12-08 13:03:00,13:03,10579650,11856400,1276750,BUY
2020-12-08 13:04:00,13:04,10574125,11876250,1302125,BUY
2020-12-08 13:05:00,13:05,10629825,11936900,1307075,BUY
2020-12-08 13:06:00,13:06,10511925,11817525,1305600,BUY
2020-12-08 13:07:00,13:07,10477350,11815625,1338275,BUY
2020-12-08 13:08:00,13:08,10450575,11746850,1296275,BUY
2020-12-08 13:09:00,13:09,10362675,11681125,1318450,BUY
2020-12-08 13:10:00,13:10,10405100,11699750,1294650,BUY
2020-12-08 13:11:00,13:11,10381675,11701800,1320125,BUY
2020-12-08 13:12:00,13:12,10352275,11580875,1228600,BUY
2020-12-08 13:13:00,13:13,10315125,11633200,1318075,BUY
2020-12-08 13:14:00,13:14,10315125,11636900,1321775,BUY
2020-12-08 13:15:00,13:15,10374250,11654125,1279875,BUY
2020-12-08 13:16:00,13:16,10393325,11576175,1182850,BUY
2020-12-08 13:17:00,13:17,10363225,11538275,1175050,BUY
2020-12-08 13:18:00,13:18,10225450,11580500,1355050,BUY
2020-12-08 13:19:00,13:19,10290175,11539425,1249250,BUY
2020-12-08 13:20:00,13:20,10342325,11500650,1158325,BUY
2020-12-08 13:21:00,13:21,10277775,11628700,1350925,BUY
2020-12-08 13:22:00,13:22,10393150,11628625,1235475,BUY
2020-12-08 13:23:00,13:23,10350725,11535850,1185125,BUY
2020-12-08 13:24:00,13:24,10319025,11633125,1314100,BUY
2020-12-08 13:25:00,13:25,10340925,11611825,1270900,BUY
2020-12-08 13:26:00,13:26,10349150,11603025,1253875,BUY
2020-12-08 13:27:00,13:27,10428875,11600175,1171300,BUY
2020-12-08 13:28:00,13:28,10318875,11567975,1249100,BUY
2020-12-08 13:29:00,13:29,10424025,11628575,1204550,BUY
2020-12-08 13:30:00,13:30,10450925,11624850,1173925,BUY
2020-12-08 13:31:00,13:31,10375450,11649000,1273550,BUY
2020-12-08 13:32:00,13:32,10467100,11689025,1221925,BUY
2020-12-08 13:33:00,13:33,10456025,11694275,1238250,BUY
2020-12-08 13:34:00,13:34,10436700,11688150,1251450,BUY
2020-12-08 13:35:00,13:35,10431725,11694775,1263050,BUY
2020-12-08 13:36:00,13:36,10337375,11588825,1251450,BUY
2020-12-08 13:37:00,13:37,10337375,11622475,1285100,BUY
2020-12-08 13:38:00,13:38,10337375,11600400,1263025,BUY
2020-12-08 13:39:00,13:39,10326925,11626125,1299200,BUY
2020-12-08 13:40:00,13:40,10239100,11619750,1380650,BUY
2020-12-08 13:41:00,13:41,10290200,11613075,1322875,BUY
2020-12-08 13:42:00,13:42,10334675,11630100,1295425,BUY
2020-12-08 13:43:00,13:43,10331400,11590675,1259275,BUY
2020-12-08 13:44:00,13:44,10382475,11644425,1261950,BUY
2020-12-08 13:45:00,13:45,10362775,11665125,1302350,BUY
2020-12-08 13:46:00,13:46,10287850,11656650,1368800,BUY
2020-12-08 13:47:00,13:47,10357425,11624625,1267200,BUY
2020-12-08 13:48:00,13:48,10379925,11679575,1299650,BUY
2020-12-08 13:49:00,13:49,10361525,11634925,1273400,BUY
2020-12-08 13:50:00,13:50,10278650,11666850,1388200,BUY
2020-12-08 13:51:00,13:51,10430750,11684075,1253325,BUY
2020-12-08 13:52:00,13:52,10436400,11621125,1184725,BUY
2020-12-08 13:53:00,13:53,10380425,11648425,1268000,BUY
2020-12-08 13:54:00,13:54,10349575,11637000,1287425,BUY
2020-12-08 13:55:00,13:55,10349575,11704075,1354500,BUY
2020-12-08 13:56:00,13:56,10382825,11693500,1310675,BUY
2020-12-08 13:57:00,13:57,10368850,11642900,1274050,BUY
2020-12-08 13:58:00,13:58,10456825,11734425,1277600,BUY
2020-12-08 13:59:00,13:59,10385950,11701975,1316025,BUY
2020-12-08 14:00:00,14:00,10284475,11715500,1431025,BUY
2020-12-08 14:01:00,14:01,10358550,11641100,1282550,BUY
2020-12-08 14:02:00,14:02,10277175,11706750,1429575,BUY
2020-12-08 14:03:00,14:03,10176800,11673825,1497025,BUY
2020-12-08 14:04:00,14:04,10338650,11629225,1290575,BUY
2020-12-08 14:05:00,14:05,10320650,11676975,1356325,BUY
2020-12-08 14:06:00,14:06,10377875,11680250,1302375,BUY
2020-12-08 14:07:00,14:07,10341425,11680250,1338825,BUY
2020-12-08 14:08:00,14:08,10347325,11689050,1341725,BUY
2020-12-08 14:09:00,14:09,10421750,11635875,1214125,BUY
2020-12-08 14:10:00,14:10,10448800,11684550,1235750,BUY
2020-12-08 14:11:00,14:11,10298675,11681350,1382675,BUY
2020-12-08 14:12:00,14:12,10333675,11638675,1305000,BUY
2020-12-08 14:13:00,14:13,10235675,11568575,1332900,BUY
2020-12-08 14:14:00,14:14,10325725,11555500,1229775,BUY
2020-12-08 14:15:00,14:15,10383775,11554625,1170850,BUY
2020-12-08 14:16:00,14:16,10359850,11634675,1274825,BUY
2020-12-08 14:17:00,14:17,10331500,11578425,1246925,BUY
2020-12-08 14:18:00,14:18,10309875,10891425,581550,BUY
2020-12-08 14:19:00,14:19,10346075,11669500,1323425,BUY
2020-12-08 14:20:00,14:20,10336525,11678525,1342000,BUY
2020-12-08 14:21:00,14:21,10316725,11576675,1259950,BUY
2020-12-08 14:22:00,14:22,10338300,11625750,1287450,BUY
2020-12-08 14:23:00,14:23,10222075,11620875,1398800,BUY
2020-12-08 14:24:00,14:24,10200575,11638250,1437675,BUY
2020-12-08 14:25:00,14:25,10274800,11634475,1359675,BUY
2020-12-08 14:26:00,14:26,10251075,11568075,1317000,BUY
2020-12-08 14:27:00,14:27,10255025,11627150,1372125,BUY
2020-12-08 14:28:00,14:28,10162850,11599875,1437025,BUY
2020-12-08 14:29:00,14:29,10198225,11602025,1403800,BUY
2020-12-08 14:30:00,14:30,10224575,11582525,1357950,BUY
2020-12-08 14:31:00,14:31,10210400,11581000,1370600,BUY
2020-12-08 14:32:00,14:32,10229375,11577550,1348175,BUY
2020-12-08 14:33:00,14:33,10070500,11485425,1414925,BUY
2020-12-08 14:34:00,14:34,10054850,11492675,1437825,BUY
2020-12-08 14:35:00,14:35,10076425,11491200,1414775,BUY
2020-12-08 14:36:00,14:36,10075250,11369200,1293950,BUY
2020-12-08 14:37:00,14:37,10059875,11368100,1308225,BUY
2020-12-08 14:38:00,14:38,10073625,11373950,1300325,BUY
2020-12-08 14:39:00,14:39,9949200,11310750,1361550,BUY
2020-12-08 14:40:00,14:40,9958000,11299825,1341825,BUY
2020-12-08 14:41:00,14:41,9952750,11301075,1348325,BUY
2020-12-08 14:42:00,14:42,9958825,11188475,1229650,BUY
2020-12-08 14:43:00,14:43,9978300,11214875,1236575,BUY
2020-12-08 14:44:00,14:44,9998900,11278675,1279775,BUY
2020-12-08 14:45:00,14:45,9858100,11289625,1431525,BUY
2020-12-08 14:46:00,14:46,9887825,11266050,1378225,BUY
2020-12-08 14:47:00,14:47,9871975,11267800,1395825,BUY
2020-12-08 14:48:00,14:48,9867350,11218400,1351050,BUY
2020-12-08 14:49:00,14:49,9774700,11204625,1429925,BUY
2020-12-08 14:50:00,14:50,9764225,11217100,1452875,BUY
2020-12-08 14:51:00,14:51,9767325,11164550,1397225,BUY
2020-12-08 14:52:00,14:52,9800800,11157150,1356350,BUY
2020-12-08 14:53:00,14:53,9795150,11167775,1372625,BUY
2020-12-08 14:54:00,14:54,9691350,11084550,1393200,BUY
2020-12-08 14:55:00,14:55,9777375,11114275,1336900,BUY
2020-12-08 14:56:00,14:56,9757650,11127050,1369400,BUY
2020-12-08 14:57:00,14:57,9634550,11038625,1404075,BUY
2020-12-08 14:58:00,14:58,9570350,11037075,1466725,BUY
2020-12-08 14:59:00,14:59,9469700,11036100,1566400,BUY
2020-12-08 15:00:00,15:00,9541100,10973100,1432000,BUY
2020-12-08 15:01:00,15:01,9442525,10895275,1452750,BUY
2020-12-08 15:02:00,15:02,9439700,10968900,1529200,BUY
2020-12-08 15:03:00,15:03,9420250,10903575,1483325,BUY
2020-12-08 15:04:00,15:04,9410100,10914975,1504875,BUY
2020-12-08 15:05:00,15:05,9163650,10913950,1750300,BUY
2020-12-08 15:06:00,15:06,9311100,10847050,1535950,BUY
2020-12-08 15:07:00,15:07,9359875,10880325,1520450,BUY
2020-12-08 15:08:00,15:08,9346925,10870500,1523575,BUY
2020-12-08 15:09:00,15:09,9361500,10723125,1361625,BUY
2020-12-08 15:10:00,15:10,9327475,10722600,1395125,BUY
2020-12-08 15:11:00,15:11,9340475,10675700,1335225,BUY
2020-12-08 15:12:00,15:12,9130275,10512325,1382050,BUY
2020-12-08 15:13:00,15:13,9117300,10515000,1397700,BUY
2020-12-08 15:14:00,15:14,9102575,10459125,1356550,BUY
2020-12-08 15:15:00,15:15,9070300,10458675,1388375,BUY
2020-12-08 15:16:00,15:16,9077925,10455475,1377550,BUY
2020-12-08 15:17:00,15:17,9023950,10453625,1429675,BUY
2020-12-08 15:18:00,15:18,8874225,10348275,1474050,BUY
2020-12-08 15:19:00,15:19,8911675,10345275,1433600,BUY
2020-12-08 15:20:00,15:20,8990900,10349100,1358200,BUY
2020-12-08 15:21:00,15:21,8697925,10153050,1455125,BUY
2020-12-08 15:22:00,15:22,8707800,10196575,1488775,BUY
2020-12-08 15:23:00,15:23,8596450,10194850,1598400,BUY
2020-12-08 15:24:00,15:24,8466175,10055250,1589075,BUY
2020-12-08 15:25:00,15:25,8502950,10057100,1554150,BUY
2020-12-08 15:26:00,15:26,8450325,9990725,1540400,BUY
2020-12-08 15:27:00,15:27,8359350,9942450,1583100,BUY
2020-12-08 15:28:00,15:28,8276450,9943025,1666575,BUY
2020-12-08 15:29:00,15:29,8368975,9947675,1578700,BUY
2020-12-09 09:15:00,09:15,8116050,9730825,1614775,BUY
2020-12-09 09:16:00,09:16,8100125,9731450,1631325,BUY
2020-12-09 09:17:00,09:17,8250225,9892875,1642650,BUY
2020-12-09 09:18:00,09:18,8202175,9931000,1728825,BUY
2020-12-09 09:19:00,09:19,8242150,9931575,1689425,BUY
2020-12-09 09:20:00,09:20,8846375,10698275,1851900,BUY
2020-12-09 09:21:00,09:21,8846300,10697125,1850825,BUY
2020-12-09 09:22:00,09:22,8847875,10638300,1790425,BUY
2020-12-09 09:23:00,09:23,9091875,10822700,1730825,BUY
2020-12-09 09:24:00,09:24,9038225,10923200,1884975,BUY
2020-12-09 09:25:00,09:25,9101275,10922575,1821300,BUY
2020-12-09 09:26:00,09:26,9366275,11068100,1701825,BUY
2020-12-09 09:27:00,09:27,9361850,11047475,1685625,BUY
2020-12-09 09:28:00,09:28,9370775,11003950,1633175,BUY
2020-12-09 09:29:00,09:29,9597650,11135150,1537500,BUY
2020-12-09 09:30:00,09:30,9579400,11071300,1491900,BUY
2020-12-09 09:31:00,09:31,9572650,11136175,1563525,BUY
2020-12-09 09:32:00,09:32,9800250,11285625,1485375,BUY
2020-12-09 09:33:00,09:33,9884100,11240225,1356125,BUY
2020-12-09 09:34:00,09:34,9893975,11224400,1330425,BUY
2020-12-09 09:35:00,09:35,9943525,11352550,1409025,BUY
2020-12-09 09:36:00,09:36,9943525,11377000,1433475,BUY
2020-12-09 09:37:00,09:37,9940650,11397250,1456600,BUY
2020-12-09 09:38:00,09:38,10151725,11425100,1273375,BUY
2020-12-09 09:39:00,09:39,10140100,11439475,1299375,BUY
2020-12-09 09:40:00,09:40,10065650,11463075,1397425,BUY
2020-12-09 09:41:00,09:41,10156150,11552575,1396425,BUY
2020-12-09 09:42:00,09:42,10249200,11469175,1219975,BUY
2020-12-09 09:43:00,09:43,10236725,11550875,1314150,BUY
2020-12-09 09:44:00,09:44,10229700,11777850,1548150,BUY
2020-12-09 09:45:00,09:45,10126025,11716575,1590550,BUY
2020-12-09 09:46:00,09:46,10201450,11796925,1595475,BUY
2020-12-09 09:47:00,09:47,10239950,12040475,1800525,BUY
2020-12-09 09:48:00,09:48,10211725,11959350,1747625,BUY
2020-12-09 09:49:00,09:49,10211725,12040475,1828750,BUY
2020-12-09 09:50:00,09:50,10310525,12060125,1749600,BUY
2020-12-09 09:51:00,09:51,10263175,12057875,1794700,BUY
2020-12-09 09:52:00,09:52,10247050,12103800,1856750,BUY
2020-12-09 09:53:00,09:53,10335200,12210650,1875450,BUY
2020-12-09 09:54:00,09:54,10300275,12120700,1820425,BUY
2020-12-09 09:55:00,09:55,10293325,12088725,1795400,BUY
2020-12-09 09:56:00,09:56,10423925,12160900,1736975,BUY
2020-12-09 09:57:00,09:57,10383600,12204825,1821225,BUY
2020-12-09 09:58:00,09:58,10278150,12308700,2030550,BUY
2020-12-09 09:59:00,09:59,10512275,12406400,1894125,BUY
2020-12-09 10:00:00,10:00,10546850,12406400,1859550,BUY
2020-12-09 10:01:00,10:01,10562500,12408125,1845625,BUY
2020-12-09 10:02:00,10:02,10549650,12362575,1812925,BUY
2020-12-09 10:03:00,10:03,10653225,12312825,1659600,BUY
2020-12-09 10:04:00,10:04,10605900,12315250,1709350,BUY
2020-12-09 10:05:00,10:05,10723575,12423425,1699850,BUY
2020-12-09 10:06:00,10:06,10712350,12439300,1726950,BUY
2020-12-09 10:07:00,10:07,10710650,12346425,1635775,BUY
2020-12-09 10:08:00,10:08,10611150,12425600,1814450,BUY
2020-12-09 10:09:00,10:09,10589125,12479450,1890325,BUY
2020-12-09 10:10:00,10:10,10703425,12433725,1730300,BUY
2020-12-09 10:11:00,10:11,10724700,12540700,1816000,BUY
2020-12-09 10:12:00,10:12,10714425,12519950,1805525,BUY
2020-12-09 10:13:00,10:13,10771450,12542050,1770600,BUY
2020-12-09 10:14:00,10:14,10605400,12475975,1870575,BUY
2020-12-09 10:15:00,10:15,10749850,12552725,1802875,BUY
2020-12-09 10:16:00,10:16,10696900,12551600,1854700,BUY
2020-12-09 10:17:00,10:17,10651300,12603400,1952100,BUY
2020-12-09 10:18:00,10:18,10547300,12625850,2078550,BUY
2020-12-09 10:19:00,10:19,10612850,12575550,1962700,BUY
2020-12-09 10:20:00,10:20,10506450,12605050,2098600,BUY
2020-12-09 10:21:00,10:21,10672850,12625100,1952250,BUY
2020-12-09 10:22:00,10:22,10672850,12603400,1930550,BUY
2020-12-09 10:23:00,10:23,10579700,12670000,2090300,BUY
2020-12-09 10:24:00,10:24,10535700,12669650,2133950,BUY
2020-12-09 10:25:00,10:25,10697225,12670600,1973375,BUY
2020-12-09 10:26:00,10:26,10643550,12752125,2108575,BUY
2020-12-09 10:27:00,10:27,10677100,12752125,2075025,BUY
2020-12-09 10:28:00,10:28,10606800,12641750,2034950,BUY
2020-12-09 10:29:00,10:29,10621875,12686300,2064425,BUY
2020-12-09 10:30:00,10:30,10564225,12766325,2202100,BUY
2020-12-09 10:31:00,10:31,10620500,12744625,2124125,BUY
2020-12-09 10:32:00,10:32,10452975,12746750,2293775,BUY
2020-12-09 10:33:00,10:33,10486500,12728475,2241975,BUY
2020-12-09 10:34:00,10:34,10577125,12726475,2149350,BUY
2020-12-09 10:35:00,10:35,10629900,12700425,2070525,BUY
2020-12-09 10:36:00,10:36,10408100,12698800,2290700,BUY
2020-12-09 10:37:00,10:37,10666775,12698800,2032025,BUY
2020-12-09 10:38:00,10:38,10468850,12562075,2093225,BUY
2020-12-09 10:39:00,10:39,10605400,12750675,2145275,BUY
2020-12-09 10:40:00,10:40,10475800,12651975,2176175,BUY
2020-12-09 10:41:00,10:41,10725075,12548150,1823075,BUY
2020-12-09 10:42:00,10:42,10638000,12836225,2198225,BUY
2020-12-09 10:43:00,10:43,10668650,12735600,2066950,BUY
2020-12-09 10:44:00,10:44,10526800,12794275,2267475,BUY
2020-12-09 10:45:00,10:45,10670525,12798200,2127675,BUY
2020-12-09 10:46:00,10:46,10670525,12734575,2064050,BUY
2020-12-09 10:47:00,10:47,10637975,12737050,2099075,BUY
2020-12-09 10:48:00,10:48,10563925,12817650,2253725,BUY
2020-12-09 10:49:00,10:49,10675200,12758575,2083375,BUY
2020-12-09 10:50:00,10:50,10723700,12783450,2059750,BUY
2020-12-09 10:51:00,10:51,10757650,12820700,2063050,BUY
2020-12-09 10:52:00,10:52,10724325,12874925,2150600,BUY
2020-12-09 10:53:00,10:53,10655950,12877375,2221425,BUY
2020-12-09 10:54:00,10:54,10641175,12808925,2167750,BUY
2020-12-09 10:55:00,10:55,10495250,12828525,2333275,BUY
2020-12-09 10:56:00,10:56,10691525,12794100,2102575,BUY
2020-12-09 10:57:00,10:57,10598100,12839275,2241175,BUY
2020-12-09 10:58:00,10:58,10648950,12815225,2166275,BUY
2020-12-09 10:59:00,10:59,10547925,12865075,2317150,BUY
2020-12-09 11:00:00,11:00,10803700,12918300,2114600,BUY
2020-12-09 11:01:00,11:01,10958475,12926625,1968150,BUY
2020-12-09 11:02:00,11:02,10845750,12772475,1926725,BUY
2020-12-09 11:03:00,11:03,10783700,12898925,2115225,BUY
2020-12-09 11:04:00,11:04,10839725,12842750,2003025,BUY
2020-12-09 11:05:00,11:05,10831750,12936225,2104475,BUY
2020-12-09 11:06:00,11:06,10885450,12956675,2071225,BUY
2020-12-09 11:07:00,11:07,10859475,12979875,2120400,BUY
2020-12-09 11:08:00,11:08,10774175,12891100,2116925,BUY
2020-12-09 11:09:00,11:09,10737100,12808475,2071375,BUY
2020-12-09 11:10:00,11:10,10694175,12967925,2273750,BUY
2020-12-09 11:11:00,11:11,10768125,12928650,2160525,BUY
2020-12-09 11:12:00,11:12,10742300,12885875,2143575,BUY
2020-12-09 11:13:00,11:13,10709475,13003500,2294025,BUY
2020-12-09 11:14:00,11:14,10714325,12929000,2214675,BUY
2020-12-09 11:15:00,11:15,10702375,12958250,2255875,BUY
2020-12-09 11:16:00,11:16,10748800,12981200,2232400,BUY
2020-12-09 11:17:00,11:17,10546500,12996275,2449775,BUY
2020-12-09 11:18:00,11:18,10711675,12866000,2154325,BUY
2020-12-09 11:19:00,11:19,10715000,13023675,2308675,BUY
2020-12-09 11:20:00,11:20,10794850,12978025,2183175,BUY
2020-12-09 11:21:00,11:21,10768350,13061625,2293275,BUY
2020-12-09 11:22:00,11:22,10735025,13011850,2276825,BUY
2020-12-09 11:23:00,11:23,10784125,13090675,2306550,BUY
2020-12-09 11:24:00,11:24,10712125,12991300,2279175,BUY
2020-12-09 11:25:00,11:25,10693175,13034775,2341600,BUY
2020-12-09 11:26:00,11:26,10899500,12947550,2048050,BUY
2020-12-09 11:27:00,11:27,10830500,13064175,2233675,BUY
2020-12-09 11:28:00,11:28,10882775,13047950,2165175,BUY
2020-12-09 11:29:00,11:29,10932550,13020650,2088100,BUY
2020-12-09 11:30:00,11:30,10738825,13134775,2395950,BUY
2020-12-09 11:31:00,11:31,10832675,13016825,2184150,BUY
2020-12-09 11:32:00,11:32,10648175,13054675,2406500,BUY
2020-12-09 11:33:00,11:33,10722200,13039825,2317625,BUY
2020-12-09 11:34:00,11:34,10743975,13067425,2323450,BUY
2020-12-09 11:35:00,11:35,10831200,13124775,2293575,BUY
2020-12-09 11:36:00,11:36,10708200,13103525,2395325,BUY
2020-12-09 11:37:00,11:37,10989075,13198750,2209675,BUY
2020-12-09 11:38:00,11:38,10669400,13125125,2455725,BUY
2020-12-09 11:39:00,11:39,10544400,13125725,2581325,BUY
2020-12-09 11:40:00,11:40,10674975,13108625,2433650,BUY
2020-12-09 11:41:00,11:41,10615025,13097075,2482050,BUY
2020-12-09 11:42:00,11:42,10633175,13268750,2635575,BUY
2020-12-09 11:43:00,11:43,10614575,13050875,2436300,BUY
2020-12-09 11:44:00,11:44,10393500,12533750,2140250,BUY
2020-12-09 11:45:00,11:45,10636750,12568950,1932200,BUY
2020-12-09 11:46:00,11:46,10701150,13222175,2521025,BUY
2020-12-09 11:47:00,11:47,10536625,13285900,2749275,BUY
2020-12-09 11:48:00,11:48,10497350,13305875,2808525,BUY
2020-12-09 11:49:00,11:49,10530350,13308000,2777650,BUY
2020-12-09 11:50:00,11:50,10500050,13232075,2732025,BUY
2020-12-09 11:51:00,11:51,10499800,13220625,2720825,BUY
2020-12-09 11:52:00,11:52,10546250,13275150,2728900,BUY
2020-12-09 11:53:00,11:53,10460650,13376825,2916175,BUY
2020-12-09 11:54:00,11:54,10537100,13287175,2750075,BUY
2020-12-09 11:55:00,11:55,10598150,13375600,2777450,BUY
2020-12-09 11:56:00,11:56,10481000,13290000,2809000,BUY
2020-12-09 11:57:00,11:57,10484525,13287250,2802725,BUY
2020-12-09 11:58:00,11:58,10390475,13252200,2861725,BUY
2020-12-09 11:59:00,11:59,10520775,13241250,2720475,BUY
2020-12-09 12:00:00,12:00,10544750,13193225,2648475,BUY
2020-12-09 12:01:00,12:01,10608300,12445925,1837625,BUY
2020-12-09 12:02:00,12:02,10628125,13222225,2594100,BUY
2020-12-09 12:03:00,12:03,10631925,13254000,2622075,BUY
2020-12-09 12:04:00,12:04,10495125,12585175,2090050,BUY
2020-12-09 12:05:00,12:05,10475925,13140050,2664125,BUY
2020-12-09 12:06:00,12:06,10586900,13196775,2609875,BUY
2020-12-09 12:07:00,12:07,10674575,13367250,2692675,BUY
2020-12-09 12:08:00,12:08,10668975,13123450,2454475,BUY
2020-12-09 12:09:00,12:09,10618250,13162700,2544450,BUY
2020-12-09 12:10:00,12:10,10563350,13231525,2668175,BUY
2020-12-09 12:11:00,12:11,10655475,13048525,2393050,BUY
2020-12-09 12:12:00,12:12,10611975,13271775,2659800,BUY
2020-12-09 12:13:00,12:13,10587125,13303825,2716700,BUY
2020-12-09 12:14:00,12:14,10556625,13345075,2788450,BUY
2020-12-09 12:15:00,12:15,10690900,13452775,2761875,BUY
2020-12-09 12:16:00,12:16,10567275,13359625,2792350,BUY
2020-12-09 12:17:00,12:17,10665725,13127175,2461450,BUY
2020-12-09 12:18:00,12:18,10597450,13245400,2647950,BUY
2020-12-09 12:19:00,12:19,10655450,13331425,2675975,BUY
2020-12-09 12:20:00,12:20,10642550,11814025,1171475,BUY
2020-12-09 12:21:00,12:21,10700100,13350725,2650625,BUY
2020-12-09 12:22:00,12:22,10663775,13379100,2715325,BUY
2020-12-09 12:23:00,12:23,10700100,13336575,2636475,BUY
2020-12-09 12:24:00,12:24,10689500,13383225,2693725,BUY
2020-12-09 12:25:00,12:25,10504375,13283300,2778925,BUY
2020-12-09 12:26:00,12:26,10692775,13356950,2664175,BUY
2020-12-09 12:27:00,12:27,10761325,13452425,2691100,BUY
2020-12-09 12:28:00,12:28,10702575,13388575,2686000,BUY
2020-12-09 12:29:00,12:29,10545850,13335150,2789300,BUY
2020-12-09 12:30:00,12:30,10633275,13414200,2780925,BUY
2020-12-09 12:31:00,12:31,10594975,13431050,2836075,BUY
2020-12-09 12:32:00,12:32,10509225,13278625,2769400,BUY
2020-12-09 12:33:00,12:33,10488250,13243775,2755525,BUY
2020-12-09 12:34:00,12:34,10437600,13245800,2808200,BUY
2020-12-09 12:35:00,12:35,10545250,12798975,2253725,BUY
2020-12-09 12:36:00,12:36,10540975,12782375,2241400,BUY
2020-12-09 12:37:00,12:37,10605675,13436075,2830400,BUY
2020-12-09 12:38:00,12:38,10587850,13468600,2880750,BUY
2020-12-09 12:39:00,12:39,10611900,13509000,2897100,BUY
2020-12-09 12:40:00,12:40,10522225,13330100,2807875,BUY
2020-12-09 12:41:00,12:41,10625175,13486100,2860925,BUY
2020-12-09 12:42:00,12:42,10484325,13298400,2814075,BUY
2020-12-09 12:43:00,12:43,10520400,13465450,2945050,BUY
2020-12-09 12:44:00,12:44,10557300,12775525,2218225,BUY
2020-12-09 12:45:00,12:45,10619275,13445600,2826325,BUY
2020-12-09 12:46:00,12:46,10603100,13446925,2843825,BUY
2020-12-09 12:47:00,12:47,10563450,13469725,2906275,BUY
2020-12-09 12:48:00,12:48,10372125,13464525,3092400,BUY
2020-12-09 12:49:00,12:49,10336050,13628875,3292825,BUY
2020-12-09 12:50:00,12:50,10468250,13560325,3092075,BUY
2020-12-09 12:51:00,12:51,10572250,13481900,2909650,BUY
2020-12-09 12:52:00,12:52,10438300,13516275,3077975,BUY
2020-12-09 12:53:00,12:53,10240825,13410100,3169275,BUY
2020-12-09 12:54:00,12:54,10608775,13433525,2824750,BUY
2020-12-09 12:55:00,12:55,10400550,12880475,2479925,BUY
2020-12-09 12:56:00,12:56,10645000,13403550,2758550,BUY
2020-12-09 12:57:00,12:57,10680475,13600250,2919775,BUY
2020-12-09 12:58:00,12:58,10680475,13524250,2843775,BUY
2020-12-09 12:59:00,12:59,10699325,13537025,2837700,BUY
2020-12-09 13:00:00,13:00,10618525,13667150,3048625,BUY
2020-12-09 13:01:00,13:01,10623675,13592650,2968975,BUY
2020-12-09 13:02:00,13:02,10450600,13653000,3202400,BUY
2020-12-09 13:03:00,13:03,10462675,13622250,3159575,BUY
2020-12-09 13:04:00,13:04,10498750,13485075,2986325,BUY
2020-12-09 13:05:00,13:05,10501250,13624475,3123225,BUY
2020-12-09 13:06:00,13:06,10290300,13533850,3243550,BUY
2020-12-09 13:07:00,13:07,10254225,13613550,3359325,BUY
2020-12-09 13:08:00,13:08,10279175,13686550,3407375,BUY
2020-12-09 13:09:00,13:09,10404800,13644075,3239275,BUY
2020-12-09 13:10:00,13:10,10445000,13632950,3187950,BUY
2020-12-09 13:11:00,13:11,10462100,13685050,3222950,BUY
2020-12-09 13:12:00,13:12,10349450,13657200,3307750,BUY
2020-12-09 13:13:00,13:13,10298200,13580075,3281875,BUY
2020-12-09 13:14:00,13:14,10341375,12910850,2569475,BUY
2020-12-09 13:15:00,13:15,10391800,13570025,3178225,BUY
2020-12-09 13:16:00,13:16,10362250,13715050,3352800,BUY
2020-12-09 13:17:00,13:17,10403500,13701325,3297825,BUY
2020-12-09 13:18:00,13:18,10158825,13807975,3649150,BUY
2020-12-09 13:19:00,13:19,10298400,13842350,3543950,BUY
2020-12-09 13:20:00,13:20,10263125,13120425,2857300,BUY
2020-12-09 13:21:00,13:21,10106900,13784475,3677575,BUY
2020-12-09 13:22:00,13:22,10251175,13603975,3352800,BUY
2020-12-09 13:23:00,13:23,10299425,13767975,3468550,BUY
2020-12-09 13:24:00,13:24,10065825,13661975,3596150,BUY
2020-12-09 13:25:00,13:25,10315300,13737850,3422550,BUY
2020-12-09 13:26:00,13:26,10277025,13707525,3430500,BUY
2020-12-09 13:27:00,13:27,9940750,13679150,3738400,BUY
2020-12-09 13:28:00,13:28,10048500,13654575,3606075,BUY
2020-12-09 13:29:00,13:29,10012450,13671175,3658725,BUY
2020-12-09 13:30:00,13:30,9012725,13571750,4559025,BUY
2020-12-09 13:31:00,13:31,9035800,13549450,4513650,BUY
2020-12-09 13:32:00,13:32,8950225,13574200,4623975,BUY
2020-12-09 13:33:00,13:33,8950350,13608700,4658350,BUY
2020-12-09 13:34:00,13:34,8952525,13590100,4637575,BUY
2020-12-09 13:35:00,13:35,8988700,13682600,4693900,BUY
2020-12-09 13:36:00,13:36,9066375,13588050,4521675,BUY
2020-12-09 13:37:00,13:37,9078375,13582775,4504400,BUY
2020-12-09 13:38:00,13:38,9068375,13640725,4572350,BUY
2020-12-09 13:39:00,13:39,8987500,13675825,4688325,BUY
2020-12-09 13:40:00,13:40,8970000,13705875,4735875,BUY
2020-12-09 13:41:00,13:41,9113175,13694500,4581325,BUY
2020-12-09 13:42:00,13:42,9057250,13697125,4639875,BUY
2020-12-09 13:43:00,13:43,9121025,13724775,4603750,BUY
2020-12-09 13:44:00,13:44,9123125,13759800,4636675,BUY
2020-12-09 13:45:00,13:45,9127850,13730425,4602575,BUY
2020-12-09 13:46:00,13:46,9176150,13685575,4509425,BUY
2020-12-09 13:47:00,13:47,9128650,13681350,4552700,BUY
2020-12-09 13:48:00,13:48,9072350,13603100,4530750,BUY
2020-12-09 13:49:00,13:49,9053525,13573825,4520300,BUY
2020-12-09 13:50:00,13:50,9114625,13675375,4560750,BUY
2020-12-09 13:51:00,13:51,9057550,13577375,4519825,BUY
2020-12-09 13:52:00,13:52,9061675,13583550,4521875,BUY
2020-12-09 13:53:00,13:53,9110525,13480250,4369725,BUY
2020-12-09 13:54:00,13:54,9233200,13589375,4356175,BUY
2020-12-09 13:55:00,13:55,9182675,13595000,4412325,BUY
2020-12-09 13:56:00,13:56,9217825,13602925,4385100,BUY
2020-12-09 13:57:00,13:57,9005000,13588875,4583875,BUY
2020-12-09 13:58:00,13:58,9022375,13579450,4557075,BUY
2020-12-09 13:59:00,13:59,8921125,13452200,4531075,BUY
2020-12-09 14:00:00,14:00,8995250,13530400,4535150,BUY
2020-12-09 14:01:00,14:01,9018025,13546800,4528775,BUY
2020-12-09 14:02:00,14:02,8946850,13472725,4525875,BUY
2020-12-09 14:03:00,14:03,8894825,13530500,4635675,BUY
2020-12-09 14:04:00,14:04,8884900,13481425,4596525,BUY
2020-12-09 14:05:00,14:05,8849925,13537575,4687650,BUY
2020-12-09 14:06:00,14:06,8836600,13534625,4698025,BUY
2020-12-09 14:07:00,14:07,8808250,13531700,4723450,BUY
2020-12-09 14:08:00,14:08,8834500,13487900,4653400,BUY
2020-12-09 14:09:00,14:09,8499525,13419375,4919850,BUY
2020-12-09 14:10:00,14:10,8533700,13463400,4929700,BUY
2020-12-09 14:11:00,14:11,8497925,13460225,4962300,BUY
2020-12-09 14:12:00,14:12,8580700,13557925,4977225,BUY
2020-12-09 14:13:00,14:13,8615425,13576700,4961275,BUY
2020-12-09 14:14:00,14:14,8618175,13523875,4905700,BUY
2020-12-09 14:15:00,14:15,8416875,13563225,5146350,BUY
2020-12-09 14:16:00,14:16,8376875,13566325,5189450,BUY
2020-12-09 14:17:00,14:17,8381075,13593125,5212050,BUY
2020-12-09 14:18:00,14:18,8439750,13470175,5030425,BUY
2020-12-09 14:19:00,14:19,8429875,13571450,5141575,BUY
2020-12-09 14:20:00,14:20,8382175,13536225,5154050,BUY
2020-12-09 14:21:00,14:21,8388300,13553450,5165150,BUY
2020-12-09 14:22:00,14:22,8392700,13500525,5107825,BUY
2020-12-09 14:23:00,14:23,8392700,13538325,5145625,BUY
2020-12-09 14:24:00,14:24,8368025,13592075,5224050,BUY
2020-12-09 14:25:00,14:25,8390750,13605600,5214850,BUY
2020-12-09 14:26:00,14:26,8320275,13620175,5299900,BUY
2020-12-09 14:27:00,14:27,8620550,13625225,5004675,BUY
2020-12-09 14:28:00,14:28,8482725,13565800,5083075,BUY
2020-12-09 14:29:00,14:29,8583675,13625500,5041825,BUY
2020-12-09 14:30:00,14:30,8566675,13674175,5107500,BUY
2020-12-09 14:31:00,14:31,8609500,13675425,5065925,BUY
2020-12-09 14:32:00,14:32,8608950,13675425,5066475,BUY
2020-12-09 14:33:00,14:33,8524050,13637450,5113400,BUY
2020-12-09 14:34:00,14:34,8609025,13693525,5084500,BUY
2020-12-09 14:35:00,14:35,8669575,13684475,5014900,BUY
2020-12-09 14:36:00,14:36,8664875,13654825,4989950,BUY
2020-12-09 14:37:00,14:37,8612125,13693525,5081400,BUY
2020-12-09 14:38:00,14:38,8612125,13695225,5083100,BUY
2020-12-09 14:39:00,14:39,8676600,13740225,5063625,BUY
2020-12-09 14:40:00,14:40,8614650,13786750,5172100,BUY
2020-12-09 14:41:00,14:41,8686425,13791700,5105275,BUY
2020-12-09 14:42:00,14:42,8693575,13829825,5136250,BUY
2020-12-09 14:43:00,14:43,8691275,13845975,5154700,BUY
2020-12-09 14:44:00,14:44,8711300,13786625,5075325,BUY
2020-12-09 14:45:00,14:45,8800225,13827275,5027050,BUY
2020-12-09 14:46:00,14:46,8718950,13822150,5103200,BUY
2020-12-09 14:47:00,14:47,8890100,13823875,4933775,BUY
2020-12-09 14:48:00,14:48,8763350,13700850,4937500,BUY
2020-12-09 14:49:00,14:49,8710475,13856600,5146125,BUY
2020-12-09 14:50:00,14:50,8910725,13861675,4950950,BUY
2020-12-09 14:51:00,14:51,8764050,13646925,4882875,BUY
2020-12-09 14:52:00,14:52,8760675,13633125,4872450,BUY
2020-12-09 14:53:00,14:53,8743600,13659850,4916250,BUY
2020-12-09 14:54:00,14:54,8713275,13407475,4694200,BUY
2020-12-09 14:55:00,14:55,8760700,13476700,4716000,BUY
2020-12-09 14:56:00,14:56,8712575,13442700,4730125,BUY
2020-12-09 14:57:00,14:57,8521725,13464575,4942850,BUY
2020-12-09 14:58:00,14:58,8745750,13453725,4707975,BUY
2020-12-09 14:59:00,14:59,8702325,13381300,4678975,BUY
2020-12-09 15:00:00,15:00,8691950,13176600,4484650,BUY
2020-12-09 15:01:00,15:01,8661225,13157900,4496675,BUY
2020-12-09 15:02:00,15:02,8542975,13145275,4602300,BUY
2020-12-09 15:03:00,15:03,8517125,13103325,4586200,BUY
2020-12-09 15:04:00,15:04,8494950,13077000,4582050,BUY
2020-12-09 15:05:00,15:05,8545350,13075575,4530225,BUY
2020-12-09 15:06:00,15:06,8479075,13015975,4536900,BUY
2020-12-09 15:07:00,15:07,8403575,13018325,4614750,BUY
2020-12-09 15:08:00,15:08,8316625,13011575,4694950,BUY
2020-12-09 15:09:00,15:09,8360725,12925900,4565175,BUY
2020-12-09 15:10:00,15:10,8407925,12969200,4561275,BUY
2020-12-09 15:11:00,15:11,8425150,12972450,4547300,BUY
2020-12-09 15:12:00,15:12,8198750,12786400,4587650,BUY
2020-12-09 15:13:00,15:13,8206300,12797725,4591425,BUY
2020-12-09 15:14:00,15:14,8028750,12805125,4776375,BUY
2020-12-09 15:15:00,15:15,8192100,12539575,4347475,BUY
2020-12-09 15:16:00,15:16,8191400,12525850,4334450,BUY
2020-12-09 15:17:00,15:17,8153725,12485550,4331825,BUY
2020-12-09 15:18:00,15:18,7995025,12159425,4164400,BUY
2020-12-09 15:19:00,15:19,8043450,12244400,4200950,BUY
2020-12-09 15:20:00,15:20,8129625,12233500,4103875,BUY
2020-12-09 15:21:00,15:21,7886525,11764775,3878250,BUY
2020-12-09 15:22:00,15:22,7867025,11769550,3902525,BUY
2020-12-09 15:23:00,15:23,7790825,11764775,3973950,BUY
2020-12-09 15:24:00,15:24,7552600,11376375,3823775,BUY
2020-12-09 15:25:00,15:25,7675075,11409100,3734025,BUY
2020-12-09 15:26:00,15:26,7645100,11406775,3761675,BUY
2020-12-09 15:27:00,15:27,7469225,11155650,3686425,BUY
2020-12-09 15:28:00,15:28,7478850,11135450,3656600,BUY
2020-12-09 15:29:00,15:29,7492375,11161925,3669550,BUY
2020-12-10 09:15:00,09:15,7206250,10109200,2902950,BUY
2020-12-10 09:16:00,09:16,7206250,10828550,3622300,BUY
2020-12-10 09:17:00,09:17,7431025,11100775,3669750,BUY
2020-12-10 09:18:00,09:18,7477875,11100675,3622800,BUY
2020-12-10 09:19:00,09:19,7472650,11083225,3610575,BUY
2020-12-10 09:20:00,09:20,8021950,11715600,3693650,BUY
2020-12-10 09:21:00,09:21,7991825,11712050,3720225,BUY
2020-12-10 09:22:00,09:22,7882225,11689950,3807725,BUY
2020-12-10 09:23:00,09:23,8502175,12299700,3797525,BUY
2020-12-10 09:24:00,09:24,8607275,12327375,3720100,BUY
2020-12-10 09:25:00,09:25,8616700,12315525,3698825,BUY
2020-12-10 09:26:00,09:26,9190175,13076275,3886100,BUY
2020-12-10 09:27:00,09:27,9246350,13051550,3805200,BUY
2020-12-10 09:28:00,09:28,9223800,13082650,3858850,BUY
2020-12-10 09:29:00,09:29,10031850,13516950,3485100,BUY
2020-12-10 09:30:00,09:30,10018900,13501325,3482425,BUY
2020-12-10 09:31:00,09:31,9990075,13477975,3487900,BUY
2020-12-10 09:32:00,09:32,10604525,13844400,3239875,BUY
2020-12-10 09:33:00,09:33,10649650,13832900,3183250,BUY
2020-12-10 09:34:00,09:34,10627425,13840025,3212600,BUY
2020-12-10 09:35:00,09:35,11131850,14231150,3099300,BUY
2020-12-10 09:36:00,09:36,11058050,14228350,3170300,BUY
2020-12-10 09:37:00,09:37,11003900,14252200,3248300,BUY
2020-12-10 09:38:00,09:38,11481300,14196000,2714700,BUY
2020-12-10 09:39:00,09:39,11493475,14193000,2699525,BUY
2020-12-10 09:40:00,09:40,11478000,14189200,2711200,BUY
2020-12-10 09:41:00,09:41,11654400,14162950,2508550,BUY
2020-12-10 09:42:00,09:42,11632875,14183950,2551075,BUY
2020-12-10 09:43:00,09:43,11736575,14174700,2438125,BUY
2020-12-10 09:44:00,09:44,11947875,14647175,2699300,BUY
2020-12-10 09:45:00,09:45,12075150,14653800,2578650,BUY
2020-12-10 09:46:00,09:46,12045350,14666225,2620875,BUY
2020-12-10 09:47:00,09:47,12224125,15030475,2806350,BUY
2020-12-10 09:48:00,09:48,12221675,15043525,2821850,BUY
2020-12-10 09:49:00,09:49,12185125,14996500,2811375,BUY
2020-12-10 09:50:00,09:50,12446650,15132850,2686200,BUY
2020-12-10 09:51:00,09:51,12507150,15176000,2668850,BUY
2020-12-10 09:52:00,09:52,12490350,15194725,2704375,BUY
2020-12-10 09:53:00,09:53,12871575,15683625,2812050,BUY
2020-12-10 09:54:00,09:54,12852875,15604925,2752050,BUY
2020-12-10 09:55:00,09:55,12882750,15695600,2812850,BUY
2020-12-10 09:56:00,09:56,13074775,15887575,2812800,BUY
2020-12-10 09:57:00,09:57,13147550,15892525,2744975,BUY
2020-12-10 09:58:00,09:58,13121075,15865925,2744850,BUY
2020-12-10 09:59:00,09:59,13242400,16164175,2921775,BUY
2020-12-10 10:00:00,10:00,13237525,16179950,2942425,BUY
2020-12-10 10:01:00,10:01,13234700,16180800,2946100,BUY
2020-12-10 10:02:00,10:02,13401225,16243725,2842500,BUY
2020-12-10 10:03:00,10:03,13308475,16233150,2924675,BUY
2020-12-10 10:04:00,10:04,13530200,16270750,2740550,BUY
2020-12-10 10:05:00,10:05,13636850,16366825,2729975,BUY
2020-12-10 10:06:00,10:06,13707050,16390900,2683850,BUY
2020-12-10 10:07:00,10:07,13732000,16337375,2605375,BUY
2020-12-10 10:08:00,10:08,13970825,16143975,2173150,BUY
2020-12-10 10:09:00,10:09,13973325,16206975,2233650,BUY
2020-12-10 10:10:00,10:10,13896650,16270875,2374225,BUY
2020-12-10 10:11:00,10:11,14168200,16380925,2212725,BUY
2020-12-10 10:12:00,10:12,14005700,16417750,2412050,BUY
2020-12-10 10:13:00,10:13,14019225,16436825,2417600,BUY
2020-12-10 10:14:00,10:14,14296950,16620250,2323300,BUY
2020-12-10 10:15:00,10:15,14335150,16590275,2255125,BUY
2020-12-10 10:16:00,10:16,14311850,16627150,2315300,BUY
2020-12-10 10:17:00,10:17,14576725,16736000,2159275,BUY
2020-12-10 10:18:00,10:18,14486075,16751700,2265625,BUY
2020-12-10 10:19:00,10:19,14508400,16845325,2336925,BUY
2020-12-10 10:20:00,10:20,14632225,16741775,2109550,BUY
2020-12-10 10:21:00,10:21,14659200,16792500,2133300,BUY
2020-12-10 10:22:00,10:22,14692200,16715050,2022850,BUY
2020-12-10 10:23:00,10:23,14628325,16810375,2182050,BUY
2020-12-10 10:24:00,10:24,14376925,16809675,2432750,BUY
2020-12-10 10:25:00,10:25,14617600,16715125,2097525,BUY
2020-12-10 10:26:00,10:26,14681475,16594025,1912550,BUY
2020-12-10 10:27:00,10:27,14612650,16695175,2082525,BUY
2020-12-10 10:28:00,10:28,14669200,16095800,1426600,BUY
2020-12-10 10:29:00,10:29,14676800,16632600,1955800,BUY
2020-12-10 10:30:00,10:30,14679875,16651225,1971350,BUY
2020-12-10 10:31:00,10:31,14693150,16636800,1943650,BUY
2020-12-10 10:32:00,10:32,14906900,16707150,1800250,BUY
2020-12-10 10:33:00,10:33,14734100,16689900,1955800,BUY
2020-12-10 10:34:00,10:34,14922325,16108825,1186500,BUY
2020-12-10 10:35:00,10:35,14926175,16723200,1797025,BUY
2020-12-10 10:36:00,10:36,14902100,16755225,1853125,BUY
2020-12-10 10:37:00,10:37,14949550,16671150,1721600,BUY
2020-12-10 10:38:00,10:38,15044350,16113025,1068675,BUY
2020-12-10 10:39:00,10:39,15016575,16142000,1125425,BUY
2020-12-10 10:40:00,10:40,15042700,16718200,1675500,BUY
2020-12-10 10:41:00,10:41,15183950,16563050,1379100,BUY
2020-12-10 10:42:00,10:42,15183925,16516875,1332950,BUY
2020-12-10 10:43:00,10:43,15166725,16638125,1471400,BUY
2020-12-10 10:44:00,10:44,15066275,16773075,1706800,BUY
2020-12-10 10:45:00,10:45,15103525,16879675,1776150,BUY
2020-12-10 10:46:00,10:46,14940025,16684975,1744950,BUY
2020-12-10 10:47:00,10:47,15000475,16528950,1528475,BUY
2020-12-10 10:48:00,10:48,15165375,16717825,1552450,BUY
2020-12-10 10:49:00,10:49,15087150,16747600,1660450,BUY
2020-12-10 10:50:00,10:50,15026650,16182550,1155900,BUY
2020-12-10 10:51:00,10:51,15130975,16731275,1600300,BUY
2020-12-10 10:52:00,10:52,15061250,16806700,1745450,BUY
2020-12-10 10:53:00,10:53,15130575,16875650,1745075,BUY
2020-12-10 10:54:00,10:54,15029225,16896375,1867150,BUY
2020-12-10 10:55:00,10:55,15257975,16956650,1698675,BUY
2020-12-10 10:56:00,10:56,15068650,16774700,1706050,BUY
2020-12-10 10:57:00,10:57,15172525,16831625,1659100,BUY
2020-12-10 10:58:00,10:58,15132400,16765025,1632625,BUY
2020-12-10 10:59:00,10:59,15269275,16729800,1460525,BUY
2020-12-10 11:00:00,11:00,15239850,16670000,1430150,BUY
2020-12-10 11:01:00,11:01,15251775,16758975,1507200,BUY
2020-12-10 11:02:00,11:02,15195050,16827575,1632525,BUY
2020-12-10 11:03:00,11:03,15199075,16863950,1664875,BUY
2020-12-10 11:04:00,11:04,15218800,16868125,1649325,BUY
2020-12-10 11:05:00,11:05,15224650,16734275,1509625,BUY
2020-12-10 11:06:00,11:06,15282075,16838875,1556800,BUY
2020-12-10 11:07:00,11:07,15280925,16841400,1560475,BUY
2020-12-10 11:08:00,11:08,15255775,16219925,964150,BUY
2020-12-10 11:09:00,11:09,15274500,16775900,1501400,BUY
2020-12-10 11:10:00,11:10,15229225,16733950,1504725,BUY
2020-12-10 11:11:00,11:11,15366500,16898500,1532000,BUY
2020-12-10 11:12:00,11:12,15321400,16880450,1559050,BUY
2020-12-10 11:13:00,11:13,15406250,16901175,1494925,BUY
2020-12-10 11:14:00,11:14,15418225,17163650,1745425,BUY
2020-12-10 11:15:00,11:15,15320775,17181975,1861200,BUY
2020-12-10 11:16:00,11:16,15402125,17129375,1727250,BUY
2020-12-10 11:17:00,11:17,15612075,17190325,1578250,BUY
2020-12-10 11:18:00,11:18,15498075,17243075,1745000,BUY
2020-12-10 11:19:00,11:19,15526225,17088950,1562725,BUY
2020-12-10 11:20:00,11:20,15772450,17293900,1521450,BUY
2020-12-10 11:21:00,11:21,15704550,17336150,1631600,BUY
2020-12-10 11:22:00,11:22,15682575,17223825,1541250,BUY
2020-12-10 11:23:00,11:23,15800850,17396875,1596025,BUY
2020-12-10 11:24:00,11:24,15781000,17477900,1696900,BUY
2020-12-10 11:25:00,11:25,15859000,16584550,725550,BUY
2020-12-10 11:26:00,11:26,15976400,17110475,1134075,BUY
2020-12-10 11:27:00,11:27,15763050,17542200,1779150,BUY
2020-12-10 11:28:00,11:28,16014225,17665200,1650975,BUY
2020-12-10 11:29:00,11:29,16042175,17704625,1662450,BUY
2020-12-10 11:30:00,11:30,16047100,17099125,1052025,BUY
2020-12-10 11:31:00,11:31,15990100,17701025,1710925,BUY
2020-12-10 11:32:00,11:32,16119300,17783000,1663700,BUY
2020-12-10 11:33:00,11:33,16083500,17635475,1551975,BUY
2020-12-10 11:34:00,11:34,16130575,17667675,1537100,BUY
2020-12-10 11:35:00,11:35,16203225,17812650,1609425,BUY
2020-12-10 11:36:00,11:36,16158275,16471425,313150,BUY
2020-12-10 11:37:00,11:37,16223475,17878600,1655125,BUY
2020-12-10 11:38:00,11:38,16146250,17322650,1176400,BUY
2020-12-10 11:39:00,11:39,16108125,17888900,1780775,BUY
2020-12-10 11:40:00,11:40,16202175,17296175,1094000,BUY
2020-12-10 11:41:00,11:41,16245850,17669000,1423150,BUY
2020-12-10 11:42:00,11:42,16416075,18018950,1602875,BUY
2020-12-10 11:43:00,11:43,16278500,17866550,1588050,BUY
2020-12-10 11:44:00,11:44,15813100,17800875,1987775,BUY
2020-12-10 11:45:00,11:45,16290875,17723425,1432550,BUY
2020-12-10 11:46:00,11:46,16241450,17647575,1406125,BUY
2020-12-10 11:47:00,11:47,16253850,17053225,799375,BUY
2020-12-10 11:48:00,11:48,16249125,17595725,1346600,BUY
2020-12-10 11:49:00,11:49,16231950,17619800,1387850,BUY
2020-12-10 11:50:00,11:50,16268950,17236300,967350,BUY
2020-12-10 11:51:00,11:51,16344400,17497175,1152775,BUY
2020-12-10 11:52:00,11:52,16442200,17601350,1159150,BUY
2020-12-10 11:53:00,11:53,16496825,17277625,780800,BUY
2020-12-10 11:54:00,11:54,16458500,17274100,815600,BUY
2020-12-10 11:55:00,11:55,16493075,17132850,639775,BUY
2020-12-10 11:56:00,11:56,16605425,17035825,430400,BUY
2020-12-10 11:57:00,11:57,16432575,17067200,634625,BUY
2020-12-10 11:58:00,11:58,16416025,17003225,587200,BUY
2020-12-10 11:59:00,11:59,16357775,17035025,677250,BUY
2020-12-10 12:00:00,12:00,16570700,17116200,545500,BUY
2020-12-10 12:01:00,12:01,16608800,16960625,351825,BUY
2020-12-10 12:02:00,12:02,16608800,16987800,379000,BUY
2020-12-10 12:03:00,12:03,16627100,16372775,-254325,SELL
2020-12-10 12:04:00,12:04,16694775,17068225,373450,BUY
2020-12-10 12:05:00,12:05,16371725,17061250,689525,BUY
2020-12-10 12:06:00,12:06,16742525,17231375,488850,BUY
2020-12-10 12:07:00,12:07,16752125,17191400,439275,BUY
2020-12-10 12:08:00,12:08,16643675,16654775,11100,BUY
2020-12-10 12:09:00,12:09,16696950,17037975,341025,BUY
2020-12-10 12:10:00,12:10,16680850,16455375,-225475,SELL
2020-12-10 12:11:00,12:11,16759500,17025300,265800,BUY
2020-12-10 12:12:00,12:12,16740000,16392225,-347775,SELL
2020-12-10 12:13:00,12:13,16610150,16444950,-165200,SELL
2020-12-10 12:14:00,12:14,16850375,16952200,101825,BUY
2020-12-10 12:15:00,12:15,16885700,16907200,21500,BUY
2020-12-10 12:16:00,12:16,16921675,16364000,-557675,SELL
2020-12-10 12:17:00,12:17,16921675,16334250,-587425,SELL
2020-12-10 12:18:00,12:18,16786775,16580675,-206100,SELL
2020-12-10 12:19:00,12:19,16766750,16578150,-188600,SELL
2020-12-10 12:20:00,12:20,16809025,16598150,-210875,SELL
2020-12-10 12:21:00,12:21,16771500,16607975,-163525,SELL
2020-12-10 12:22:00,12:22,16758300,16634675,-123625,SELL
2020-12-10 12:23:00,12:23,16755000,16716625,-38375,SELL
2020-12-10 12:24:00,12:24,16788050,16768250,-19800,SELL
2020-12-10 12:25:00,12:25,16772025,16119625,-652400,SELL
2020-12-10 12:26:00,12:26,16779700,16673100,-106600,SELL
2020-12-10 12:27:00,12:27,16802925,16607325,-195600,SELL
2020-12-10 12:28:00,12:28,16788200,16643875,-144325,SELL
2020-12-10 12:29:00,12:29,16673900,16752300,78400,BUY
2020-12-10 12:30:00,12:30,16863100,16840975,-22125,SELL
2020-12-10 12:31:00,12:31,16884650,16796825,-87825,SELL
2020-12-10 12:32:00,12:32,16896100,16787550,-108550,SELL
2020-12-10 12:33:00,12:33,16814200,16229300,-584900,SELL
2020-12-10 12:34:00,12:34,16881475,16794425,-87050,SELL
2020-12-10 12:35:00,12:35,16922350,16767550,-154800,SELL
2020-12-10 12:36:00,12:36,16971550,16959850,-11700,SELL
2020-12-10 12:37:00,12:37,16964175,17014850,50675,BUY
2020-12-10 12:38:00,12:38,17006050,17021250,15200,BUY
2020-12-10 12:39:00,12:39,17060750,17081350,20600,BUY
2020-12-10 12:40:00,12:40,17010325,16964775,-45550,SELL
2020-12-10 12:41:00,12:41,16973600,17114300,140700,BUY
2020-12-10 12:42:00,12:42,17009300,17088775,79475,BUY
2020-12-10 12:43:00,12:43,16989500,17081650,92150,BUY
2020-12-10 12:44:00,12:44,16845450,17031950,186500,BUY
2020-12-10 12:45:00,12:45,17087150,17229250,142100,BUY
2020-12-10 12:46:00,12:46,16932525,17182200,249675,BUY
2020-12-10 12:47:00,12:47,16875550,16997025,121475,BUY
2020-12-10 12:48:00,12:48,17098725,17146600,47875,BUY
2020-12-10 12:49:00,12:49,17133150,17224975,91825,BUY
2020-12-10 12:50:00,12:50,16916775,17252225,335450,BUY
2020-12-10 12:51:00,12:51,16773600,17260500,486900,BUY
2020-12-10 12:52:00,12:52,16986425,17145825,159400,BUY
2020-12-10 12:53:00,12:53,16879500,17197650,318150,BUY
2020-12-10 12:54:00,12:54,16919150,17175900,256750,BUY
2020-12-10 12:55:00,12:55,16980575,17248300,267725,BUY
2020-12-10 12:56:00,12:56,16990625,17167700,177075,BUY
2020-12-10 12:57:00,12:57,17112425,17230900,118475,BUY
2020-12-10 12:58:00,12:58,17014675,17006375,-8300,SELL
2020-12-10 12:59:00,12:59,17020150,17205875,185725,BUY
2020-12-10 13:00:00,13:00,16974575,17322875,348300,BUY
2020-12-10 13:01:00,13:01,16984600,16340975,-643625,SELL
2020-12-10 13:02:00,13:02,16904900,17340150,435250,BUY
2020-12-10 13:03:00,13:03,17040250,17364550,324300,BUY
2020-12-10 13:04:00,13:04,17021925,17237400,215475,BUY
2020-12-10 13:05:00,13:05,17056500,17235050,178550,BUY
2020-12-10 13:06:00,13:06,16935600,17374725,439125,BUY
2020-12-10 13:07:00,13:07,16969500,17271650,302150,BUY
2020-12-10 13:08:00,13:08,16899750,17303975,404225,BUY
2020-12-10 13:09:00,13:09,16905775,17308600,402825,BUY
2020-12-10 13:10:00,13:10,17040950,17273825,232875,BUY
2020-12-10 13:11:00,13:11,17057350,17344275,286925,BUY
2020-12-10 13:12:00,13:12,16935800,16882350,-53450,SELL
2020-12-10 13:13:00,13:13,17014025,16817950,-196075,SELL
2020-12-10 13:14:00,13:14,16999750,17367775,368025,BUY
2020-12-10 13:15:00,13:15,17002650,17342950,340300,BUY
2020-12-10 13:16:00,13:16,16942075,17360425,418350,BUY
2020-12-10 13:17:00,13:17,16865950,17340550,474600,BUY
2020-12-10 13:18:00,13:18,16898250,17233175,334925,BUY
2020-12-10 13:19:00,13:19,16894650,17269350,374700,BUY
2020-12-10 13:20:00,13:20,16930375,17246650,316275,BUY
2020-12-10 13:21:00,13:21,16856725,17498225,641500,BUY
2020-12-10 13:22:00,13:22,16905250,17499125,593875,BUY
2020-12-10 13:23:00,13:23,16908750,17424375,515625,BUY
2020-12-10 13:24:00,13:24,16846475,17479200,632725,BUY
2020-12-10 13:25:00,13:25,16797125,17412500,615375,BUY
2020-12-10 13:26:00,13:26,16797125,17416050,618925,BUY
2020-12-10 13:27:00,13:27,16765450,17549350,783900,BUY
2020-12-10 13:28:00,13:28,16750900,17525600,774700,BUY
2020-12-10 13:29:00,13:29,16769875,17489850,719975,BUY
2020-12-10 13:30:00,13:30,16870125,17775050,904925,BUY
2020-12-10 13:31:00,13:31,16972200,17782600,810400,BUY
2020-12-10 13:32:00,13:32,16988950,17782600,793650,BUY
2020-12-10 13:33:00,13:33,16820475,17549625,729150,BUY
2020-12-10 13:34:00,13:34,16827150,17549550,722400,BUY
2020-12-10 13:35:00,13:35,16824100,17514175,690075,BUY
2020-12-10 13:36:00,13:36,16419975,17115525,695550,BUY
2020-12-10 13:37:00,13:37,16390625,17035550,644925,BUY
2020-12-10 13:38:00,13:38,16364325,17121550,757225,BUY
2020-12-10 13:39:00,13:39,16496000,16731675,235675,BUY
2020-12-10 13:40:00,13:40,16505200,16741250,236050,BUY
2020-12-10 13:41:00,13:41,16466750,16741300,274550,BUY
2020-12-10 13:42:00,13:42,16400700,16679175,278475,BUY
2020-12-10 13:43:00,13:43,16415625,16690000,274375,BUY
2020-12-10 13:44:00,13:44,16416100,16596725,180625,BUY
2020-12-10 13:45:00,13:45,16263100,16344500,81400,BUY
2020-12-10 13:46:00,13:46,16246925,16228400,-18525,SELL
2020-12-10 13:47:00,13:47,16251850,16328800,76950,BUY
2020-12-10 13:48:00,13:48,16304350,16531125,226775,BUY
2020-12-10 13:49:00,13:49,16299200,16605600,306400,BUY
2020-12-10 13:50:00,13:50,16328200,16592175,263975,BUY
2020-12-10 13:51:00,13:51,16441100,16919825,478725,BUY
2020-12-10 13:52:00,13:52,16303725,16851700,547975,BUY
2020-12-10 13:53:00,13:53,16413100,16668875,255775,BUY
2020-12-10 13:54:00,13:54,16550750,16924025,373275,BUY
2020-12-10 13:55:00,13:55,16527700,16388525,-139175,SELL
2020-12-10 13:56:00,13:56,16552400,16868600,316200,BUY
2020-12-10 13:57:00,13:57,16435000,16836600,401600,BUY
2020-12-10 13:58:00,13:58,16422175,16739125,316950,BUY
2020-12-10 13:59:00,13:59,16408725,16769925,361200,BUY
2020-12-10 14:00:00,14:00,16365300,16423225,57925,BUY
2020-12-10 14:01:00,14:01,16329775,16309850,-19925,SELL
2020-12-10 14:02:00,14:02,16365200,16331550,-33650,SELL
2020-12-10 14:03:00,14:03,15898650,17009050,1110400,BUY
2020-12-10 14:04:00,14:04,16122525,16991850,869325,BUY
2020-12-10 14:05:00,14:05,16122525,17118325,995800,BUY
2020-12-10 14:06:00,14:06,16010850,17198650,1187800,BUY
2020-12-10 14:07:00,14:07,16099225,17224450,1125225,BUY
2020-12-10 14:08:00,14:08,16102650,17281600,1178950,BUY
2020-12-10 14:09:00,14:09,16181050,17135925,954875,BUY
2020-12-10 14:10:00,14:10,16163825,17305500,1141675,BUY
2020-12-10 14:11:00,14:11,16176550,17248100,1071550,BUY
2020-12-10 14:12:00,14:12,16145975,16997300,851325,BUY
2020-12-10 14:13:00,14:13,16181875,17041525,859650,BUY
2020-12-10 14:14:00,14:14,16174450,17113800,939350,BUY
2020-12-10 14:15:00,14:15,16207900,17125950,918050,BUY
2020-12-10 14:16:00,14:16,16203325,16490200,286875,BUY
2020-12-10 14:17:00,14:17,16190600,17168625,978025,BUY
2020-12-10 14:18:00,14:18,16141725,16955575,813850,BUY
2020-12-10 14:19:00,14:19,16177325,16986000,808675,BUY
2020-12-10 14:20:00,14:20,16199725,16964250,764525,BUY
2020-12-10 14:21:00,14:21,16176900,17081375,904475,BUY
2020-12-10 14:22:00,14:22,16189450,17067175,877725,BUY
2020-12-10 14:23:00,14:23,16145700,17050250,904550,BUY
2020-12-10 14:24:00,14:24,16167125,16610575,443450,BUY
2020-12-10 14:25:00,14:25,16183000,17081150,898150,BUY
2020-12-10 14:26:00,14:26,16203500,17131275,927775,BUY
2020-12-10 14:27:00,14:27,15986275,17332800,1346525,BUY
2020-12-10 14:28:00,14:28,15973175,17315425,1342250,BUY
2020-12-10 14:29:00,14:29,16033825,17293050,1259225,BUY
2020-12-10 14:30:00,14:30,15357450,17354450,1997000,BUY
2020-12-10 14:31:00,14:31,15380275,17373600,1993325,BUY
2020-12-10 14:32:00,14:32,15362850,17370850,2008000,BUY
2020-12-10 14:33:00,14:33,15022350,17489525,2467175,BUY
2020-12-10 14:34:00,14:34,14658425,17481000,2822575,BUY
2020-12-10 14:35:00,14:35,14970025,17438050,2468025,BUY
2020-12-10 14:36:00,14:36,14901825,17277750,2375925,BUY
2020-12-10 14:37:00,14:37,14750175,17366725,2616550,BUY
2020-12-10 14:38:00,14:38,14917425,17315450,2398025,BUY
2020-12-10 14:39:00,14:39,14889700,17385950,2496250,BUY
2020-12-10 14:40:00,14:40,14901825,17463975,2562150,BUY
2020-12-10 14:41:00,14:41,14883125,17402750,2519625,BUY
2020-12-10 14:42:00,14:42,15037125,17507475,2470350,BUY
2020-12-10 14:43:00,14:43,15036225,17617050,2580825,BUY
2020-12-10 14:44:00,14:44,15029400,17585575,2556175,BUY
2020-12-10 14:45:00,14:45,14479125,17482050,3002925,BUY
2020-12-10 14:46:00,14:46,14487300,16956250,2468950,BUY
2020-12-10 14:47:00,14:47,14495575,17417775,2922200,BUY
2020-12-10 14:48:00,14:48,14210175,17306500,3096325,BUY
2020-12-10 14:49:00,14:49,14232700,17335875,3103175,BUY
2020-12-10 14:50:00,14:50,14226500,17306425,3079925,BUY
2020-12-10 14:51:00,14:51,14142950,17286775,3143825,BUY
2020-12-10 14:52:00,14:52,14185875,17306325,3120450,BUY
2020-12-10 14:53:00,14:53,14174875,17306475,3131600,BUY
2020-12-10 14:54:00,14:54,14362300,17258225,2895925,BUY
2020-12-10 14:55:00,14:55,14374025,16685700,2311675,BUY
2020-12-10 14:56:00,14:56,14390500,17259625,2869125,BUY
2020-12-10 14:57:00,14:57,13451075,17165825,3714750,BUY
2020-12-10 14:58:00,14:58,13481675,17163675,3682000,BUY
2020-12-10 14:59:00,14:59,13392125,17185800,3793675,BUY
2020-12-10 15:00:00,15:00,13089075,17071600,3982525,BUY
2020-12-10 15:01:00,15:01,13140900,17048625,3907725,BUY
2020-12-10 15:02:00,15:02,13118300,17046150,3927850,BUY
2020-12-10 15:03:00,15:03,13088725,16299100,3210375,BUY
2020-12-10 15:04:00,15:04,13053075,16745250,3692175,BUY
2020-12-10 15:05:00,15:05,13057200,16902575,3845375,BUY
2020-12-10 15:06:00,15:06,13229675,16984600,3754925,BUY
2020-12-10 15:07:00,15:07,13262825,16980150,3717325,BUY
2020-12-10 15:08:00,15:08,13298450,16980150,3681700,BUY
2020-12-10 15:09:00,15:09,12993800,16883750,3889950,BUY
2020-12-10 15:10:00,15:10,12994300,16910100,3915800,BUY
2020-12-10 15:11:00,15:11,12949350,16908625,3959275,BUY
2020-12-10 15:12:00,15:12,12899275,16709300,3810025,BUY
2020-12-10 15:13:00,15:13,12876975,16611850,3734875,BUY
2020-12-10 15:14:00,15:14,12885675,16619150,3733475,BUY
2020-12-10 15:15:00,15:15,12263125,15957875,3694750,BUY
2020-12-10 15:16:00,15:16,12264725,16061050,3796325,BUY
2020-12-10 15:17:00,15:17,12139575,15663425,3523850,BUY
2020-12-10 15:18:00,15:18,11094475,15222800,4128325,BUY
2020-12-10 15:19:00,15:19,11082550,14618925,3536375,BUY
2020-12-10 15:20:00,15:20,11096450,14723950,3627500,BUY
2020-12-10 15:21:00,15:21,9887575,14060150,4172575,BUY
2020-12-10 15:22:00,15:22,9714000,13925050,4211050,BUY
2020-12-10 15:23:00,15:23,9820175,14045675,4225500,BUY
2020-12-10 15:24:00,15:24,8678450,12915050,4236600,BUY
2020-12-10 15:25:00,15:25,9074450,12873300,3798850,BUY
2020-12-10 15:26:00,15:26,8952900,13376475,4423575,BUY
2020-12-10 15:27:00,15:27,8289825,12537775,4247950,BUY
2020-12-10 15:28:00,15:28,8485450,12499850,4014400,BUY
2020-12-10 15:29:00,15:29,8511925,12044375,3532450,BUY
