,timestamp,call,put,diff,sellOrBuy
2020-10-23 09:15:00,09:15,4932700,5312850,380150,BUY
2020-10-23 09:16:00,09:16,5517975,5200000,-317975,SELL
2020-10-23 09:17:00,09:17,5706725,5635700,-71025,SELL
2020-10-23 09:18:00,09:18,5462825,5641350,178525,BUY
2020-10-23 09:19:00,09:19,5481550,5503850,22300,BUY
2020-10-23 09:20:00,09:20,6052900,6174450,121550,BUY
2020-10-23 09:21:00,09:21,5713250,6043825,330575,BUY
2020-10-23 09:22:00,09:22,6221900,6173625,-48275,SELL
2020-10-23 09:23:00,09:23,6389875,6340350,-49525,SELL
2020-10-23 09:24:00,09:24,6339325,6266425,-72900,SELL
2020-10-23 09:25:00,09:25,6297275,6377025,79750,BUY
2020-10-23 09:26:00,09:26,6398175,6474725,76550,BUY
2020-10-23 09:27:00,09:27,6053700,6456075,402375,BUY
2020-10-23 09:28:00,09:28,6265125,6438775,173650,BUY
2020-10-23 09:29:00,09:29,6678125,6574675,-103450,SELL
2020-10-23 09:30:00,09:30,6545375,6598575,53200,BUY
2020-10-23 09:31:00,09:31,6586500,6395275,-191225,SELL
2020-10-23 09:32:00,09:32,6685850,6716975,31125,BUY
2020-10-23 09:33:00,09:33,6648625,6597100,-51525,SELL
2020-10-23 09:34:00,09:34,6782175,6450450,-331725,SELL
2020-10-23 09:35:00,09:35,7238050,6476150,-761900,SELL
2020-10-23 09:36:00,09:36,6821700,6790100,-31600,SELL
2020-10-23 09:37:00,09:37,6444050,6666300,222250,BUY
2020-10-23 09:38:00,09:38,6851225,6797200,-54025,SELL
2020-10-23 09:39:00,09:39,6806850,6882250,75400,BUY
2020-10-23 09:40:00,09:40,6882975,6906600,23625,BUY
2020-10-23 09:41:00,09:41,7073700,6722750,-350950,SELL
2020-10-23 09:42:00,09:42,6725200,6630225,-94975,SELL
2020-10-23 09:43:00,09:43,6782075,6995325,213250,BUY
2020-10-23 09:44:00,09:44,7035475,6718350,-317125,SELL
2020-10-23 09:45:00,09:45,7017550,6907175,-110375,SELL
2020-10-23 09:46:00,09:46,7021225,6875000,-146225,SELL
2020-10-23 09:47:00,09:47,7080075,6987225,-92850,SELL
2020-10-23 09:48:00,09:48,7084750,7060000,-24750,SELL
2020-10-23 09:49:00,09:49,7666725,7082775,-583950,SELL
2020-10-23 09:50:00,09:50,6960375,7118700,158325,BUY
2020-10-23 09:51:00,09:51,6994600,7153125,158525,BUY
2020-10-23 09:52:00,09:52,7261600,6924775,-336825,SELL
2020-10-23 09:53:00,09:53,7073075,7138950,65875,BUY
2020-10-23 09:54:00,09:54,7348000,7176600,-171400,SELL
2020-10-23 09:55:00,09:55,7128575,7139925,11350,BUY
2020-10-23 09:56:00,09:56,7149450,7138975,-10475,SELL
2020-10-23 09:57:00,09:57,7507925,7040425,-467500,SELL
2020-10-23 09:58:00,09:58,7334775,6892850,-441925,SELL
2020-10-23 09:59:00,09:59,7603175,7267025,-336150,SELL
2020-10-23 10:00:00,10:00,7472475,7135675,-336800,SELL
2020-10-23 10:01:00,10:01,7433350,7087200,-346150,SELL
2020-10-23 10:02:00,10:02,7362200,7326500,-35700,SELL
2020-10-23 10:03:00,10:03,7597150,7378900,-218250,SELL
2020-10-23 10:04:00,10:04,7579000,6827875,-751125,SELL
2020-10-23 10:05:00,10:05,7908925,7419400,-489525,SELL
2020-10-23 10:06:00,10:06,7481500,7192675,-288825,SELL
2020-10-23 10:07:00,10:07,7812250,7463000,-349250,SELL
2020-10-23 10:08:00,10:08,7719825,6944150,-775675,SELL
2020-10-23 10:09:00,10:09,7887575,7500025,-387550,SELL
2020-10-23 10:10:00,10:10,8146300,7470875,-675425,SELL
2020-10-23 10:11:00,10:11,7652700,7155800,-496900,SELL
2020-10-23 10:12:00,10:12,7641575,7127825,-513750,SELL
2020-10-23 10:13:00,10:13,7732475,7325825,-406650,SELL
2020-10-23 10:14:00,10:14,7699900,7139900,-560000,SELL
2020-10-23 10:15:00,10:15,7814100,7375125,-438975,SELL
2020-10-23 10:16:00,10:16,7995900,7072325,-923575,SELL
2020-10-23 10:17:00,10:17,7699450,7083550,-615900,SELL
2020-10-23 10:18:00,10:18,7835975,7536650,-299325,SELL
2020-10-23 10:19:00,10:19,7863025,7437150,-425875,SELL
2020-10-23 10:20:00,10:20,7592875,7501825,-91050,SELL
2020-10-23 10:21:00,10:21,7792425,7517175,-275250,SELL
2020-10-23 10:22:00,10:22,7924225,7466675,-457550,SELL
2020-10-23 10:23:00,10:23,8056350,7313825,-742525,SELL
2020-10-23 10:24:00,10:24,7570625,7405550,-165075,SELL
2020-10-23 10:25:00,10:25,7814125,7424775,-389350,SELL
2020-10-23 10:26:00,10:26,7795075,7352325,-442750,SELL
2020-10-23 10:27:00,10:27,7803775,7447550,-356225,SELL
2020-10-23 10:28:00,10:28,8003200,7552550,-450650,SELL
2020-10-23 10:29:00,10:29,7657875,7474825,-183050,SELL
2020-10-23 10:30:00,10:30,7836675,7413900,-422775,SELL
2020-10-23 10:31:00,10:31,7929850,7627450,-302400,SELL
2020-10-23 10:32:00,10:32,8051150,7507250,-543900,SELL
2020-10-23 10:33:00,10:33,7758275,7368675,-389600,SELL
2020-10-23 10:34:00,10:34,8550175,7441550,-1108625,SELL
2020-10-23 10:35:00,10:35,8507125,7284825,-1222300,SELL
2020-10-23 10:36:00,10:36,8141725,7428175,-713550,SELL
2020-10-23 10:37:00,10:37,7988125,7437950,-550175,SELL
2020-10-23 10:38:00,10:38,7875250,7300725,-574525,SELL
2020-10-23 10:39:00,10:39,8222975,7373725,-849250,SELL
2020-10-23 10:40:00,10:40,8411075,7336175,-1074900,SELL
2020-10-23 10:41:00,10:41,7850975,7450550,-400425,SELL
2020-10-23 10:42:00,10:42,7976350,7341325,-635025,SELL
2020-10-23 10:43:00,10:43,8209650,7360100,-849550,SELL
2020-10-23 10:44:00,10:44,8019550,7236950,-782600,SELL
2020-10-23 10:45:00,10:45,8306325,7508425,-797900,SELL
2020-10-23 10:46:00,10:46,8068175,7427025,-641150,SELL
2020-10-23 10:47:00,10:47,8348150,7475075,-873075,SELL
2020-10-23 10:48:00,10:48,8152950,7400925,-752025,SELL
2020-10-23 10:49:00,10:49,8530800,7660375,-870425,SELL
2020-10-23 10:50:00,10:50,8417400,7667725,-749675,SELL
2020-10-23 10:51:00,10:51,8411625,7625400,-786225,SELL
2020-10-23 10:52:00,10:52,8205275,7732075,-473200,SELL
2020-10-23 10:53:00,10:53,8599025,7639175,-959850,SELL
2020-10-23 10:54:00,10:54,8131600,7631050,-500550,SELL
2020-10-23 10:55:00,10:55,8813525,7617625,-1195900,SELL
2020-10-23 10:56:00,10:56,8455925,7648000,-807925,SELL
2020-10-23 10:57:00,10:57,8632700,7454450,-1178250,SELL
2020-10-23 10:58:00,10:58,8766400,7572825,-1193575,SELL
2020-10-23 10:59:00,10:59,8286025,7602000,-684025,SELL
2020-10-23 11:00:00,11:00,8469725,7352875,-1116850,SELL
2020-10-23 11:01:00,11:01,8488950,7566500,-922450,SELL
2020-10-23 11:02:00,11:02,8406850,7450975,-955875,SELL
2020-10-23 11:03:00,11:03,8539650,7647950,-891700,SELL
2020-10-23 11:04:00,11:04,8602725,7564050,-1038675,SELL
2020-10-23 11:05:00,11:05,8582100,7550400,-1031700,SELL
2020-10-23 11:06:00,11:06,8439100,7709800,-729300,SELL
2020-10-23 11:07:00,11:07,8423975,7546075,-877900,SELL
2020-10-23 11:08:00,11:08,8374375,7369450,-1004925,SELL
2020-10-23 11:09:00,11:09,8458025,7830600,-627425,SELL
2020-10-23 11:10:00,11:10,8603325,7628050,-975275,SELL
2020-10-23 11:11:00,11:11,8466900,7929300,-537600,SELL
2020-10-23 11:12:00,11:12,8360200,7701925,-658275,SELL
2020-10-23 11:13:00,11:13,8682075,7641425,-1040650,SELL
2020-10-23 11:14:00,11:14,8464250,7653750,-810500,SELL
2020-10-23 11:15:00,11:15,8600950,7950100,-650850,SELL
2020-10-23 11:16:00,11:16,8464575,7524550,-940025,SELL
2020-10-23 11:17:00,11:17,8662175,7664000,-998175,SELL
2020-10-23 11:18:00,11:18,8405000,7674000,-731000,SELL
2020-10-23 11:19:00,11:19,8416475,7791700,-624775,SELL
2020-10-23 11:20:00,11:20,8669000,7635725,-1033275,SELL
2020-10-23 11:21:00,11:21,8690850,7881475,-809375,SELL
2020-10-23 11:22:00,11:22,8896600,7647775,-1248825,SELL
2020-10-23 11:23:00,11:23,9098400,7671825,-1426575,SELL
2020-10-23 11:24:00,11:24,8599725,7298000,-1301725,SELL
2020-10-23 11:25:00,11:25,8628225,7538950,-1089275,SELL
2020-10-23 11:26:00,11:26,8573625,7569800,-1003825,SELL
2020-10-23 11:27:00,11:27,8538600,7827050,-711550,SELL
2020-10-23 11:28:00,11:28,8932400,7665800,-1266600,SELL
2020-10-23 11:29:00,11:29,8774375,7874075,-900300,SELL
2020-10-23 11:30:00,11:30,8468200,7808700,-659500,SELL
2020-10-23 11:31:00,11:31,9114450,8004800,-1109650,SELL
2020-10-23 11:32:00,11:32,8649675,7783475,-866200,SELL
2020-10-23 11:33:00,11:33,8851875,7805400,-1046475,SELL
2020-10-23 11:34:00,11:34,8545250,7576450,-968800,SELL
2020-10-23 11:35:00,11:35,8821425,7803350,-1018075,SELL
2020-10-23 11:36:00,11:36,8482950,7821600,-661350,SELL
2020-10-23 11:37:00,11:37,8507475,7719825,-787650,SELL
2020-10-23 11:38:00,11:38,8524750,7732175,-792575,SELL
2020-10-23 11:39:00,11:39,8812675,7700800,-1111875,SELL
2020-10-23 11:40:00,11:40,8661825,7704300,-957525,SELL
2020-10-23 11:41:00,11:41,9054850,7845150,-1209700,SELL
2020-10-23 11:42:00,11:42,8761600,7872075,-889525,SELL
2020-10-23 11:43:00,11:43,9258175,7625875,-1632300,SELL
2020-10-23 11:44:00,11:44,8741200,7638550,-1102650,SELL
2020-10-23 11:45:00,11:45,8757925,7741900,-1016025,SELL
2020-10-23 11:46:00,11:46,9619100,7977025,-1642075,SELL
2020-10-23 11:47:00,11:47,8795225,7658125,-1137100,SELL
2020-10-23 11:48:00,11:48,9101225,7663725,-1437500,SELL
2020-10-23 11:49:00,11:49,9183025,7580275,-1602750,SELL
2020-10-23 11:50:00,11:50,8813500,7780800,-1032700,SELL
2020-10-23 11:51:00,11:51,8832775,7731925,-1100850,SELL
2020-10-23 11:52:00,11:52,8823975,7791925,-1032050,SELL
2020-10-23 11:53:00,11:53,8772750,7675825,-1096925,SELL
2020-10-23 11:54:00,11:54,8724350,7711450,-1012900,SELL
2020-10-23 11:55:00,11:55,8808100,7876225,-931875,SELL
2020-10-23 11:56:00,11:56,8858350,7615775,-1242575,SELL
2020-10-23 11:57:00,11:57,8722000,7682175,-1039825,SELL
2020-10-23 11:58:00,11:58,8741875,7625325,-1116550,SELL
2020-10-23 11:59:00,11:59,8597925,7592850,-1005075,SELL
2020-10-23 12:00:00,12:00,9343650,7967975,-1375675,SELL
2020-10-23 12:01:00,12:01,9076600,7641900,-1434700,SELL
2020-10-23 12:02:00,12:02,9086625,7579725,-1506900,SELL
2020-10-23 12:03:00,12:03,8852400,7858475,-993925,SELL
2020-10-23 12:04:00,12:04,8653800,7302150,-1351650,SELL
2020-10-23 12:05:00,12:05,8973775,7680950,-1292825,SELL
2020-10-23 12:06:00,12:06,8799850,7331075,-1468775,SELL
2020-10-23 12:07:00,12:07,9208375,7705450,-1502925,SELL
2020-10-23 12:08:00,12:08,9061125,7848250,-1212875,SELL
2020-10-23 12:09:00,12:09,9281475,7422825,-1858650,SELL
2020-10-23 12:10:00,12:10,8822100,8023975,-798125,SELL
2020-10-23 12:11:00,12:11,9334450,7726925,-1607525,SELL
2020-10-23 12:12:00,12:12,9156075,7734450,-1421625,SELL
2020-10-23 12:13:00,12:13,8970400,7966200,-1004200,SELL
2020-10-23 12:14:00,12:14,8997975,7741275,-1256700,SELL
2020-10-23 12:15:00,12:15,9063075,7874750,-1188325,SELL
2020-10-23 12:16:00,12:16,8867100,7598625,-1268475,SELL
2020-10-23 12:17:00,12:17,8978975,7945025,-1033950,SELL
2020-10-23 12:18:00,12:18,8905075,7800450,-1104625,SELL
2020-10-23 12:19:00,12:19,8844425,7803450,-1040975,SELL
2020-10-23 12:20:00,12:20,8884100,7756075,-1128025,SELL
2020-10-23 12:21:00,12:21,8973475,7433625,-1539850,SELL
2020-10-23 12:22:00,12:22,9308100,7919825,-1388275,SELL
2020-10-23 12:23:00,12:23,9140150,7976900,-1163250,SELL
2020-10-23 12:24:00,12:24,9118850,7966300,-1152550,SELL
2020-10-23 12:25:00,12:25,8698400,7960575,-737825,SELL
2020-10-23 12:26:00,12:26,8969900,8042300,-927600,SELL
2020-10-23 12:27:00,12:27,9373925,7834400,-1539525,SELL
2020-10-23 12:28:00,12:28,8924175,7850125,-1074050,SELL
2020-10-23 12:29:00,12:29,8564050,7746475,-817575,SELL
2020-10-23 12:30:00,12:30,9310225,7965200,-1345025,SELL
2020-10-23 12:31:00,12:31,9192325,8095300,-1097025,SELL
2020-10-23 12:32:00,12:32,9185850,7927675,-1258175,SELL
2020-10-23 12:33:00,12:33,8948550,7780175,-1168375,SELL
2020-10-23 12:34:00,12:34,9194275,7805375,-1388900,SELL
2020-10-23 12:35:00,12:35,9232775,7601225,-1631550,SELL
2020-10-23 12:36:00,12:36,9067425,7896075,-1171350,SELL
2020-10-23 12:37:00,12:37,9238750,7545000,-1693750,SELL
2020-10-23 12:38:00,12:38,8844575,7875025,-969550,SELL
2020-10-23 12:39:00,12:39,9422300,7974650,-1447650,SELL
2020-10-23 12:40:00,12:40,9066875,8012275,-1054600,SELL
2020-10-23 12:41:00,12:41,9173275,7837650,-1335625,SELL
2020-10-23 12:42:00,12:42,9091450,7779325,-1312125,SELL
2020-10-23 12:43:00,12:43,8963525,7523300,-1440225,SELL
2020-10-23 12:44:00,12:44,9007550,7595425,-1412125,SELL
2020-10-23 12:45:00,12:45,9061100,7744650,-1316450,SELL
2020-10-23 12:46:00,12:46,9139250,7963575,-1175675,SELL
2020-10-23 12:47:00,12:47,8872800,7480525,-1392275,SELL
2020-10-23 12:48:00,12:48,8987825,7666025,-1321800,SELL
2020-10-23 12:49:00,12:49,9561200,7912250,-1648950,SELL
2020-10-23 12:50:00,12:50,9550900,7798650,-1752250,SELL
2020-10-23 12:51:00,12:51,9312175,7573200,-1738975,SELL
2020-10-23 12:52:00,12:52,8958525,8093675,-864850,SELL
2020-10-23 12:53:00,12:53,9375425,7774875,-1600550,SELL
2020-10-23 12:54:00,12:54,9138725,7948775,-1189950,SELL
2020-10-23 12:55:00,12:55,9108675,7588050,-1520625,SELL
2020-10-23 12:56:00,12:56,9491600,7707600,-1784000,SELL
2020-10-23 12:57:00,12:57,9076375,7840100,-1236275,SELL
2020-10-23 12:58:00,12:58,9176475,7674350,-1502125,SELL
2020-10-23 12:59:00,12:59,8943775,7483300,-1460475,SELL
2020-10-23 13:00:00,13:00,9398075,8070025,-1328050,SELL
2020-10-23 13:01:00,13:01,9427300,8133500,-1293800,SELL
2020-10-23 13:02:00,13:02,9328850,7878275,-1450575,SELL
2020-10-23 13:03:00,13:03,9956925,8123675,-1833250,SELL
2020-10-23 13:04:00,13:04,9160425,7606925,-1553500,SELL
2020-10-23 13:05:00,13:05,9076875,7893275,-1183600,SELL
2020-10-23 13:06:00,13:06,8994275,7916025,-1078250,SELL
2020-10-23 13:07:00,13:07,9148225,8050350,-1097875,SELL
2020-10-23 13:08:00,13:08,9399125,7773575,-1625550,SELL
2020-10-23 13:09:00,13:09,9341950,7772875,-1569075,SELL
2020-10-23 13:10:00,13:10,9037200,7900050,-1137150,SELL
2020-10-23 13:11:00,13:11,9156900,7431400,-1725500,SELL
2020-10-23 13:12:00,13:12,9347450,7688300,-1659150,SELL
2020-10-23 13:13:00,13:13,9126450,7636600,-1489850,SELL
2020-10-23 13:14:00,13:14,9168275,7949225,-1219050,SELL
2020-10-23 13:15:00,13:15,9393700,7878325,-1515375,SELL
2020-10-23 13:16:00,13:16,9216050,7699675,-1516375,SELL
2020-10-23 13:17:00,13:17,9297675,8263150,-1034525,SELL
2020-10-23 13:18:00,13:18,9526250,8244650,-1281600,SELL
2020-10-23 13:19:00,13:19,9106700,8253625,-853075,SELL
2020-10-23 13:20:00,13:20,9677175,8315225,-1361950,SELL
2020-10-23 13:21:00,13:21,9681700,7984075,-1697625,SELL
2020-10-23 13:22:00,13:22,9464775,8111450,-1353325,SELL
2020-10-23 13:23:00,13:23,9242925,8175975,-1066950,SELL
2020-10-23 13:24:00,13:24,8993800,8077400,-916400,SELL
2020-10-23 13:25:00,13:25,9255400,8310525,-944875,SELL
2020-10-23 13:26:00,13:26,9259400,8303200,-956200,SELL
2020-10-23 13:27:00,13:27,9557250,8036100,-1521150,SELL
2020-10-23 13:28:00,13:28,9323300,7878525,-1444775,SELL
2020-10-23 13:29:00,13:29,9557250,7659200,-1898050,SELL
2020-10-23 13:30:00,13:30,9112275,7607350,-1504925,SELL
2020-10-23 13:31:00,13:31,9226725,8037125,-1189600,SELL
2020-10-23 13:32:00,13:32,9120250,8092000,-1028250,SELL
2020-10-23 13:33:00,13:33,8997675,8281825,-715850,SELL
2020-10-23 13:34:00,13:34,9239750,8269875,-969875,SELL
2020-10-23 13:35:00,13:35,9084875,8332550,-752325,SELL
2020-10-23 13:36:00,13:36,9140825,8090100,-1050725,SELL
2020-10-23 13:37:00,13:37,9047525,8155725,-891800,SELL
2020-10-23 13:38:00,13:38,9207000,7962975,-1244025,SELL
2020-10-23 13:39:00,13:39,9442400,7853225,-1589175,SELL
2020-10-23 13:40:00,13:40,9217725,8064100,-1153625,SELL
2020-10-23 13:41:00,13:41,9155650,8082275,-1073375,SELL
2020-10-23 13:42:00,13:42,9241975,8222525,-1019450,SELL
2020-10-23 13:43:00,13:43,9046600,8206550,-840050,SELL
2020-10-23 13:44:00,13:44,9193775,8142475,-1051300,SELL
2020-10-23 13:45:00,13:45,9609575,8286975,-1322600,SELL
2020-10-23 13:46:00,13:46,9222025,7998675,-1223350,SELL
2020-10-23 13:47:00,13:47,9203800,8214200,-989600,SELL
2020-10-23 13:48:00,13:48,9287175,8261150,-1026025,SELL
2020-10-23 13:49:00,13:49,9173275,8161975,-1011300,SELL
2020-10-23 13:50:00,13:50,9261275,8143500,-1117775,SELL
2020-10-23 13:51:00,13:51,9461800,8222650,-1239150,SELL
2020-10-23 13:52:00,13:52,9686825,8300425,-1386400,SELL
2020-10-23 13:53:00,13:53,9614725,8102175,-1512550,SELL
2020-10-23 13:54:00,13:54,9070850,8241100,-829750,SELL
2020-10-23 13:55:00,13:55,9431525,8158525,-1273000,SELL
2020-10-23 13:56:00,13:56,9001825,7661800,-1340025,SELL
2020-10-23 13:57:00,13:57,9100550,7848225,-1252325,SELL
2020-10-23 13:58:00,13:58,9091050,7951925,-1139125,SELL
2020-10-23 13:59:00,13:59,9377075,8073750,-1303325,SELL
2020-10-23 14:00:00,14:00,9227975,8070350,-1157625,SELL
2020-10-23 14:01:00,14:01,9047525,7986650,-1060875,SELL
2020-10-23 14:02:00,14:02,9186550,7519150,-1667400,SELL
2020-10-23 14:03:00,14:03,9602475,8260725,-1341750,SELL
2020-10-23 14:04:00,14:04,9249900,8081525,-1168375,SELL
2020-10-23 14:05:00,14:05,9427975,8253150,-1174825,SELL
2020-10-23 14:06:00,14:06,9459075,8236250,-1222825,SELL
2020-10-23 14:07:00,14:07,9473725,7918075,-1555650,SELL
2020-10-23 14:08:00,14:08,9279425,8100975,-1178450,SELL
2020-10-23 14:09:00,14:09,9212800,8248975,-963825,SELL
2020-10-23 14:10:00,14:10,9291900,8157575,-1134325,SELL
2020-10-23 14:11:00,14:11,9267550,8048475,-1219075,SELL
2020-10-23 14:12:00,14:12,9773450,8131525,-1641925,SELL
2020-10-23 14:13:00,14:13,9094950,7876025,-1218925,SELL
2020-10-23 14:14:00,14:14,9114350,8179900,-934450,SELL
2020-10-23 14:15:00,14:15,9506575,8172125,-1334450,SELL
2020-10-23 14:16:00,14:16,9185150,8050550,-1134600,SELL
2020-10-23 14:17:00,14:17,9525625,7986875,-1538750,SELL
2020-10-23 14:18:00,14:18,9462575,8290675,-1171900,SELL
2020-10-23 14:19:00,14:19,9629675,8250450,-1379225,SELL
2020-10-23 14:20:00,14:20,9528600,8264825,-1263775,SELL
2020-10-23 14:21:00,14:21,9517550,8287350,-1230200,SELL
2020-10-23 14:22:00,14:22,9491525,7705675,-1785850,SELL
2020-10-23 14:23:00,14:23,9716725,8065850,-1650875,SELL
2020-10-23 14:24:00,14:24,9222425,7854700,-1367725,SELL
2020-10-23 14:25:00,14:25,9256875,7961575,-1295300,SELL
2020-10-23 14:26:00,14:26,9245850,8279450,-966400,SELL
2020-10-23 14:27:00,14:27,9383900,8228525,-1155375,SELL
2020-10-23 14:28:00,14:28,9966950,8276450,-1690500,SELL
2020-10-23 14:29:00,14:29,9622225,8245150,-1377075,SELL
2020-10-23 14:30:00,14:30,9409225,8192375,-1216850,SELL
2020-10-23 14:31:00,14:31,9366050,8175925,-1190125,SELL
2020-10-23 14:32:00,14:32,9414325,8144350,-1269975,SELL
2020-10-23 14:33:00,14:33,9636050,8247800,-1388250,SELL
2020-10-23 14:34:00,14:34,9650450,8206375,-1444075,SELL
2020-10-23 14:35:00,14:35,9506900,8139400,-1367500,SELL
2020-10-23 14:36:00,14:36,9169975,8034125,-1135850,SELL
2020-10-23 14:37:00,14:37,9614900,7770450,-1844450,SELL
2020-10-23 14:38:00,14:38,9529175,7843650,-1685525,SELL
2020-10-23 14:39:00,14:39,9401100,8389175,-1011925,SELL
2020-10-23 14:40:00,14:40,10067800,8421800,-1646000,SELL
2020-10-23 14:41:00,14:41,9333400,8188550,-1144850,SELL
2020-10-23 14:42:00,14:42,9375625,8254875,-1120750,SELL
2020-10-23 14:43:00,14:43,9535025,8194325,-1340700,SELL
2020-10-23 14:44:00,14:44,10171400,8426500,-1744900,SELL
2020-10-23 14:45:00,14:45,9795950,8407925,-1388025,SELL
2020-10-23 14:46:00,14:46,9440800,8337025,-1103775,SELL
2020-10-23 14:47:00,14:47,9249625,8274725,-974900,SELL
2020-10-23 14:48:00,14:48,9176175,8266050,-910125,SELL
2020-10-23 14:49:00,14:49,9435025,8303000,-1132025,SELL
2020-10-23 14:50:00,14:50,9529200,8391700,-1137500,SELL
2020-10-23 14:51:00,14:51,9392250,8063125,-1329125,SELL
2020-10-23 14:52:00,14:52,9383800,8280400,-1103400,SELL
2020-10-23 14:53:00,14:53,9236775,8048500,-1188275,SELL
2020-10-23 14:54:00,14:54,9365875,8199375,-1166500,SELL
2020-10-23 14:55:00,14:55,8985975,7773875,-1212100,SELL
2020-10-23 14:56:00,14:56,9157425,8312925,-844500,SELL
2020-10-23 14:57:00,14:57,9690525,8300925,-1389600,SELL
2020-10-23 14:58:00,14:58,9453700,8078325,-1375375,SELL
2020-10-23 14:59:00,14:59,9275300,8134875,-1140425,SELL
2020-10-23 15:00:00,15:00,8995725,8151950,-843775,SELL
2020-10-23 15:01:00,15:01,8970125,7693425,-1276700,SELL
2020-10-23 15:02:00,15:02,9078775,8100200,-978575,SELL
2020-10-23 15:03:00,15:03,9031400,8133425,-897975,SELL
2020-10-23 15:04:00,15:04,9087350,8101375,-985975,SELL
2020-10-23 15:05:00,15:05,9333675,8149425,-1184250,SELL
2020-10-23 15:06:00,15:06,8721650,8136200,-585450,SELL
2020-10-23 15:07:00,15:07,8944025,8114275,-829750,SELL
2020-10-23 15:08:00,15:08,9246650,7675425,-1571225,SELL
2020-10-23 15:09:00,15:09,9281175,7913100,-1368075,SELL
2020-10-23 15:10:00,15:10,9261450,8185500,-1075950,SELL
2020-10-23 15:11:00,15:11,9265025,7985975,-1279050,SELL
2020-10-23 15:12:00,15:12,8978600,8218325,-760275,SELL
2020-10-23 15:13:00,15:13,8986125,8232125,-754000,SELL
2020-10-23 15:14:00,15:14,8997650,8151750,-845900,SELL
2020-10-23 15:15:00,15:15,9144675,8064750,-1079925,SELL
2020-10-23 15:16:00,15:16,8667925,8043675,-624250,SELL
2020-10-23 15:17:00,15:17,8946500,8086375,-860125,SELL
2020-10-23 15:18:00,15:18,9053150,8077125,-976025,SELL
2020-10-23 15:19:00,15:19,8627475,8035275,-592200,SELL
2020-10-23 15:20:00,15:20,8844875,7917950,-926925,SELL
2020-10-23 15:21:00,15:21,8454475,7860800,-593675,SELL
2020-10-23 15:22:00,15:22,8658475,7813100,-845375,SELL
2020-10-23 15:23:00,15:23,8413350,7955900,-457450,SELL
2020-10-23 15:24:00,15:24,8875725,7666100,-1209625,SELL
2020-10-23 15:25:00,15:25,8615425,7918250,-697175,SELL
2020-10-23 15:26:00,15:26,8545150,7889075,-656075,SELL
2020-10-23 15:27:00,15:27,8469700,7758700,-711000,SELL
2020-10-23 15:28:00,15:28,8726875,7603675,-1123200,SELL
2020-10-23 15:29:00,15:29,8565400,7802800,-762600,SELL
2020-10-26 09:15:00,09:15,8425675,7534675,-891000,SELL
2020-10-26 09:16:00,09:16,8032650,7497550,-535100,SELL
2020-10-26 09:17:00,09:17,8564900,7299925,-1264975,SELL
2020-10-26 09:18:00,09:18,8479100,7597775,-881325,SELL
2020-10-26 09:19:00,09:19,8268100,7589900,-678200,SELL
2020-10-26 09:20:00,09:20,8824450,8082850,-741600,SELL
2020-10-26 09:21:00,09:21,8684650,7959175,-725475,SELL
2020-10-26 09:22:00,09:22,8701125,7997700,-703425,SELL
2020-10-26 09:23:00,09:23,9058175,8227750,-830425,SELL
2020-10-26 09:24:00,09:24,8781000,8427900,-353100,SELL
2020-10-26 09:25:00,09:25,8932050,8265175,-666875,SELL
2020-10-26 09:26:00,09:26,9269050,8652300,-616750,SELL
2020-10-26 09:27:00,09:27,9421175,8471700,-949475,SELL
2020-10-26 09:28:00,09:28,9360050,8580275,-779775,SELL
2020-10-26 09:29:00,09:29,9428150,8607100,-821050,SELL
2020-10-26 09:30:00,09:30,9446075,8769450,-676625,SELL
2020-10-26 09:31:00,09:31,9445725,8556400,-889325,SELL
2020-10-26 09:32:00,09:32,9599175,8805900,-793275,SELL
2020-10-26 09:33:00,09:33,9553975,8685700,-868275,SELL
2020-10-26 09:34:00,09:34,9644850,8918325,-726525,SELL
2020-10-26 09:35:00,09:35,9489200,9014975,-474225,SELL
2020-10-26 09:36:00,09:36,9445325,8791625,-653700,SELL
2020-10-26 09:37:00,09:37,9540125,8743700,-796425,SELL
2020-10-26 09:38:00,09:38,9471525,8751525,-720000,SELL
2020-10-26 09:39:00,09:39,9462975,8447150,-1015825,SELL
2020-10-26 09:40:00,09:40,9536575,8344875,-1191700,SELL
2020-10-26 09:41:00,09:41,9477350,9075750,-401600,SELL
2020-10-26 09:42:00,09:42,9468675,8922950,-545725,SELL
2020-10-26 09:43:00,09:43,9558900,9038375,-520525,SELL
2020-10-26 09:44:00,09:44,9352400,9112575,-239825,SELL
2020-10-26 09:45:00,09:45,9361050,9176025,-185025,SELL
2020-10-26 09:46:00,09:46,9537650,8984450,-553200,SELL
2020-10-26 09:47:00,09:47,9635600,9275625,-359975,SELL
2020-10-26 09:48:00,09:48,9630775,9174375,-456400,SELL
2020-10-26 09:49:00,09:49,9748150,9288150,-460000,SELL
2020-10-26 09:50:00,09:50,9625475,9272125,-353350,SELL
2020-10-26 09:51:00,09:51,9435675,9283025,-152650,SELL
2020-10-26 09:52:00,09:52,9580900,9322675,-258225,SELL
2020-10-26 09:53:00,09:53,9417950,9271475,-146475,SELL
2020-10-26 09:54:00,09:54,9479625,9224200,-255425,SELL
2020-10-26 09:55:00,09:55,9663475,9333825,-329650,SELL
2020-10-26 09:56:00,09:56,9404350,9246200,-158150,SELL
2020-10-26 09:57:00,09:57,9679850,9176425,-503425,SELL
2020-10-26 09:58:00,09:58,9478500,9176175,-302325,SELL
2020-10-26 09:59:00,09:59,9240100,9201675,-38425,SELL
2020-10-26 10:00:00,10:00,9794875,9330475,-464400,SELL
2020-10-26 10:01:00,10:01,9454125,9286025,-168100,SELL
2020-10-26 10:02:00,10:02,9483525,9106950,-376575,SELL
2020-10-26 10:03:00,10:03,9856650,9375625,-481025,SELL
2020-10-26 10:04:00,10:04,9680600,9344275,-336325,SELL
2020-10-26 10:05:00,10:05,9649875,9443300,-206575,SELL
2020-10-26 10:06:00,10:06,9871200,9499375,-371825,SELL
2020-10-26 10:07:00,10:07,9757275,9506875,-250400,SELL
2020-10-26 10:08:00,10:08,9865050,9514475,-350575,SELL
2020-10-26 10:09:00,10:09,9757850,9330475,-427375,SELL
2020-10-26 10:10:00,10:10,9980300,9342850,-637450,SELL
2020-10-26 10:11:00,10:11,10251200,9741350,-509850,SELL
2020-10-26 10:12:00,10:12,9913275,9635850,-277425,SELL
2020-10-26 10:13:00,10:13,9522825,9516900,-5925,SELL
2020-10-26 10:14:00,10:14,9575025,9581825,6800,BUY
2020-10-26 10:15:00,10:15,10056600,9698825,-357775,SELL
2020-10-26 10:16:00,10:16,9802050,9474100,-327950,SELL
2020-10-26 10:17:00,10:17,9845625,9623375,-222250,SELL
2020-10-26 10:18:00,10:18,10069050,9553350,-515700,SELL
2020-10-26 10:19:00,10:19,10013125,9490550,-522575,SELL
2020-10-26 10:20:00,10:20,9934900,9605650,-329250,SELL
2020-10-26 10:21:00,10:21,9920475,9690700,-229775,SELL
2020-10-26 10:22:00,10:22,9887475,9594650,-292825,SELL
2020-10-26 10:23:00,10:23,10113825,9508600,-605225,SELL
2020-10-26 10:24:00,10:24,9794300,9655350,-138950,SELL
2020-10-26 10:25:00,10:25,10043575,9528350,-515225,SELL
2020-10-26 10:26:00,10:26,9989425,9514525,-474900,SELL
2020-10-26 10:27:00,10:27,9970875,9610575,-360300,SELL
2020-10-26 10:28:00,10:28,9957100,9528225,-428875,SELL
2020-10-26 10:29:00,10:29,9623000,9426900,-196100,SELL
2020-10-26 10:30:00,10:30,9861125,9262225,-598900,SELL
2020-10-26 10:31:00,10:31,10028400,9639425,-388975,SELL
2020-10-26 10:32:00,10:32,9928575,9283800,-644775,SELL
2020-10-26 10:33:00,10:33,10179025,9432800,-746225,SELL
2020-10-26 10:34:00,10:34,9964625,9646300,-318325,SELL
2020-10-26 10:35:00,10:35,9867850,9682350,-185500,SELL
2020-10-26 10:36:00,10:36,9950600,9610825,-339775,SELL
2020-10-26 10:37:00,10:37,9730725,9709300,-21425,SELL
2020-10-26 10:38:00,10:38,9817600,9488675,-328925,SELL
2020-10-26 10:39:00,10:39,9855050,9359425,-495625,SELL
2020-10-26 10:40:00,10:40,9855050,9644650,-210400,SELL
2020-10-26 10:41:00,10:41,9747750,9646925,-100825,SELL
2020-10-26 10:42:00,10:42,9934900,9752625,-182275,SELL
2020-10-26 10:43:00,10:43,10275075,9930275,-344800,SELL
2020-10-26 10:44:00,10:44,10010550,9665325,-345225,SELL
2020-10-26 10:45:00,10:45,10107375,9924175,-183200,SELL
2020-10-26 10:46:00,10:46,10018600,9747375,-271225,SELL
2020-10-26 10:47:00,10:47,9858575,9839025,-19550,SELL
2020-10-26 10:48:00,10:48,10625850,9883375,-742475,SELL
2020-10-26 10:49:00,10:49,9924850,9753700,-171150,SELL
2020-10-26 10:50:00,10:50,9945175,9551150,-394025,SELL
2020-10-26 10:51:00,10:51,9987625,9542950,-444675,SELL
2020-10-26 10:52:00,10:52,10006300,9749500,-256800,SELL
2020-10-26 10:53:00,10:53,9826825,9653000,-173825,SELL
2020-10-26 10:54:00,10:54,9752575,9791625,39050,BUY
2020-10-26 10:55:00,10:55,10153250,9650425,-502825,SELL
2020-10-26 10:56:00,10:56,10013950,9679750,-334200,SELL
2020-10-26 10:57:00,10:57,10343250,9555825,-787425,SELL
2020-10-26 10:58:00,10:58,10347675,9807400,-540275,SELL
2020-10-26 10:59:00,10:59,10124500,9737575,-386925,SELL
2020-10-26 11:00:00,11:00,9833175,9362600,-470575,SELL
2020-10-26 11:01:00,11:01,9891875,9901925,10050,BUY
2020-10-26 11:02:00,11:02,10130250,9548525,-581725,SELL
2020-10-26 11:03:00,11:03,10278400,9706600,-571800,SELL
2020-10-26 11:04:00,11:04,9738375,9881850,143475,BUY
2020-10-26 11:05:00,11:05,10050375,9944700,-105675,SELL
2020-10-26 11:06:00,11:06,10172375,9926650,-245725,SELL
2020-10-26 11:07:00,11:07,10195575,10065800,-129775,SELL
2020-10-26 11:08:00,11:08,9846650,9807175,-39475,SELL
2020-10-26 11:09:00,11:09,10204125,9851100,-353025,SELL
2020-10-26 11:10:00,11:10,10118375,9831300,-287075,SELL
2020-10-26 11:11:00,11:11,10020575,9881900,-138675,SELL
2020-10-26 11:12:00,11:12,10084625,9933475,-151150,SELL
2020-10-26 11:13:00,11:13,10170025,9857500,-312525,SELL
2020-10-26 11:14:00,11:14,10212225,10030400,-181825,SELL
2020-10-26 11:15:00,11:15,10728100,10112525,-615575,SELL
2020-10-26 11:16:00,11:16,10224725,10128300,-96425,SELL
2020-10-26 11:17:00,11:17,10345125,9810800,-534325,SELL
2020-10-26 11:18:00,11:18,10246100,9814500,-431600,SELL
2020-10-26 11:19:00,11:19,10341825,9978075,-363750,SELL
2020-10-26 11:20:00,11:20,9976000,9871850,-104150,SELL
2020-10-26 11:21:00,11:21,9962925,9601300,-361625,SELL
2020-10-26 11:22:00,11:22,9936275,9955425,19150,BUY
2020-10-26 11:23:00,11:23,10151925,9767675,-384250,SELL
2020-10-26 11:24:00,11:24,10202175,9957650,-244525,SELL
2020-10-26 11:25:00,11:25,10177700,9866850,-310850,SELL
2020-10-26 11:26:00,11:26,10225600,9902525,-323075,SELL
2020-10-26 11:27:00,11:27,10168625,9784525,-384100,SELL
2020-10-26 11:28:00,11:28,10218275,9774375,-443900,SELL
2020-10-26 11:29:00,11:29,10001050,9455650,-545400,SELL
2020-10-26 11:30:00,11:30,10377150,9801750,-575400,SELL
2020-10-26 11:31:00,11:31,10327300,9467075,-860225,SELL
2020-10-26 11:32:00,11:32,10016175,9581950,-434225,SELL
2020-10-26 11:33:00,11:33,10007975,9522475,-485500,SELL
2020-10-26 11:34:00,11:34,10073625,9855425,-218200,SELL
2020-10-26 11:35:00,11:35,10788125,9676150,-1111975,SELL
2020-10-26 11:36:00,11:36,10301775,9742800,-558975,SELL
2020-10-26 11:37:00,11:37,10301775,9429725,-872050,SELL
2020-10-26 11:38:00,11:38,10633675,9614300,-1019375,SELL
2020-10-26 11:39:00,11:39,10654425,9590075,-1064350,SELL
2020-10-26 11:40:00,11:40,10630975,9730200,-900775,SELL
2020-10-26 11:41:00,11:41,10337550,9357200,-980350,SELL
2020-10-26 11:42:00,11:42,10549000,9271875,-1277125,SELL
2020-10-26 11:43:00,11:43,10611075,9408200,-1202875,SELL
2020-10-26 11:44:00,11:44,10658050,9453075,-1204975,SELL
2020-10-26 11:45:00,11:45,10910700,9365075,-1545625,SELL
2020-10-26 11:46:00,11:46,10321875,9363550,-958325,SELL
2020-10-26 11:47:00,11:47,10640975,9353325,-1287650,SELL
2020-10-26 11:48:00,11:48,10462700,9335375,-1127325,SELL
2020-10-26 11:49:00,11:49,10748700,9111800,-1636900,SELL
2020-10-26 11:50:00,11:50,10705325,9507425,-1197900,SELL
2020-10-26 11:51:00,11:51,10728775,9288325,-1440450,SELL
2020-10-26 11:52:00,11:52,10802225,9241900,-1560325,SELL
2020-10-26 11:53:00,11:53,10695400,9437175,-1258225,SELL
2020-10-26 11:54:00,11:54,10546625,9252150,-1294475,SELL
2020-10-26 11:55:00,11:55,10642250,8948350,-1693900,SELL
2020-10-26 11:56:00,11:56,10810900,9123575,-1687325,SELL
2020-10-26 11:57:00,11:57,10974975,9353375,-1621600,SELL
2020-10-26 11:58:00,11:58,10845175,9185125,-1660050,SELL
2020-10-26 11:59:00,11:59,10607725,9633775,-973950,SELL
2020-10-26 12:00:00,12:00,10636925,9521800,-1115125,SELL
2020-10-26 12:01:00,12:01,10815825,9343000,-1472825,SELL
2020-10-26 12:02:00,12:02,10943025,9380250,-1562775,SELL
2020-10-26 12:03:00,12:03,11184725,9037300,-2147425,SELL
2020-10-26 12:04:00,12:04,10679375,8954750,-1724625,SELL
2020-10-26 12:05:00,12:05,10929025,9316075,-1612950,SELL
2020-10-26 12:06:00,12:06,10748300,9020750,-1727550,SELL
2020-10-26 12:07:00,12:07,10752525,9361800,-1390725,SELL
2020-10-26 12:08:00,12:08,11144575,9449725,-1694850,SELL
2020-10-26 12:09:00,12:09,11470600,9608350,-1862250,SELL
2020-10-26 12:10:00,12:10,11384100,9588825,-1795275,SELL
2020-10-26 12:11:00,12:11,11080300,9053925,-2026375,SELL
2020-10-26 12:12:00,12:12,10998200,9420650,-1577550,SELL
2020-10-26 12:13:00,12:13,11206875,9153100,-2053775,SELL
2020-10-26 12:14:00,12:14,11174525,9334675,-1839850,SELL
2020-10-26 12:15:00,12:15,11581975,9495575,-2086400,SELL
2020-10-26 12:16:00,12:16,11474850,9272050,-2202800,SELL
2020-10-26 12:17:00,12:17,11336350,9251100,-2085250,SELL
2020-10-26 12:18:00,12:18,11474550,9411775,-2062775,SELL
2020-10-26 12:19:00,12:19,11371325,9399275,-1972050,SELL
2020-10-26 12:20:00,12:20,11353000,9439650,-1913350,SELL
2020-10-26 12:21:00,12:21,11463350,9574250,-1889100,SELL
2020-10-26 12:22:00,12:22,11351800,9350500,-2001300,SELL
2020-10-26 12:23:00,12:23,11150075,9515800,-1634275,SELL
2020-10-26 12:24:00,12:24,11146075,9626775,-1519300,SELL
2020-10-26 12:25:00,12:25,11343600,9560775,-1782825,SELL
2020-10-26 12:26:00,12:26,11447525,9530925,-1916600,SELL
2020-10-26 12:27:00,12:27,11816725,9483975,-2332750,SELL
2020-10-26 12:28:00,12:28,11020900,9022275,-1998625,SELL
2020-10-26 12:29:00,12:29,11181775,9177050,-2004725,SELL
2020-10-26 12:30:00,12:30,11563600,9443125,-2120475,SELL
2020-10-26 12:31:00,12:31,11405700,9405150,-2000550,SELL
2020-10-26 12:32:00,12:32,11562450,9467025,-2095425,SELL
2020-10-26 12:33:00,12:33,11141000,9339600,-1801400,SELL
2020-10-26 12:34:00,12:34,11464450,9397625,-2066825,SELL
2020-10-26 12:35:00,12:35,11540900,9302975,-2237925,SELL
2020-10-26 12:36:00,12:36,11406175,9188050,-2218125,SELL
2020-10-26 12:37:00,12:37,11801125,9300500,-2500625,SELL
2020-10-26 12:38:00,12:38,11566100,9376575,-2189525,SELL
2020-10-26 12:39:00,12:39,12020075,9431875,-2588200,SELL
2020-10-26 12:40:00,12:40,11767450,9398625,-2368825,SELL
2020-10-26 12:41:00,12:41,11992500,9199400,-2793100,SELL
2020-10-26 12:42:00,12:42,11501525,9153925,-2347600,SELL
2020-10-26 12:43:00,12:43,11678925,9296900,-2382025,SELL
2020-10-26 12:44:00,12:44,11924725,9152175,-2772550,SELL
2020-10-26 12:45:00,12:45,12087800,8882800,-3205000,SELL
2020-10-26 12:46:00,12:46,11768975,9156150,-2612825,SELL
2020-10-26 12:47:00,12:47,11559575,8875150,-2684425,SELL
2020-10-26 12:48:00,12:48,11520700,9081575,-2439125,SELL
2020-10-26 12:49:00,12:49,11705800,8975075,-2730725,SELL
2020-10-26 12:50:00,12:50,12138125,9163050,-2975075,SELL
2020-10-26 12:51:00,12:51,11834600,9150350,-2684250,SELL
2020-10-26 12:52:00,12:52,11847150,9164800,-2682350,SELL
2020-10-26 12:53:00,12:53,11753300,9175775,-2577525,SELL
2020-10-26 12:54:00,12:54,11765725,8628100,-3137625,SELL
2020-10-26 12:55:00,12:55,12168850,9107975,-3060875,SELL
2020-10-26 12:56:00,12:56,11947500,8983325,-2964175,SELL
2020-10-26 12:57:00,12:57,11836500,9089725,-2746775,SELL
2020-10-26 12:58:00,12:58,12409350,9184225,-3225125,SELL
2020-10-26 12:59:00,12:59,11970200,9148150,-2822050,SELL
2020-10-26 13:00:00,13:00,12031550,8962575,-3068975,SELL
2020-10-26 13:01:00,13:01,12355750,9031700,-3324050,SELL
2020-10-26 13:02:00,13:02,11867275,9107875,-2759400,SELL
2020-10-26 13:03:00,13:03,12152125,9065325,-3086800,SELL
2020-10-26 13:04:00,13:04,11986000,9061575,-2924425,SELL
2020-10-26 13:05:00,13:05,12180375,8876575,-3303800,SELL
2020-10-26 13:06:00,13:06,12378975,8997350,-3381625,SELL
2020-10-26 13:07:00,13:07,12377700,8860600,-3517100,SELL
2020-10-26 13:08:00,13:08,12134750,8907050,-3227700,SELL
2020-10-26 13:09:00,13:09,12189800,8828500,-3361300,SELL
2020-10-26 13:10:00,13:10,12222400,9148275,-3074125,SELL
2020-10-26 13:11:00,13:11,12211850,8989100,-3222750,SELL
2020-10-26 13:12:00,13:12,12326750,8974325,-3352425,SELL
2020-10-26 13:13:00,13:13,12511100,9147650,-3363450,SELL
2020-10-26 13:14:00,13:14,12180500,9028950,-3151550,SELL
2020-10-26 13:15:00,13:15,12183325,8963700,-3219625,SELL
2020-10-26 13:16:00,13:16,12281250,9065675,-3215575,SELL
2020-10-26 13:17:00,13:17,12359025,9111950,-3247075,SELL
2020-10-26 13:18:00,13:18,12351350,9027150,-3324200,SELL
2020-10-26 13:19:00,13:19,12190350,9281750,-2908600,SELL
2020-10-26 13:20:00,13:20,12179950,9243175,-2936775,SELL
2020-10-26 13:21:00,13:21,12251500,9153475,-3098025,SELL
2020-10-26 13:22:00,13:22,12378700,9180050,-3198650,SELL
2020-10-26 13:23:00,13:23,12429250,9206575,-3222675,SELL
2020-10-26 13:24:00,13:24,12371425,9232950,-3138475,SELL
2020-10-26 13:25:00,13:25,12680600,9223650,-3456950,SELL
2020-10-26 13:26:00,13:26,12442450,9192700,-3249750,SELL
2020-10-26 13:27:00,13:27,11795675,9240000,-2555675,SELL
2020-10-26 13:28:00,13:28,12152675,9251475,-2901200,SELL
2020-10-26 13:29:00,13:29,12669200,9149925,-3519275,SELL
2020-10-26 13:30:00,13:30,12592300,9185725,-3406575,SELL
2020-10-26 13:31:00,13:31,12207275,9260550,-2946725,SELL
2020-10-26 13:32:00,13:32,12732950,9123775,-3609175,SELL
2020-10-26 13:33:00,13:33,12639700,9290550,-3349150,SELL
2020-10-26 13:34:00,13:34,12703775,9208325,-3495450,SELL
2020-10-26 13:35:00,13:35,12519950,9312900,-3207050,SELL
2020-10-26 13:36:00,13:36,12508575,9219950,-3288625,SELL
2020-10-26 13:37:00,13:37,12318850,9345825,-2973025,SELL
2020-10-26 13:38:00,13:38,12554350,9105625,-3448725,SELL
2020-10-26 13:39:00,13:39,12502975,9280800,-3222175,SELL
2020-10-26 13:40:00,13:40,12576875,9325550,-3251325,SELL
2020-10-26 13:41:00,13:41,12489475,9137400,-3352075,SELL
2020-10-26 13:42:00,13:42,12567300,9184575,-3382725,SELL
2020-10-26 13:43:00,13:43,12365300,9166825,-3198475,SELL
2020-10-26 13:44:00,13:44,12574575,9114800,-3459775,SELL
2020-10-26 13:45:00,13:45,12616850,9333700,-3283150,SELL
2020-10-26 13:46:00,13:46,12770125,9410325,-3359800,SELL
2020-10-26 13:47:00,13:47,12423575,9448850,-2974725,SELL
2020-10-26 13:48:00,13:48,12688575,9371650,-3316925,SELL
2020-10-26 13:49:00,13:49,12680125,9284500,-3395625,SELL
2020-10-26 13:50:00,13:50,12750425,9249000,-3501425,SELL
2020-10-26 13:51:00,13:51,12627800,9341525,-3286275,SELL
2020-10-26 13:52:00,13:52,12975450,9502425,-3473025,SELL
2020-10-26 13:53:00,13:53,12627800,9441950,-3185850,SELL
2020-10-26 13:54:00,13:54,12620375,9396100,-3224275,SELL
2020-10-26 13:55:00,13:55,12806950,9365850,-3441100,SELL
2020-10-26 13:56:00,13:56,12814150,9340225,-3473925,SELL
2020-10-26 13:57:00,13:57,12951000,9333825,-3617175,SELL
2020-10-26 13:58:00,13:58,12949275,9413250,-3536025,SELL
2020-10-26 13:59:00,13:59,12824050,9332800,-3491250,SELL
2020-10-26 14:00:00,14:00,12904450,9312925,-3591525,SELL
2020-10-26 14:01:00,14:01,12554850,9382975,-3171875,SELL
2020-10-26 14:02:00,14:02,13156650,9481900,-3674750,SELL
2020-10-26 14:03:00,14:03,13098925,9278050,-3820875,SELL
2020-10-26 14:04:00,14:04,12824225,9253300,-3570925,SELL
2020-10-26 14:05:00,14:05,12804125,9233775,-3570350,SELL
2020-10-26 14:06:00,14:06,12990200,9229500,-3760700,SELL
2020-10-26 14:07:00,14:07,12683425,9187150,-3496275,SELL
2020-10-26 14:08:00,14:08,12855350,9056850,-3798500,SELL
2020-10-26 14:09:00,14:09,12931575,9121400,-3810175,SELL
2020-10-26 14:10:00,14:10,13209825,9277725,-3932100,SELL
2020-10-26 14:11:00,14:11,12892600,9175775,-3716825,SELL
2020-10-26 14:12:00,14:12,13177175,9145025,-4032150,SELL
2020-10-26 14:13:00,14:13,13274800,9074650,-4200150,SELL
2020-10-26 14:14:00,14:14,13131600,9137900,-3993700,SELL
2020-10-26 14:15:00,14:15,13192200,9154350,-4037850,SELL
2020-10-26 14:16:00,14:16,13311950,9430825,-3881125,SELL
2020-10-26 14:17:00,14:17,12961875,9418125,-3543750,SELL
2020-10-26 14:18:00,14:18,13209975,9317750,-3892225,SELL
2020-10-26 14:19:00,14:19,13084400,9237325,-3847075,SELL
2020-10-26 14:20:00,14:20,13065700,9170175,-3895525,SELL
2020-10-26 14:21:00,14:21,13074525,9247125,-3827400,SELL
2020-10-26 14:22:00,14:22,13235125,9262850,-3972275,SELL
2020-10-26 14:23:00,14:23,12999750,9184875,-3814875,SELL
2020-10-26 14:24:00,14:24,13123975,9315275,-3808700,SELL
2020-10-26 14:25:00,14:25,12987625,9194525,-3793100,SELL
2020-10-26 14:26:00,14:26,12757450,9353000,-3404450,SELL
2020-10-26 14:27:00,14:27,13001275,9096875,-3904400,SELL
2020-10-26 14:28:00,14:28,12956375,9082475,-3873900,SELL
2020-10-26 14:29:00,14:29,12759100,9250750,-3508350,SELL
2020-10-26 14:30:00,14:30,12997050,9121625,-3875425,SELL
2020-10-26 14:31:00,14:31,13012725,9084925,-3927800,SELL
2020-10-26 14:32:00,14:32,12984850,9064750,-3920100,SELL
2020-10-26 14:33:00,14:33,13373500,9252950,-4120550,SELL
2020-10-26 14:34:00,14:34,13163725,9327300,-3836425,SELL
2020-10-26 14:35:00,14:35,13110250,9337900,-3772350,SELL
2020-10-26 14:36:00,14:36,12973875,9339900,-3633975,SELL
2020-10-26 14:37:00,14:37,13112825,9315475,-3797350,SELL
2020-10-26 14:38:00,14:38,13319525,9274925,-4044600,SELL
2020-10-26 14:39:00,14:39,12787100,9098325,-3688775,SELL
2020-10-26 14:40:00,14:40,12981650,9287325,-3694325,SELL
2020-10-26 14:41:00,14:41,12993125,9268275,-3724850,SELL
2020-10-26 14:42:00,14:42,13153700,9356450,-3797250,SELL
2020-10-26 14:43:00,14:43,13164600,9337375,-3827225,SELL
2020-10-26 14:44:00,14:44,12781050,9349425,-3431625,SELL
2020-10-26 14:45:00,14:45,13333950,9255700,-4078250,SELL
2020-10-26 14:46:00,14:46,12995900,9163500,-3832400,SELL
2020-10-26 14:47:00,14:47,13012250,9397050,-3615200,SELL
2020-10-26 14:48:00,14:48,12838300,9136000,-3702300,SELL
2020-10-26 14:49:00,14:49,12836975,9050475,-3786500,SELL
2020-10-26 14:50:00,14:50,12850625,9218575,-3632050,SELL
2020-10-26 14:51:00,14:51,12839200,9050875,-3788325,SELL
2020-10-26 14:52:00,14:52,12897350,9223950,-3673400,SELL
2020-10-26 14:53:00,14:53,12957725,9180150,-3777575,SELL
2020-10-26 14:54:00,14:54,12902125,9200775,-3701350,SELL
2020-10-26 14:55:00,14:55,12884375,9047375,-3837000,SELL
2020-10-26 14:56:00,14:56,12875800,9053100,-3822700,SELL
2020-10-26 14:57:00,14:57,12918675,9148325,-3770350,SELL
2020-10-26 14:58:00,14:58,13035750,8727100,-4308650,SELL
2020-10-26 14:59:00,14:59,13218775,8915475,-4303300,SELL
2020-10-26 15:00:00,15:00,12892800,8919200,-3973600,SELL
2020-10-26 15:01:00,15:01,12979675,9078600,-3901075,SELL
2020-10-26 15:02:00,15:02,13003650,9126375,-3877275,SELL
2020-10-26 15:03:00,15:03,12868425,8923950,-3944475,SELL
2020-10-26 15:04:00,15:04,12862225,9035125,-3827100,SELL
2020-10-26 15:05:00,15:05,12868425,8894475,-3973950,SELL
2020-10-26 15:06:00,15:06,12929150,9022775,-3906375,SELL
2020-10-26 15:07:00,15:07,12762650,9042450,-3720200,SELL
2020-10-26 15:08:00,15:08,12807450,8933400,-3874050,SELL
2020-10-26 15:09:00,15:09,12915150,8924575,-3990575,SELL
2020-10-26 15:10:00,15:10,12833125,8965150,-3867975,SELL
2020-10-26 15:11:00,15:11,13018125,8983100,-4035025,SELL
2020-10-26 15:12:00,15:12,12819575,8921050,-3898525,SELL
2020-10-26 15:13:00,15:13,13002275,8817500,-4184775,SELL
2020-10-26 15:14:00,15:14,12514725,8777000,-3737725,SELL
2020-10-26 15:15:00,15:15,12713775,8841725,-3872050,SELL
2020-10-26 15:16:00,15:16,12821400,8860875,-3960525,SELL
2020-10-26 15:17:00,15:17,12693275,8660050,-4033225,SELL
2020-10-26 15:18:00,15:18,12686400,8662900,-4023500,SELL
2020-10-26 15:19:00,15:19,12737100,8635625,-4101475,SELL
2020-10-26 15:20:00,15:20,12699875,8778250,-3921625,SELL
2020-10-26 15:21:00,15:21,12455125,8547925,-3907200,SELL
2020-10-26 15:22:00,15:22,12126650,8469725,-3656925,SELL
2020-10-26 15:23:00,15:23,12248625,8500900,-3747725,SELL
2020-10-26 15:24:00,15:24,12013075,8307050,-3706025,SELL
2020-10-26 15:25:00,15:25,11925350,8446350,-3479000,SELL
2020-10-26 15:26:00,15:26,12023425,8396225,-3627200,SELL
2020-10-26 15:27:00,15:27,12031000,8309825,-3721175,SELL
2020-10-26 15:28:00,15:28,12128375,8201775,-3926600,SELL
2020-10-26 15:29:00,15:29,12082425,8328575,-3753850,SELL
2020-10-27 09:15:00,09:15,12048825,8130000,-3918825,SELL
2020-10-27 09:16:00,09:16,11888950,8032775,-3856175,SELL
2020-10-27 09:17:00,09:17,11642975,8091675,-3551300,SELL
2020-10-27 09:18:00,09:18,11628550,8150850,-3477700,SELL
2020-10-27 09:19:00,09:19,11768075,8035900,-3732175,SELL
2020-10-27 09:20:00,09:20,11864675,8503975,-3360700,SELL
2020-10-27 09:21:00,09:21,11943650,8243900,-3699750,SELL
2020-10-27 09:22:00,09:22,11824875,8585150,-3239725,SELL
2020-10-27 09:23:00,09:23,12223075,9039600,-3183475,SELL
2020-10-27 09:24:00,09:24,12263100,9091900,-3171200,SELL
2020-10-27 09:25:00,09:25,12222575,9074600,-3147975,SELL
2020-10-27 09:26:00,09:26,12239125,9350375,-2888750,SELL
2020-10-27 09:27:00,09:27,12137650,9345350,-2792300,SELL
2020-10-27 09:28:00,09:28,12505625,9320875,-3184750,SELL
2020-10-27 09:29:00,09:29,12280550,9521250,-2759300,SELL
2020-10-27 09:30:00,09:30,12391625,9563425,-2828200,SELL
2020-10-27 09:31:00,09:31,12101625,9530900,-2570725,SELL
2020-10-27 09:32:00,09:32,12405150,9839550,-2565600,SELL
2020-10-27 09:33:00,09:33,12450025,9858850,-2591175,SELL
2020-10-27 09:34:00,09:34,12272250,9904725,-2367525,SELL
2020-10-27 09:35:00,09:35,12583325,10067400,-2515925,SELL
2020-10-27 09:36:00,09:36,12410750,10077350,-2333400,SELL
2020-10-27 09:37:00,09:37,12721475,10065375,-2656100,SELL
2020-10-27 09:38:00,09:38,12692000,10141325,-2550675,SELL
2020-10-27 09:39:00,09:39,12650800,10147125,-2503675,SELL
2020-10-27 09:40:00,09:40,12789300,10134575,-2654725,SELL
2020-10-27 09:41:00,09:41,12360500,10149850,-2210650,SELL
2020-10-27 09:42:00,09:42,12723825,10144025,-2579800,SELL
2020-10-27 09:43:00,09:43,12517475,10178900,-2338575,SELL
2020-10-27 09:44:00,09:44,12631475,10268625,-2362850,SELL
2020-10-27 09:45:00,09:45,12702100,10331300,-2370800,SELL
2020-10-27 09:46:00,09:46,12575600,10173400,-2402200,SELL
2020-10-27 09:47:00,09:47,12069750,10301500,-1768250,SELL
2020-10-27 09:48:00,09:48,12083550,10261250,-1822300,SELL
2020-10-27 09:49:00,09:49,12141250,10330075,-1811175,SELL
2020-10-27 09:50:00,09:50,11931175,10320750,-1610425,SELL
2020-10-27 09:51:00,09:51,11769975,10412075,-1357900,SELL
2020-10-27 09:52:00,09:52,12040350,10419750,-1620600,SELL
2020-10-27 09:53:00,09:53,11784775,10480300,-1304475,SELL
2020-10-27 09:54:00,09:54,12071925,10584900,-1487025,SELL
2020-10-27 09:55:00,09:55,11606575,10429025,-1177550,SELL
2020-10-27 09:56:00,09:56,12278850,10549475,-1729375,SELL
2020-10-27 09:57:00,09:57,12181075,10660175,-1520900,SELL
2020-10-27 09:58:00,09:58,12197250,10621875,-1575375,SELL
2020-10-27 09:59:00,09:59,11716950,10621100,-1095850,SELL
2020-10-27 10:00:00,10:00,11835175,10560500,-1274675,SELL
2020-10-27 10:01:00,10:01,12031350,10449775,-1581575,SELL
2020-10-27 10:02:00,10:02,11942400,10796325,-1146075,SELL
2020-10-27 10:03:00,10:03,11954525,10518475,-1436050,SELL
2020-10-27 10:04:00,10:04,11960875,10758500,-1202375,SELL
2020-10-27 10:05:00,10:05,11836975,10735550,-1101425,SELL
2020-10-27 10:06:00,10:06,11783000,10892825,-890175,SELL
2020-10-27 10:07:00,10:07,11751200,10835600,-915600,SELL
2020-10-27 10:08:00,10:08,12236175,10777650,-1458525,SELL
2020-10-27 10:09:00,10:09,12015550,10978250,-1037300,SELL
2020-10-27 10:10:00,10:10,11818225,10933150,-885075,SELL
2020-10-27 10:11:00,10:11,11795350,11081825,-713525,SELL
2020-10-27 10:12:00,10:12,11836700,10899250,-937450,SELL
2020-10-27 10:13:00,10:13,11799125,10920675,-878450,SELL
2020-10-27 10:14:00,10:14,12308850,11016100,-1292750,SELL
2020-10-27 10:15:00,10:15,12222000,11203300,-1018700,SELL
2020-10-27 10:16:00,10:16,11983500,11214650,-768850,SELL
2020-10-27 10:17:00,10:17,12244600,11098350,-1146250,SELL
2020-10-27 10:18:00,10:18,12204500,11292700,-911800,SELL
2020-10-27 10:19:00,10:19,12117100,11135525,-981575,SELL
2020-10-27 10:20:00,10:20,12035375,11196450,-838925,SELL
2020-10-27 10:21:00,10:21,12151125,11055525,-1095600,SELL
2020-10-27 10:22:00,10:22,11818750,10822650,-996100,SELL
2020-10-27 10:23:00,10:23,11945825,11268150,-677675,SELL
2020-10-27 10:24:00,10:24,12025550,11244750,-780800,SELL
2020-10-27 10:25:00,10:25,12002150,11102575,-899575,SELL
2020-10-27 10:26:00,10:26,11811750,11167275,-644475,SELL
2020-10-27 10:27:00,10:27,11835150,11128125,-707025,SELL
2020-10-27 10:28:00,10:28,12226775,11131725,-1095050,SELL
2020-10-27 10:29:00,10:29,12253125,11430650,-822475,SELL
2020-10-27 10:30:00,10:30,11959125,11460525,-498600,SELL
2020-10-27 10:31:00,10:31,11952825,11188800,-764025,SELL
2020-10-27 10:32:00,10:32,12007075,11359450,-647625,SELL
2020-10-27 10:33:00,10:33,12164250,11032650,-1131600,SELL
2020-10-27 10:34:00,10:34,11820275,11296000,-524275,SELL
2020-10-27 10:35:00,10:35,12328850,11178850,-1150000,SELL
2020-10-27 10:36:00,10:36,12046500,11446775,-599725,SELL
2020-10-27 10:37:00,10:37,12117475,11316850,-800625,SELL
2020-10-27 10:38:00,10:38,12004425,11258475,-745950,SELL
2020-10-27 10:39:00,10:39,12082250,11308875,-773375,SELL
2020-10-27 10:40:00,10:40,12073975,11013475,-1060500,SELL
2020-10-27 10:41:00,10:41,11973825,11422300,-551525,SELL
2020-10-27 10:42:00,10:42,12024750,11251925,-772825,SELL
2020-10-27 10:43:00,10:43,12197350,11479475,-717875,SELL
2020-10-27 10:44:00,10:44,11796875,11541300,-255575,SELL
2020-10-27 10:45:00,10:45,12001225,11699575,-301650,SELL
2020-10-27 10:46:00,10:46,11973725,11431975,-541750,SELL
2020-10-27 10:47:00,10:47,11798825,11637025,-161800,SELL
2020-10-27 10:48:00,10:48,12420750,11822775,-597975,SELL
2020-10-27 10:49:00,10:49,11975375,11782875,-192500,SELL
2020-10-27 10:50:00,10:50,11770675,11731075,-39600,SELL
2020-10-27 10:51:00,10:51,11697200,11641225,-55975,SELL
2020-10-27 10:52:00,10:52,11703700,11115800,-587900,SELL
2020-10-27 10:53:00,10:53,11527575,11517900,-9675,SELL
2020-10-27 10:54:00,10:54,11737625,11427500,-310125,SELL
2020-10-27 10:55:00,10:55,11738350,11776875,38525,BUY
2020-10-27 10:56:00,10:56,11747225,11461750,-285475,SELL
2020-10-27 10:57:00,10:57,11685550,10819425,-866125,SELL
2020-10-27 10:58:00,10:58,11692925,11670250,-22675,SELL
2020-10-27 10:59:00,10:59,11741200,11574275,-166925,SELL
2020-10-27 11:00:00,11:00,11940475,11488050,-452425,SELL
2020-10-27 11:01:00,11:01,11944450,11839425,-105025,SELL
2020-10-27 11:02:00,11:02,11749700,11473175,-276525,SELL
2020-10-27 11:03:00,11:03,11909600,11785750,-123850,SELL
2020-10-27 11:04:00,11:04,11734600,11753300,18700,BUY
2020-10-27 11:05:00,11:05,11794525,11657050,-137475,SELL
2020-10-27 11:06:00,11:06,11831750,11878550,46800,BUY
2020-10-27 11:07:00,11:07,11950300,11695650,-254650,SELL
2020-10-27 11:08:00,11:08,11488325,11909400,421075,BUY
2020-10-27 11:09:00,11:09,12073975,11455675,-618300,SELL
2020-10-27 11:10:00,11:10,11928475,11825550,-102925,SELL
2020-10-27 11:11:00,11:11,11794375,11738950,-55425,SELL
2020-10-27 11:12:00,11:12,11911350,11178375,-732975,SELL
2020-10-27 11:13:00,11:13,11718450,11547975,-170475,SELL
2020-10-27 11:14:00,11:14,11523150,11777325,254175,BUY
2020-10-27 11:15:00,11:15,11840250,11623975,-216275,SELL
2020-10-27 11:16:00,11:16,12051450,11711700,-339750,SELL
2020-10-27 11:17:00,11:17,11734750,11799575,64825,BUY
2020-10-27 11:18:00,11:18,11962350,11632600,-329750,SELL
2020-10-27 11:19:00,11:19,11577100,11173350,-403750,SELL
2020-10-27 11:20:00,11:20,11726950,11709025,-17925,SELL
2020-10-27 11:21:00,11:21,12064850,11858625,-206225,SELL
2020-10-27 11:22:00,11:22,11605925,11903675,297750,BUY
2020-10-27 11:23:00,11:23,11497650,11215625,-282025,SELL
2020-10-27 11:24:00,11:24,11928500,11628150,-300350,SELL
2020-10-27 11:25:00,11:25,11523350,11853600,330250,BUY
2020-10-27 11:26:00,11:26,11543250,11870125,326875,BUY
2020-10-27 11:27:00,11:27,12060175,11891975,-168200,SELL
2020-10-27 11:28:00,11:28,11781450,11804900,23450,BUY
2020-10-27 11:29:00,11:29,11688125,11731750,43625,BUY
2020-10-27 11:30:00,11:30,11684450,11643575,-40875,SELL
2020-10-27 11:31:00,11:31,11687600,11838650,151050,BUY
2020-10-27 11:32:00,11:32,11685975,11623775,-62200,SELL
2020-10-27 11:33:00,11:33,11564650,11799200,234550,BUY
2020-10-27 11:34:00,11:34,11500750,11782975,282225,BUY
2020-10-27 11:35:00,11:35,11480800,11767375,286575,BUY
2020-10-27 11:36:00,11:36,11647225,11347400,-299825,SELL
2020-10-27 11:37:00,11:37,11459175,11651150,191975,BUY
2020-10-27 11:38:00,11:38,11590625,11718300,127675,BUY
2020-10-27 11:39:00,11:39,11783100,11930625,147525,BUY
2020-10-27 11:40:00,11:40,12002625,11978950,-23675,SELL
2020-10-27 11:41:00,11:41,11678475,11705700,27225,BUY
2020-10-27 11:42:00,11:42,11655375,11609675,-45700,SELL
2020-10-27 11:43:00,11:43,11634575,11876800,242225,BUY
2020-10-27 11:44:00,11:44,11359700,11698525,338825,BUY
2020-10-27 11:45:00,11:45,12048000,11820025,-227975,SELL
2020-10-27 11:46:00,11:46,11575050,11856550,281500,BUY
2020-10-27 11:47:00,11:47,11509650,11853425,343775,BUY
2020-10-27 11:48:00,11:48,11194350,11682000,487650,BUY
2020-10-27 11:49:00,11:49,11188675,11720575,531900,BUY
2020-10-27 11:50:00,11:50,11148325,12013050,864725,BUY
2020-10-27 11:51:00,11:51,11286575,11791000,504425,BUY
2020-10-27 11:52:00,11:52,11319775,11771450,451675,BUY
2020-10-27 11:53:00,11:53,11682700,11976150,293450,BUY
2020-10-27 11:54:00,11:54,11548100,12212450,664350,BUY
2020-10-27 11:55:00,11:55,11362200,12009575,647375,BUY
2020-10-27 11:56:00,11:56,11269975,12226400,956425,BUY
2020-10-27 11:57:00,11:57,11343300,12126600,783300,BUY
2020-10-27 11:58:00,11:58,11021300,11993975,972675,BUY
2020-10-27 11:59:00,11:59,11288425,12261750,973325,BUY
2020-10-27 12:00:00,12:00,11495550,12235375,739825,BUY
2020-10-27 12:01:00,12:01,11328475,12235525,907050,BUY
2020-10-27 12:02:00,12:02,11348150,12100400,752250,BUY
2020-10-27 12:03:00,12:03,11304550,12177600,873050,BUY
2020-10-27 12:04:00,12:04,11428500,12045550,617050,BUY
2020-10-27 12:05:00,12:05,11167925,11957175,789250,BUY
2020-10-27 12:06:00,12:06,11538375,12131925,593550,BUY
2020-10-27 12:07:00,12:07,11205400,12078450,873050,BUY
2020-10-27 12:08:00,12:08,11349175,12176700,827525,BUY
2020-10-27 12:09:00,12:09,11154400,12247425,1093025,BUY
2020-10-27 12:10:00,12:10,11171375,12130050,958675,BUY
2020-10-27 12:11:00,12:11,10971950,11944850,972900,BUY
2020-10-27 12:12:00,12:12,10796100,11979750,1183650,BUY
2020-10-27 12:13:00,12:13,10955325,12142500,1187175,BUY
2020-10-27 12:14:00,12:14,10977875,12149950,1172075,BUY
2020-10-27 12:15:00,12:15,11183550,12198575,1015025,BUY
2020-10-27 12:16:00,12:16,10999850,11861675,861825,BUY
2020-10-27 12:17:00,12:17,10828950,11914675,1085725,BUY
2020-10-27 12:18:00,12:18,10764450,12188175,1423725,BUY
2020-10-27 12:19:00,12:19,10661325,12184200,1522875,BUY
2020-10-27 12:20:00,12:20,10952200,11984225,1032025,BUY
2020-10-27 12:21:00,12:21,11016425,11901275,884850,BUY
2020-10-27 12:22:00,12:22,10957575,12098525,1140950,BUY
2020-10-27 12:23:00,12:23,10839025,12014950,1175925,BUY
2020-10-27 12:24:00,12:24,10943825,12135700,1191875,BUY
2020-10-27 12:25:00,12:25,10948875,12084425,1135550,BUY
2020-10-27 12:26:00,12:26,10873850,12237425,1363575,BUY
2020-10-27 12:27:00,12:27,10929300,11990775,1061475,BUY
2020-10-27 12:28:00,12:28,11077900,12071075,993175,BUY
2020-10-27 12:29:00,12:29,10930025,11982425,1052400,BUY
2020-10-27 12:30:00,12:30,10957275,12371625,1414350,BUY
2020-10-27 12:31:00,12:31,10946075,12232600,1286525,BUY
2020-10-27 12:32:00,12:32,10992100,12125675,1133575,BUY
2020-10-27 12:33:00,12:33,11055525,12278200,1222675,BUY
2020-10-27 12:34:00,12:34,10881125,12294250,1413125,BUY
2020-10-27 12:35:00,12:35,10807325,12181700,1374375,BUY
2020-10-27 12:36:00,12:36,10998525,11990075,991550,BUY
2020-10-27 12:37:00,12:37,10833300,12273875,1440575,BUY
2020-10-27 12:38:00,12:38,11109400,12393850,1284450,BUY
2020-10-27 12:39:00,12:39,11371300,12074875,703575,BUY
2020-10-27 12:40:00,12:40,11210075,12223400,1013325,BUY
2020-10-27 12:41:00,12:41,11199050,12405900,1206850,BUY
2020-10-27 12:42:00,12:42,11237975,12386500,1148525,BUY
2020-10-27 12:43:00,12:43,10875150,12343175,1468025,BUY
2020-10-27 12:44:00,12:44,11130400,12247375,1116975,BUY
2020-10-27 12:45:00,12:45,10914725,12530800,1616075,BUY
2020-10-27 12:46:00,12:46,11046050,12195750,1149700,BUY
2020-10-27 12:47:00,12:47,11308650,12539275,1230625,BUY
2020-10-27 12:48:00,12:48,10945950,12462675,1516725,BUY
2020-10-27 12:49:00,12:49,11113725,12493925,1380200,BUY
2020-10-27 12:50:00,12:50,10797875,12354900,1557025,BUY
2020-10-27 12:51:00,12:51,11065725,12562675,1496950,BUY
2020-10-27 12:52:00,12:52,11139400,12093575,954175,BUY
2020-10-27 12:53:00,12:53,10963850,11980700,1016850,BUY
2020-10-27 12:54:00,12:54,11198300,12358525,1160225,BUY
2020-10-27 12:55:00,12:55,10989025,12645025,1656000,BUY
2020-10-27 12:56:00,12:56,10379475,12441825,2062350,BUY
2020-10-27 12:57:00,12:57,11336050,12643700,1307650,BUY
2020-10-27 12:58:00,12:58,10959325,12443475,1484150,BUY
2020-10-27 12:59:00,12:59,11180650,12105100,924450,BUY
2020-10-27 13:00:00,13:00,11278925,12406500,1127575,BUY
2020-10-27 13:01:00,13:01,11728675,12673750,945075,BUY
2020-10-27 13:02:00,13:02,11188550,12667750,1479200,BUY
2020-10-27 13:03:00,13:03,11168575,12568225,1399650,BUY
2020-10-27 13:04:00,13:04,11344700,12234575,889875,BUY
2020-10-27 13:05:00,13:05,11041250,12527625,1486375,BUY
2020-10-27 13:06:00,13:06,11194350,12313175,1118825,BUY
2020-10-27 13:07:00,13:07,11183000,12743350,1560350,BUY
2020-10-27 13:08:00,13:08,11274925,12690550,1415625,BUY
2020-10-27 13:09:00,13:09,11334475,12826350,1491875,BUY
2020-10-27 13:10:00,13:10,11539200,12792050,1252850,BUY
2020-10-27 13:11:00,13:11,11068125,12793675,1725550,BUY
2020-10-27 13:12:00,13:12,10718350,12792850,2074500,BUY
2020-10-27 13:13:00,13:13,10531700,12791375,2259675,BUY
2020-10-27 13:14:00,13:14,10703375,12763100,2059725,BUY
2020-10-27 13:15:00,13:15,10958750,12672275,1713525,BUY
2020-10-27 13:16:00,13:16,10771625,12317450,1545825,BUY
2020-10-27 13:17:00,13:17,11062375,12799150,1736775,BUY
2020-10-27 13:18:00,13:18,10882450,12227975,1345525,BUY
2020-10-27 13:19:00,13:19,10700825,12898150,2197325,BUY
2020-10-27 13:20:00,13:20,10878500,12714825,1836325,BUY
2020-10-27 13:21:00,13:21,10558825,12326100,1767275,BUY
2020-10-27 13:22:00,13:22,10555975,12491800,1935825,BUY
2020-10-27 13:23:00,13:23,10570125,12781875,2211750,BUY
2020-10-27 13:24:00,13:24,10481100,13096975,2615875,BUY
2020-10-27 13:25:00,13:25,10602150,12859475,2257325,BUY
2020-10-27 13:26:00,13:26,10850700,12397950,1547250,BUY
2020-10-27 13:27:00,13:27,10627650,12752700,2125050,BUY
2020-10-27 13:28:00,13:28,10810375,13291175,2480800,BUY
2020-10-27 13:29:00,13:29,10571975,13133700,2561725,BUY
2020-10-27 13:30:00,13:30,10449050,13273225,2824175,BUY
2020-10-27 13:31:00,13:31,10815100,13031150,2216050,BUY
2020-10-27 13:32:00,13:32,10438150,13022600,2584450,BUY
2020-10-27 13:33:00,13:33,10736175,13048500,2312325,BUY
2020-10-27 13:34:00,13:34,10792550,13148975,2356425,BUY
2020-10-27 13:35:00,13:35,10749975,13191700,2441725,BUY
2020-10-27 13:36:00,13:36,10703700,12837900,2134200,BUY
2020-10-27 13:37:00,13:37,10943725,13101775,2158050,BUY
2020-10-27 13:38:00,13:38,10857475,13171250,2313775,BUY
2020-10-27 13:39:00,13:39,10472750,12948875,2476125,BUY
2020-10-27 13:40:00,13:40,10477225,13323650,2846425,BUY
2020-10-27 13:41:00,13:41,10908225,13148625,2240400,BUY
2020-10-27 13:42:00,13:42,10716325,13036725,2320400,BUY
2020-10-27 13:43:00,13:43,10702800,13153350,2450550,BUY
2020-10-27 13:44:00,13:44,10889225,13253225,2364000,BUY
2020-10-27 13:45:00,13:45,10766650,13111500,2344850,BUY
2020-10-27 13:46:00,13:46,10659050,12905675,2246625,BUY
2020-10-27 13:47:00,13:47,10738900,13266775,2527875,BUY
2020-10-27 13:48:00,13:48,10650475,12921450,2270975,BUY
2020-10-27 13:49:00,13:49,10805075,12953075,2148000,BUY
2020-10-27 13:50:00,13:50,10717725,13214375,2496650,BUY
2020-10-27 13:51:00,13:51,10526750,13274150,2747400,BUY
2020-10-27 13:52:00,13:52,10645950,12832650,2186700,BUY
2020-10-27 13:53:00,13:53,10528450,12866300,2337850,BUY
2020-10-27 13:54:00,13:54,10524600,13059100,2534500,BUY
2020-10-27 13:55:00,13:55,10702425,13116650,2414225,BUY
2020-10-27 13:56:00,13:56,11024050,13053100,2029050,BUY
2020-10-27 13:57:00,13:57,11047725,12956950,1909225,BUY
2020-10-27 13:58:00,13:58,10838400,12993725,2155325,BUY
2020-10-27 13:59:00,13:59,10686650,12965200,2278550,BUY
2020-10-27 14:00:00,14:00,10546975,13210825,2663850,BUY
2020-10-27 14:01:00,14:01,10549950,12425225,1875275,BUY
2020-10-27 14:02:00,14:02,10666875,13198425,2531550,BUY
2020-10-27 14:03:00,14:03,11032400,12733700,1701300,BUY
2020-10-27 14:04:00,14:04,10428250,12951275,2523025,BUY
2020-10-27 14:05:00,14:05,10738900,13239525,2500625,BUY
2020-10-27 14:06:00,14:06,10482250,12377350,1895100,BUY
2020-10-27 14:07:00,14:07,10647800,12782750,2134950,BUY
2020-10-27 14:08:00,14:08,10664825,13324525,2659700,BUY
2020-10-27 14:09:00,14:09,10362025,13310375,2948350,BUY
2020-10-27 14:10:00,14:10,10300850,13316450,3015600,BUY
2020-10-27 14:11:00,14:11,10592075,13261050,2668975,BUY
2020-10-27 14:12:00,14:12,10296800,13201550,2904750,BUY
2020-10-27 14:13:00,14:13,10665250,13402150,2736900,BUY
2020-10-27 14:14:00,14:14,10402625,13351375,2948750,BUY
2020-10-27 14:15:00,14:15,10593225,13338775,2745550,BUY
2020-10-27 14:16:00,14:16,10465075,13424150,2959075,BUY
2020-10-27 14:17:00,14:17,10764575,13582850,2818275,BUY
2020-10-27 14:18:00,14:18,10881800,13450875,2569075,BUY
2020-10-27 14:19:00,14:19,11031375,13635750,2604375,BUY
2020-10-27 14:20:00,14:20,10626975,13557425,2930450,BUY
2020-10-27 14:21:00,14:21,10522500,13537800,3015300,BUY
2020-10-27 14:22:00,14:22,10520875,13549775,3028900,BUY
2020-10-27 14:23:00,14:23,10697575,13580075,2882500,BUY
2020-10-27 14:24:00,14:24,10487825,13439025,2951200,BUY
2020-10-27 14:25:00,14:25,10304950,13539450,3234500,BUY
2020-10-27 14:26:00,14:26,10652575,13471400,2818825,BUY
2020-10-27 14:27:00,14:27,10663075,13396200,2733125,BUY
2020-10-27 14:28:00,14:28,10414800,13494000,3079200,BUY
2020-10-27 14:29:00,14:29,10723975,13175050,2451075,BUY
2020-10-27 14:30:00,14:30,10650025,13494600,2844575,BUY
2020-10-27 14:31:00,14:31,10486925,13632300,3145375,BUY
2020-10-27 14:32:00,14:32,10720175,13653900,2933725,BUY
2020-10-27 14:33:00,14:33,10409525,13584100,3174575,BUY
2020-10-27 14:34:00,14:34,10409475,13623075,3213600,BUY
2020-10-27 14:35:00,14:35,10406900,13623675,3216775,BUY
2020-10-27 14:36:00,14:36,10083225,13614200,3530975,BUY
2020-10-27 14:37:00,14:37,10142400,13623625,3481225,BUY
2020-10-27 14:38:00,14:38,10323150,13391825,3068675,BUY
2020-10-27 14:39:00,14:39,10134125,13395200,3261075,BUY
2020-10-27 14:40:00,14:40,10157500,13643500,3486000,BUY
2020-10-27 14:41:00,14:41,9984150,13581750,3597600,BUY
2020-10-27 14:42:00,14:42,10129650,13508200,3378550,BUY
2020-10-27 14:43:00,14:43,10281150,13507675,3226525,BUY
2020-10-27 14:44:00,14:44,10258000,13649600,3391600,BUY
2020-10-27 14:45:00,14:45,10224700,13573575,3348875,BUY
2020-10-27 14:46:00,14:46,9938600,13503200,3564600,BUY
2020-10-27 14:47:00,14:47,10336100,13468200,3132100,BUY
2020-10-27 14:48:00,14:48,10075600,13563025,3487425,BUY
2020-10-27 14:49:00,14:49,10199625,13596925,3397300,BUY
2020-10-27 14:50:00,14:50,9898675,13591650,3692975,BUY
2020-10-27 14:51:00,14:51,10222375,13566650,3344275,BUY
2020-10-27 14:52:00,14:52,10094000,13444300,3350300,BUY
2020-10-27 14:53:00,14:53,10017400,13514500,3497100,BUY
2020-10-27 14:54:00,14:54,10029550,13471250,3441700,BUY
2020-10-27 14:55:00,14:55,10464425,13555725,3091300,BUY
2020-10-27 14:56:00,14:56,10214375,13600750,3386375,BUY
2020-10-27 14:57:00,14:57,10079175,13442150,3362975,BUY
2020-10-27 14:58:00,14:58,9843625,13284275,3440650,BUY
2020-10-27 14:59:00,14:59,9890825,13443275,3552450,BUY
2020-10-27 15:00:00,15:00,9866850,13306500,3439650,BUY
2020-10-27 15:01:00,15:01,9682325,13301100,3618775,BUY
2020-10-27 15:02:00,15:02,9796025,13286175,3490150,BUY
2020-10-27 15:03:00,15:03,9888800,13257900,3369100,BUY
2020-10-27 15:04:00,15:04,9866300,13234425,3368125,BUY
2020-10-27 15:05:00,15:05,10038425,13322175,3283750,BUY
2020-10-27 15:06:00,15:06,9944700,13190925,3246225,BUY
2020-10-27 15:07:00,15:07,9790275,13186650,3396375,BUY
2020-10-27 15:08:00,15:08,10036900,13244975,3208075,BUY
2020-10-27 15:09:00,15:09,9907750,12987200,3079450,BUY
2020-10-27 15:10:00,15:10,9869625,13172500,3302875,BUY
2020-10-27 15:11:00,15:11,9857050,13222325,3365275,BUY
2020-10-27 15:12:00,15:12,9775225,13148100,3372875,BUY
2020-10-27 15:13:00,15:13,10004950,13086100,3081150,BUY
2020-10-27 15:14:00,15:14,9814125,13073200,3259075,BUY
2020-10-27 15:15:00,15:15,9909975,12913200,3003225,BUY
2020-10-27 15:16:00,15:16,9784325,12929700,3145375,BUY
2020-10-27 15:17:00,15:17,9786525,12936225,3149700,BUY
2020-10-27 15:18:00,15:18,9885825,12661150,2775325,BUY
2020-10-27 15:19:00,15:19,9532875,12733875,3201000,BUY
2020-10-27 15:20:00,15:20,9855350,12781500,2926150,BUY
2020-10-27 15:21:00,15:21,9725450,12605975,2880525,BUY
2020-10-27 15:22:00,15:22,9530625,12551375,3020750,BUY
2020-10-27 15:23:00,15:23,9738800,12459500,2720700,BUY
2020-10-27 15:24:00,15:24,9679225,12477400,2798175,BUY
2020-10-27 15:25:00,15:25,9735325,12503975,2768650,BUY
2020-10-27 15:26:00,15:26,9636100,12211050,2574950,BUY
2020-10-27 15:27:00,15:27,9632775,12353575,2720800,BUY
2020-10-27 15:28:00,15:28,9225625,12295775,3070150,BUY
2020-10-27 15:29:00,15:29,9414025,12361325,2947300,BUY
2020-10-28 09:15:00,09:15,9119825,11908600,2788775,BUY
2020-10-28 09:16:00,09:16,9200600,11865500,2664900,BUY
2020-10-28 09:17:00,09:17,9089850,12028375,2938525,BUY
2020-10-28 09:18:00,09:18,9171400,12169300,2997900,BUY
2020-10-28 09:19:00,09:19,9266900,12041675,2774775,BUY
2020-10-28 09:20:00,09:20,9541300,12518100,2976800,BUY
2020-10-28 09:21:00,09:21,9703800,12468975,2765175,BUY
2020-10-28 09:22:00,09:22,9511275,12415225,2903950,BUY
2020-10-28 09:23:00,09:23,10357900,12777600,2419700,BUY
2020-10-28 09:24:00,09:24,10164175,12754200,2590025,BUY
2020-10-28 09:25:00,09:25,10358700,12829600,2470900,BUY
2020-10-28 09:26:00,09:26,10915525,12842125,1926600,BUY
2020-10-28 09:27:00,09:27,10600325,12571550,1971225,BUY
2020-10-28 09:28:00,09:28,10999625,12879625,1880000,BUY
2020-10-28 09:29:00,09:29,10548050,13059200,2511150,BUY
2020-10-28 09:30:00,09:30,10986300,13058350,2072050,BUY
2020-10-28 09:31:00,09:31,11146625,13009150,1862525,BUY
2020-10-28 09:32:00,09:32,11154700,12930875,1776175,BUY
2020-10-28 09:33:00,09:33,11006300,12977175,1970875,BUY
2020-10-28 09:34:00,09:34,10973575,12939775,1966200,BUY
2020-10-28 09:35:00,09:35,11202300,13106750,1904450,BUY
2020-10-28 09:36:00,09:36,11009100,13166600,2157500,BUY
2020-10-28 09:37:00,09:37,11001775,13116550,2114775,BUY
2020-10-28 09:38:00,09:38,11068850,13104900,2036050,BUY
2020-10-28 09:39:00,09:39,11246800,13044950,1798150,BUY
2020-10-28 09:40:00,09:40,11027975,13194300,2166325,BUY
2020-10-28 09:41:00,09:41,10545575,13100150,2554575,BUY
2020-10-28 09:42:00,09:42,11411800,12961350,1549550,BUY
2020-10-28 09:43:00,09:43,11407975,12852275,1444300,BUY
2020-10-28 09:44:00,09:44,10908950,12944950,2036000,BUY
2020-10-28 09:45:00,09:45,10998300,12535425,1537125,BUY
2020-10-28 09:46:00,09:46,11052175,12884325,1832150,BUY
2020-10-28 09:47:00,09:47,11259075,12743450,1484375,BUY
2020-10-28 09:48:00,09:48,11129650,13161875,2032225,BUY
2020-10-28 09:49:00,09:49,11053700,13013750,1960050,BUY
2020-10-28 09:50:00,09:50,11455375,12912325,1456950,BUY
2020-10-28 09:51:00,09:51,11219650,12774550,1554900,BUY
2020-10-28 09:52:00,09:52,11605000,12952200,1347200,BUY
2020-10-28 09:53:00,09:53,11324600,13125950,1801350,BUY
2020-10-28 09:54:00,09:54,11332575,12504150,1171575,BUY
2020-10-28 09:55:00,09:55,11671425,13003400,1331975,BUY
2020-10-28 09:56:00,09:56,12009675,13263325,1253650,BUY
2020-10-28 09:57:00,09:57,11863725,13204200,1340475,BUY
2020-10-28 09:58:00,09:58,11727925,12651825,923900,BUY
2020-10-28 09:59:00,09:59,11510375,12944400,1434025,BUY
2020-10-28 10:00:00,10:00,12118200,13162375,1044175,BUY
2020-10-28 10:01:00,10:01,11963825,13154575,1190750,BUY
2020-10-28 10:02:00,10:02,11837775,12940700,1102925,BUY
2020-10-28 10:03:00,10:03,11929300,12971200,1041900,BUY
2020-10-28 10:04:00,10:04,12005550,13063050,1057500,BUY
2020-10-28 10:05:00,10:05,12055650,12846000,790350,BUY
2020-10-28 10:06:00,10:06,12101275,12947800,846525,BUY
2020-10-28 10:07:00,10:07,12144900,12629375,484475,BUY
2020-10-28 10:08:00,10:08,12173875,12694825,520950,BUY
2020-10-28 10:09:00,10:09,12202900,12484075,281175,BUY
2020-10-28 10:10:00,10:10,12392175,12636775,244600,BUY
2020-10-28 10:11:00,10:11,12025775,12273525,247750,BUY
2020-10-28 10:12:00,10:12,12696500,12948275,251775,BUY
2020-10-28 10:13:00,10:13,12543325,12661875,118550,BUY
2020-10-28 10:14:00,10:14,12392300,12827300,435000,BUY
2020-10-28 10:15:00,10:15,12686725,12841375,154650,BUY
2020-10-28 10:16:00,10:16,12392300,12769675,377375,BUY
2020-10-28 10:17:00,10:17,12529700,12682250,152550,BUY
2020-10-28 10:18:00,10:18,12586475,12576025,-10450,SELL
2020-10-28 10:19:00,10:19,12478500,12633650,155150,BUY
2020-10-28 10:20:00,10:20,12749650,12496025,-253625,SELL
2020-10-28 10:21:00,10:21,12818450,12655975,-162475,SELL
2020-10-28 10:22:00,10:22,12801425,12703300,-98125,SELL
2020-10-28 10:23:00,10:23,12442175,12472125,29950,BUY
2020-10-28 10:24:00,10:24,12699350,12615900,-83450,SELL
2020-10-28 10:25:00,10:25,12498325,12216200,-282125,SELL
2020-10-28 10:26:00,10:26,12665375,12620525,-44850,SELL
2020-10-28 10:27:00,10:27,13011250,12852325,-158925,SELL
2020-10-28 10:28:00,10:28,12403775,12698175,294400,BUY
2020-10-28 10:29:00,10:29,12545325,12524275,-21050,SELL
2020-10-28 10:30:00,10:30,12801050,12283100,-517950,SELL
2020-10-28 10:31:00,10:31,12886225,12917900,31675,BUY
2020-10-28 10:32:00,10:32,12699700,12908975,209275,BUY
2020-10-28 10:33:00,10:33,12853400,12918050,64650,BUY
2020-10-28 10:34:00,10:34,12644325,12391050,-253275,SELL
2020-10-28 10:35:00,10:35,12820400,12545400,-275000,SELL
2020-10-28 10:36:00,10:36,13308250,12612875,-695375,SELL
2020-10-28 10:37:00,10:37,12836225,12818025,-18200,SELL
2020-10-28 10:38:00,10:38,12958550,12397875,-560675,SELL
2020-10-28 10:39:00,10:39,13048025,12605775,-442250,SELL
2020-10-28 10:40:00,10:40,12832100,12682025,-150075,SELL
2020-10-28 10:41:00,10:41,13000800,12439000,-561800,SELL
2020-10-28 10:42:00,10:42,13114800,12386450,-728350,SELL
2020-10-28 10:43:00,10:43,13063400,12654100,-409300,SELL
2020-10-28 10:44:00,10:44,13135600,12879350,-256250,SELL
2020-10-28 10:45:00,10:45,13523500,13077650,-445850,SELL
2020-10-28 10:46:00,10:46,13262975,12933700,-329275,SELL
2020-10-28 10:47:00,10:47,13185700,12735375,-450325,SELL
2020-10-28 10:48:00,10:48,13348675,12529675,-819000,SELL
2020-10-28 10:49:00,10:49,13134950,12498875,-636075,SELL
2020-10-28 10:50:00,10:50,13169250,12249450,-919800,SELL
2020-10-28 10:51:00,10:51,13351025,12307850,-1043175,SELL
2020-10-28 10:52:00,10:52,13304550,12705800,-598750,SELL
2020-10-28 10:53:00,10:53,13055400,12427575,-627825,SELL
2020-10-28 10:54:00,10:54,13324575,12320575,-1004000,SELL
2020-10-28 10:55:00,10:55,13541175,12954750,-586425,SELL
2020-10-28 10:56:00,10:56,13170725,12699250,-471475,SELL
2020-10-28 10:57:00,10:57,13149150,12874150,-275000,SELL
2020-10-28 10:58:00,10:58,13301200,12862025,-439175,SELL
2020-10-28 10:59:00,10:59,13476550,12899325,-577225,SELL
2020-10-28 11:00:00,11:00,13378025,12670050,-707975,SELL
2020-10-28 11:01:00,11:01,13394350,12792125,-602225,SELL
2020-10-28 11:02:00,11:02,13271650,12778775,-492875,SELL
2020-10-28 11:03:00,11:03,13721450,12759150,-962300,SELL
2020-10-28 11:04:00,11:04,13159675,12933975,-225700,SELL
2020-10-28 11:05:00,11:05,12981350,12837250,-144100,SELL
2020-10-28 11:06:00,11:06,13293375,12881375,-412000,SELL
2020-10-28 11:07:00,11:07,13284225,12993400,-290825,SELL
2020-10-28 11:08:00,11:08,13274825,12917875,-356950,SELL
2020-10-28 11:09:00,11:09,13556650,12661125,-895525,SELL
2020-10-28 11:10:00,11:10,13183475,12765650,-417825,SELL
2020-10-28 11:11:00,11:11,13075100,12671875,-403225,SELL
2020-10-28 11:12:00,11:12,13042400,12721900,-320500,SELL
2020-10-28 11:13:00,11:13,13646225,12777800,-868425,SELL
2020-10-28 11:14:00,11:14,13643900,12724975,-918925,SELL
2020-10-28 11:15:00,11:15,13325850,12906925,-418925,SELL
2020-10-28 11:16:00,11:16,13701600,12914825,-786775,SELL
2020-10-28 11:17:00,11:17,13704925,12737350,-967575,SELL
2020-10-28 11:18:00,11:18,13943750,12951000,-992750,SELL
2020-10-28 11:19:00,11:19,13842550,12891750,-950800,SELL
2020-10-28 11:20:00,11:20,13739650,12821275,-918375,SELL
2020-10-28 11:21:00,11:21,13555825,12408650,-1147175,SELL
2020-10-28 11:22:00,11:22,13625725,13000225,-625500,SELL
2020-10-28 11:23:00,11:23,13594775,12658075,-936700,SELL
2020-10-28 11:24:00,11:24,13790200,12959050,-831150,SELL
2020-10-28 11:25:00,11:25,13601125,13073075,-528050,SELL
2020-10-28 11:26:00,11:26,13705625,12823325,-882300,SELL
2020-10-28 11:27:00,11:27,13634700,12344475,-1290225,SELL
2020-10-28 11:28:00,11:28,13497700,12579100,-918600,SELL
2020-10-28 11:29:00,11:29,13935825,12857425,-1078400,SELL
2020-10-28 11:30:00,11:30,13994200,13145150,-849050,SELL
2020-10-28 11:31:00,11:31,13903200,12687025,-1216175,SELL
2020-10-28 11:32:00,11:32,13455625,12550300,-905325,SELL
2020-10-28 11:33:00,11:33,13851775,12826425,-1025350,SELL
2020-10-28 11:34:00,11:34,13839650,12631200,-1208450,SELL
2020-10-28 11:35:00,11:35,13811875,12897325,-914550,SELL
2020-10-28 11:36:00,11:36,13544425,12451450,-1092975,SELL
2020-10-28 11:37:00,11:37,13761875,12749025,-1012850,SELL
2020-10-28 11:38:00,11:38,13580200,12629625,-950575,SELL
2020-10-28 11:39:00,11:39,13440475,12596875,-843600,SELL
2020-10-28 11:40:00,11:40,13862725,12876425,-986300,SELL
2020-10-28 11:41:00,11:41,14177425,12841625,-1335800,SELL
2020-10-28 11:42:00,11:42,13926675,12830475,-1096200,SELL
2020-10-28 11:43:00,11:43,13618525,12819225,-799300,SELL
2020-10-28 11:44:00,11:44,13626325,12390200,-1236125,SELL
2020-10-28 11:45:00,11:45,14011225,12968825,-1042400,SELL
2020-10-28 11:46:00,11:46,13978725,13002225,-976500,SELL
2020-10-28 11:47:00,11:47,13704575,12775575,-929000,SELL
2020-10-28 11:48:00,11:48,13879450,12854100,-1025350,SELL
2020-10-28 11:49:00,11:49,13695825,12763325,-932500,SELL
2020-10-28 11:50:00,11:50,13526650,12547550,-979100,SELL
2020-10-28 11:51:00,11:51,13840425,12445625,-1394800,SELL
2020-10-28 11:52:00,11:52,13525725,12889150,-636575,SELL
2020-10-28 11:53:00,11:53,13630175,12349125,-1281050,SELL
2020-10-28 11:54:00,11:54,13522050,12861600,-660450,SELL
2020-10-28 11:55:00,11:55,13519175,12834450,-684725,SELL
2020-10-28 11:56:00,11:56,13930200,12668025,-1262175,SELL
2020-10-28 11:57:00,11:57,13442000,12548050,-893950,SELL
2020-10-28 11:58:00,11:58,13896400,12924800,-971600,SELL
2020-10-28 11:59:00,11:59,14038575,12868075,-1170500,SELL
2020-10-28 12:00:00,12:00,14124875,13112850,-1012025,SELL
2020-10-28 12:01:00,12:01,13660200,12870475,-789725,SELL
2020-10-28 12:02:00,12:02,14051675,12906925,-1144750,SELL
2020-10-28 12:03:00,12:03,13885225,12525450,-1359775,SELL
2020-10-28 12:04:00,12:04,13467050,12486075,-980975,SELL
2020-10-28 12:05:00,12:05,13727875,12600375,-1127500,SELL
2020-10-28 12:06:00,12:06,13546500,11716050,-1830450,SELL
2020-10-28 12:07:00,12:07,13740675,12723625,-1017050,SELL
2020-10-28 12:08:00,12:08,13545075,12786275,-758800,SELL
2020-10-28 12:09:00,12:09,13470600,12079700,-1390900,SELL
2020-10-28 12:10:00,12:10,13711075,12459025,-1252050,SELL
2020-10-28 12:11:00,12:11,13979150,12751875,-1227275,SELL
2020-10-28 12:12:00,12:12,13746600,12346450,-1400150,SELL
2020-10-28 12:13:00,12:13,13658725,12586675,-1072050,SELL
2020-10-28 12:14:00,12:14,13914225,12167625,-1746600,SELL
2020-10-28 12:15:00,12:15,13802025,12319675,-1482350,SELL
2020-10-28 12:16:00,12:16,13634475,12840275,-794200,SELL
2020-10-28 12:17:00,12:17,14075525,12893125,-1182400,SELL
2020-10-28 12:18:00,12:18,13925125,13200275,-724850,SELL
2020-10-28 12:19:00,12:19,13687175,12696600,-990575,SELL
2020-10-28 12:20:00,12:20,13525950,13167800,-358150,SELL
2020-10-28 12:21:00,12:21,13525150,12534550,-990600,SELL
2020-10-28 12:22:00,12:22,13605675,12843800,-761875,SELL
2020-10-28 12:23:00,12:23,13872925,12723875,-1149050,SELL
2020-10-28 12:24:00,12:24,13571375,12599975,-971400,SELL
2020-10-28 12:25:00,12:25,13591650,11953950,-1637700,SELL
2020-10-28 12:26:00,12:26,14057675,12666375,-1391300,SELL
2020-10-28 12:27:00,12:27,14058575,12994400,-1064175,SELL
2020-10-28 12:28:00,12:28,14012575,12996925,-1015650,SELL
2020-10-28 12:29:00,12:29,13793275,12533150,-1260125,SELL
2020-10-28 12:30:00,12:30,13955425,12771150,-1184275,SELL
2020-10-28 12:31:00,12:31,13729325,12711750,-1017575,SELL
2020-10-28 12:32:00,12:32,13798975,12480100,-1318875,SELL
2020-10-28 12:33:00,12:33,13518950,12326075,-1192875,SELL
2020-10-28 12:34:00,12:34,13497500,12505775,-991725,SELL
2020-10-28 12:35:00,12:35,14100700,12530800,-1569900,SELL
2020-10-28 12:36:00,12:36,13853700,12167875,-1685825,SELL
2020-10-28 12:37:00,12:37,13902975,12211750,-1691225,SELL
2020-10-28 12:38:00,12:38,14223975,12407475,-1816500,SELL
2020-10-28 12:39:00,12:39,14328625,12326175,-2002450,SELL
2020-10-28 12:40:00,12:40,14118550,12283450,-1835100,SELL
2020-10-28 12:41:00,12:41,14120650,11782825,-2337825,SELL
2020-10-28 12:42:00,12:42,14106700,12066075,-2040625,SELL
2020-10-28 12:43:00,12:43,14038925,11906775,-2132150,SELL
2020-10-28 12:44:00,12:44,14303150,11876075,-2427075,SELL
2020-10-28 12:45:00,12:45,14543150,11897475,-2645675,SELL
2020-10-28 12:46:00,12:46,14126825,11874575,-2252250,SELL
2020-10-28 12:47:00,12:47,14374400,11919725,-2454675,SELL
2020-10-28 12:48:00,12:48,14624175,11652525,-2971650,SELL
2020-10-28 12:49:00,12:49,14557150,11769925,-2787225,SELL
2020-10-28 12:50:00,12:50,14629525,11412250,-3217275,SELL
2020-10-28 12:51:00,12:51,14826275,11849775,-2976500,SELL
2020-10-28 12:52:00,12:52,14613075,11864250,-2748825,SELL
2020-10-28 12:53:00,12:53,14744800,11595250,-3149550,SELL
2020-10-28 12:54:00,12:54,14703525,11241050,-3462475,SELL
2020-10-28 12:55:00,12:55,14670700,11188150,-3482550,SELL
2020-10-28 12:56:00,12:56,14679075,11239775,-3439300,SELL
2020-10-28 12:57:00,12:57,14976100,11333650,-3642450,SELL
2020-10-28 12:58:00,12:58,14720125,11298525,-3421600,SELL
2020-10-28 12:59:00,12:59,14515175,11589050,-2926125,SELL
2020-10-28 13:00:00,13:00,14371250,11144150,-3227100,SELL
2020-10-28 13:01:00,13:01,14845650,11468475,-3377175,SELL
2020-10-28 13:02:00,13:02,14924600,11411575,-3513025,SELL
2020-10-28 13:03:00,13:03,14994800,11266900,-3727900,SELL
2020-10-28 13:04:00,13:04,14904300,11310325,-3593975,SELL
2020-10-28 13:05:00,13:05,15085800,10716650,-4369150,SELL
2020-10-28 13:06:00,13:06,14965375,10952525,-4012850,SELL
2020-10-28 13:07:00,13:07,15152300,11038125,-4114175,SELL
2020-10-28 13:08:00,13:08,14946000,11311675,-3634325,SELL
2020-10-28 13:09:00,13:09,14796875,11284800,-3512075,SELL
2020-10-28 13:10:00,13:10,15071350,11195200,-3876150,SELL
2020-10-28 13:11:00,13:11,14620050,11082200,-3537850,SELL
2020-10-28 13:12:00,13:12,14933500,11424275,-3509225,SELL
2020-10-28 13:13:00,13:13,15123550,11374650,-3748900,SELL
2020-10-28 13:14:00,13:14,14982825,11034775,-3948050,SELL
2020-10-28 13:15:00,13:15,14838550,11140500,-3698050,SELL
2020-10-28 13:16:00,13:16,14678075,11085175,-3592900,SELL
2020-10-28 13:17:00,13:17,14718625,11054700,-3663925,SELL
2020-10-28 13:18:00,13:18,15192025,11378200,-3813825,SELL
2020-10-28 13:19:00,13:19,15031375,11318050,-3713325,SELL
2020-10-28 13:20:00,13:20,14870975,11132000,-3738975,SELL
2020-10-28 13:21:00,13:21,14832650,10959550,-3873100,SELL
2020-10-28 13:22:00,13:22,14725375,10857050,-3868325,SELL
2020-10-28 13:23:00,13:23,14854050,10986675,-3867375,SELL
2020-10-28 13:24:00,13:24,14714875,10897900,-3816975,SELL
2020-10-28 13:25:00,13:25,14762100,11031850,-3730250,SELL
2020-10-28 13:26:00,13:26,14834050,11154225,-3679825,SELL
2020-10-28 13:27:00,13:27,14989700,11036150,-3953550,SELL
2020-10-28 13:28:00,13:28,14959725,10996450,-3963275,SELL
2020-10-28 13:29:00,13:29,14935375,10863900,-4071475,SELL
2020-10-28 13:30:00,13:30,14684575,11088950,-3595625,SELL
2020-10-28 13:31:00,13:31,14680150,11240300,-3439850,SELL
2020-10-28 13:32:00,13:32,14611125,11125425,-3485700,SELL
2020-10-28 13:33:00,13:33,14735975,10801700,-3934275,SELL
2020-10-28 13:34:00,13:34,14470200,11067700,-3402500,SELL
2020-10-28 13:35:00,13:35,14669525,10746925,-3922600,SELL
2020-10-28 13:36:00,13:36,14777125,10994825,-3782300,SELL
2020-10-28 13:37:00,13:37,14788400,11195225,-3593175,SELL
2020-10-28 13:38:00,13:38,14857425,10814000,-4043425,SELL
2020-10-28 13:39:00,13:39,14558325,10987350,-3570975,SELL
2020-10-28 13:40:00,13:40,14605950,10547150,-4058800,SELL
2020-10-28 13:41:00,13:41,14881275,10987275,-3894000,SELL
2020-10-28 13:42:00,13:42,14754750,11023100,-3731650,SELL
2020-10-28 13:43:00,13:43,14766525,10781500,-3985025,SELL
2020-10-28 13:44:00,13:44,14593700,10986025,-3607675,SELL
2020-10-28 13:45:00,13:45,14739950,10376050,-4363900,SELL
2020-10-28 13:46:00,13:46,14449125,10604700,-3844425,SELL
2020-10-28 13:47:00,13:47,14448525,10610450,-3838075,SELL
2020-10-28 13:48:00,13:48,14379475,10898350,-3481125,SELL
2020-10-28 13:49:00,13:49,14361900,10403875,-3958025,SELL
2020-10-28 13:50:00,13:50,14673650,10950100,-3723550,SELL
2020-10-28 13:51:00,13:51,14496800,10967350,-3529450,SELL
2020-10-28 13:52:00,13:52,14589675,10587400,-4002275,SELL
2020-10-28 13:53:00,13:53,14509700,10350575,-4159125,SELL
2020-10-28 13:54:00,13:54,14639150,10792950,-3846200,SELL
2020-10-28 13:55:00,13:55,14522350,10832200,-3690150,SELL
2020-10-28 13:56:00,13:56,14495575,10964150,-3531425,SELL
2020-10-28 13:57:00,13:57,14346250,10780550,-3565700,SELL
2020-10-28 13:58:00,13:58,14653700,10762225,-3891475,SELL
2020-10-28 13:59:00,13:59,14516325,10900000,-3616325,SELL
2020-10-28 14:00:00,14:00,14543400,11030950,-3512450,SELL
2020-10-28 14:01:00,14:01,14514975,10723450,-3791525,SELL
2020-10-28 14:02:00,14:02,14429525,10711250,-3718275,SELL
2020-10-28 14:03:00,14:03,14364925,10557475,-3807450,SELL
2020-10-28 14:04:00,14:04,14540275,10375050,-4165225,SELL
2020-10-28 14:05:00,14:05,14553825,10661775,-3892050,SELL
2020-10-28 14:06:00,14:06,14534325,10716400,-3817925,SELL
2020-10-28 14:07:00,14:07,14361650,10506875,-3854775,SELL
2020-10-28 14:08:00,14:08,14379050,10599500,-3779550,SELL
2020-10-28 14:09:00,14:09,14380275,10408650,-3971625,SELL
2020-10-28 14:10:00,14:10,14436550,10399500,-4037050,SELL
2020-10-28 14:11:00,14:11,14359225,10466950,-3892275,SELL
2020-10-28 14:12:00,14:12,14575500,10294500,-4281000,SELL
2020-10-28 14:13:00,14:13,14598550,10850850,-3747700,SELL
2020-10-28 14:14:00,14:14,14589700,10444175,-4145525,SELL
2020-10-28 14:15:00,14:15,14485500,10587375,-3898125,SELL
2020-10-28 14:16:00,14:16,14599825,10564900,-4034925,SELL
2020-10-28 14:17:00,14:17,14362950,10780050,-3582900,SELL
2020-10-28 14:18:00,14:18,14460750,10514275,-3946475,SELL
2020-10-28 14:19:00,14:19,14494125,10587800,-3906325,SELL
2020-10-28 14:20:00,14:20,14441425,10835475,-3605950,SELL
2020-10-28 14:21:00,14:21,14667075,10684225,-3982850,SELL
2020-10-28 14:22:00,14:22,14245725,10592400,-3653325,SELL
2020-10-28 14:23:00,14:23,14255450,10573675,-3681775,SELL
2020-10-28 14:24:00,14:24,14364925,10495075,-3869850,SELL
2020-10-28 14:25:00,14:25,14314125,10529700,-3784425,SELL
2020-10-28 14:26:00,14:26,14272050,10624625,-3647425,SELL
2020-10-28 14:27:00,14:27,14251700,10636225,-3615475,SELL
2020-10-28 14:28:00,14:28,14238050,10256900,-3981150,SELL
2020-10-28 14:29:00,14:29,14251700,10774800,-3476900,SELL
2020-10-28 14:30:00,14:30,14278050,10716475,-3561575,SELL
2020-10-28 14:31:00,14:31,14233775,10594200,-3639575,SELL
2020-10-28 14:32:00,14:32,14600925,10667800,-3933125,SELL
2020-10-28 14:33:00,14:33,14530850,10559150,-3971700,SELL
2020-10-28 14:34:00,14:34,14395875,10728125,-3667750,SELL
2020-10-28 14:35:00,14:35,14600375,10685150,-3915225,SELL
2020-10-28 14:36:00,14:36,14394250,10569875,-3824375,SELL
2020-10-28 14:37:00,14:37,14258175,10462875,-3795300,SELL
2020-10-28 14:38:00,14:38,14272700,10264650,-4008050,SELL
2020-10-28 14:39:00,14:39,14122325,10598825,-3523500,SELL
2020-10-28 14:40:00,14:40,14169750,10196375,-3973375,SELL
2020-10-28 14:41:00,14:41,14251425,10691425,-3560000,SELL
2020-10-28 14:42:00,14:42,14013875,10488900,-3524975,SELL
2020-10-28 14:43:00,14:43,14416225,10531625,-3884600,SELL
2020-10-28 14:44:00,14:44,14335025,10561450,-3773575,SELL
2020-10-28 14:45:00,14:45,14204800,10547025,-3657775,SELL
2020-10-28 14:46:00,14:46,14366025,10687700,-3678325,SELL
2020-10-28 14:47:00,14:47,13928175,10568375,-3359800,SELL
2020-10-28 14:48:00,14:48,14102125,10523800,-3578325,SELL
2020-10-28 14:49:00,14:49,14138775,10640575,-3498200,SELL
2020-10-28 14:50:00,14:50,14225900,10616975,-3608925,SELL
2020-10-28 14:51:00,14:51,14125825,10653750,-3472075,SELL
2020-10-28 14:52:00,14:52,14111975,10579600,-3532375,SELL
2020-10-28 14:53:00,14:53,14322925,10598150,-3724775,SELL
2020-10-28 14:54:00,14:54,14334100,10759325,-3574775,SELL
2020-10-28 14:55:00,14:55,14232000,10681175,-3550825,SELL
2020-10-28 14:56:00,14:56,13888900,10655875,-3233025,SELL
2020-10-28 14:57:00,14:57,13943050,10606950,-3336100,SELL
2020-10-28 14:58:00,14:58,14064100,10523425,-3540675,SELL
2020-10-28 14:59:00,14:59,13936175,10623650,-3312525,SELL
2020-10-28 15:00:00,15:00,13873900,10575100,-3298800,SELL
2020-10-28 15:01:00,15:01,13907200,10591450,-3315750,SELL
2020-10-28 15:02:00,15:02,13926725,10607550,-3319175,SELL
2020-10-28 15:03:00,15:03,13805275,10728200,-3077075,SELL
2020-10-28 15:04:00,15:04,13798675,10522000,-3276675,SELL
2020-10-28 15:05:00,15:05,14071125,10542375,-3528750,SELL
2020-10-28 15:06:00,15:06,13782350,10551175,-3231175,SELL
2020-10-28 15:07:00,15:07,13918100,10555375,-3362725,SELL
2020-10-28 15:08:00,15:08,13736050,10668100,-3067950,SELL
2020-10-28 15:09:00,15:09,13759800,10510400,-3249400,SELL
2020-10-28 15:10:00,15:10,13603100,10147975,-3455125,SELL
2020-10-28 15:11:00,15:11,13726300,10552200,-3174100,SELL
2020-10-28 15:12:00,15:12,13599775,10400475,-3199300,SELL
2020-10-28 15:13:00,15:13,13496025,10448875,-3047150,SELL
2020-10-28 15:14:00,15:14,13561350,10421700,-3139650,SELL
2020-10-28 15:15:00,15:15,13417275,10241650,-3175625,SELL
2020-10-28 15:16:00,15:16,13165425,10259800,-2905625,SELL
2020-10-28 15:17:00,15:17,13483875,10364250,-3119625,SELL
2020-10-28 15:18:00,15:18,13046225,10182275,-2863950,SELL
2020-10-28 15:19:00,15:19,13041325,10089425,-2951900,SELL
2020-10-28 15:20:00,15:20,13228175,10226725,-3001450,SELL
2020-10-28 15:21:00,15:21,12752125,10058500,-2693625,SELL
2020-10-28 15:22:00,15:22,12911750,9911475,-3000275,SELL
2020-10-28 15:23:00,15:23,12776900,9943675,-2833225,SELL
2020-10-28 15:24:00,15:24,12730525,9881850,-2848675,SELL
2020-10-28 15:25:00,15:25,12573525,10043775,-2529750,SELL
2020-10-28 15:26:00,15:26,12731425,9986950,-2744475,SELL
2020-10-28 15:27:00,15:27,12539475,9959425,-2580050,SELL
2020-10-28 15:28:00,15:28,12530075,9807650,-2722425,SELL
2020-10-28 15:29:00,15:29,12659700,9980800,-2678900,SELL
2020-10-29 09:15:00,09:15,12389225,9879525,-2509700,SELL
2020-10-29 09:16:00,09:16,12503550,9727800,-2775750,SELL
2020-10-29 09:17:00,09:17,12831700,10399275,-2432425,SELL
2020-10-29 09:18:00,09:18,12789775,10250700,-2539075,SELL
2020-10-29 09:19:00,09:19,12847325,10224200,-2623125,SELL
2020-10-29 09:20:00,09:20,13750950,11012475,-2738475,SELL
2020-10-29 09:21:00,09:21,13866775,11152850,-2713925,SELL
2020-10-29 09:22:00,09:22,13779875,10897825,-2882050,SELL
2020-10-29 09:23:00,09:23,14688300,11990050,-2698250,SELL
2020-10-29 09:24:00,09:24,14819700,11918225,-2901475,SELL
2020-10-29 09:25:00,09:25,14889125,11981075,-2908050,SELL
2020-10-29 09:26:00,09:26,15287900,12462175,-2825725,SELL
2020-10-29 09:27:00,09:27,15509300,12667125,-2842175,SELL
2020-10-29 09:28:00,09:28,15535125,12585925,-2949200,SELL
2020-10-29 09:29:00,09:29,16028225,13204775,-2823450,SELL
2020-10-29 09:30:00,09:30,16246450,13305825,-2940625,SELL
2020-10-29 09:31:00,09:31,16375500,13204975,-3170525,SELL
2020-10-29 09:32:00,09:32,17112525,13573100,-3539425,SELL
2020-10-29 09:33:00,09:33,17134550,13527500,-3607050,SELL
2020-10-29 09:34:00,09:34,17312975,13739300,-3573675,SELL
2020-10-29 09:35:00,09:35,17735750,14287100,-3448650,SELL
2020-10-29 09:36:00,09:36,17756375,14155225,-3601150,SELL
2020-10-29 09:37:00,09:37,17825675,14311925,-3513750,SELL
2020-10-29 09:38:00,09:38,17546600,14534925,-3011675,SELL
2020-10-29 09:39:00,09:39,17754550,14483850,-3270700,SELL
2020-10-29 09:40:00,09:40,17838025,14171950,-3666075,SELL
2020-10-29 09:41:00,09:41,17907150,14631050,-3276100,SELL
2020-10-29 09:42:00,09:42,18014250,14700875,-3313375,SELL
2020-10-29 09:43:00,09:43,17757825,14789500,-2968325,SELL
2020-10-29 09:44:00,09:44,18170375,15143950,-3026425,SELL
2020-10-29 09:45:00,09:45,18162550,14890650,-3271900,SELL
2020-10-29 09:46:00,09:46,17795850,14916350,-2879500,SELL
2020-10-29 09:47:00,09:47,18020025,15314450,-2705575,SELL
2020-10-29 09:48:00,09:48,18422950,15011200,-3411750,SELL
2020-10-29 09:49:00,09:49,18215050,15077375,-3137675,SELL
2020-10-29 09:50:00,09:50,17965600,15329900,-2635700,SELL
2020-10-29 09:51:00,09:51,17956700,15333875,-2622825,SELL
2020-10-29 09:52:00,09:52,18161425,15346650,-2814775,SELL
2020-10-29 09:53:00,09:53,18278900,15801675,-2477225,SELL
2020-10-29 09:54:00,09:54,18409675,15753925,-2655750,SELL
2020-10-29 09:55:00,09:55,18480200,15596875,-2883325,SELL
2020-10-29 09:56:00,09:56,18270425,16124475,-2145950,SELL
2020-10-29 09:57:00,09:57,18175400,15810150,-2365250,SELL
2020-10-29 09:58:00,09:58,18670625,15923750,-2746875,SELL
2020-10-29 09:59:00,09:59,18192500,15869875,-2322625,SELL
2020-10-29 10:00:00,10:00,18713825,15903950,-2809875,SELL
2020-10-29 10:01:00,10:01,18894025,15848850,-3045175,SELL
2020-10-29 10:02:00,10:02,19083200,15885300,-3197900,SELL
2020-10-29 10:03:00,10:03,19052650,15989050,-3063600,SELL
2020-10-29 10:04:00,10:04,18864875,15890850,-2974025,SELL
2020-10-29 10:05:00,10:05,18819075,15697400,-3121675,SELL
2020-10-29 10:06:00,10:06,18821275,15913950,-2907325,SELL
2020-10-29 10:07:00,10:07,18839300,16010800,-2828500,SELL
2020-10-29 10:08:00,10:08,19360250,15936825,-3423425,SELL
2020-10-29 10:09:00,10:09,19468775,16005075,-3463700,SELL
2020-10-29 10:10:00,10:10,19096400,16113450,-2982950,SELL
2020-10-29 10:11:00,10:11,19679650,16006600,-3673050,SELL
2020-10-29 10:12:00,10:12,19550200,16282025,-3268175,SELL
2020-10-29 10:13:00,10:13,19695475,16250950,-3444525,SELL
2020-10-29 10:14:00,10:14,19609125,16473025,-3136100,SELL
2020-10-29 10:15:00,10:15,19578400,16245325,-3333075,SELL
2020-10-29 10:16:00,10:16,19186625,16567875,-2618750,SELL
2020-10-29 10:17:00,10:17,19475750,16308075,-3167675,SELL
2020-10-29 10:18:00,10:18,19624875,16759550,-2865325,SELL
2020-10-29 10:19:00,10:19,19783925,16800050,-2983875,SELL
2020-10-29 10:20:00,10:20,19865325,16791700,-3073625,SELL
2020-10-29 10:21:00,10:21,20108950,16945825,-3163125,SELL
2020-10-29 10:22:00,10:22,20069750,16842050,-3227700,SELL
2020-10-29 10:23:00,10:23,19905200,16218125,-3687075,SELL
2020-10-29 10:24:00,10:24,19827475,16504300,-3323175,SELL
2020-10-29 10:25:00,10:25,19397675,16502975,-2894700,SELL
2020-10-29 10:26:00,10:26,20022900,16143325,-3879575,SELL
2020-10-29 10:27:00,10:27,19580600,16061550,-3519050,SELL
2020-10-29 10:28:00,10:28,19219925,15803900,-3416025,SELL
2020-10-29 10:29:00,10:29,19945475,16642525,-3302950,SELL
2020-10-29 10:30:00,10:30,20334325,16413525,-3920800,SELL
2020-10-29 10:31:00,10:31,20169225,16392025,-3777200,SELL
2020-10-29 10:32:00,10:32,20239150,16600100,-3639050,SELL
2020-10-29 10:33:00,10:33,20438125,16744200,-3693925,SELL
2020-10-29 10:34:00,10:34,20095100,16578750,-3516350,SELL
2020-10-29 10:35:00,10:35,20888625,16531925,-4356700,SELL
2020-10-29 10:36:00,10:36,20685525,16412700,-4272825,SELL
2020-10-29 10:37:00,10:37,20469325,15747575,-4721750,SELL
2020-10-29 10:38:00,10:38,20441500,16518625,-3922875,SELL
2020-10-29 10:39:00,10:39,20289900,16299100,-3990800,SELL
2020-10-29 10:40:00,10:40,20296375,15978800,-4317575,SELL
2020-10-29 10:41:00,10:41,20705875,16504250,-4201625,SELL
2020-10-29 10:42:00,10:42,20619500,16354650,-4264850,SELL
2020-10-29 10:43:00,10:43,20433975,16005150,-4428825,SELL
2020-10-29 10:44:00,10:44,20746400,16763775,-3982625,SELL
2020-10-29 10:45:00,10:45,20616775,16575025,-4041750,SELL
2020-10-29 10:46:00,10:46,20581975,16761550,-3820425,SELL
2020-10-29 10:47:00,10:47,20964525,16482500,-4482025,SELL
2020-10-29 10:48:00,10:48,20447500,16647375,-3800125,SELL
2020-10-29 10:49:00,10:49,20923400,15850250,-5073150,SELL
2020-10-29 10:50:00,10:50,20587750,16354325,-4233425,SELL
2020-10-29 10:51:00,10:51,20230750,16322525,-3908225,SELL
2020-10-29 10:52:00,10:52,20962350,16421925,-4540425,SELL
2020-10-29 10:53:00,10:53,20652175,16266025,-4386150,SELL
2020-10-29 10:54:00,10:54,21195825,16092975,-5102850,SELL
2020-10-29 10:55:00,10:55,21175200,16682825,-4492375,SELL
2020-10-29 10:56:00,10:56,20909300,15621750,-5287550,SELL
2020-10-29 10:57:00,10:57,21065950,16347125,-4718825,SELL
2020-10-29 10:58:00,10:58,21295275,16354625,-4940650,SELL
2020-10-29 10:59:00,10:59,21048200,16547050,-4501150,SELL
2020-10-29 11:00:00,11:00,21451450,16905625,-4545825,SELL
2020-10-29 11:01:00,11:01,21489575,16959575,-4530000,SELL
2020-10-29 11:02:00,11:02,21675475,17100525,-4574950,SELL
2020-10-29 11:03:00,11:03,21734350,16918600,-4815750,SELL
2020-10-29 11:04:00,11:04,21490800,16500575,-4990225,SELL
2020-10-29 11:05:00,11:05,21293525,16546300,-4747225,SELL
2020-10-29 11:06:00,11:06,21682700,17242950,-4439750,SELL
2020-10-29 11:07:00,11:07,21515300,16447800,-5067500,SELL
2020-10-29 11:08:00,11:08,21548150,16491750,-5056400,SELL
2020-10-29 11:09:00,11:09,21111250,17310525,-3800725,SELL
2020-10-29 11:10:00,11:10,21356975,17365850,-3991125,SELL
2020-10-29 11:11:00,11:11,21525250,17024875,-4500375,SELL
2020-10-29 11:12:00,11:12,21556850,17170975,-4385875,SELL
2020-10-29 11:13:00,11:13,21581675,16997050,-4584625,SELL
2020-10-29 11:14:00,11:14,21645475,17115475,-4530000,SELL
2020-10-29 11:15:00,11:15,21661950,16579075,-5082875,SELL
2020-10-29 11:16:00,11:16,21842625,17263325,-4579300,SELL
2020-10-29 11:17:00,11:17,21552600,17192225,-4360375,SELL
2020-10-29 11:18:00,11:18,21176925,16822925,-4354000,SELL
2020-10-29 11:19:00,11:19,21325700,17480300,-3845400,SELL
2020-10-29 11:20:00,11:20,21553950,17523125,-4030825,SELL
2020-10-29 11:21:00,11:21,21779600,17394325,-4385275,SELL
2020-10-29 11:22:00,11:22,21768300,17331850,-4436450,SELL
2020-10-29 11:23:00,11:23,21708875,17333300,-4375575,SELL
2020-10-29 11:24:00,11:24,21102925,16751950,-4350975,SELL
2020-10-29 11:25:00,11:25,21873675,17682825,-4190850,SELL
2020-10-29 11:26:00,11:26,21866925,17603275,-4263650,SELL
2020-10-29 11:27:00,11:27,21718150,17553975,-4164175,SELL
2020-10-29 11:28:00,11:28,21754125,17145800,-4608325,SELL
2020-10-29 11:29:00,11:29,21635875,17702100,-3933775,SELL
2020-10-29 11:30:00,11:30,21317225,17633500,-3683725,SELL
2020-10-29 11:31:00,11:31,21460500,17830300,-3630200,SELL
2020-10-29 11:32:00,11:32,21884775,17570200,-4314575,SELL
2020-10-29 11:33:00,11:33,21946750,17925900,-4020850,SELL
2020-10-29 11:34:00,11:34,21995600,17626400,-4369200,SELL
2020-10-29 11:35:00,11:35,21849250,17951700,-3897550,SELL
2020-10-29 11:36:00,11:36,21530400,17974400,-3556000,SELL
2020-10-29 11:37:00,11:37,22199300,17982550,-4216750,SELL
2020-10-29 11:38:00,11:38,21912250,18023175,-3889075,SELL
2020-10-29 11:39:00,11:39,21156050,17987950,-3168100,SELL
2020-10-29 11:40:00,11:40,21196250,17875200,-3321050,SELL
2020-10-29 11:41:00,11:41,21236125,17653500,-3582625,SELL
2020-10-29 11:42:00,11:42,21551975,17832850,-3719125,SELL
2020-10-29 11:43:00,11:43,21776775,17935400,-3841375,SELL
2020-10-29 11:44:00,11:44,21867075,17644775,-4222300,SELL
2020-10-29 11:45:00,11:45,21806375,17888550,-3917825,SELL
2020-10-29 11:46:00,11:46,22182250,17732400,-4449850,SELL
2020-10-29 11:47:00,11:47,21373850,18078525,-3295325,SELL
2020-10-29 11:48:00,11:48,21797750,17583100,-4214650,SELL
2020-10-29 11:49:00,11:49,22065600,18193975,-3871625,SELL
2020-10-29 11:50:00,11:50,21340500,18332900,-3007600,SELL
2020-10-29 11:51:00,11:51,21159000,18392175,-2766825,SELL
2020-10-29 11:52:00,11:52,21177150,18066900,-3110250,SELL
2020-10-29 11:53:00,11:53,21409400,18241200,-3168200,SELL
2020-10-29 11:54:00,11:54,21401025,18076325,-3324700,SELL
2020-10-29 11:55:00,11:55,21524425,18469575,-3054850,SELL
2020-10-29 11:56:00,11:56,20875625,18552125,-2323500,SELL
2020-10-29 11:57:00,11:57,20626025,18430675,-2195350,SELL
2020-10-29 11:58:00,11:58,20636575,17984550,-2652025,SELL
2020-10-29 11:59:00,11:59,20908250,18807325,-2100925,SELL
2020-10-29 12:00:00,12:00,20709250,18882600,-1826650,SELL
2020-10-29 12:01:00,12:01,20905150,18808700,-2096450,SELL
2020-10-29 12:02:00,12:02,20236125,19137450,-1098675,SELL
2020-10-29 12:03:00,12:03,20379550,18820025,-1559525,SELL
2020-10-29 12:04:00,12:04,19996925,19363000,-633925,SELL
2020-10-29 12:05:00,12:05,20317925,19385150,-932775,SELL
2020-10-29 12:06:00,12:06,20405575,19137400,-1268175,SELL
2020-10-29 12:07:00,12:07,19877450,18769150,-1108300,SELL
2020-10-29 12:08:00,12:08,20260550,19377300,-883250,SELL
2020-10-29 12:09:00,12:09,20529750,19476600,-1053150,SELL
2020-10-29 12:10:00,12:10,20227675,19226100,-1001575,SELL
2020-10-29 12:11:00,12:11,20269850,19676675,-593175,SELL
2020-10-29 12:12:00,12:12,19905675,19119950,-785725,SELL
2020-10-29 12:13:00,12:13,20088175,19410400,-677775,SELL
2020-10-29 12:14:00,12:14,20423925,19729100,-694825,SELL
2020-10-29 12:15:00,12:15,20279775,19660325,-619450,SELL
2020-10-29 12:16:00,12:16,20457075,19728175,-728900,SELL
2020-10-29 12:17:00,12:17,20092400,19842450,-249950,SELL
2020-10-29 12:18:00,12:18,20421925,19426025,-995900,SELL
2020-10-29 12:19:00,12:19,20499550,19572675,-926875,SELL
2020-10-29 12:20:00,12:20,20710925,19641400,-1069525,SELL
2020-10-29 12:21:00,12:21,20753625,19506200,-1247425,SELL
2020-10-29 12:22:00,12:22,20675250,19224225,-1451025,SELL
2020-10-29 12:23:00,12:23,20823925,19637975,-1185950,SELL
2020-10-29 12:24:00,12:24,19992375,19906850,-85525,SELL
2020-10-29 12:25:00,12:25,20423375,20158225,-265150,SELL
2020-10-29 12:26:00,12:26,20700925,19278750,-1422175,SELL
2020-10-29 12:27:00,12:27,20777750,19770250,-1007500,SELL
2020-10-29 12:28:00,12:28,20993200,19871450,-1121750,SELL
2020-10-29 12:29:00,12:29,20424775,20185650,-239125,SELL
2020-10-29 12:30:00,12:30,20607300,20226275,-381025,SELL
2020-10-29 12:31:00,12:31,20795775,20416350,-379425,SELL
2020-10-29 12:32:00,12:32,20889825,19983275,-906550,SELL
2020-10-29 12:33:00,12:33,21247850,20064375,-1183475,SELL
2020-10-29 12:34:00,12:34,20845725,19571300,-1274425,SELL
2020-10-29 12:35:00,12:35,21165800,19910975,-1254825,SELL
2020-10-29 12:36:00,12:36,21210950,19206550,-2004400,SELL
2020-10-29 12:37:00,12:37,21313550,19850200,-1463350,SELL
2020-10-29 12:38:00,12:38,21176175,19696825,-1479350,SELL
2020-10-29 12:39:00,12:39,21339275,19885250,-1454025,SELL
2020-10-29 12:40:00,12:40,20702075,19306025,-1396050,SELL
2020-10-29 12:41:00,12:41,20833050,19195400,-1637650,SELL
2020-10-29 12:42:00,12:42,21465075,19484050,-1981025,SELL
2020-10-29 12:43:00,12:43,21550025,19351575,-2198450,SELL
2020-10-29 12:44:00,12:44,21215550,19193225,-2022325,SELL
2020-10-29 12:45:00,12:45,21184000,19296275,-1887725,SELL
2020-10-29 12:46:00,12:46,21521400,18766200,-2755200,SELL
2020-10-29 12:47:00,12:47,21489775,19271925,-2217850,SELL
2020-10-29 12:48:00,12:48,21835850,19516625,-2319225,SELL
2020-10-29 12:49:00,12:49,21437325,18708600,-2728725,SELL
2020-10-29 12:50:00,12:50,21615225,18982650,-2632575,SELL
2020-10-29 12:51:00,12:51,22062450,19397425,-2665025,SELL
2020-10-29 12:52:00,12:52,22051475,19538975,-2512500,SELL
2020-10-29 12:53:00,12:53,21951325,19182325,-2769000,SELL
2020-10-29 12:54:00,12:54,21737400,19217875,-2519525,SELL
2020-10-29 12:55:00,12:55,21437600,19633525,-1804075,SELL
2020-10-29 12:56:00,12:56,21907575,19956250,-1951325,SELL
2020-10-29 12:57:00,12:57,21699000,19132850,-2566150,SELL
2020-10-29 12:58:00,12:58,22380575,18845075,-3535500,SELL
2020-10-29 12:59:00,12:59,21966225,18995525,-2970700,SELL
2020-10-29 13:00:00,13:00,21678350,19417125,-2261225,SELL
2020-10-29 13:01:00,13:01,22580650,19219125,-3361525,SELL
2020-10-29 13:02:00,13:02,22046850,19379875,-2666975,SELL
2020-10-29 13:03:00,13:03,22727700,19344300,-3383400,SELL
2020-10-29 13:04:00,13:04,22832525,19083800,-3748725,SELL
2020-10-29 13:05:00,13:05,22931375,19598600,-3332775,SELL
2020-10-29 13:06:00,13:06,22707475,18285300,-4422175,SELL
2020-10-29 13:07:00,13:07,22630600,18390525,-4240075,SELL
2020-10-29 13:08:00,13:08,21733175,18798700,-2934475,SELL
2020-10-29 13:09:00,13:09,22121750,18021625,-4100125,SELL
2020-10-29 13:10:00,13:10,22543650,18659725,-3883925,SELL
2020-10-29 13:11:00,13:11,22973675,18288650,-4685025,SELL
2020-10-29 13:12:00,13:12,23002050,18226800,-4775250,SELL
2020-10-29 13:13:00,13:13,22899700,18415375,-4484325,SELL
2020-10-29 13:14:00,13:14,23141050,18498250,-4642800,SELL
2020-10-29 13:15:00,13:15,23194350,18245550,-4948800,SELL
2020-10-29 13:16:00,13:16,22579125,17922500,-4656625,SELL
2020-10-29 13:17:00,13:17,22995675,18196900,-4798775,SELL
2020-10-29 13:18:00,13:18,23365850,17381450,-5984400,SELL
2020-10-29 13:19:00,13:19,23071300,17413050,-5658250,SELL
2020-10-29 13:20:00,13:20,23226950,17224350,-6002600,SELL
2020-10-29 13:21:00,13:21,23233025,16772800,-6460225,SELL
2020-10-29 13:22:00,13:22,22982050,17521350,-5460700,SELL
2020-10-29 13:23:00,13:23,22808300,16794425,-6013875,SELL
2020-10-29 13:24:00,13:24,22881400,16912625,-5968775,SELL
2020-10-29 13:25:00,13:25,22805100,17093550,-5711550,SELL
2020-10-29 13:26:00,13:26,22882600,17308350,-5574250,SELL
2020-10-29 13:27:00,13:27,23238025,17188325,-6049700,SELL
2020-10-29 13:28:00,13:28,22877125,16800025,-6077100,SELL
2020-10-29 13:29:00,13:29,23123725,17087800,-6035925,SELL
2020-10-29 13:30:00,13:30,23911900,16881975,-7029925,SELL
2020-10-29 13:31:00,13:31,23657725,17421725,-6236000,SELL
2020-10-29 13:32:00,13:32,22955075,17402200,-5552875,SELL
2020-10-29 13:33:00,13:33,23547725,17655175,-5892550,SELL
2020-10-29 13:34:00,13:34,23610975,17488375,-6122600,SELL
2020-10-29 13:35:00,13:35,23553300,17313300,-6240000,SELL
2020-10-29 13:36:00,13:36,23943375,17449650,-6493725,SELL
2020-10-29 13:37:00,13:37,23086275,17627625,-5458650,SELL
2020-10-29 13:38:00,13:38,23899725,17279600,-6620125,SELL
2020-10-29 13:39:00,13:39,24186450,17576200,-6610250,SELL
2020-10-29 13:40:00,13:40,24050775,17669725,-6381050,SELL
2020-10-29 13:41:00,13:41,24160425,17546250,-6614175,SELL
2020-10-29 13:42:00,13:42,23451425,17309075,-6142350,SELL
2020-10-29 13:43:00,13:43,23760900,17490000,-6270900,SELL
2020-10-29 13:44:00,13:44,23892725,17247125,-6645600,SELL
2020-10-29 13:45:00,13:45,23692725,17461400,-6231325,SELL
2020-10-29 13:46:00,13:46,23582475,17553775,-6028700,SELL
2020-10-29 13:47:00,13:47,23694025,17784975,-5909050,SELL
2020-10-29 13:48:00,13:48,23412200,17616250,-5795950,SELL
2020-10-29 13:49:00,13:49,23103600,17728125,-5375475,SELL
2020-10-29 13:50:00,13:50,23980475,17774125,-6206350,SELL
2020-10-29 13:51:00,13:51,23582050,17778250,-5803800,SELL
2020-10-29 13:52:00,13:52,23687050,17949875,-5737175,SELL
2020-10-29 13:53:00,13:53,24060900,18199100,-5861800,SELL
2020-10-29 13:54:00,13:54,23241725,17577950,-5663775,SELL
2020-10-29 13:55:00,13:55,23100450,18193425,-4907025,SELL
2020-10-29 13:56:00,13:56,23215875,17926750,-5289125,SELL
2020-10-29 13:57:00,13:57,23673375,18019000,-5654375,SELL
2020-10-29 13:58:00,13:58,23798250,17795725,-6002525,SELL
2020-10-29 13:59:00,13:59,23490100,17157850,-6332250,SELL
2020-10-29 14:00:00,14:00,23867425,17967025,-5900400,SELL
2020-10-29 14:01:00,14:01,23595750,17877450,-5718300,SELL
2020-10-29 14:02:00,14:02,23897200,17535200,-6362000,SELL
2020-10-29 14:03:00,14:03,23367450,16767000,-6600450,SELL
2020-10-29 14:04:00,14:04,22756200,17078400,-5677800,SELL
2020-10-29 14:05:00,14:05,23315050,16791700,-6523350,SELL
2020-10-29 14:06:00,14:06,23493425,16549650,-6943775,SELL
2020-10-29 14:07:00,14:07,23327075,16993750,-6333325,SELL
2020-10-29 14:08:00,14:08,23144375,17245450,-5898925,SELL
2020-10-29 14:09:00,14:09,23208150,17211325,-5996825,SELL
2020-10-29 14:10:00,14:10,23247425,16551975,-6695450,SELL
2020-10-29 14:11:00,14:11,23345450,16825600,-6519850,SELL
2020-10-29 14:12:00,14:12,23081925,17488000,-5593925,SELL
2020-10-29 14:13:00,14:13,23501700,17513125,-5988575,SELL
2020-10-29 14:14:00,14:14,23453575,16854600,-6598975,SELL
2020-10-29 14:15:00,14:15,23417300,17682275,-5735025,SELL
2020-10-29 14:16:00,14:16,23360450,17770550,-5589900,SELL
2020-10-29 14:17:00,14:17,23513200,17334750,-6178450,SELL
2020-10-29 14:18:00,14:18,22925925,16616225,-6309700,SELL
2020-10-29 14:19:00,14:19,23183950,17406025,-5777925,SELL
2020-10-29 14:20:00,14:20,23397000,17692300,-5704700,SELL
2020-10-29 14:21:00,14:21,23560500,17819200,-5741300,SELL
2020-10-29 14:22:00,14:22,23543225,18014475,-5528750,SELL
2020-10-29 14:23:00,14:23,23400975,17634475,-5766500,SELL
2020-10-29 14:24:00,14:24,23202950,18136500,-5066450,SELL
2020-10-29 14:25:00,14:25,23769650,17750900,-6018750,SELL
2020-10-29 14:26:00,14:26,23747325,18153800,-5593525,SELL
2020-10-29 14:27:00,14:27,23727700,18153700,-5574000,SELL
2020-10-29 14:28:00,14:28,23547150,17448425,-6098725,SELL
2020-10-29 14:29:00,14:29,23668850,17979800,-5689050,SELL
2020-10-29 14:30:00,14:30,23253475,17674500,-5578975,SELL
2020-10-29 14:31:00,14:31,23228200,18447175,-4781025,SELL
2020-10-29 14:32:00,14:32,23540125,18045625,-5494500,SELL
2020-10-29 14:33:00,14:33,23274150,18015925,-5258225,SELL
2020-10-29 14:34:00,14:34,22984950,17380325,-5604625,SELL
2020-10-29 14:35:00,14:35,23472125,18511475,-4960650,SELL
2020-10-29 14:36:00,14:36,23023700,18129475,-4894225,SELL
2020-10-29 14:37:00,14:37,22957700,18381725,-4575975,SELL
2020-10-29 14:38:00,14:38,22628150,17756500,-4871650,SELL
2020-10-29 14:39:00,14:39,23124875,18355625,-4769250,SELL
2020-10-29 14:40:00,14:40,23343775,18241225,-5102550,SELL
2020-10-29 14:41:00,14:41,23298825,18208675,-5090150,SELL
2020-10-29 14:42:00,14:42,23410750,18291425,-5119325,SELL
2020-10-29 14:43:00,14:43,22923500,18433775,-4489725,SELL
2020-10-29 14:44:00,14:44,22696650,18086250,-4610400,SELL
2020-10-29 14:45:00,14:45,22944925,18226175,-4718750,SELL
2020-10-29 14:46:00,14:46,22984450,17964700,-5019750,SELL
2020-10-29 14:47:00,14:47,23305025,18041225,-5263800,SELL
2020-10-29 14:48:00,14:48,22411900,18029625,-4382275,SELL
2020-10-29 14:49:00,14:49,23337525,17731350,-5606175,SELL
2020-10-29 14:50:00,14:50,23172200,17809625,-5362575,SELL
2020-10-29 14:51:00,14:51,23326000,17647925,-5678075,SELL
2020-10-29 14:52:00,14:52,22783750,17664625,-5119125,SELL
2020-10-29 14:53:00,14:53,23129075,17845550,-5283525,SELL
2020-10-29 14:54:00,14:54,23108750,17349900,-5758850,SELL
2020-10-29 14:55:00,14:55,22430475,17931000,-4499475,SELL
2020-10-29 14:56:00,14:56,22976950,17803150,-5173800,SELL
2020-10-29 14:57:00,14:57,23124050,18193250,-4930800,SELL
2020-10-29 14:58:00,14:58,23246625,17796950,-5449675,SELL
2020-10-29 14:59:00,14:59,22991200,17631050,-5360150,SELL
2020-10-29 15:00:00,15:00,22928175,17798175,-5130000,SELL
2020-10-29 15:01:00,15:01,22552125,17372675,-5179450,SELL
2020-10-29 15:02:00,15:02,22809900,17328875,-5481025,SELL
2020-10-29 15:03:00,15:03,22153250,17807150,-4346100,SELL
2020-10-29 15:04:00,15:04,22038075,17992325,-4045750,SELL
2020-10-29 15:05:00,15:05,21957600,18352700,-3604900,SELL
2020-10-29 15:06:00,15:06,21708125,17777725,-3930400,SELL
2020-10-29 15:07:00,15:07,21155875,17772100,-3383775,SELL
2020-10-29 15:08:00,15:08,21800875,17652900,-4147975,SELL
2020-10-29 15:09:00,15:09,21582200,17654175,-3928025,SELL
2020-10-29 15:10:00,15:10,21670950,17438600,-4232350,SELL
2020-10-29 15:11:00,15:11,21629475,17562875,-4066600,SELL
2020-10-29 15:12:00,15:12,20261075,17157850,-3103225,SELL
2020-10-29 15:13:00,15:13,20839275,17147225,-3692050,SELL
2020-10-29 15:14:00,15:14,20878525,17634950,-3243575,SELL
2020-10-29 15:15:00,15:15,21258175,17265250,-3992925,SELL
2020-10-29 15:16:00,15:16,21222200,17189775,-4032425,SELL
2020-10-29 15:17:00,15:17,21402175,17189600,-4212575,SELL
2020-10-29 15:18:00,15:18,21229725,16953775,-4275950,SELL
2020-10-29 15:19:00,15:19,20809925,16657850,-4152075,SELL
2020-10-29 15:20:00,15:20,20942850,16750450,-4192400,SELL
2020-10-29 15:21:00,15:21,21246750,15966675,-5280075,SELL
2020-10-29 15:22:00,15:22,21244825,15459525,-5785300,SELL
2020-10-29 15:23:00,15:23,21178775,16500025,-4678750,SELL
2020-10-29 15:24:00,15:24,20596500,16331325,-4265175,SELL
2020-10-29 15:25:00,15:25,20665975,17031800,-3634175,SELL
2020-10-29 15:26:00,15:26,20283650,16716250,-3567400,SELL
2020-10-29 15:27:00,15:27,18970200,14568975,-4401225,SELL
2020-10-29 15:28:00,15:28,18915700,16214650,-2701050,SELL
2020-10-29 15:29:00,15:29,18954300,16049600,-2904700,SELL
