,timestamp,call,put,diff,sellOrBuy
2020-09-18 09:15:00,09:15,6647000,5133575,-1513425,SELL
2020-09-18 09:16:00,09:16,6615975,5139250,-1476725,SELL
2020-09-18 09:17:00,09:17,6979300,5609275,-1370025,SELL
2020-09-18 09:18:00,09:18,6907975,5406575,-1501400,SELL
2020-09-18 09:19:00,09:19,6940575,5620950,-1319625,SELL
2020-09-18 09:20:00,09:20,7285825,5870800,-1415025,SELL
2020-09-18 09:21:00,09:21,7198675,5814250,-1384425,SELL
2020-09-18 09:22:00,09:22,7260400,5757575,-1502825,SELL
2020-09-18 09:23:00,09:23,7474100,5704625,-1769475,SELL
2020-09-18 09:24:00,09:24,7385075,5848350,-1536725,SELL
2020-09-18 09:25:00,09:25,7491600,5752675,-1738925,SELL
2020-09-18 09:26:00,09:26,7532150,6052475,-1479675,SELL
2020-09-18 09:27:00,09:27,7576625,6057400,-1519225,SELL
2020-09-18 09:28:00,09:28,7482775,6044550,-1438225,SELL
2020-09-18 09:29:00,09:29,7604475,6164700,-1439775,SELL
2020-09-18 09:30:00,09:30,7605225,6040725,-1564500,SELL
2020-09-18 09:31:00,09:31,7718425,6223600,-1494825,SELL
2020-09-18 09:32:00,09:32,7813500,6178775,-1634725,SELL
2020-09-18 09:33:00,09:33,7710850,6167725,-1543125,SELL
2020-09-18 09:34:00,09:34,7817875,6001100,-1816775,SELL
2020-09-18 09:35:00,09:35,7845750,6315375,-1530375,SELL
2020-09-18 09:36:00,09:36,7843700,5914550,-1929150,SELL
2020-09-18 09:37:00,09:37,7917075,6007100,-1909975,SELL
2020-09-18 09:38:00,09:38,7882025,6316750,-1565275,SELL
2020-09-18 09:39:00,09:39,7955200,6322575,-1632625,SELL
2020-09-18 09:40:00,09:40,7865650,6055375,-1810275,SELL
2020-09-18 09:41:00,09:41,7911800,6356450,-1555350,SELL
2020-09-18 09:42:00,09:42,8015675,6436975,-1578700,SELL
2020-09-18 09:43:00,09:43,7927725,6439100,-1488625,SELL
2020-09-18 09:44:00,09:44,8104450,6318475,-1785975,SELL
2020-09-18 09:45:00,09:45,8121125,6472025,-1649100,SELL
2020-09-18 09:46:00,09:46,8103900,6131550,-1972350,SELL
2020-09-18 09:47:00,09:47,8104125,6536125,-1568000,SELL
2020-09-18 09:48:00,09:48,8145550,6400525,-1745025,SELL
2020-09-18 09:49:00,09:49,8117350,6406750,-1710600,SELL
2020-09-18 09:50:00,09:50,8199875,6395850,-1804025,SELL
2020-09-18 09:51:00,09:51,8170000,6545775,-1624225,SELL
2020-09-18 09:52:00,09:52,8125800,6371400,-1754400,SELL
2020-09-18 09:53:00,09:53,8065825,6147125,-1918700,SELL
2020-09-18 09:54:00,09:54,8142775,6501000,-1641775,SELL
2020-09-18 09:55:00,09:55,8214600,6437600,-1777000,SELL
2020-09-18 09:56:00,09:56,8129975,6494875,-1635100,SELL
2020-09-18 09:57:00,09:57,8077625,6460475,-1617150,SELL
2020-09-18 09:58:00,09:58,8243675,6548600,-1695075,SELL
2020-09-18 09:59:00,09:59,8169600,6608175,-1561425,SELL
2020-09-18 10:00:00,10:00,8244050,6474175,-1769875,SELL
2020-09-18 10:01:00,10:01,8135525,6476100,-1659425,SELL
2020-09-18 10:02:00,10:02,8276675,6522250,-1754425,SELL
2020-09-18 10:03:00,10:03,8358225,6741225,-1617000,SELL
2020-09-18 10:04:00,10:04,8244550,6412225,-1832325,SELL
2020-09-18 10:05:00,10:05,8323025,6531350,-1791675,SELL
2020-09-18 10:06:00,10:06,8381550,6615325,-1766225,SELL
2020-09-18 10:07:00,10:07,8287725,6440025,-1847700,SELL
2020-09-18 10:08:00,10:08,8417850,6808650,-1609200,SELL
2020-09-18 10:09:00,10:09,8483125,6756200,-1726925,SELL
2020-09-18 10:10:00,10:10,8470675,6759975,-1710700,SELL
2020-09-18 10:11:00,10:11,8479225,6803825,-1675400,SELL
2020-09-18 10:12:00,10:12,8546675,6841250,-1705425,SELL
2020-09-18 10:13:00,10:13,8465000,6794225,-1670775,SELL
2020-09-18 10:14:00,10:14,8641875,6856350,-1785525,SELL
2020-09-18 10:15:00,10:15,8656550,6854375,-1802175,SELL
2020-09-18 10:16:00,10:16,8628650,6816675,-1811975,SELL
2020-09-18 10:17:00,10:17,8609975,6522850,-2087125,SELL
2020-09-18 10:18:00,10:18,8641675,6881275,-1760400,SELL
2020-09-18 10:19:00,10:19,8608950,6876450,-1732500,SELL
2020-09-18 10:20:00,10:20,8761875,6792525,-1969350,SELL
2020-09-18 10:21:00,10:21,8556600,6952975,-1603625,SELL
2020-09-18 10:22:00,10:22,8751150,6912000,-1839150,SELL
2020-09-18 10:23:00,10:23,8724375,6932975,-1791400,SELL
2020-09-18 10:24:00,10:24,8740175,6683225,-2056950,SELL
2020-09-18 10:25:00,10:25,8679675,6503475,-2176200,SELL
2020-09-18 10:26:00,10:26,8848950,6883950,-1965000,SELL
2020-09-18 10:27:00,10:27,8772300,6853150,-1919150,SELL
2020-09-18 10:28:00,10:28,8740025,6494200,-2245825,SELL
2020-09-18 10:29:00,10:29,8717975,6597575,-2120400,SELL
2020-09-18 10:30:00,10:30,8792450,6762975,-2029475,SELL
2020-09-18 10:31:00,10:31,8691575,6851800,-1839775,SELL
2020-09-18 10:32:00,10:32,8661150,6705975,-1955175,SELL
2020-09-18 10:33:00,10:33,8687900,6721350,-1966550,SELL
2020-09-18 10:34:00,10:34,8841000,6651975,-2189025,SELL
2020-09-18 10:35:00,10:35,8974925,6597125,-2377800,SELL
2020-09-18 10:36:00,10:36,8763525,6348025,-2415500,SELL
2020-09-18 10:37:00,10:37,8938525,6851050,-2087475,SELL
2020-09-18 10:38:00,10:38,8920500,6548525,-2371975,SELL
2020-09-18 10:39:00,10:39,8991100,6467725,-2523375,SELL
2020-09-18 10:40:00,10:40,8996100,6966025,-2030075,SELL
2020-09-18 10:41:00,10:41,9077250,6959150,-2118100,SELL
2020-09-18 10:42:00,10:42,9003225,6511125,-2492100,SELL
2020-09-18 10:43:00,10:43,9080875,6675725,-2405150,SELL
2020-09-18 10:44:00,10:44,9006250,6775675,-2230575,SELL
2020-09-18 10:45:00,10:45,9052050,6776775,-2275275,SELL
2020-09-18 10:46:00,10:46,9049475,6797625,-2251850,SELL
2020-09-18 10:47:00,10:47,8920625,6647600,-2273025,SELL
2020-09-18 10:48:00,10:48,9149725,6778825,-2370900,SELL
2020-09-18 10:49:00,10:49,9173975,6978300,-2195675,SELL
2020-09-18 10:50:00,10:50,9173125,6782550,-2390575,SELL
2020-09-18 10:51:00,10:51,9142100,7068700,-2073400,SELL
2020-09-18 10:52:00,10:52,9072925,6537025,-2535900,SELL
2020-09-18 10:53:00,10:53,8864850,6543750,-2321100,SELL
2020-09-18 10:54:00,10:54,8838575,6719575,-2119000,SELL
2020-09-18 10:55:00,10:55,9066975,6924625,-2142350,SELL
2020-09-18 10:56:00,10:56,9048200,6960575,-2087625,SELL
2020-09-18 10:57:00,10:57,9080375,6815425,-2264950,SELL
2020-09-18 10:58:00,10:58,8947025,6643850,-2303175,SELL
2020-09-18 10:59:00,10:59,9077225,6654350,-2422875,SELL
2020-09-18 11:00:00,11:00,9175350,7090125,-2085225,SELL
2020-09-18 11:01:00,11:01,8970050,6640325,-2329725,SELL
2020-09-18 11:02:00,11:02,8536525,6832725,-1703800,SELL
2020-09-18 11:03:00,11:03,9113450,6843375,-2270075,SELL
2020-09-18 11:04:00,11:04,9076950,6667450,-2409500,SELL
2020-09-18 11:05:00,11:05,9077900,6902775,-2175125,SELL
2020-09-18 11:06:00,11:06,9159125,6871875,-2287250,SELL
2020-09-18 11:07:00,11:07,9047575,6837475,-2210100,SELL
2020-09-18 11:08:00,11:08,9266225,6889850,-2376375,SELL
2020-09-18 11:09:00,11:09,9292100,6974775,-2317325,SELL
2020-09-18 11:10:00,11:10,9191175,6717700,-2473475,SELL
2020-09-18 11:11:00,11:11,9272925,6817650,-2455275,SELL
2020-09-18 11:12:00,11:12,9367575,7207525,-2160050,SELL
2020-09-18 11:13:00,11:13,9276225,7072750,-2203475,SELL
2020-09-18 11:14:00,11:14,9346425,6990500,-2355925,SELL
2020-09-18 11:15:00,11:15,9357350,7085200,-2272150,SELL
2020-09-18 11:16:00,11:16,9351475,6854125,-2497350,SELL
2020-09-18 11:17:00,11:17,9448575,6763450,-2685125,SELL
2020-09-18 11:18:00,11:18,9476800,6747650,-2729150,SELL
2020-09-18 11:19:00,11:19,9487975,6915225,-2572750,SELL
2020-09-18 11:20:00,11:20,9319750,6885550,-2434200,SELL
2020-09-18 11:21:00,11:21,9405700,7007850,-2397850,SELL
2020-09-18 11:22:00,11:22,9316175,6882525,-2433650,SELL
2020-09-18 11:23:00,11:23,9164375,7045550,-2118825,SELL
2020-09-18 11:24:00,11:24,9449400,6959975,-2489425,SELL
2020-09-18 11:25:00,11:25,9494775,7193425,-2301350,SELL
2020-09-18 11:26:00,11:26,9464975,6828350,-2636625,SELL
2020-09-18 11:27:00,11:27,9554750,6886625,-2668125,SELL
2020-09-18 11:28:00,11:28,9588650,6971450,-2617200,SELL
2020-09-18 11:29:00,11:29,9525800,6645025,-2880775,SELL
2020-09-18 11:30:00,11:30,9693025,7391850,-2301175,SELL
2020-09-18 11:31:00,11:31,9676950,7025125,-2651825,SELL
2020-09-18 11:32:00,11:32,9598925,7242775,-2356150,SELL
2020-09-18 11:33:00,11:33,9597175,7237075,-2360100,SELL
2020-09-18 11:34:00,11:34,9483275,7145700,-2337575,SELL
2020-09-18 11:35:00,11:35,9587200,7222550,-2364650,SELL
2020-09-18 11:36:00,11:36,9542525,6924300,-2618225,SELL
2020-09-18 11:37:00,11:37,9555875,7315700,-2240175,SELL
2020-09-18 11:38:00,11:38,9477575,6952000,-2525575,SELL
2020-09-18 11:39:00,11:39,9544675,7081350,-2463325,SELL
2020-09-18 11:40:00,11:40,9680250,6968425,-2711825,SELL
2020-09-18 11:41:00,11:41,9585100,6998225,-2586875,SELL
2020-09-18 11:42:00,11:42,9591325,7171900,-2419425,SELL
2020-09-18 11:43:00,11:43,9655625,7351700,-2303925,SELL
2020-09-18 11:44:00,11:44,9562600,7157900,-2404700,SELL
2020-09-18 11:45:00,11:45,9533925,7168925,-2365000,SELL
2020-09-18 11:46:00,11:46,9655375,7196525,-2458850,SELL
2020-09-18 11:47:00,11:47,9709325,7223400,-2485925,SELL
2020-09-18 11:48:00,11:48,9657800,6849650,-2808150,SELL
2020-09-18 11:49:00,11:49,9709000,6608725,-3100275,SELL
2020-09-18 11:50:00,11:50,9758150,7058250,-2699900,SELL
2020-09-18 11:51:00,11:51,9664950,7040625,-2624325,SELL
2020-09-18 11:52:00,11:52,9638425,6718675,-2919750,SELL
2020-09-18 11:53:00,11:53,9732150,6579175,-3152975,SELL
2020-09-18 11:54:00,11:54,9794650,7106500,-2688150,SELL
2020-09-18 11:55:00,11:55,9757850,6661900,-3095950,SELL
2020-09-18 11:56:00,11:56,9766350,6795600,-2970750,SELL
2020-09-18 11:57:00,11:57,9711450,7230950,-2480500,SELL
2020-09-18 11:58:00,11:58,9705100,6647325,-3057775,SELL
2020-09-18 11:59:00,11:59,9798300,7242225,-2556075,SELL
2020-09-18 12:00:00,12:00,9773650,6551875,-3221775,SELL
2020-09-18 12:01:00,12:01,9841375,6825775,-3015600,SELL
2020-09-18 12:02:00,12:02,9849550,7135725,-2713825,SELL
2020-09-18 12:03:00,12:03,9845550,6706000,-3139550,SELL
2020-09-18 12:04:00,12:04,9828425,7287725,-2540700,SELL
2020-09-18 12:05:00,12:05,9748475,6882050,-2866425,SELL
2020-09-18 12:06:00,12:06,9845325,7121925,-2723400,SELL
2020-09-18 12:07:00,12:07,9818800,6870625,-2948175,SELL
2020-09-18 12:08:00,12:08,9923075,6459075,-3464000,SELL
2020-09-18 12:09:00,12:09,9623825,6579800,-3044025,SELL
2020-09-18 12:10:00,12:10,9902175,7277475,-2624700,SELL
2020-09-18 12:11:00,12:11,9886025,6606200,-3279825,SELL
2020-09-18 12:12:00,12:12,9933650,6864050,-3069600,SELL
2020-09-18 12:13:00,12:13,9770625,6154475,-3616150,SELL
2020-09-18 12:14:00,12:14,10001025,7028875,-2972150,SELL
2020-09-18 12:15:00,12:15,9874200,7155475,-2718725,SELL
2020-09-18 12:16:00,12:16,9944900,7097425,-2847475,SELL
2020-09-18 12:17:00,12:17,10048425,7205600,-2842825,SELL
2020-09-18 12:18:00,12:18,10100800,7603400,-2497400,SELL
2020-09-18 12:19:00,12:19,10009625,7261975,-2747650,SELL
2020-09-18 12:20:00,12:20,10048425,7336250,-2712175,SELL
2020-09-18 12:21:00,12:21,9888500,7368350,-2520150,SELL
2020-09-18 12:22:00,12:22,8924400,6973250,-1951150,SELL
2020-09-18 12:23:00,12:23,9787400,6965300,-2822100,SELL
2020-09-18 12:24:00,12:24,9631975,7203500,-2428475,SELL
2020-09-18 12:25:00,12:25,10167900,6975725,-3192175,SELL
2020-09-18 12:26:00,12:26,10234650,7470175,-2764475,SELL
2020-09-18 12:27:00,12:27,9662575,7382375,-2280200,SELL
2020-09-18 12:28:00,12:28,9877275,7211150,-2666125,SELL
2020-09-18 12:29:00,12:29,10033950,7296950,-2737000,SELL
2020-09-18 12:30:00,12:30,9803075,7262150,-2540925,SELL
2020-09-18 12:31:00,12:31,9795250,7009775,-2785475,SELL
2020-09-18 12:32:00,12:32,9737400,7252400,-2485000,SELL
2020-09-18 12:33:00,12:33,9684425,7244275,-2440150,SELL
2020-09-18 12:34:00,12:34,10129275,7256200,-2873075,SELL
2020-09-18 12:35:00,12:35,10159800,7457525,-2702275,SELL
2020-09-18 12:36:00,12:36,9748625,6997625,-2751000,SELL
2020-09-18 12:37:00,12:37,9821325,7285275,-2536050,SELL
2020-09-18 12:38:00,12:38,9978500,7271050,-2707450,SELL
2020-09-18 12:39:00,12:39,10293650,7504700,-2788950,SELL
2020-09-18 12:40:00,12:40,10290875,7717200,-2573675,SELL
2020-09-18 12:41:00,12:41,10376925,7110625,-3266300,SELL
2020-09-18 12:42:00,12:42,10212725,7522625,-2690100,SELL
2020-09-18 12:43:00,12:43,10343700,7368725,-2974975,SELL
2020-09-18 12:44:00,12:44,10251250,7535675,-2715575,SELL
2020-09-18 12:45:00,12:45,10497625,7775575,-2722050,SELL
2020-09-18 12:46:00,12:46,10459125,7355375,-3103750,SELL
2020-09-18 12:47:00,12:47,10393825,7600225,-2793600,SELL
2020-09-18 12:48:00,12:48,10365200,7209350,-3155850,SELL
2020-09-18 12:49:00,12:49,10579450,7621850,-2957600,SELL
2020-09-18 12:50:00,12:50,10445400,6935300,-3510100,SELL
2020-09-18 12:51:00,12:51,10532200,7732450,-2799750,SELL
2020-09-18 12:52:00,12:52,10366300,7648000,-2718300,SELL
2020-09-18 12:53:00,12:53,10459100,7683000,-2776100,SELL
2020-09-18 12:54:00,12:54,10465175,7224075,-3241100,SELL
2020-09-18 12:55:00,12:55,10492250,7510700,-2981550,SELL
2020-09-18 12:56:00,12:56,10330575,7656500,-2674075,SELL
2020-09-18 12:57:00,12:57,10372200,7541725,-2830475,SELL
2020-09-18 12:58:00,12:58,10536575,7939525,-2597050,SELL
2020-09-18 12:59:00,12:59,10424550,7553400,-2871150,SELL
2020-09-18 13:00:00,13:00,10536150,7615425,-2920725,SELL
2020-09-18 13:01:00,13:01,10536250,7513750,-3022500,SELL
2020-09-18 13:02:00,13:02,10456875,7590800,-2866075,SELL
2020-09-18 13:03:00,13:03,10571325,7337750,-3233575,SELL
2020-09-18 13:04:00,13:04,10599825,7895975,-2703850,SELL
2020-09-18 13:05:00,13:05,10429275,7785575,-2643700,SELL
2020-09-18 13:06:00,13:06,10471625,7569500,-2902125,SELL
2020-09-18 13:07:00,13:07,10582325,7615325,-2967000,SELL
2020-09-18 13:08:00,13:08,10599950,7781575,-2818375,SELL
2020-09-18 13:09:00,13:09,10421875,7738550,-2683325,SELL
2020-09-18 13:10:00,13:10,10495000,7500275,-2994725,SELL
2020-09-18 13:11:00,13:11,10721500,7968875,-2752625,SELL
2020-09-18 13:12:00,13:12,10619950,7786975,-2832975,SELL
2020-09-18 13:13:00,13:13,10617675,7779425,-2838250,SELL
2020-09-18 13:14:00,13:14,10592775,7781875,-2810900,SELL
2020-09-18 13:15:00,13:15,10502575,8007350,-2495225,SELL
2020-09-18 13:16:00,13:16,10698250,7627425,-3070825,SELL
2020-09-18 13:17:00,13:17,10614075,7620550,-2993525,SELL
2020-09-18 13:18:00,13:18,10495975,7687375,-2808600,SELL
2020-09-18 13:19:00,13:19,10358900,7780600,-2578300,SELL
2020-09-18 13:20:00,13:20,10559100,7174350,-3384750,SELL
2020-09-18 13:21:00,13:21,10391875,7441950,-2949925,SELL
2020-09-18 13:22:00,13:22,10393975,7991975,-2402000,SELL
2020-09-18 13:23:00,13:23,10163375,7507425,-2655950,SELL
2020-09-18 13:24:00,13:24,10570125,7746975,-2823150,SELL
2020-09-18 13:25:00,13:25,10821525,8041250,-2780275,SELL
2020-09-18 13:26:00,13:26,10572600,7869925,-2702675,SELL
2020-09-18 13:27:00,13:27,10475875,7708725,-2767150,SELL
2020-09-18 13:28:00,13:28,10511975,7879425,-2632550,SELL
2020-09-18 13:29:00,13:29,10446025,7434425,-3011600,SELL
2020-09-18 13:30:00,13:30,10534525,7745225,-2789300,SELL
2020-09-18 13:31:00,13:31,10594600,7707600,-2887000,SELL
2020-09-18 13:32:00,13:32,10098600,7839475,-2259125,SELL
2020-09-18 13:33:00,13:33,10486425,7734875,-2751550,SELL
2020-09-18 13:34:00,13:34,10310000,8022400,-2287600,SELL
2020-09-18 13:35:00,13:35,10533900,7787125,-2746775,SELL
2020-09-18 13:36:00,13:36,10338700,7747675,-2591025,SELL
2020-09-18 13:37:00,13:37,10761450,7746275,-3015175,SELL
2020-09-18 13:38:00,13:38,10671800,7498975,-3172825,SELL
2020-09-18 13:39:00,13:39,9940475,7782300,-2158175,SELL
2020-09-18 13:40:00,13:40,10485000,7736975,-2748025,SELL
2020-09-18 13:41:00,13:41,10699925,7654950,-3044975,SELL
2020-09-18 13:42:00,13:42,10832150,7882925,-2949225,SELL
2020-09-18 13:43:00,13:43,10571200,7817600,-2753600,SELL
2020-09-18 13:44:00,13:44,10381125,7782600,-2598525,SELL
2020-09-18 13:45:00,13:45,10814075,8339075,-2475000,SELL
2020-09-18 13:46:00,13:46,10760175,8060200,-2699975,SELL
2020-09-18 13:47:00,13:47,10482075,8026600,-2455475,SELL
2020-09-18 13:48:00,13:48,10651575,7794850,-2856725,SELL
2020-09-18 13:49:00,13:49,10214350,8006450,-2207900,SELL
2020-09-18 13:50:00,13:50,10733925,7974975,-2758950,SELL
2020-09-18 13:51:00,13:51,10604800,7878900,-2725900,SELL
2020-09-18 13:52:00,13:52,10692800,7838800,-2854000,SELL
2020-09-18 13:53:00,13:53,10597100,8025725,-2571375,SELL
2020-09-18 13:54:00,13:54,10654850,7961575,-2693275,SELL
2020-09-18 13:55:00,13:55,10339025,7751200,-2587825,SELL
2020-09-18 13:56:00,13:56,10712250,8043175,-2669075,SELL
2020-09-18 13:57:00,13:57,10809300,8213000,-2596300,SELL
2020-09-18 13:58:00,13:58,10755525,7768700,-2986825,SELL
2020-09-18 13:59:00,13:59,10675825,7757850,-2917975,SELL
2020-09-18 14:00:00,14:00,10848950,7948100,-2900850,SELL
2020-09-18 14:01:00,14:01,10765225,7782900,-2982325,SELL
2020-09-18 14:02:00,14:02,10432175,7970850,-2461325,SELL
2020-09-18 14:03:00,14:03,10673400,7744300,-2929100,SELL
2020-09-18 14:04:00,14:04,10858350,7918075,-2940275,SELL
2020-09-18 14:05:00,14:05,10335675,7753350,-2582325,SELL
2020-09-18 14:06:00,14:06,10695200,8073500,-2621700,SELL
2020-09-18 14:07:00,14:07,10560800,7918825,-2641975,SELL
2020-09-18 14:08:00,14:08,10883625,7795300,-3088325,SELL
2020-09-18 14:09:00,14:09,10650525,7943375,-2707150,SELL
2020-09-18 14:10:00,14:10,10870725,7789100,-3081625,SELL
2020-09-18 14:11:00,14:11,10070525,7764050,-2306475,SELL
2020-09-18 14:12:00,14:12,10954850,7916850,-3038000,SELL
2020-09-18 14:13:00,14:13,10803000,7144175,-3658825,SELL
2020-09-18 14:14:00,14:14,10906200,7101925,-3804275,SELL
2020-09-18 14:15:00,14:15,11040150,8064425,-2975725,SELL
2020-09-18 14:16:00,14:16,10911275,7655275,-3256000,SELL
2020-09-18 14:17:00,14:17,10947775,8033525,-2914250,SELL
2020-09-18 14:18:00,14:18,11068050,8062150,-3005900,SELL
2020-09-18 14:19:00,14:19,11031475,7934575,-3096900,SELL
2020-09-18 14:20:00,14:20,11118950,8246600,-2872350,SELL
2020-09-18 14:21:00,14:21,11184100,7989525,-3194575,SELL
2020-09-18 14:22:00,14:22,11189725,7949350,-3240375,SELL
2020-09-18 14:23:00,14:23,11142250,7924025,-3218225,SELL
2020-09-18 14:24:00,14:24,11002700,7640350,-3362350,SELL
2020-09-18 14:25:00,14:25,11001300,7660275,-3341025,SELL
2020-09-18 14:26:00,14:26,11033425,7378450,-3654975,SELL
2020-09-18 14:27:00,14:27,11030950,7615825,-3415125,SELL
2020-09-18 14:28:00,14:28,10964300,7526700,-3437600,SELL
2020-09-18 14:29:00,14:29,10972750,7491225,-3481525,SELL
2020-09-18 14:30:00,14:30,11045100,7450225,-3594875,SELL
2020-09-18 14:31:00,14:31,11016800,7479675,-3537125,SELL
2020-09-18 14:32:00,14:32,11018300,7520650,-3497650,SELL
2020-09-18 14:33:00,14:33,11087000,7526900,-3560100,SELL
2020-09-18 14:34:00,14:34,11093875,7559400,-3534475,SELL
2020-09-18 14:35:00,14:35,11069850,7535925,-3533925,SELL
2020-09-18 14:36:00,14:36,11189450,7583025,-3606425,SELL
2020-09-18 14:37:00,14:37,11198850,7619950,-3578900,SELL
2020-09-18 14:38:00,14:38,11222825,7560000,-3662825,SELL
2020-09-18 14:39:00,14:39,11294225,7309950,-3984275,SELL
2020-09-18 14:40:00,14:40,11289125,7550450,-3738675,SELL
2020-09-18 14:41:00,14:41,11290200,7309175,-3981025,SELL
2020-09-18 14:42:00,14:42,11379700,7416850,-3962850,SELL
2020-09-18 14:43:00,14:43,11358550,7233675,-4124875,SELL
2020-09-18 14:44:00,14:44,11389100,7524675,-3864425,SELL
2020-09-18 14:45:00,14:45,11547225,7502850,-4044375,SELL
2020-09-18 14:46:00,14:46,11541425,7605975,-3935450,SELL
2020-09-18 14:47:00,14:47,11494175,7495875,-3998300,SELL
2020-09-18 14:48:00,14:48,11479650,7519900,-3959750,SELL
2020-09-18 14:49:00,14:49,11517300,7531500,-3985800,SELL
2020-09-18 14:50:00,14:50,11510775,7470850,-4039925,SELL
2020-09-18 14:51:00,14:51,11297200,7604475,-3692725,SELL
2020-09-18 14:52:00,14:52,11249275,7361625,-3887650,SELL
2020-09-18 14:53:00,14:53,11100775,7365500,-3735275,SELL
2020-09-18 14:54:00,14:54,11219675,7394250,-3825425,SELL
2020-09-18 14:55:00,14:55,11215675,7440475,-3775200,SELL
2020-09-18 14:56:00,14:56,11198150,7322850,-3875300,SELL
2020-09-18 14:57:00,14:57,11137650,7470450,-3667200,SELL
2020-09-18 14:58:00,14:58,11095350,7437375,-3657975,SELL
2020-09-18 14:59:00,14:59,11122450,7463650,-3658800,SELL
2020-09-18 15:00:00,15:00,11041500,7534050,-3507450,SELL
2020-09-18 15:01:00,15:01,11074850,7406575,-3668275,SELL
2020-09-18 15:02:00,15:02,11083325,7301100,-3782225,SELL
2020-09-18 15:03:00,15:03,11004825,7506250,-3498575,SELL
2020-09-18 15:04:00,15:04,11063500,7154500,-3909000,SELL
2020-09-18 15:05:00,15:05,11057600,7533850,-3523750,SELL
2020-09-18 15:06:00,15:06,11043100,7422225,-3620875,SELL
2020-09-18 15:07:00,15:07,11048875,7580550,-3468325,SELL
2020-09-18 15:08:00,15:08,11038850,7519250,-3519600,SELL
2020-09-18 15:09:00,15:09,11008400,7229050,-3779350,SELL
2020-09-18 15:10:00,15:10,11054550,7357600,-3696950,SELL
2020-09-18 15:11:00,15:11,11086800,7177100,-3909700,SELL
2020-09-18 15:12:00,15:12,10918600,7349150,-3569450,SELL
2020-09-18 15:13:00,15:13,10931675,6950050,-3981625,SELL
2020-09-18 15:14:00,15:14,10916725,7361200,-3555525,SELL
2020-09-18 15:15:00,15:15,10851475,7048050,-3803425,SELL
2020-09-18 15:16:00,15:16,10869275,7199075,-3670200,SELL
2020-09-18 15:17:00,15:17,10855575,7071700,-3783875,SELL
2020-09-18 15:18:00,15:18,10801075,7218550,-3582525,SELL
2020-09-18 15:19:00,15:19,10770425,7194475,-3575950,SELL
2020-09-18 15:20:00,15:20,10844225,7184225,-3660000,SELL
2020-09-18 15:21:00,15:21,10645700,7148275,-3497425,SELL
2020-09-18 15:22:00,15:22,10642250,7037050,-3605200,SELL
2020-09-18 15:23:00,15:23,10600975,6880900,-3720075,SELL
2020-09-18 15:24:00,15:24,10617025,6977700,-3639325,SELL
2020-09-18 15:25:00,15:25,10594125,6985550,-3608575,SELL
2020-09-18 15:26:00,15:26,10544825,6788775,-3756050,SELL
2020-09-18 15:27:00,15:27,10426750,6891650,-3535100,SELL
2020-09-18 15:28:00,15:28,10416325,6944650,-3471675,SELL
2020-09-18 15:29:00,15:29,10463800,6896200,-3567600,SELL
2020-09-21 09:15:00,09:15,9981250,6577200,-3404050,SELL
2020-09-21 09:16:00,09:16,9924700,6414825,-3509875,SELL
2020-09-21 09:17:00,09:17,10252975,6875800,-3377175,SELL
2020-09-21 09:18:00,09:18,10143375,6673200,-3470175,SELL
2020-09-21 09:19:00,09:19,10265925,6718100,-3547825,SELL
2020-09-21 09:20:00,09:20,10587775,7189675,-3398100,SELL
2020-09-21 09:21:00,09:21,10609000,7150800,-3458200,SELL
2020-09-21 09:22:00,09:22,10594425,7056675,-3537750,SELL
2020-09-21 09:23:00,09:23,10712100,7295875,-3416225,SELL
2020-09-21 09:24:00,09:24,10675750,7211675,-3464075,SELL
2020-09-21 09:25:00,09:25,10704125,7350675,-3353450,SELL
2020-09-21 09:26:00,09:26,10638325,7314300,-3324025,SELL
2020-09-21 09:27:00,09:27,10767025,7303900,-3463125,SELL
2020-09-21 09:28:00,09:28,10860675,7260975,-3599700,SELL
2020-09-21 09:29:00,09:29,10867425,7201300,-3666125,SELL
2020-09-21 09:30:00,09:30,10748000,7442950,-3305050,SELL
2020-09-21 09:31:00,09:31,10815000,7193025,-3621975,SELL
2020-09-21 09:32:00,09:32,10972500,7353400,-3619100,SELL
2020-09-21 09:33:00,09:33,10903425,7264800,-3638625,SELL
2020-09-21 09:34:00,09:34,10875225,7401950,-3473275,SELL
2020-09-21 09:35:00,09:35,10948275,7402750,-3545525,SELL
2020-09-21 09:36:00,09:36,10865075,7131025,-3734050,SELL
2020-09-21 09:37:00,09:37,10753025,7210250,-3542775,SELL
2020-09-21 09:38:00,09:38,10702225,7351250,-3350975,SELL
2020-09-21 09:39:00,09:39,10459200,7340125,-3119075,SELL
2020-09-21 09:40:00,09:40,10827975,7492200,-3335775,SELL
2020-09-21 09:41:00,09:41,10644075,7465850,-3178225,SELL
2020-09-21 09:42:00,09:42,10843525,7432025,-3411500,SELL
2020-09-21 09:43:00,09:43,10747750,7548350,-3199400,SELL
2020-09-21 09:44:00,09:44,10803325,7519550,-3283775,SELL
2020-09-21 09:45:00,09:45,10741175,7505475,-3235700,SELL
2020-09-21 09:46:00,09:46,10936425,7427975,-3508450,SELL
2020-09-21 09:47:00,09:47,11026575,7632525,-3394050,SELL
2020-09-21 09:48:00,09:48,10966175,7743400,-3222775,SELL
2020-09-21 09:49:00,09:49,10903250,7320350,-3582900,SELL
2020-09-21 09:50:00,09:50,10752000,7731525,-3020475,SELL
2020-09-21 09:51:00,09:51,10850200,7632000,-3218200,SELL
2020-09-21 09:52:00,09:52,10881850,7675200,-3206650,SELL
2020-09-21 09:53:00,09:53,10717250,7562650,-3154600,SELL
2020-09-21 09:54:00,09:54,10726725,7794725,-2932000,SELL
2020-09-21 09:55:00,09:55,10705225,7527675,-3177550,SELL
2020-09-21 09:56:00,09:56,10970175,7459025,-3511150,SELL
2020-09-21 09:57:00,09:57,10896375,7767550,-3128825,SELL
2020-09-21 09:58:00,09:58,10905325,7598950,-3306375,SELL
2020-09-21 09:59:00,09:59,11080500,7664250,-3416250,SELL
2020-09-21 10:00:00,10:00,11149225,7727425,-3421800,SELL
2020-09-21 10:01:00,10:01,10909850,7688850,-3221000,SELL
2020-09-21 10:02:00,10:02,11085525,7858075,-3227450,SELL
2020-09-21 10:03:00,10:03,11036625,7707025,-3329600,SELL
2020-09-21 10:04:00,10:04,10932725,7733300,-3199425,SELL
2020-09-21 10:05:00,10:05,11016850,8048300,-2968550,SELL
2020-09-21 10:06:00,10:06,11006750,7818150,-3188600,SELL
2020-09-21 10:07:00,10:07,11222875,7762025,-3460850,SELL
2020-09-21 10:08:00,10:08,11233250,7760250,-3473000,SELL
2020-09-21 10:09:00,10:09,11257850,7845950,-3411900,SELL
2020-09-21 10:10:00,10:10,11291800,7961750,-3330050,SELL
2020-09-21 10:11:00,10:11,11179675,8006575,-3173100,SELL
2020-09-21 10:12:00,10:12,11398750,7913150,-3485600,SELL
2020-09-21 10:13:00,10:13,11287275,7998475,-3288800,SELL
2020-09-21 10:14:00,10:14,11372425,7923375,-3449050,SELL
2020-09-21 10:15:00,10:15,11292100,8090475,-3201625,SELL
2020-09-21 10:16:00,10:16,11370400,7961000,-3409400,SELL
2020-09-21 10:17:00,10:17,11373750,8045925,-3327825,SELL
2020-09-21 10:18:00,10:18,11256850,7720425,-3536425,SELL
2020-09-21 10:19:00,10:19,11075000,7663125,-3411875,SELL
2020-09-21 10:20:00,10:20,11415900,8142150,-3273750,SELL
2020-09-21 10:21:00,10:21,11481925,8311300,-3170625,SELL
2020-09-21 10:22:00,10:22,11435425,8175600,-3259825,SELL
2020-09-21 10:23:00,10:23,11296225,8355075,-2941150,SELL
2020-09-21 10:24:00,10:24,11296300,7893850,-3402450,SELL
2020-09-21 10:25:00,10:25,11385375,8371075,-3014300,SELL
2020-09-21 10:26:00,10:26,10995025,8042650,-2952375,SELL
2020-09-21 10:27:00,10:27,10989850,8014525,-2975325,SELL
2020-09-21 10:28:00,10:28,10963375,8021050,-2942325,SELL
2020-09-21 10:29:00,10:29,10999875,8037550,-2962325,SELL
2020-09-21 10:30:00,10:30,11232350,7923650,-3308700,SELL
2020-09-21 10:31:00,10:31,11234875,8098675,-3136200,SELL
2020-09-21 10:32:00,10:32,11223300,7969675,-3253625,SELL
2020-09-21 10:33:00,10:33,11165875,7951375,-3214500,SELL
2020-09-21 10:34:00,10:34,11202675,8123900,-3078775,SELL
2020-09-21 10:35:00,10:35,11011125,7993100,-3018025,SELL
2020-09-21 10:36:00,10:36,11121625,8348925,-2772700,SELL
2020-09-21 10:37:00,10:37,11198350,8053525,-3144825,SELL
2020-09-21 10:38:00,10:38,11202725,8166725,-3036000,SELL
2020-09-21 10:39:00,10:39,11181250,8029625,-3151625,SELL
2020-09-21 10:40:00,10:40,11198925,8237500,-2961425,SELL
2020-09-21 10:41:00,10:41,11046575,8200975,-2845600,SELL
2020-09-21 10:42:00,10:42,10998675,8146300,-2852375,SELL
2020-09-21 10:43:00,10:43,11188000,8146175,-3041825,SELL
2020-09-21 10:44:00,10:44,10845150,8165800,-2679350,SELL
2020-09-21 10:45:00,10:45,11023625,8064025,-2959600,SELL
2020-09-21 10:46:00,10:46,10976825,7932125,-3044700,SELL
2020-09-21 10:47:00,10:47,11270550,8214900,-3055650,SELL
2020-09-21 10:48:00,10:48,11117575,8300450,-2817125,SELL
2020-09-21 10:49:00,10:49,11076675,8151175,-2925500,SELL
2020-09-21 10:50:00,10:50,11123325,8066150,-3057175,SELL
2020-09-21 10:51:00,10:51,11166375,8249300,-2917075,SELL
2020-09-21 10:52:00,10:52,11001075,8253450,-2747625,SELL
2020-09-21 10:53:00,10:53,11317175,8285900,-3031275,SELL
2020-09-21 10:54:00,10:54,11139100,7812725,-3326375,SELL
2020-09-21 10:55:00,10:55,11011100,8186675,-2824425,SELL
2020-09-21 10:56:00,10:56,11275800,8094100,-3181700,SELL
2020-09-21 10:57:00,10:57,11309775,8311050,-2998725,SELL
2020-09-21 10:58:00,10:58,10801150,8042225,-2758925,SELL
2020-09-21 10:59:00,10:59,11310250,8296475,-3013775,SELL
2020-09-21 11:00:00,11:00,11308725,8176550,-3132175,SELL
2020-09-21 11:01:00,11:01,11256000,8151275,-3104725,SELL
2020-09-21 11:02:00,11:02,11105100,8305775,-2799325,SELL
2020-09-21 11:03:00,11:03,11304150,8446575,-2857575,SELL
2020-09-21 11:04:00,11:04,11345550,8506825,-2838725,SELL
2020-09-21 11:05:00,11:05,11247025,8305850,-2941175,SELL
2020-09-21 11:06:00,11:06,11305650,8379750,-2925900,SELL
2020-09-21 11:07:00,11:07,11244750,8467250,-2777500,SELL
2020-09-21 11:08:00,11:08,11028700,7951525,-3077175,SELL
2020-09-21 11:09:00,11:09,11337625,8557075,-2780550,SELL
2020-09-21 11:10:00,11:10,10776725,8452750,-2323975,SELL
2020-09-21 11:11:00,11:11,10859825,8194500,-2665325,SELL
2020-09-21 11:12:00,11:12,10557525,7899000,-2658525,SELL
2020-09-21 11:13:00,11:13,10966050,8101300,-2864750,SELL
2020-09-21 11:14:00,11:14,11239100,8310525,-2928575,SELL
2020-09-21 11:15:00,11:15,11152075,8302225,-2849850,SELL
2020-09-21 11:16:00,11:16,11303800,8295300,-3008500,SELL
2020-09-21 11:17:00,11:17,10997475,8132150,-2865325,SELL
2020-09-21 11:18:00,11:18,11297975,8352100,-2945875,SELL
2020-09-21 11:19:00,11:19,10819300,8093300,-2726000,SELL
2020-09-21 11:20:00,11:20,11237100,8375350,-2861750,SELL
2020-09-21 11:21:00,11:21,11366900,8198025,-3168875,SELL
2020-09-21 11:22:00,11:22,11345350,8424450,-2920900,SELL
2020-09-21 11:23:00,11:23,11381750,8218800,-3162950,SELL
2020-09-21 11:24:00,11:24,11307050,8191325,-3115725,SELL
2020-09-21 11:25:00,11:25,11323250,8280275,-3042975,SELL
2020-09-21 11:26:00,11:26,11371125,7962075,-3409050,SELL
2020-09-21 11:27:00,11:27,11407125,8398300,-3008825,SELL
2020-09-21 11:28:00,11:28,11044975,8267450,-2777525,SELL
2020-09-21 11:29:00,11:29,10840950,7930300,-2910650,SELL
2020-09-21 11:30:00,11:30,11117400,8142800,-2974600,SELL
2020-09-21 11:31:00,11:31,11300175,8103350,-3196825,SELL
2020-09-21 11:32:00,11:32,11431350,8103575,-3327775,SELL
2020-09-21 11:33:00,11:33,11381125,8323775,-3057350,SELL
2020-09-21 11:34:00,11:34,11147650,8338025,-2809625,SELL
2020-09-21 11:35:00,11:35,11065975,8259525,-2806450,SELL
2020-09-21 11:36:00,11:36,11465525,8454550,-3010975,SELL
2020-09-21 11:37:00,11:37,10949075,8217925,-2731150,SELL
2020-09-21 11:38:00,11:38,11025800,8171100,-2854700,SELL
2020-09-21 11:39:00,11:39,11431725,8452525,-2979200,SELL
2020-09-21 11:40:00,11:40,11251625,8451075,-2800550,SELL
2020-09-21 11:41:00,11:41,11461250,8723425,-2737825,SELL
2020-09-21 11:42:00,11:42,10260800,8422025,-1838775,SELL
2020-09-21 11:43:00,11:43,10880650,8392150,-2488500,SELL
2020-09-21 11:44:00,11:44,11211300,8100800,-3110500,SELL
2020-09-21 11:45:00,11:45,10980300,8286850,-2693450,SELL
2020-09-21 11:46:00,11:46,10589000,8196900,-2392100,SELL
2020-09-21 11:47:00,11:47,10658150,7798850,-2859300,SELL
2020-09-21 11:48:00,11:48,10990875,7996600,-2994275,SELL
2020-09-21 11:49:00,11:49,11464200,8589500,-2874700,SELL
2020-09-21 11:50:00,11:50,11265675,8396550,-2869125,SELL
2020-09-21 11:51:00,11:51,10453925,8607200,-1846725,SELL
2020-09-21 11:52:00,11:52,11306050,8508225,-2797825,SELL
2020-09-21 11:53:00,11:53,11183350,7527125,-3656225,SELL
2020-09-21 11:54:00,11:54,11120850,8354900,-2765950,SELL
2020-09-21 11:55:00,11:55,11277225,8517500,-2759725,SELL
2020-09-21 11:56:00,11:56,11172275,8345025,-2827250,SELL
2020-09-21 11:57:00,11:57,10902175,8347975,-2554200,SELL
2020-09-21 11:58:00,11:58,11304250,8380000,-2924250,SELL
2020-09-21 11:59:00,11:59,10769700,8336250,-2433450,SELL
2020-09-21 12:00:00,12:00,11536525,8673775,-2862750,SELL
2020-09-21 12:01:00,12:01,10946275,8401700,-2544575,SELL
2020-09-21 12:02:00,12:02,11320600,8448650,-2871950,SELL
2020-09-21 12:03:00,12:03,10602725,8476300,-2126425,SELL
2020-09-21 12:04:00,12:04,10780200,8336100,-2444100,SELL
2020-09-21 12:05:00,12:05,11520475,8187550,-3332925,SELL
2020-09-21 12:06:00,12:06,10902950,8037950,-2865000,SELL
2020-09-21 12:07:00,12:07,11284050,8578250,-2705800,SELL
2020-09-21 12:08:00,12:08,10866200,8559550,-2306650,SELL
2020-09-21 12:09:00,12:09,11356025,8056200,-3299825,SELL
2020-09-21 12:10:00,12:10,10951675,8519500,-2432175,SELL
2020-09-21 12:11:00,12:11,11312925,8511725,-2801200,SELL
2020-09-21 12:12:00,12:12,11262150,8248925,-3013225,SELL
2020-09-21 12:13:00,12:13,11177325,8377925,-2799400,SELL
2020-09-21 12:14:00,12:14,11447025,8566250,-2880775,SELL
2020-09-21 12:15:00,12:15,11305200,8360600,-2944600,SELL
2020-09-21 12:16:00,12:16,11475175,8169725,-3305450,SELL
2020-09-21 12:17:00,12:17,10802525,8218600,-2583925,SELL
2020-09-21 12:18:00,12:18,11320475,8303150,-3017325,SELL
2020-09-21 12:19:00,12:19,11210225,8133025,-3077200,SELL
2020-09-21 12:20:00,12:20,11067550,8354850,-2712700,SELL
2020-09-21 12:21:00,12:21,11379125,8554150,-2824975,SELL
2020-09-21 12:22:00,12:22,10691700,8248200,-2443500,SELL
2020-09-21 12:23:00,12:23,11071350,8433600,-2637750,SELL
2020-09-21 12:24:00,12:24,11674625,8878000,-2796625,SELL
2020-09-21 12:25:00,12:25,11466350,8609775,-2856575,SELL
2020-09-21 12:26:00,12:26,10916625,8663100,-2253525,SELL
2020-09-21 12:27:00,12:27,11431550,8261300,-3170250,SELL
2020-09-21 12:28:00,12:28,11349275,8572375,-2776900,SELL
2020-09-21 12:29:00,12:29,9746525,8603375,-1143150,SELL
2020-09-21 12:30:00,12:30,11340325,8528600,-2811725,SELL
2020-09-21 12:31:00,12:31,11585275,8661825,-2923450,SELL
2020-09-21 12:32:00,12:32,11115375,8777875,-2337500,SELL
2020-09-21 12:33:00,12:33,11242175,8589525,-2652650,SELL
2020-09-21 12:34:00,12:34,11478975,8583900,-2895075,SELL
2020-09-21 12:35:00,12:35,10997275,8633925,-2363350,SELL
2020-09-21 12:36:00,12:36,11185100,8601750,-2583350,SELL
2020-09-21 12:37:00,12:37,11318950,8574925,-2744025,SELL
2020-09-21 12:38:00,12:38,11678275,8893600,-2784675,SELL
2020-09-21 12:39:00,12:39,11530300,8486275,-3044025,SELL
2020-09-21 12:40:00,12:40,11671950,8899850,-2772100,SELL
2020-09-21 12:41:00,12:41,11586200,8637875,-2948325,SELL
2020-09-21 12:42:00,12:42,11338425,8655475,-2682950,SELL
2020-09-21 12:43:00,12:43,11123900,8643775,-2480125,SELL
2020-09-21 12:44:00,12:44,11013950,8592800,-2421150,SELL
2020-09-21 12:45:00,12:45,11518375,8587825,-2930550,SELL
2020-09-21 12:46:00,12:46,11812950,8710750,-3102200,SELL
2020-09-21 12:47:00,12:47,11368725,8426950,-2941775,SELL
2020-09-21 12:48:00,12:48,11421900,8574825,-2847075,SELL
2020-09-21 12:49:00,12:49,11694425,8674350,-3020075,SELL
2020-09-21 12:50:00,12:50,11553675,8554375,-2999300,SELL
2020-09-21 12:51:00,12:51,11774150,8417375,-3356775,SELL
2020-09-21 12:52:00,12:52,11075425,8346775,-2728650,SELL
2020-09-21 12:53:00,12:53,11541475,8572975,-2968500,SELL
2020-09-21 12:54:00,12:54,11500950,8697650,-2803300,SELL
2020-09-21 12:55:00,12:55,11810575,8595875,-3214700,SELL
2020-09-21 12:56:00,12:56,11598775,8719275,-2879500,SELL
2020-09-21 12:57:00,12:57,11265900,8564450,-2701450,SELL
2020-09-21 12:58:00,12:58,11583800,8461800,-3122000,SELL
2020-09-21 12:59:00,12:59,11675375,8429575,-3245800,SELL
2020-09-21 13:00:00,13:00,11597800,8556600,-3041200,SELL
2020-09-21 13:01:00,13:01,11743700,8611200,-3132500,SELL
2020-09-21 13:02:00,13:02,11547400,8595200,-2952200,SELL
2020-09-21 13:03:00,13:03,11854100,8748725,-3105375,SELL
2020-09-21 13:04:00,13:04,11536600,8738550,-2798050,SELL
2020-09-21 13:05:00,13:05,11776575,8600550,-3176025,SELL
2020-09-21 13:06:00,13:06,11437925,8571300,-2866625,SELL
2020-09-21 13:07:00,13:07,11238325,8602900,-2635425,SELL
2020-09-21 13:08:00,13:08,11546075,8305925,-3240150,SELL
2020-09-21 13:09:00,13:09,12005100,8456875,-3548225,SELL
2020-09-21 13:10:00,13:10,11877150,8587675,-3289475,SELL
2020-09-21 13:11:00,13:11,11853075,8529825,-3323250,SELL
2020-09-21 13:12:00,13:12,11902150,8301500,-3600650,SELL
2020-09-21 13:13:00,13:13,11835900,8455925,-3379975,SELL
2020-09-21 13:14:00,13:14,11840350,8393750,-3446600,SELL
2020-09-21 13:15:00,13:15,11988775,8629050,-3359725,SELL
2020-09-21 13:16:00,13:16,12092300,8175500,-3916800,SELL
2020-09-21 13:17:00,13:17,12022000,8542075,-3479925,SELL
2020-09-21 13:18:00,13:18,11631300,8311275,-3320025,SELL
2020-09-21 13:19:00,13:19,11608525,8516775,-3091750,SELL
2020-09-21 13:20:00,13:20,12019625,8256850,-3762775,SELL
2020-09-21 13:21:00,13:21,12144350,8408200,-3736150,SELL
2020-09-21 13:22:00,13:22,12061225,8217500,-3843725,SELL
2020-09-21 13:23:00,13:23,12072550,8418500,-3654050,SELL
2020-09-21 13:24:00,13:24,11902400,8227550,-3674850,SELL
2020-09-21 13:25:00,13:25,12239575,8406775,-3832800,SELL
2020-09-21 13:26:00,13:26,11495600,8420525,-3075075,SELL
2020-09-21 13:27:00,13:27,12048825,8423450,-3625375,SELL
2020-09-21 13:28:00,13:28,12031500,8261825,-3769675,SELL
2020-09-21 13:29:00,13:29,11935600,8038175,-3897425,SELL
2020-09-21 13:30:00,13:30,12149300,8416625,-3732675,SELL
2020-09-21 13:31:00,13:31,12244125,8349325,-3894800,SELL
2020-09-21 13:32:00,13:32,11389225,8501875,-2887350,SELL
2020-09-21 13:33:00,13:33,11590075,8212750,-3377325,SELL
2020-09-21 13:34:00,13:34,11567800,8193225,-3374575,SELL
2020-09-21 13:35:00,13:35,12015300,8369350,-3645950,SELL
2020-09-21 13:36:00,13:36,11879625,8197075,-3682550,SELL
2020-09-21 13:37:00,13:37,12058300,8393325,-3664975,SELL
2020-09-21 13:38:00,13:38,11743025,8396100,-3346925,SELL
2020-09-21 13:39:00,13:39,12447625,8600750,-3846875,SELL
2020-09-21 13:40:00,13:40,12314850,8452700,-3862150,SELL
2020-09-21 13:41:00,13:41,12471500,8319050,-4152450,SELL
2020-09-21 13:42:00,13:42,12260725,8023850,-4236875,SELL
2020-09-21 13:43:00,13:43,12121450,8166675,-3954775,SELL
2020-09-21 13:44:00,13:44,12043950,7934425,-4109525,SELL
2020-09-21 13:45:00,13:45,12229900,8023300,-4206600,SELL
2020-09-21 13:46:00,13:46,12299300,8158025,-4141275,SELL
2020-09-21 13:47:00,13:47,12163375,8036550,-4126825,SELL
2020-09-21 13:48:00,13:48,11920225,8131950,-3788275,SELL
2020-09-21 13:49:00,13:49,12312200,8195250,-4116950,SELL
2020-09-21 13:50:00,13:50,12351700,7846625,-4505075,SELL
2020-09-21 13:51:00,13:51,12148975,7757125,-4391850,SELL
2020-09-21 13:52:00,13:52,12409925,8173125,-4236800,SELL
2020-09-21 13:53:00,13:53,12504975,8122950,-4382025,SELL
2020-09-21 13:54:00,13:54,12510725,7948825,-4561900,SELL
2020-09-21 13:55:00,13:55,12389650,7918350,-4471300,SELL
2020-09-21 13:56:00,13:56,12617475,7957650,-4659825,SELL
2020-09-21 13:57:00,13:57,12604825,7900725,-4704100,SELL
2020-09-21 13:58:00,13:58,12658725,7751700,-4907025,SELL
2020-09-21 13:59:00,13:59,12364950,7728325,-4636625,SELL
2020-09-21 14:00:00,14:00,12494225,7926225,-4568000,SELL
2020-09-21 14:01:00,14:01,12691700,7910250,-4781450,SELL
2020-09-21 14:02:00,14:02,12561975,7760200,-4801775,SELL
2020-09-21 14:03:00,14:03,12615150,8041525,-4573625,SELL
2020-09-21 14:04:00,14:04,12557125,7623650,-4933475,SELL
2020-09-21 14:05:00,14:05,12579350,7826025,-4753325,SELL
2020-09-21 14:06:00,14:06,12460950,7809725,-4651225,SELL
2020-09-21 14:07:00,14:07,12264625,7575975,-4688650,SELL
2020-09-21 14:08:00,14:08,12391225,7868875,-4522350,SELL
2020-09-21 14:09:00,14:09,12713800,7602950,-5110850,SELL
2020-09-21 14:10:00,14:10,12634075,7688075,-4946000,SELL
2020-09-21 14:11:00,14:11,12598925,7400700,-5198225,SELL
2020-09-21 14:12:00,14:12,12589225,7626250,-4962975,SELL
2020-09-21 14:13:00,14:13,12783450,7519200,-5264250,SELL
2020-09-21 14:14:00,14:14,12367900,7673225,-4694675,SELL
2020-09-21 14:15:00,14:15,12644425,7631950,-5012475,SELL
2020-09-21 14:16:00,14:16,12765250,7583025,-5182225,SELL
2020-09-21 14:17:00,14:17,12606250,7559300,-5046950,SELL
2020-09-21 14:18:00,14:18,12596025,7251425,-5344600,SELL
2020-09-21 14:19:00,14:19,12906375,7424450,-5481925,SELL
2020-09-21 14:20:00,14:20,12772350,7227550,-5544800,SELL
2020-09-21 14:21:00,14:21,12675350,7221900,-5453450,SELL
2020-09-21 14:22:00,14:22,12843175,7381275,-5461900,SELL
2020-09-21 14:23:00,14:23,12422850,7257475,-5165375,SELL
2020-09-21 14:24:00,14:24,12813700,7250250,-5563450,SELL
2020-09-21 14:25:00,14:25,12826500,7285450,-5541050,SELL
2020-09-21 14:26:00,14:26,12610875,7252150,-5358725,SELL
2020-09-21 14:27:00,14:27,12716900,7220100,-5496800,SELL
2020-09-21 14:28:00,14:28,12630450,7177275,-5453175,SELL
2020-09-21 14:29:00,14:29,12681450,7284325,-5397125,SELL
2020-09-21 14:30:00,14:30,12617975,7214300,-5403675,SELL
2020-09-21 14:31:00,14:31,12727625,7246825,-5480800,SELL
2020-09-21 14:32:00,14:32,12658925,7033725,-5625200,SELL
2020-09-21 14:33:00,14:33,12587850,7385675,-5202175,SELL
2020-09-21 14:34:00,14:34,12770675,7041475,-5729200,SELL
2020-09-21 14:35:00,14:35,12823250,7339350,-5483900,SELL
2020-09-21 14:36:00,14:36,12838625,7036825,-5801800,SELL
2020-09-21 14:37:00,14:37,12824900,7183275,-5641625,SELL
2020-09-21 14:38:00,14:38,12815375,7089600,-5725775,SELL
2020-09-21 14:39:00,14:39,12842850,7274150,-5568700,SELL
2020-09-21 14:40:00,14:40,12853675,7260200,-5593475,SELL
2020-09-21 14:41:00,14:41,12836350,7342625,-5493725,SELL
2020-09-21 14:42:00,14:42,12882950,7264875,-5618075,SELL
2020-09-21 14:43:00,14:43,12891625,7096900,-5794725,SELL
2020-09-21 14:44:00,14:44,12845100,7426850,-5418250,SELL
2020-09-21 14:45:00,14:45,12837300,7241225,-5596075,SELL
2020-09-21 14:46:00,14:46,12865425,7302325,-5563100,SELL
2020-09-21 14:47:00,14:47,12834275,7319275,-5515000,SELL
2020-09-21 14:48:00,14:48,12829575,7302825,-5526750,SELL
2020-09-21 14:49:00,14:49,12843850,7248875,-5594975,SELL
2020-09-21 14:50:00,14:50,12799175,6888200,-5910975,SELL
2020-09-21 14:51:00,14:51,12894375,7058075,-5836300,SELL
2020-09-21 14:52:00,14:52,12870625,6961375,-5909250,SELL
2020-09-21 14:53:00,14:53,12820600,7234750,-5585850,SELL
2020-09-21 14:54:00,14:54,12884000,7287075,-5596925,SELL
2020-09-21 14:55:00,14:55,12857750,6926775,-5930975,SELL
2020-09-21 14:56:00,14:56,12883425,6984525,-5898900,SELL
2020-09-21 14:57:00,14:57,12731650,7210725,-5520925,SELL
2020-09-21 14:58:00,14:58,12690875,7012025,-5678850,SELL
2020-09-21 14:59:00,14:59,12635625,6957525,-5678100,SELL
2020-09-21 15:00:00,15:00,12769225,6886500,-5882725,SELL
2020-09-21 15:01:00,15:01,12763475,7264100,-5499375,SELL
2020-09-21 15:02:00,15:02,12707975,7066125,-5641850,SELL
2020-09-21 15:03:00,15:03,12613975,7110725,-5503250,SELL
2020-09-21 15:04:00,15:04,12720275,7193225,-5527050,SELL
2020-09-21 15:05:00,15:05,12730500,7375825,-5354675,SELL
2020-09-21 15:06:00,15:06,12579750,7282325,-5297425,SELL
2020-09-21 15:07:00,15:07,12478775,7198100,-5280675,SELL
2020-09-21 15:08:00,15:08,12618600,7238950,-5379650,SELL
2020-09-21 15:09:00,15:09,12578850,6985525,-5593325,SELL
2020-09-21 15:10:00,15:10,12547850,7032225,-5515625,SELL
2020-09-21 15:11:00,15:11,12501975,7125800,-5376175,SELL
2020-09-21 15:12:00,15:12,12547800,7135525,-5412275,SELL
2020-09-21 15:13:00,15:13,12509875,7038150,-5471725,SELL
2020-09-21 15:14:00,15:14,12517100,6883875,-5633225,SELL
2020-09-21 15:15:00,15:15,12514025,7104825,-5409200,SELL
2020-09-21 15:16:00,15:16,12517000,6999425,-5517575,SELL
2020-09-21 15:17:00,15:17,12537625,7161325,-5376300,SELL
2020-09-21 15:18:00,15:18,12335625,6839350,-5496275,SELL
2020-09-21 15:19:00,15:19,12385250,6772600,-5612650,SELL
2020-09-21 15:20:00,15:20,12324800,6963325,-5361475,SELL
2020-09-21 15:21:00,15:21,12196250,6836000,-5360250,SELL
2020-09-21 15:22:00,15:22,12169875,6630400,-5539475,SELL
2020-09-21 15:23:00,15:23,12207875,6908125,-5299750,SELL
2020-09-21 15:24:00,15:24,12120650,6720725,-5399925,SELL
2020-09-21 15:25:00,15:25,12047075,6901750,-5145325,SELL
2020-09-21 15:26:00,15:26,12009325,6768250,-5241075,SELL
2020-09-21 15:27:00,15:27,11986025,6499050,-5486975,SELL
2020-09-21 15:28:00,15:28,11980650,6701775,-5278875,SELL
2020-09-21 15:29:00,15:29,11998100,6717600,-5280500,SELL
2020-09-22 09:15:00,09:15,11468175,6225800,-5242375,SELL
2020-09-22 09:16:00,09:16,11550025,6358225,-5191800,SELL
2020-09-22 09:17:00,09:17,11621875,6320675,-5301200,SELL
2020-09-22 09:18:00,09:18,11667625,6547000,-5120625,SELL
2020-09-22 09:19:00,09:19,11650625,6547825,-5102800,SELL
2020-09-22 09:20:00,09:20,11805625,6931275,-4874350,SELL
2020-09-22 09:21:00,09:21,11792200,6644525,-5147675,SELL
2020-09-22 09:22:00,09:22,11811625,6745300,-5066325,SELL
2020-09-22 09:23:00,09:23,11852825,6830750,-5022075,SELL
2020-09-22 09:24:00,09:24,11970050,6993300,-4976750,SELL
2020-09-22 09:25:00,09:25,11871400,7037725,-4833675,SELL
2020-09-22 09:26:00,09:26,12131900,7392850,-4739050,SELL
2020-09-22 09:27:00,09:27,12064650,7392650,-4672000,SELL
2020-09-22 09:28:00,09:28,12118725,7391325,-4727400,SELL
2020-09-22 09:29:00,09:29,12255450,7258400,-4997050,SELL
2020-09-22 09:30:00,09:30,12212925,7050900,-5162025,SELL
2020-09-22 09:31:00,09:31,12353950,7523400,-4830550,SELL
2020-09-22 09:32:00,09:32,12422125,7737050,-4685075,SELL
2020-09-22 09:33:00,09:33,12300600,7439000,-4861600,SELL
2020-09-22 09:34:00,09:34,12292375,7725150,-4567225,SELL
2020-09-22 09:35:00,09:35,12439550,7716875,-4722675,SELL
2020-09-22 09:36:00,09:36,12405175,7681350,-4723825,SELL
2020-09-22 09:37:00,09:37,12368125,7855150,-4512975,SELL
2020-09-22 09:38:00,09:38,12222725,7848125,-4374600,SELL
2020-09-22 09:39:00,09:39,12162450,7562650,-4599800,SELL
2020-09-22 09:40:00,09:40,12409325,8074375,-4334950,SELL
2020-09-22 09:41:00,09:41,12493400,8003750,-4489650,SELL
2020-09-22 09:42:00,09:42,12529150,8191200,-4337950,SELL
2020-09-22 09:43:00,09:43,12404825,8080525,-4324300,SELL
2020-09-22 09:44:00,09:44,12600600,8139975,-4460625,SELL
2020-09-22 09:45:00,09:45,12414575,8207175,-4207400,SELL
2020-09-22 09:46:00,09:46,12556100,8202550,-4353550,SELL
2020-09-22 09:47:00,09:47,12591825,8264425,-4327400,SELL
2020-09-22 09:48:00,09:48,12568125,7990050,-4578075,SELL
2020-09-22 09:49:00,09:49,12488700,8188075,-4300625,SELL
2020-09-22 09:50:00,09:50,12708800,8566725,-4142075,SELL
2020-09-22 09:51:00,09:51,12394875,8434375,-3960500,SELL
2020-09-22 09:52:00,09:52,12774200,8367475,-4406725,SELL
2020-09-22 09:53:00,09:53,12640625,8586300,-4054325,SELL
2020-09-22 09:54:00,09:54,12682900,8280900,-4402000,SELL
2020-09-22 09:55:00,09:55,12300150,8341275,-3958875,SELL
2020-09-22 09:56:00,09:56,12600225,8146900,-4453325,SELL
2020-09-22 09:57:00,09:57,12572225,8517400,-4054825,SELL
2020-09-22 09:58:00,09:58,12552750,8446025,-4106725,SELL
2020-09-22 09:59:00,09:59,12606725,8956900,-3649825,SELL
2020-09-22 10:00:00,10:00,12690900,8861175,-3829725,SELL
2020-09-22 10:01:00,10:01,12612300,8750650,-3861650,SELL
2020-09-22 10:02:00,10:02,12557225,8658000,-3899225,SELL
2020-09-22 10:03:00,10:03,12248675,8542575,-3706100,SELL
2020-09-22 10:04:00,10:04,12560850,8829225,-3731625,SELL
2020-09-22 10:05:00,10:05,12354225,8831625,-3522600,SELL
2020-09-22 10:06:00,10:06,12784175,9117700,-3666475,SELL
2020-09-22 10:07:00,10:07,12800725,8788075,-4012650,SELL
2020-09-22 10:08:00,10:08,12370400,8591975,-3778425,SELL
2020-09-22 10:09:00,10:09,12297050,8877750,-3419300,SELL
2020-09-22 10:10:00,10:10,12381225,8623875,-3757350,SELL
2020-09-22 10:11:00,10:11,12408500,8560475,-3848025,SELL
2020-09-22 10:12:00,10:12,12424625,8590975,-3833650,SELL
2020-09-22 10:13:00,10:13,12399350,8918550,-3480800,SELL
2020-09-22 10:14:00,10:14,11869250,8848725,-3020525,SELL
2020-09-22 10:15:00,10:15,12252850,9055000,-3197850,SELL
2020-09-22 10:16:00,10:16,12289650,8898000,-3391650,SELL
2020-09-22 10:17:00,10:17,12301425,9096700,-3204725,SELL
2020-09-22 10:18:00,10:18,12289400,8512950,-3776450,SELL
2020-09-22 10:19:00,10:19,12377675,9034625,-3343050,SELL
2020-09-22 10:20:00,10:20,12504900,8902900,-3602000,SELL
2020-09-22 10:21:00,10:21,12558675,8978625,-3580050,SELL
2020-09-22 10:22:00,10:22,12477750,9022300,-3455450,SELL
2020-09-22 10:23:00,10:23,12601725,9122850,-3478875,SELL
2020-09-22 10:24:00,10:24,12068100,9071325,-2996775,SELL
2020-09-22 10:25:00,10:25,12463550,9040000,-3423550,SELL
2020-09-22 10:26:00,10:26,12502800,9354075,-3148725,SELL
2020-09-22 10:27:00,10:27,12543550,9171950,-3371600,SELL
2020-09-22 10:28:00,10:28,12441050,9431400,-3009650,SELL
2020-09-22 10:29:00,10:29,12447650,9189725,-3257925,SELL
2020-09-22 10:30:00,10:30,12396400,9244500,-3151900,SELL
2020-09-22 10:31:00,10:31,12584300,9454975,-3129325,SELL
2020-09-22 10:32:00,10:32,12443850,8812350,-3631500,SELL
2020-09-22 10:33:00,10:33,12597050,9538225,-3058825,SELL
2020-09-22 10:34:00,10:34,12548450,8988625,-3559825,SELL
2020-09-22 10:35:00,10:35,12547625,9158375,-3389250,SELL
2020-09-22 10:36:00,10:36,12643675,9029975,-3613700,SELL
2020-09-22 10:37:00,10:37,12610625,9014625,-3596000,SELL
2020-09-22 10:38:00,10:38,12582875,9096725,-3486150,SELL
2020-09-22 10:39:00,10:39,12334050,9218800,-3115250,SELL
2020-09-22 10:40:00,10:40,12522825,9097475,-3425350,SELL
2020-09-22 10:41:00,10:41,12574200,9317750,-3256450,SELL
2020-09-22 10:42:00,10:42,12645875,9154200,-3491675,SELL
2020-09-22 10:43:00,10:43,12645325,8897325,-3748000,SELL
2020-09-22 10:44:00,10:44,12548650,8918225,-3630425,SELL
2020-09-22 10:45:00,10:45,12664950,9022825,-3642125,SELL
2020-09-22 10:46:00,10:46,12534700,8950600,-3584100,SELL
2020-09-22 10:47:00,10:47,12643375,9140300,-3503075,SELL
2020-09-22 10:48:00,10:48,12649025,9674575,-2974450,SELL
2020-09-22 10:49:00,10:49,12393625,9398625,-2995000,SELL
2020-09-22 10:50:00,10:50,12729450,9205400,-3524050,SELL
2020-09-22 10:51:00,10:51,12420125,9471700,-2948425,SELL
2020-09-22 10:52:00,10:52,12187200,9506275,-2680925,SELL
2020-09-22 10:53:00,10:53,12085150,9258800,-2826350,SELL
2020-09-22 10:54:00,10:54,12771050,9151350,-3619700,SELL
2020-09-22 10:55:00,10:55,12652575,9379050,-3273525,SELL
2020-09-22 10:56:00,10:56,12575225,9245950,-3329275,SELL
2020-09-22 10:57:00,10:57,12110450,9000725,-3109725,SELL
2020-09-22 10:58:00,10:58,12699000,9386600,-3312400,SELL
2020-09-22 10:59:00,10:59,12184750,9310475,-2874275,SELL
2020-09-22 11:00:00,11:00,12864925,9583875,-3281050,SELL
2020-09-22 11:01:00,11:01,12760650,9443500,-3317150,SELL
2020-09-22 11:02:00,11:02,12250825,9378575,-2872250,SELL
2020-09-22 11:03:00,11:03,12490750,9005350,-3485400,SELL
2020-09-22 11:04:00,11:04,12377900,9284675,-3093225,SELL
2020-09-22 11:05:00,11:05,12742825,9554025,-3188800,SELL
2020-09-22 11:06:00,11:06,12732275,9265600,-3466675,SELL
2020-09-22 11:07:00,11:07,12858600,9424525,-3434075,SELL
2020-09-22 11:08:00,11:08,11480900,9337900,-2143000,SELL
2020-09-22 11:09:00,11:09,11905300,9112625,-2792675,SELL
2020-09-22 11:10:00,11:10,12378300,9380925,-2997375,SELL
2020-09-22 11:11:00,11:11,12804200,9440050,-3364150,SELL
2020-09-22 11:12:00,11:12,12860325,9414175,-3446150,SELL
2020-09-22 11:13:00,11:13,12597975,9786850,-2811125,SELL
2020-09-22 11:14:00,11:14,12771275,9473425,-3297850,SELL
2020-09-22 11:15:00,11:15,12926225,9759925,-3166300,SELL
2020-09-22 11:16:00,11:16,12671050,9419700,-3251350,SELL
2020-09-22 11:17:00,11:17,12994325,9487800,-3506525,SELL
2020-09-22 11:18:00,11:18,12660300,9040850,-3619450,SELL
2020-09-22 11:19:00,11:19,12601850,9108250,-3493600,SELL
2020-09-22 11:20:00,11:20,12804825,9430725,-3374100,SELL
2020-09-22 11:21:00,11:21,12523125,9491825,-3031300,SELL
2020-09-22 11:22:00,11:22,12642125,9096400,-3545725,SELL
2020-09-22 11:23:00,11:23,12931425,9349100,-3582325,SELL
2020-09-22 11:24:00,11:24,12485375,9341050,-3144325,SELL
2020-09-22 11:25:00,11:25,12774150,9299100,-3475050,SELL
2020-09-22 11:26:00,11:26,12153975,9654050,-2499925,SELL
2020-09-22 11:27:00,11:27,11795075,9212025,-2583050,SELL
2020-09-22 11:28:00,11:28,12912100,9040875,-3871225,SELL
2020-09-22 11:29:00,11:29,12898225,9684975,-3213250,SELL
2020-09-22 11:30:00,11:30,13005150,9803425,-3201725,SELL
2020-09-22 11:31:00,11:31,12966200,9501325,-3464875,SELL
2020-09-22 11:32:00,11:32,12950800,9396025,-3554775,SELL
2020-09-22 11:33:00,11:33,12591700,9654675,-2937025,SELL
2020-09-22 11:34:00,11:34,12628325,9407300,-3221025,SELL
2020-09-22 11:35:00,11:35,12689425,9338075,-3351350,SELL
2020-09-22 11:36:00,11:36,12098500,9577700,-2520800,SELL
2020-09-22 11:37:00,11:37,12885150,9701000,-3184150,SELL
2020-09-22 11:38:00,11:38,12894275,9731500,-3162775,SELL
2020-09-22 11:39:00,11:39,12864150,9469875,-3394275,SELL
2020-09-22 11:40:00,11:40,12432050,9473975,-2958075,SELL
2020-09-22 11:41:00,11:41,12900650,9393275,-3507375,SELL
2020-09-22 11:42:00,11:42,12753700,8840850,-3912850,SELL
2020-09-22 11:43:00,11:43,12568850,9213425,-3355425,SELL
2020-09-22 11:44:00,11:44,13006625,9294775,-3711850,SELL
2020-09-22 11:45:00,11:45,13019450,9905775,-3113675,SELL
2020-09-22 11:46:00,11:46,12937650,8862525,-4075125,SELL
2020-09-22 11:47:00,11:47,12733025,9442450,-3290575,SELL
2020-09-22 11:48:00,11:48,11709300,9047300,-2662000,SELL
2020-09-22 11:49:00,11:49,12555075,9037750,-3517325,SELL
2020-09-22 11:50:00,11:50,12846625,9562700,-3283925,SELL
2020-09-22 11:51:00,11:51,12935825,9522325,-3413500,SELL
2020-09-22 11:52:00,11:52,12656725,9374000,-3282725,SELL
2020-09-22 11:53:00,11:53,12943825,9067000,-3876825,SELL
2020-09-22 11:54:00,11:54,12881750,9420475,-3461275,SELL
2020-09-22 11:55:00,11:55,12854350,9206800,-3647550,SELL
2020-09-22 11:56:00,11:56,12935400,9440250,-3495150,SELL
2020-09-22 11:57:00,11:57,12487125,9445625,-3041500,SELL
2020-09-22 11:58:00,11:58,12936375,9687225,-3249150,SELL
2020-09-22 11:59:00,11:59,12598825,9556700,-3042125,SELL
2020-09-22 12:00:00,12:00,12398125,9368425,-3029700,SELL
2020-09-22 12:01:00,12:01,12735775,9872850,-2862925,SELL
2020-09-22 12:02:00,12:02,12543375,9328675,-3214700,SELL
2020-09-22 12:03:00,12:03,13017300,9415200,-3602100,SELL
2020-09-22 12:04:00,12:04,12848350,9277575,-3570775,SELL
2020-09-22 12:05:00,12:05,13070250,9384425,-3685825,SELL
2020-09-22 12:06:00,12:06,12425625,9424175,-3001450,SELL
2020-09-22 12:07:00,12:07,11765900,9134800,-2631100,SELL
2020-09-22 12:08:00,12:08,12329025,9474925,-2854100,SELL
2020-09-22 12:09:00,12:09,12601375,9440175,-3161200,SELL
2020-09-22 12:10:00,12:10,12762550,9224725,-3537825,SELL
2020-09-22 12:11:00,12:11,12483950,8943675,-3540275,SELL
2020-09-22 12:12:00,12:12,13105725,9277975,-3827750,SELL
2020-09-22 12:13:00,12:13,12788675,9509775,-3278900,SELL
2020-09-22 12:14:00,12:14,12759400,9449300,-3310100,SELL
2020-09-22 12:15:00,12:15,12759175,9310100,-3449075,SELL
2020-09-22 12:16:00,12:16,12791500,9495075,-3296425,SELL
2020-09-22 12:17:00,12:17,11691825,9107950,-2583875,SELL
2020-09-22 12:18:00,12:18,12969100,9667900,-3301200,SELL
2020-09-22 12:19:00,12:19,13170925,10036725,-3134200,SELL
2020-09-22 12:20:00,12:20,13142900,9566550,-3576350,SELL
2020-09-22 12:21:00,12:21,13069300,9707400,-3361900,SELL
2020-09-22 12:22:00,12:22,12958375,9934575,-3023800,SELL
2020-09-22 12:23:00,12:23,13181325,9531050,-3650275,SELL
2020-09-22 12:24:00,12:24,13220750,9848575,-3372175,SELL
2020-09-22 12:25:00,12:25,12894200,9468150,-3426050,SELL
2020-09-22 12:26:00,12:26,13166400,9559000,-3607400,SELL
2020-09-22 12:27:00,12:27,12835850,9430050,-3405800,SELL
2020-09-22 12:28:00,12:28,12247225,9394825,-2852400,SELL
2020-09-22 12:29:00,12:29,13094700,9303300,-3791400,SELL
2020-09-22 12:30:00,12:30,12879325,9371850,-3507475,SELL
2020-09-22 12:31:00,12:31,13116750,9169025,-3947725,SELL
2020-09-22 12:32:00,12:32,13098425,9601825,-3496600,SELL
2020-09-22 12:33:00,12:33,13088800,9545625,-3543175,SELL
2020-09-22 12:34:00,12:34,12883825,9291800,-3592025,SELL
2020-09-22 12:35:00,12:35,13113325,9644400,-3468925,SELL
2020-09-22 12:36:00,12:36,13092375,9275825,-3816550,SELL
2020-09-22 12:37:00,12:37,13123975,8864325,-4259650,SELL
2020-09-22 12:38:00,12:38,13139200,9702600,-3436600,SELL
2020-09-22 12:39:00,12:39,13111150,9574275,-3536875,SELL
2020-09-22 12:40:00,12:40,12890600,9518900,-3371700,SELL
2020-09-22 12:41:00,12:41,12965400,9462550,-3502850,SELL
2020-09-22 12:42:00,12:42,13027375,9477475,-3549900,SELL
2020-09-22 12:43:00,12:43,13129900,8952050,-4177850,SELL
2020-09-22 12:44:00,12:44,12648575,8932350,-3716225,SELL
2020-09-22 12:45:00,12:45,12846200,9356375,-3489825,SELL
2020-09-22 12:46:00,12:46,12872375,9546750,-3325625,SELL
2020-09-22 12:47:00,12:47,13044925,9174650,-3870275,SELL
2020-09-22 12:48:00,12:48,13044050,9169200,-3874850,SELL
2020-09-22 12:49:00,12:49,12631150,9487350,-3143800,SELL
2020-09-22 12:50:00,12:50,12868600,9705350,-3163250,SELL
2020-09-22 12:51:00,12:51,13184850,9291800,-3893050,SELL
2020-09-22 12:52:00,12:52,13197925,9492375,-3705550,SELL
2020-09-22 12:53:00,12:53,12886250,9237625,-3648625,SELL
2020-09-22 12:54:00,12:54,13182500,9276700,-3905800,SELL
2020-09-22 12:55:00,12:55,13201775,9353225,-3848550,SELL
2020-09-22 12:56:00,12:56,13210275,9741950,-3468325,SELL
2020-09-22 12:57:00,12:57,12694275,9295150,-3399125,SELL
2020-09-22 12:58:00,12:58,12695275,9561700,-3133575,SELL
2020-09-22 12:59:00,12:59,13223350,9627300,-3596050,SELL
2020-09-22 13:00:00,13:00,13269275,9970950,-3298325,SELL
2020-09-22 13:01:00,13:01,13006125,9448750,-3557375,SELL
2020-09-22 13:02:00,13:02,13131350,9549975,-3581375,SELL
2020-09-22 13:03:00,13:03,13096400,9709100,-3387300,SELL
2020-09-22 13:04:00,13:04,12797375,9486100,-3311275,SELL
2020-09-22 13:05:00,13:05,12788025,9371575,-3416450,SELL
2020-09-22 13:06:00,13:06,13086650,9489975,-3596675,SELL
2020-09-22 13:07:00,13:07,13102000,9546075,-3555925,SELL
2020-09-22 13:08:00,13:08,13204025,9638525,-3565500,SELL
2020-09-22 13:09:00,13:09,12801700,9612525,-3189175,SELL
2020-09-22 13:10:00,13:10,12924650,9474700,-3449950,SELL
2020-09-22 13:11:00,13:11,12701500,9560375,-3141125,SELL
2020-09-22 13:12:00,13:12,12949275,8966625,-3982650,SELL
2020-09-22 13:13:00,13:13,13026525,9748025,-3278500,SELL
2020-09-22 13:14:00,13:14,12678050,9269275,-3408775,SELL
2020-09-22 13:15:00,13:15,13215500,9816025,-3399475,SELL
2020-09-22 13:16:00,13:16,12835825,9609975,-3225850,SELL
2020-09-22 13:17:00,13:17,13025175,9381925,-3643250,SELL
2020-09-22 13:18:00,13:18,13125650,9461325,-3664325,SELL
2020-09-22 13:19:00,13:19,13220350,9378350,-3842000,SELL
2020-09-22 13:20:00,13:20,13268225,9597675,-3670550,SELL
2020-09-22 13:21:00,13:21,13216725,9794950,-3421775,SELL
2020-09-22 13:22:00,13:22,12871375,9181950,-3689425,SELL
2020-09-22 13:23:00,13:23,13282400,9677050,-3605350,SELL
2020-09-22 13:24:00,13:24,13421700,9539150,-3882550,SELL
2020-09-22 13:25:00,13:25,13303925,9569725,-3734200,SELL
2020-09-22 13:26:00,13:26,12984025,9733425,-3250600,SELL
2020-09-22 13:27:00,13:27,13320700,9533150,-3787550,SELL
2020-09-22 13:28:00,13:28,13348275,9624525,-3723750,SELL
2020-09-22 13:29:00,13:29,12858750,9452775,-3405975,SELL
2020-09-22 13:30:00,13:30,12770200,9382850,-3387350,SELL
2020-09-22 13:31:00,13:31,13423250,9646800,-3776450,SELL
2020-09-22 13:32:00,13:32,13463575,9949450,-3514125,SELL
2020-09-22 13:33:00,13:33,13011125,9620450,-3390675,SELL
2020-09-22 13:34:00,13:34,13090500,9551725,-3538775,SELL
2020-09-22 13:35:00,13:35,13095650,9864900,-3230750,SELL
2020-09-22 13:36:00,13:36,13350975,9598650,-3752325,SELL
2020-09-22 13:37:00,13:37,13206525,9529675,-3676850,SELL
2020-09-22 13:38:00,13:38,13120225,10011950,-3108275,SELL
2020-09-22 13:39:00,13:39,13287625,9662100,-3625525,SELL
2020-09-22 13:40:00,13:40,13264825,9711075,-3553750,SELL
2020-09-22 13:41:00,13:41,13177375,9494950,-3682425,SELL
2020-09-22 13:42:00,13:42,12500050,9972300,-2527750,SELL
2020-09-22 13:43:00,13:43,12481825,9551750,-2930075,SELL
2020-09-22 13:44:00,13:44,13137900,9744475,-3393425,SELL
2020-09-22 13:45:00,13:45,13306825,9945475,-3361350,SELL
2020-09-22 13:46:00,13:46,13421850,10219025,-3202825,SELL
2020-09-22 13:47:00,13:47,13026100,9708825,-3317275,SELL
2020-09-22 13:48:00,13:48,13201400,9385950,-3815450,SELL
2020-09-22 13:49:00,13:49,13168500,9585800,-3582700,SELL
2020-09-22 13:50:00,13:50,12831025,9585525,-3245500,SELL
2020-09-22 13:51:00,13:51,13240275,9583850,-3656425,SELL
2020-09-22 13:52:00,13:52,12839700,9530925,-3308775,SELL
2020-09-22 13:53:00,13:53,13081200,9647150,-3434050,SELL
2020-09-22 13:54:00,13:54,13252375,9581025,-3671350,SELL
2020-09-22 13:55:00,13:55,13343175,9844275,-3498900,SELL
2020-09-22 13:56:00,13:56,13299925,9566125,-3733800,SELL
2020-09-22 13:57:00,13:57,13375375,9470350,-3905025,SELL
2020-09-22 13:58:00,13:58,13238825,9572900,-3665925,SELL
2020-09-22 13:59:00,13:59,13304675,9261525,-4043150,SELL
2020-09-22 14:00:00,14:00,13229675,9390075,-3839600,SELL
2020-09-22 14:01:00,14:01,13243725,9376900,-3866825,SELL
2020-09-22 14:02:00,14:02,13287050,9400550,-3886500,SELL
2020-09-22 14:03:00,14:03,13406450,9141425,-4265025,SELL
2020-09-22 14:04:00,14:04,13344575,9346350,-3998225,SELL
2020-09-22 14:05:00,14:05,13427375,9623150,-3804225,SELL
2020-09-22 14:06:00,14:06,12955675,9294250,-3661425,SELL
2020-09-22 14:07:00,14:07,13149625,9525025,-3624600,SELL
2020-09-22 14:08:00,14:08,13297350,9113925,-4183425,SELL
2020-09-22 14:09:00,14:09,13256625,9308075,-3948550,SELL
2020-09-22 14:10:00,14:10,13135425,9304250,-3831175,SELL
2020-09-22 14:11:00,14:11,13395000,9471025,-3923975,SELL
2020-09-22 14:12:00,14:12,13518200,9443025,-4075175,SELL
2020-09-22 14:13:00,14:13,13478650,9131700,-4346950,SELL
2020-09-22 14:14:00,14:14,13471700,9466225,-4005475,SELL
2020-09-22 14:15:00,14:15,13462725,9366425,-4096300,SELL
2020-09-22 14:16:00,14:16,13452150,9165675,-4286475,SELL
2020-09-22 14:17:00,14:17,13425200,9048875,-4376325,SELL
2020-09-22 14:18:00,14:18,13434475,9185275,-4249200,SELL
2020-09-22 14:19:00,14:19,13243850,9354375,-3889475,SELL
2020-09-22 14:20:00,14:20,13477700,9448675,-4029025,SELL
2020-09-22 14:21:00,14:21,13168675,9316625,-3852050,SELL
2020-09-22 14:22:00,14:22,13455425,9276800,-4178625,SELL
2020-09-22 14:23:00,14:23,13569850,9206500,-4363350,SELL
2020-09-22 14:24:00,14:24,13420125,9365175,-4054950,SELL
2020-09-22 14:25:00,14:25,13442775,9154250,-4288525,SELL
2020-09-22 14:26:00,14:26,13463275,9184075,-4279200,SELL
2020-09-22 14:27:00,14:27,13607300,9051925,-4555375,SELL
2020-09-22 14:28:00,14:28,13663325,9149275,-4514050,SELL
2020-09-22 14:29:00,14:29,13681975,9133750,-4548225,SELL
2020-09-22 14:30:00,14:30,13529675,8877425,-4652250,SELL
2020-09-22 14:31:00,14:31,13513150,8971150,-4542000,SELL
2020-09-22 14:32:00,14:32,13092300,8836800,-4255500,SELL
2020-09-22 14:33:00,14:33,13450150,8715450,-4734700,SELL
2020-09-22 14:34:00,14:34,13413400,8559275,-4854125,SELL
2020-09-22 14:35:00,14:35,13541175,8739150,-4802025,SELL
2020-09-22 14:36:00,14:36,13489575,8903875,-4585700,SELL
2020-09-22 14:37:00,14:37,13556475,9181350,-4375125,SELL
2020-09-22 14:38:00,14:38,13512675,8968225,-4544450,SELL
2020-09-22 14:39:00,14:39,13425275,8621475,-4803800,SELL
2020-09-22 14:40:00,14:40,13438875,8567325,-4871550,SELL
2020-09-22 14:41:00,14:41,13122100,8459550,-4662550,SELL
2020-09-22 14:42:00,14:42,13534550,8370400,-5164150,SELL
2020-09-22 14:43:00,14:43,13490775,8531625,-4959150,SELL
2020-09-22 14:44:00,14:44,13488150,8501675,-4986475,SELL
2020-09-22 14:45:00,14:45,13555575,8477625,-5077950,SELL
2020-09-22 14:46:00,14:46,13355075,8731000,-4624075,SELL
2020-09-22 14:47:00,14:47,13378300,8703900,-4674400,SELL
2020-09-22 14:48:00,14:48,13151250,8644075,-4507175,SELL
2020-09-22 14:49:00,14:49,13320500,8177450,-5143050,SELL
2020-09-22 14:50:00,14:50,13464875,8030600,-5434275,SELL
2020-09-22 14:51:00,14:51,12879975,8261025,-4618950,SELL
2020-09-22 14:52:00,14:52,13251800,8442450,-4809350,SELL
2020-09-22 14:53:00,14:53,13345525,8138925,-5206600,SELL
2020-09-22 14:54:00,14:54,13296450,8288700,-5007750,SELL
2020-09-22 14:55:00,14:55,13386700,8537200,-4849500,SELL
2020-09-22 14:56:00,14:56,13295075,8386800,-4908275,SELL
2020-09-22 14:57:00,14:57,13253975,8368400,-4885575,SELL
2020-09-22 14:58:00,14:58,13336650,8254850,-5081800,SELL
2020-09-22 14:59:00,14:59,13368275,8417775,-4950500,SELL
2020-09-22 15:00:00,15:00,13234925,8516650,-4718275,SELL
2020-09-22 15:01:00,15:01,13328425,8509825,-4818600,SELL
2020-09-22 15:02:00,15:02,13316225,8307275,-5008950,SELL
2020-09-22 15:03:00,15:03,13306575,8109050,-5197525,SELL
2020-09-22 15:04:00,15:04,13234150,8034475,-5199675,SELL
2020-09-22 15:05:00,15:05,13398575,8475850,-4922725,SELL
2020-09-22 15:06:00,15:06,13212700,8015425,-5197275,SELL
2020-09-22 15:07:00,15:07,13155175,8040225,-5114950,SELL
2020-09-22 15:08:00,15:08,13289100,8061100,-5228000,SELL
2020-09-22 15:09:00,15:09,13151025,8193025,-4958000,SELL
2020-09-22 15:10:00,15:10,13187075,8432500,-4754575,SELL
2020-09-22 15:11:00,15:11,13199100,8094150,-5104950,SELL
2020-09-22 15:12:00,15:12,12883650,8088275,-4795375,SELL
2020-09-22 15:13:00,15:13,12929800,8234200,-4695600,SELL
2020-09-22 15:14:00,15:14,13052650,8234600,-4818050,SELL
2020-09-22 15:15:00,15:15,12988725,8047775,-4940950,SELL
2020-09-22 15:16:00,15:16,12855625,7686500,-5169125,SELL
2020-09-22 15:17:00,15:17,12919950,7827125,-5092825,SELL
2020-09-22 15:18:00,15:18,12663625,7775900,-4887725,SELL
2020-09-22 15:19:00,15:19,12745775,7870225,-4875550,SELL
2020-09-22 15:20:00,15:20,12836300,7766600,-5069700,SELL
2020-09-22 15:21:00,15:21,12576350,7844175,-4732175,SELL
2020-09-22 15:22:00,15:22,12535425,7839000,-4696425,SELL
2020-09-22 15:23:00,15:23,12658150,7586150,-5072000,SELL
2020-09-22 15:24:00,15:24,12455450,7381150,-5074300,SELL
2020-09-22 15:25:00,15:25,12450325,7721000,-4729325,SELL
2020-09-22 15:26:00,15:26,12382450,7712750,-4669700,SELL
2020-09-22 15:27:00,15:27,12407950,7475275,-4932675,SELL
2020-09-22 15:28:00,15:28,12200700,7588775,-4611925,SELL
2020-09-22 15:29:00,15:29,12367350,7650525,-4716825,SELL
2020-09-23 09:15:00,09:15,12026225,7046550,-4979675,SELL
2020-09-23 09:16:00,09:16,11861400,6999650,-4861750,SELL
2020-09-23 09:17:00,09:17,12263975,7296950,-4967025,SELL
2020-09-23 09:18:00,09:18,12343325,7465600,-4877725,SELL
2020-09-23 09:19:00,09:19,12265300,7562175,-4703125,SELL
2020-09-23 09:20:00,09:20,12698950,7995900,-4703050,SELL
2020-09-23 09:21:00,09:21,12581475,7859500,-4721975,SELL
2020-09-23 09:22:00,09:22,12526975,7904275,-4622700,SELL
2020-09-23 09:23:00,09:23,12648750,8007075,-4641675,SELL
2020-09-23 09:24:00,09:24,13062075,8111600,-4950475,SELL
2020-09-23 09:25:00,09:25,13042150,8214875,-4827275,SELL
2020-09-23 09:26:00,09:26,13079875,8202225,-4877650,SELL
2020-09-23 09:27:00,09:27,12834175,8272925,-4561250,SELL
2020-09-23 09:28:00,09:28,13165525,7924325,-5241200,SELL
2020-09-23 09:29:00,09:29,13182100,8309225,-4872875,SELL
2020-09-23 09:30:00,09:30,12872000,8410025,-4461975,SELL
2020-09-23 09:31:00,09:31,12893550,8218125,-4675425,SELL
2020-09-23 09:32:00,09:32,13317050,8705425,-4611625,SELL
2020-09-23 09:33:00,09:33,13304650,8601175,-4703475,SELL
2020-09-23 09:34:00,09:34,13355425,8699600,-4655825,SELL
2020-09-23 09:35:00,09:35,13688800,8767900,-4920900,SELL
2020-09-23 09:36:00,09:36,13398475,8688675,-4709800,SELL
2020-09-23 09:37:00,09:37,13579450,8650675,-4928775,SELL
2020-09-23 09:38:00,09:38,13805100,8823525,-4981575,SELL
2020-09-23 09:39:00,09:39,13702400,8648725,-5053675,SELL
2020-09-23 09:40:00,09:40,13896900,8876800,-5020100,SELL
2020-09-23 09:41:00,09:41,13814925,8966725,-4848200,SELL
2020-09-23 09:42:00,09:42,13825625,8728350,-5097275,SELL
2020-09-23 09:43:00,09:43,12820375,8547375,-4273000,SELL
2020-09-23 09:44:00,09:44,13758800,8490925,-5267875,SELL
2020-09-23 09:45:00,09:45,14081450,8917375,-5164075,SELL
2020-09-23 09:46:00,09:46,14116925,9022125,-5094800,SELL
2020-09-23 09:47:00,09:47,14191975,9060275,-5131700,SELL
2020-09-23 09:48:00,09:48,14265800,8893575,-5372225,SELL
2020-09-23 09:49:00,09:49,14164950,9295325,-4869625,SELL
2020-09-23 09:50:00,09:50,14323925,8879575,-5444350,SELL
2020-09-23 09:51:00,09:51,14017950,8839425,-5178525,SELL
2020-09-23 09:52:00,09:52,14350425,8685550,-5664875,SELL
2020-09-23 09:53:00,09:53,14089575,9139000,-4950575,SELL
2020-09-23 09:54:00,09:54,13644925,8916175,-4728750,SELL
2020-09-23 09:55:00,09:55,13866125,8900725,-4965400,SELL
2020-09-23 09:56:00,09:56,14443325,8878625,-5564700,SELL
2020-09-23 09:57:00,09:57,14514775,8928625,-5586150,SELL
2020-09-23 09:58:00,09:58,14363500,9042925,-5320575,SELL
2020-09-23 09:59:00,09:59,14027975,8825625,-5202350,SELL
2020-09-23 10:00:00,10:00,14223625,8871550,-5352075,SELL
2020-09-23 10:01:00,10:01,14432600,8930775,-5501825,SELL
2020-09-23 10:02:00,10:02,13826475,9007550,-4818925,SELL
2020-09-23 10:03:00,10:03,14267500,9243075,-5024425,SELL
2020-09-23 10:04:00,10:04,14339750,9364500,-4975250,SELL
2020-09-23 10:05:00,10:05,14492800,9103350,-5389450,SELL
2020-09-23 10:06:00,10:06,14306375,9331750,-4974625,SELL
2020-09-23 10:07:00,10:07,14238525,9253450,-4985075,SELL
2020-09-23 10:08:00,10:08,14606525,9077600,-5528925,SELL
2020-09-23 10:09:00,10:09,14593325,9002450,-5590875,SELL
2020-09-23 10:10:00,10:10,14370125,9336325,-5033800,SELL
2020-09-23 10:11:00,10:11,14616525,9364300,-5252225,SELL
2020-09-23 10:12:00,10:12,14435725,9128925,-5306800,SELL
2020-09-23 10:13:00,10:13,14278550,9007350,-5271200,SELL
2020-09-23 10:14:00,10:14,14421925,9378700,-5043225,SELL
2020-09-23 10:15:00,10:15,14494450,9354675,-5139775,SELL
2020-09-23 10:16:00,10:16,14665575,9183450,-5482125,SELL
2020-09-23 10:17:00,10:17,14334150,9336925,-4997225,SELL
2020-09-23 10:18:00,10:18,14532000,9260200,-5271800,SELL
2020-09-23 10:19:00,10:19,14566275,9297675,-5268600,SELL
2020-09-23 10:20:00,10:20,14769200,9432575,-5336625,SELL
2020-09-23 10:21:00,10:21,14637950,9208075,-5429875,SELL
2020-09-23 10:22:00,10:22,14487150,9269225,-5217925,SELL
2020-09-23 10:23:00,10:23,14729025,9832800,-4896225,SELL
2020-09-23 10:24:00,10:24,14658900,9247125,-5411775,SELL
2020-09-23 10:25:00,10:25,14383475,9383400,-5000075,SELL
2020-09-23 10:26:00,10:26,14713575,9520100,-5193475,SELL
2020-09-23 10:27:00,10:27,14255825,9541950,-4713875,SELL
2020-09-23 10:28:00,10:28,14596450,9591125,-5005325,SELL
2020-09-23 10:29:00,10:29,14420975,9467950,-4953025,SELL
2020-09-23 10:30:00,10:30,14479125,9597350,-4881775,SELL
2020-09-23 10:31:00,10:31,14635375,9161075,-5474300,SELL
2020-09-23 10:32:00,10:32,13823450,9579200,-4244250,SELL
2020-09-23 10:33:00,10:33,14566825,9356250,-5210575,SELL
2020-09-23 10:34:00,10:34,14476425,9319850,-5156575,SELL
2020-09-23 10:35:00,10:35,13714200,9651925,-4062275,SELL
2020-09-23 10:36:00,10:36,13909325,9117550,-4791775,SELL
2020-09-23 10:37:00,10:37,14425225,9559075,-4866150,SELL
2020-09-23 10:38:00,10:38,14480125,9436875,-5043250,SELL
2020-09-23 10:39:00,10:39,14376900,9550925,-4825975,SELL
2020-09-23 10:40:00,10:40,14641650,9584050,-5057600,SELL
2020-09-23 10:41:00,10:41,14846825,9462475,-5384350,SELL
2020-09-23 10:42:00,10:42,14726950,9474675,-5252275,SELL
2020-09-23 10:43:00,10:43,13855750,9369275,-4486475,SELL
2020-09-23 10:44:00,10:44,14614825,9443475,-5171350,SELL
2020-09-23 10:45:00,10:45,14141500,9406925,-4734575,SELL
2020-09-23 10:46:00,10:46,14280775,9171575,-5109200,SELL
2020-09-23 10:47:00,10:47,13367225,9444550,-3922675,SELL
2020-09-23 10:48:00,10:48,14466375,9436950,-5029425,SELL
2020-09-23 10:49:00,10:49,14359025,9184500,-5174525,SELL
2020-09-23 10:50:00,10:50,14335125,9414500,-4920625,SELL
2020-09-23 10:51:00,10:51,14788100,9322775,-5465325,SELL
2020-09-23 10:52:00,10:52,14425625,9218350,-5207275,SELL
2020-09-23 10:53:00,10:53,13915200,9497100,-4418100,SELL
2020-09-23 10:54:00,10:54,13965650,9377925,-4587725,SELL
2020-09-23 10:55:00,10:55,14833325,9809225,-5024100,SELL
2020-09-23 10:56:00,10:56,14629625,9655075,-4974550,SELL
2020-09-23 10:57:00,10:57,13726575,9552950,-4173625,SELL
2020-09-23 10:58:00,10:58,14607350,9387075,-5220275,SELL
2020-09-23 10:59:00,10:59,14576075,9461450,-5114625,SELL
2020-09-23 11:00:00,11:00,14676525,9540975,-5135550,SELL
2020-09-23 11:01:00,11:01,14755950,9871050,-4884900,SELL
2020-09-23 11:02:00,11:02,14689725,9171475,-5518250,SELL
2020-09-23 11:03:00,11:03,14560400,9422550,-5137850,SELL
2020-09-23 11:04:00,11:04,14069275,9561750,-4507525,SELL
2020-09-23 11:05:00,11:05,14348375,9563050,-4785325,SELL
2020-09-23 11:06:00,11:06,14395100,9367625,-5027475,SELL
2020-09-23 11:07:00,11:07,14181500,9568275,-4613225,SELL
2020-09-23 11:08:00,11:08,14617525,10240800,-4376725,SELL
2020-09-23 11:09:00,11:09,14025450,9733925,-4291525,SELL
2020-09-23 11:10:00,11:10,14649700,9615125,-5034575,SELL
2020-09-23 11:11:00,11:11,14913775,9483200,-5430575,SELL
2020-09-23 11:12:00,11:12,14701750,9486950,-5214800,SELL
2020-09-23 11:13:00,11:13,13541500,9611250,-3930250,SELL
2020-09-23 11:14:00,11:14,15038125,9613400,-5424725,SELL
2020-09-23 11:15:00,11:15,14145850,9643325,-4502525,SELL
2020-09-23 11:16:00,11:16,14531850,9446300,-5085550,SELL
2020-09-23 11:17:00,11:17,14911900,9724900,-5187000,SELL
2020-09-23 11:18:00,11:18,14682675,9315750,-5366925,SELL
2020-09-23 11:19:00,11:19,14524000,9695475,-4828525,SELL
2020-09-23 11:20:00,11:20,14868550,9436625,-5431925,SELL
2020-09-23 11:21:00,11:21,14705450,9614875,-5090575,SELL
2020-09-23 11:22:00,11:22,14662000,9419625,-5242375,SELL
2020-09-23 11:23:00,11:23,14557525,9882575,-4674950,SELL
2020-09-23 11:24:00,11:24,13967600,9431650,-4535950,SELL
2020-09-23 11:25:00,11:25,14484400,10177025,-4307375,SELL
2020-09-23 11:26:00,11:26,13967625,9618975,-4348650,SELL
2020-09-23 11:27:00,11:27,14584425,9669900,-4914525,SELL
2020-09-23 11:28:00,11:28,14708725,10226150,-4482575,SELL
2020-09-23 11:29:00,11:29,14564475,9754975,-4809500,SELL
2020-09-23 11:30:00,11:30,14719850,10370125,-4349725,SELL
2020-09-23 11:31:00,11:31,14715675,9762550,-4953125,SELL
2020-09-23 11:32:00,11:32,13872125,9513300,-4358825,SELL
2020-09-23 11:33:00,11:33,14299100,9705800,-4593300,SELL
2020-09-23 11:34:00,11:34,13685250,9734550,-3950700,SELL
2020-09-23 11:35:00,11:35,14567400,9516050,-5051350,SELL
2020-09-23 11:36:00,11:36,14307775,10080750,-4227025,SELL
2020-09-23 11:37:00,11:37,14537950,9504725,-5033225,SELL
2020-09-23 11:38:00,11:38,14495375,9846725,-4648650,SELL
2020-09-23 11:39:00,11:39,14900825,9499575,-5401250,SELL
2020-09-23 11:40:00,11:40,14665850,9602050,-5063800,SELL
2020-09-23 11:41:00,11:41,14466300,9712250,-4754050,SELL
2020-09-23 11:42:00,11:42,14488325,9839075,-4649250,SELL
2020-09-23 11:43:00,11:43,14437525,9780400,-4657125,SELL
2020-09-23 11:44:00,11:44,14410625,9514075,-4896550,SELL
2020-09-23 11:45:00,11:45,14276350,9898750,-4377600,SELL
2020-09-23 11:46:00,11:46,14676225,9635300,-5040925,SELL
2020-09-23 11:47:00,11:47,14543475,9585425,-4958050,SELL
2020-09-23 11:48:00,11:48,14639650,9583200,-5056450,SELL
2020-09-23 11:49:00,11:49,14812675,9627150,-5185525,SELL
2020-09-23 11:50:00,11:50,13180975,10231050,-2949925,SELL
2020-09-23 11:51:00,11:51,14726700,9845600,-4881100,SELL
2020-09-23 11:52:00,11:52,14680775,10080225,-4600550,SELL
2020-09-23 11:53:00,11:53,14901600,9661650,-5239950,SELL
2020-09-23 11:54:00,11:54,15018775,9424825,-5593950,SELL
2020-09-23 11:55:00,11:55,15075350,10052550,-5022800,SELL
2020-09-23 11:56:00,11:56,15095550,9957125,-5138425,SELL
2020-09-23 11:57:00,11:57,15051225,10158425,-4892800,SELL
2020-09-23 11:58:00,11:58,15022950,9937250,-5085700,SELL
2020-09-23 11:59:00,11:59,15087875,10001800,-5086075,SELL
2020-09-23 12:00:00,12:00,15076125,10229625,-4846500,SELL
2020-09-23 12:01:00,12:01,14988125,10431050,-4557075,SELL
2020-09-23 12:02:00,12:02,15210775,10062200,-5148575,SELL
2020-09-23 12:03:00,12:03,14913275,9885100,-5028175,SELL
2020-09-23 12:04:00,12:04,14749675,9952050,-4797625,SELL
2020-09-23 12:05:00,12:05,14877775,9595275,-5282500,SELL
2020-09-23 12:06:00,12:06,14981600,9797675,-5183925,SELL
2020-09-23 12:07:00,12:07,14799325,9607450,-5191875,SELL
2020-09-23 12:08:00,12:08,14532925,9489725,-5043200,SELL
2020-09-23 12:09:00,12:09,14903725,9649950,-5253775,SELL
2020-09-23 12:10:00,12:10,14836250,9455325,-5380925,SELL
2020-09-23 12:11:00,12:11,14867725,10000675,-4867050,SELL
2020-09-23 12:12:00,12:12,14831600,9536775,-5294825,SELL
2020-09-23 12:13:00,12:13,14582750,9761450,-4821300,SELL
2020-09-23 12:14:00,12:14,14503500,9453275,-5050225,SELL
2020-09-23 12:15:00,12:15,14824375,9900275,-4924100,SELL
2020-09-23 12:16:00,12:16,14808900,9616950,-5191950,SELL
2020-09-23 12:17:00,12:17,14671800,9527675,-5144125,SELL
2020-09-23 12:18:00,12:18,14653475,9383700,-5269775,SELL
2020-09-23 12:19:00,12:19,14704950,9507700,-5197250,SELL
2020-09-23 12:20:00,12:20,13895325,9029725,-4865600,SELL
2020-09-23 12:21:00,12:21,14785700,9012275,-5773425,SELL
2020-09-23 12:22:00,12:22,13865775,9356600,-4509175,SELL
2020-09-23 12:23:00,12:23,14430250,9283650,-5146600,SELL
2020-09-23 12:24:00,12:24,14559375,9621000,-4938375,SELL
2020-09-23 12:25:00,12:25,13644200,9324475,-4319725,SELL
2020-09-23 12:26:00,12:26,14867450,9721700,-5145750,SELL
2020-09-23 12:27:00,12:27,14896550,9968975,-4927575,SELL
2020-09-23 12:28:00,12:28,14611925,9470475,-5141450,SELL
2020-09-23 12:29:00,12:29,14764275,9308150,-5456125,SELL
2020-09-23 12:30:00,12:30,14647150,9431200,-5215950,SELL
2020-09-23 12:31:00,12:31,14559375,9333600,-5225775,SELL
2020-09-23 12:32:00,12:32,14337850,9311675,-5026175,SELL
2020-09-23 12:33:00,12:33,14519875,9684250,-4835625,SELL
2020-09-23 12:34:00,12:34,14472650,9661650,-4811000,SELL
2020-09-23 12:35:00,12:35,14515400,9795250,-4720150,SELL
2020-09-23 12:36:00,12:36,14119100,9401325,-4717775,SELL
2020-09-23 12:37:00,12:37,13647800,9186275,-4461525,SELL
2020-09-23 12:38:00,12:38,14717850,9435725,-5282125,SELL
2020-09-23 12:39:00,12:39,14621675,9451025,-5170650,SELL
2020-09-23 12:40:00,12:40,14476050,9804300,-4671750,SELL
2020-09-23 12:41:00,12:41,14503050,9618700,-4884350,SELL
2020-09-23 12:42:00,12:42,14652250,9549600,-5102650,SELL
2020-09-23 12:43:00,12:43,14361450,9768100,-4593350,SELL
2020-09-23 12:44:00,12:44,14673350,9456125,-5217225,SELL
2020-09-23 12:45:00,12:45,14885950,9877675,-5008275,SELL
2020-09-23 12:46:00,12:46,14248275,9760975,-4487300,SELL
2020-09-23 12:47:00,12:47,13920325,9629225,-4291100,SELL
2020-09-23 12:48:00,12:48,14437175,9430675,-5006500,SELL
2020-09-23 12:49:00,12:49,14646875,9385950,-5260925,SELL
2020-09-23 12:50:00,12:50,14811200,9304250,-5506950,SELL
2020-09-23 12:51:00,12:51,14651450,9750100,-4901350,SELL
2020-09-23 12:52:00,12:52,14792675,9382550,-5410125,SELL
2020-09-23 12:53:00,12:53,14658500,9557575,-5100925,SELL
2020-09-23 12:54:00,12:54,14053175,9564575,-4488600,SELL
2020-09-23 12:55:00,12:55,14767900,9448925,-5318975,SELL
2020-09-23 12:56:00,12:56,14596100,9245525,-5350575,SELL
2020-09-23 12:57:00,12:57,14465900,8977425,-5488475,SELL
2020-09-23 12:58:00,12:58,14116350,9369925,-4746425,SELL
2020-09-23 12:59:00,12:59,14176775,8855125,-5321650,SELL
2020-09-23 13:00:00,13:00,13572675,9417750,-4154925,SELL
2020-09-23 13:01:00,13:01,13987275,9472500,-4514775,SELL
2020-09-23 13:02:00,13:02,14008825,9146025,-4862800,SELL
2020-09-23 13:03:00,13:03,13407750,9170725,-4237025,SELL
2020-09-23 13:04:00,13:04,13994325,8699325,-5295000,SELL
2020-09-23 13:05:00,13:05,13323050,9003700,-4319350,SELL
2020-09-23 13:06:00,13:06,14555225,8982125,-5573100,SELL
2020-09-23 13:07:00,13:07,14455250,9045350,-5409900,SELL
2020-09-23 13:08:00,13:08,14680300,9439350,-5240950,SELL
2020-09-23 13:09:00,13:09,14168650,8909550,-5259100,SELL
2020-09-23 13:10:00,13:10,14676475,9178200,-5498275,SELL
2020-09-23 13:11:00,13:11,13911475,9259475,-4652000,SELL
2020-09-23 13:12:00,13:12,14509600,9169275,-5340325,SELL
2020-09-23 13:13:00,13:13,14393025,8912650,-5480375,SELL
2020-09-23 13:14:00,13:14,14337375,8989000,-5348375,SELL
2020-09-23 13:15:00,13:15,13617475,9083025,-4534450,SELL
2020-09-23 13:16:00,13:16,14216650,9229450,-4987200,SELL
2020-09-23 13:17:00,13:17,14156825,9182300,-4974525,SELL
2020-09-23 13:18:00,13:18,14402450,9261725,-5140725,SELL
2020-09-23 13:19:00,13:19,14205125,9104925,-5100200,SELL
2020-09-23 13:20:00,13:20,14071375,9295050,-4776325,SELL
2020-09-23 13:21:00,13:21,13988700,9400950,-4587750,SELL
2020-09-23 13:22:00,13:22,13737075,9111475,-4625600,SELL
2020-09-23 13:23:00,13:23,14161500,9046625,-5114875,SELL
2020-09-23 13:24:00,13:24,14323750,9306400,-5017350,SELL
2020-09-23 13:25:00,13:25,14954575,9175200,-5779375,SELL
2020-09-23 13:26:00,13:26,14503700,9358100,-5145600,SELL
2020-09-23 13:27:00,13:27,14698725,9132675,-5566050,SELL
2020-09-23 13:28:00,13:28,14831575,8876400,-5955175,SELL
2020-09-23 13:29:00,13:29,14238050,9111550,-5126500,SELL
2020-09-23 13:30:00,13:30,14699500,9230700,-5468800,SELL
2020-09-23 13:31:00,13:31,14793700,9319775,-5473925,SELL
2020-09-23 13:32:00,13:32,14415850,9106375,-5309475,SELL
2020-09-23 13:33:00,13:33,14157825,8877275,-5280550,SELL
2020-09-23 13:34:00,13:34,14028400,8786450,-5241950,SELL
2020-09-23 13:35:00,13:35,14555900,9324800,-5231100,SELL
2020-09-23 13:36:00,13:36,14494400,9286700,-5207700,SELL
2020-09-23 13:37:00,13:37,14265575,8867450,-5398125,SELL
2020-09-23 13:38:00,13:38,14666975,8780250,-5886725,SELL
2020-09-23 13:39:00,13:39,14850175,9136950,-5713225,SELL
2020-09-23 13:40:00,13:40,14548550,9309000,-5239550,SELL
2020-09-23 13:41:00,13:41,14472925,9837450,-4635475,SELL
2020-09-23 13:42:00,13:42,14911175,8867625,-6043550,SELL
2020-09-23 13:43:00,13:43,14838800,8638500,-6200300,SELL
2020-09-23 13:44:00,13:44,14760950,8779175,-5981775,SELL
2020-09-23 13:45:00,13:45,14675900,8455375,-6220525,SELL
2020-09-23 13:46:00,13:46,14501975,8526625,-5975350,SELL
2020-09-23 13:47:00,13:47,14438725,8422975,-6015750,SELL
2020-09-23 13:48:00,13:48,14193425,8564725,-5628700,SELL
2020-09-23 13:49:00,13:49,14676000,8085750,-6590250,SELL
2020-09-23 13:50:00,13:50,14699275,8613775,-6085500,SELL
2020-09-23 13:51:00,13:51,14818950,8415325,-6403625,SELL
2020-09-23 13:52:00,13:52,14690075,8258400,-6431675,SELL
2020-09-23 13:53:00,13:53,14761000,8275250,-6485750,SELL
2020-09-23 13:54:00,13:54,14703050,8137075,-6565975,SELL
2020-09-23 13:55:00,13:55,14595575,8336575,-6259000,SELL
2020-09-23 13:56:00,13:56,14642175,8420650,-6221525,SELL
2020-09-23 13:57:00,13:57,14615150,8251250,-6363900,SELL
2020-09-23 13:58:00,13:58,14526425,8143075,-6383350,SELL
2020-09-23 13:59:00,13:59,14114850,8083650,-6031200,SELL
2020-09-23 14:00:00,14:00,14651475,8363100,-6288375,SELL
2020-09-23 14:01:00,14:01,14622950,7929800,-6693150,SELL
2020-09-23 14:02:00,14:02,14646325,8312775,-6333550,SELL
2020-09-23 14:03:00,14:03,14537550,8394300,-6143250,SELL
2020-09-23 14:04:00,14:04,14783975,8310000,-6473975,SELL
2020-09-23 14:05:00,14:05,14597575,8162575,-6435000,SELL
2020-09-23 14:06:00,14:06,14345150,8414600,-5930550,SELL
2020-09-23 14:07:00,14:07,14737050,7943900,-6793150,SELL
2020-09-23 14:08:00,14:08,14617600,8051250,-6566350,SELL
2020-09-23 14:09:00,14:09,14726300,8174675,-6551625,SELL
2020-09-23 14:10:00,14:10,14549675,8252150,-6297525,SELL
2020-09-23 14:11:00,14:11,14508675,8474950,-6033725,SELL
2020-09-23 14:12:00,14:12,14828475,8500075,-6328400,SELL
2020-09-23 14:13:00,14:13,14814200,8536500,-6277700,SELL
2020-09-23 14:14:00,14:14,14358775,7937275,-6421500,SELL
2020-09-23 14:15:00,14:15,14674425,8432850,-6241575,SELL
2020-09-23 14:16:00,14:16,14534375,8382325,-6152050,SELL
2020-09-23 14:17:00,14:17,14123775,8256325,-5867450,SELL
2020-09-23 14:18:00,14:18,14467425,7830675,-6636750,SELL
2020-09-23 14:19:00,14:19,14760175,8204450,-6555725,SELL
2020-09-23 14:20:00,14:20,14520975,8259525,-6261450,SELL
2020-09-23 14:21:00,14:21,14790775,8134050,-6656725,SELL
2020-09-23 14:22:00,14:22,14821875,8165425,-6656450,SELL
2020-09-23 14:23:00,14:23,14794750,8302575,-6492175,SELL
2020-09-23 14:24:00,14:24,14552850,8519250,-6033600,SELL
2020-09-23 14:25:00,14:25,14341325,8696725,-5644600,SELL
2020-09-23 14:26:00,14:26,14617350,8601375,-6015975,SELL
2020-09-23 14:27:00,14:27,13912225,8392300,-5519925,SELL
2020-09-23 14:28:00,14:28,13890025,8152175,-5737850,SELL
2020-09-23 14:29:00,14:29,13996575,8270150,-5726425,SELL
2020-09-23 14:30:00,14:30,13772550,7924100,-5848450,SELL
2020-09-23 14:31:00,14:31,13790475,8149100,-5641375,SELL
2020-09-23 14:32:00,14:32,13872725,8132575,-5740150,SELL
2020-09-23 14:33:00,14:33,13819525,8343450,-5476075,SELL
2020-09-23 14:34:00,14:34,13877250,8222925,-5654325,SELL
2020-09-23 14:35:00,14:35,13761450,8197750,-5563700,SELL
2020-09-23 14:36:00,14:36,13228850,8088525,-5140325,SELL
2020-09-23 14:37:00,14:37,13527025,8003075,-5523950,SELL
2020-09-23 14:38:00,14:38,13452625,7863675,-5588950,SELL
2020-09-23 14:39:00,14:39,13558950,7832150,-5726800,SELL
2020-09-23 14:40:00,14:40,13644775,8170250,-5474525,SELL
2020-09-23 14:41:00,14:41,13435575,8062125,-5373450,SELL
2020-09-23 14:42:00,14:42,13540900,7849325,-5691575,SELL
2020-09-23 14:43:00,14:43,13527450,7772050,-5755400,SELL
2020-09-23 14:44:00,14:44,13640500,7837800,-5802700,SELL
2020-09-23 14:45:00,14:45,13701375,8049875,-5651500,SELL
2020-09-23 14:46:00,14:46,13700600,8133825,-5566775,SELL
2020-09-23 14:47:00,14:47,13698925,8047700,-5651225,SELL
2020-09-23 14:48:00,14:48,13649775,8086775,-5563000,SELL
2020-09-23 14:49:00,14:49,13680875,8345350,-5335525,SELL
2020-09-23 14:50:00,14:50,13744800,8476725,-5268075,SELL
2020-09-23 14:51:00,14:51,13027650,8014850,-5012800,SELL
2020-09-23 14:52:00,14:52,13535450,8088875,-5446575,SELL
2020-09-23 14:53:00,14:53,13502025,7923550,-5578475,SELL
2020-09-23 14:54:00,14:54,13135250,8126825,-5008425,SELL
2020-09-23 14:55:00,14:55,12889675,8013675,-4876000,SELL
2020-09-23 14:56:00,14:56,13162350,8004850,-5157500,SELL
2020-09-23 14:57:00,14:57,12932150,8024675,-4907475,SELL
2020-09-23 14:58:00,14:58,13275525,7981225,-5294300,SELL
2020-09-23 14:59:00,14:59,13282975,8200525,-5082450,SELL
2020-09-23 15:00:00,15:00,13175325,7907025,-5268300,SELL
2020-09-23 15:01:00,15:01,13263400,8117625,-5145775,SELL
2020-09-23 15:02:00,15:02,13045550,8065225,-4980325,SELL
2020-09-23 15:03:00,15:03,13074000,7558500,-5515500,SELL
2020-09-23 15:04:00,15:04,13128650,8155125,-4973525,SELL
2020-09-23 15:05:00,15:05,13121075,7973650,-5147425,SELL
2020-09-23 15:06:00,15:06,12509725,7926025,-4583700,SELL
2020-09-23 15:07:00,15:07,12931025,7839950,-5091075,SELL
2020-09-23 15:08:00,15:08,13061175,8014725,-5046450,SELL
2020-09-23 15:09:00,15:09,12910125,8071600,-4838525,SELL
2020-09-23 15:10:00,15:10,12961850,8132175,-4829675,SELL
2020-09-23 15:11:00,15:11,12474850,7990725,-4484125,SELL
2020-09-23 15:12:00,15:12,12684225,7956900,-4727325,SELL
2020-09-23 15:13:00,15:13,12679525,7597500,-5082025,SELL
2020-09-23 15:14:00,15:14,12388825,7674175,-4714650,SELL
2020-09-23 15:15:00,15:15,12877500,7782500,-5095000,SELL
2020-09-23 15:16:00,15:16,12867925,7717650,-5150275,SELL
2020-09-23 15:17:00,15:17,12833400,7587675,-5245725,SELL
2020-09-23 15:18:00,15:18,12801600,7745500,-5056100,SELL
2020-09-23 15:19:00,15:19,12731875,7786050,-4945825,SELL
2020-09-23 15:20:00,15:20,12833950,7640550,-5193400,SELL
2020-09-23 15:21:00,15:21,12512700,7522875,-4989825,SELL
2020-09-23 15:22:00,15:22,12145825,7573850,-4571975,SELL
2020-09-23 15:23:00,15:23,12490475,7618150,-4872325,SELL
2020-09-23 15:24:00,15:24,12269750,7623075,-4646675,SELL
2020-09-23 15:25:00,15:25,12275100,7745275,-4529825,SELL
2020-09-23 15:26:00,15:26,12200350,7575350,-4625000,SELL
2020-09-23 15:27:00,15:27,11943600,7690775,-4252825,SELL
2020-09-23 15:28:00,15:28,11845750,7717400,-4128350,SELL
2020-09-23 15:29:00,15:29,12012800,7717400,-4295400,SELL
2020-09-24 09:15:00,09:15,11736325,6212075,-5524250,SELL
2020-09-24 09:16:00,09:16,11688725,7227250,-4461475,SELL
2020-09-24 09:17:00,09:17,11828475,7442375,-4386100,SELL
2020-09-24 09:18:00,09:18,11844050,7206125,-4637925,SELL
2020-09-24 09:19:00,09:19,11787950,7420025,-4367925,SELL
2020-09-24 09:20:00,09:20,12309450,7855700,-4453750,SELL
2020-09-24 09:21:00,09:21,12327775,7979475,-4348300,SELL
2020-09-24 09:22:00,09:22,12174775,7759825,-4414950,SELL
2020-09-24 09:23:00,09:23,13333000,8350075,-4982925,SELL
2020-09-24 09:24:00,09:24,13256875,8688550,-4568325,SELL
2020-09-24 09:25:00,09:25,13256525,8702375,-4554150,SELL
2020-09-24 09:26:00,09:26,13963325,8811025,-5152300,SELL
2020-09-24 09:27:00,09:27,13809400,8678275,-5131125,SELL
2020-09-24 09:28:00,09:28,14057800,8816150,-5241650,SELL
2020-09-24 09:29:00,09:29,14814225,9439125,-5375100,SELL
2020-09-24 09:30:00,09:30,14635425,8959500,-5675925,SELL
2020-09-24 09:31:00,09:31,14852750,9574000,-5278750,SELL
2020-09-24 09:32:00,09:32,15849075,9878700,-5970375,SELL
2020-09-24 09:33:00,09:33,15845625,9788450,-6057175,SELL
2020-09-24 09:34:00,09:34,15966250,10151000,-5815250,SELL
2020-09-24 09:35:00,09:35,16029500,10487075,-5542425,SELL
2020-09-24 09:36:00,09:36,15953100,10347525,-5605575,SELL
2020-09-24 09:37:00,09:37,16328150,10257850,-6070300,SELL
2020-09-24 09:38:00,09:38,16475800,10349475,-6126325,SELL
2020-09-24 09:39:00,09:39,16450300,10619200,-5831100,SELL
2020-09-24 09:40:00,09:40,16339400,10361925,-5977475,SELL
2020-09-24 09:41:00,09:41,16825750,11033950,-5791800,SELL
2020-09-24 09:42:00,09:42,16967125,11141425,-5825700,SELL
2020-09-24 09:43:00,09:43,16679000,10874800,-5804200,SELL
2020-09-24 09:44:00,09:44,17129150,11018725,-6110425,SELL
2020-09-24 09:45:00,09:45,17406975,11039225,-6367750,SELL
2020-09-24 09:47:00,09:47,16744000,11437050,-5306950,SELL
2020-09-24 09:48:00,09:48,17117225,11163825,-5953400,SELL
2020-09-24 09:49:00,09:49,17424525,11352450,-6072075,SELL
2020-09-24 09:50:00,09:50,17376925,11787475,-5589450,SELL
2020-09-24 09:51:00,09:51,17532500,11202675,-6329825,SELL
2020-09-24 09:52:00,09:52,17569025,11502200,-6066825,SELL
2020-09-24 09:53:00,09:53,17087400,11543925,-5543475,SELL
2020-09-24 09:54:00,09:54,17845425,11468900,-6376525,SELL
2020-09-24 09:55:00,09:55,17756575,11373550,-6383025,SELL
2020-09-24 09:56:00,09:56,18050425,11602150,-6448275,SELL
2020-09-24 09:57:00,09:57,18147650,11791050,-6356600,SELL
2020-09-24 09:58:00,09:58,17943025,11643025,-6300000,SELL
2020-09-24 09:59:00,09:59,17925225,11883750,-6041475,SELL
2020-09-24 10:00:00,10:00,18224825,12056850,-6167975,SELL
2020-09-24 10:01:00,10:01,17600750,11886700,-5714050,SELL
2020-09-24 10:02:00,10:02,18538550,11848950,-6689600,SELL
2020-09-24 10:03:00,10:03,18406150,11647450,-6758700,SELL
2020-09-24 10:04:00,10:04,18309475,11952750,-6356725,SELL
2020-09-24 10:05:00,10:05,18189825,12181175,-6008650,SELL
2020-09-24 10:06:00,10:06,18670925,12030100,-6640825,SELL
2020-09-24 10:07:00,10:07,18730800,11198075,-7532725,SELL
2020-09-24 10:08:00,10:08,18711050,12252525,-6458525,SELL
2020-09-24 10:09:00,10:09,18900875,12021875,-6879000,SELL
2020-09-24 10:10:00,10:10,18552925,12602000,-5950925,SELL
2020-09-24 10:11:00,10:11,18828575,12255500,-6573075,SELL
2020-09-24 10:12:00,10:12,18720975,11916475,-6804500,SELL
2020-09-24 10:13:00,10:13,18709750,12005475,-6704275,SELL
2020-09-24 10:14:00,10:14,18945700,12408500,-6537200,SELL
2020-09-24 10:15:00,10:15,18932650,12294875,-6637775,SELL
2020-09-24 10:16:00,10:16,18953375,12260350,-6693025,SELL
2020-09-24 10:17:00,10:17,19373350,12326475,-7046875,SELL
2020-09-24 10:18:00,10:18,19300050,12429800,-6870250,SELL
2020-09-24 10:19:00,10:19,19245750,12104825,-7140925,SELL
2020-09-24 10:20:00,10:20,19353500,12179575,-7173925,SELL
2020-09-24 10:21:00,10:21,19519475,12453450,-7066025,SELL
2020-09-24 10:22:00,10:22,18889550,12184750,-6704800,SELL
2020-09-24 10:23:00,10:23,19313625,12335525,-6978100,SELL
2020-09-24 10:24:00,10:24,18137625,12688750,-5448875,SELL
2020-09-24 10:25:00,10:25,19952950,12308825,-7644125,SELL
2020-09-24 10:26:00,10:26,19608800,12696625,-6912175,SELL
2020-09-24 10:27:00,10:27,19883200,12829700,-7053500,SELL
2020-09-24 10:28:00,10:28,19863025,12813425,-7049600,SELL
2020-09-24 10:29:00,10:29,19968875,12324800,-7644075,SELL
2020-09-24 10:30:00,10:30,20463300,12395650,-8067650,SELL
2020-09-24 10:31:00,10:31,20053250,11911425,-8141825,SELL
2020-09-24 10:32:00,10:32,20531475,12495950,-8035525,SELL
2020-09-24 10:33:00,10:33,20560900,12645200,-7915700,SELL
2020-09-24 10:34:00,10:34,20360000,12607500,-7752500,SELL
2020-09-24 10:35:00,10:35,20472850,12791375,-7681475,SELL
2020-09-24 10:36:00,10:36,20826375,11935925,-8890450,SELL
2020-09-24 10:37:00,10:37,20853175,12430200,-8422975,SELL
2020-09-24 10:38:00,10:38,20894950,12474050,-8420900,SELL
2020-09-24 10:39:00,10:39,20267700,12485075,-7782625,SELL
2020-09-24 10:40:00,10:40,20043200,12696925,-7346275,SELL
2020-09-24 10:41:00,10:41,20892625,12674775,-8217850,SELL
2020-09-24 10:42:00,10:42,20751400,12627675,-8123725,SELL
2020-09-24 10:43:00,10:43,20505950,12654000,-7851950,SELL
2020-09-24 10:44:00,10:44,21080050,12548375,-8531675,SELL
2020-09-24 10:45:00,10:45,20647175,12638000,-8009175,SELL
2020-09-24 10:46:00,10:46,20881700,12368475,-8513225,SELL
2020-09-24 10:47:00,10:47,20658150,13003275,-7654875,SELL
2020-09-24 10:48:00,10:48,20655175,12830650,-7824525,SELL
2020-09-24 10:49:00,10:49,20485400,12522450,-7962950,SELL
2020-09-24 10:50:00,10:50,21053875,12970300,-8083575,SELL
2020-09-24 10:51:00,10:51,21017225,12786475,-8230750,SELL
2020-09-24 10:52:00,10:52,20698400,13087950,-7610450,SELL
2020-09-24 10:53:00,10:53,21579525,12527225,-9052300,SELL
2020-09-24 10:54:00,10:54,21758550,12862775,-8895775,SELL
2020-09-24 10:55:00,10:55,21788500,13261625,-8526875,SELL
2020-09-24 10:56:00,10:56,21506500,13001350,-8505150,SELL
2020-09-24 10:57:00,10:57,21813250,12877475,-8935775,SELL
2020-09-24 10:58:00,10:58,21581625,13107925,-8473700,SELL
2020-09-24 10:59:00,10:59,21548075,13151200,-8396875,SELL
2020-09-24 11:00:00,11:00,21353600,13403650,-7949950,SELL
2020-09-24 11:01:00,11:01,21189475,13255400,-7934075,SELL
2020-09-24 11:02:00,11:02,21430100,13296675,-8133425,SELL
2020-09-24 11:03:00,11:03,21458775,12879275,-8579500,SELL
2020-09-24 11:04:00,11:04,21713150,12432775,-9280375,SELL
2020-09-24 11:05:00,11:05,21618475,13437575,-8180900,SELL
2020-09-24 11:06:00,11:06,21706250,13577750,-8128500,SELL
2020-09-24 11:07:00,11:07,21697200,13437500,-8259700,SELL
2020-09-24 11:08:00,11:08,21544750,13045125,-8499625,SELL
2020-09-24 11:09:00,11:09,21281975,12650250,-8631725,SELL
2020-09-24 11:10:00,11:10,20735375,13282800,-7452575,SELL
2020-09-24 11:11:00,11:11,21015225,13295025,-7720200,SELL
2020-09-24 11:12:00,11:12,21981725,13550300,-8431425,SELL
2020-09-24 11:13:00,11:13,21740225,13219050,-8521175,SELL
2020-09-24 11:14:00,11:14,20995425,13054050,-7941375,SELL
2020-09-24 11:15:00,11:15,21992800,13604750,-8388050,SELL
2020-09-24 11:16:00,11:16,22195500,13066750,-9128750,SELL
2020-09-24 11:17:00,11:17,22138875,13574200,-8564675,SELL
2020-09-24 11:18:00,11:18,21333700,13367175,-7966525,SELL
2020-09-24 11:19:00,11:19,22007450,13426550,-8580900,SELL
2020-09-24 11:20:00,11:20,21135900,13763300,-7372600,SELL
2020-09-24 11:21:00,11:21,21517700,13770675,-7747025,SELL
2020-09-24 11:22:00,11:22,22676000,13636725,-9039275,SELL
2020-09-24 11:23:00,11:23,22302075,13174225,-9127850,SELL
2020-09-24 11:24:00,11:24,22491175,13196975,-9294200,SELL
2020-09-24 11:25:00,11:25,21516475,13551700,-7964775,SELL
2020-09-24 11:26:00,11:26,22519900,13534200,-8985700,SELL
2020-09-24 11:27:00,11:27,21850975,13461875,-8389100,SELL
2020-09-24 11:28:00,11:28,22395350,13501200,-8894150,SELL
2020-09-24 11:29:00,11:29,22507775,13856850,-8650925,SELL
2020-09-24 11:30:00,11:30,21010700,13243775,-7766925,SELL
2020-09-24 11:31:00,11:31,22311350,13607775,-8703575,SELL
2020-09-24 11:32:00,11:32,21949250,14060600,-7888650,SELL
2020-09-24 11:33:00,11:33,22409850,14105500,-8304350,SELL
2020-09-24 11:34:00,11:34,21672775,13730000,-7942775,SELL
2020-09-24 11:35:00,11:35,22449175,13979275,-8469900,SELL
2020-09-24 11:36:00,11:36,22336850,13585225,-8751625,SELL
2020-09-24 11:37:00,11:37,21452850,13050450,-8402400,SELL
2020-09-24 11:38:00,11:38,21781500,13708675,-8072825,SELL
2020-09-24 11:39:00,11:39,22839150,13656450,-9182700,SELL
2020-09-24 11:40:00,11:40,21949450,13891200,-8058250,SELL
2020-09-24 11:41:00,11:41,21532500,13843550,-7688950,SELL
2020-09-24 11:42:00,11:42,22311500,13959350,-8352150,SELL
2020-09-24 11:43:00,11:43,22824625,13335425,-9489200,SELL
2020-09-24 11:44:00,11:44,23107350,13570750,-9536600,SELL
2020-09-24 11:45:00,11:45,23230700,13890625,-9340075,SELL
2020-09-24 11:46:00,11:46,23274775,14215975,-9058800,SELL
2020-09-24 11:47:00,11:47,23378450,14057475,-9320975,SELL
2020-09-24 11:48:00,11:48,23022650,13509725,-9512925,SELL
2020-09-24 11:49:00,11:49,22863250,14334525,-8528725,SELL
2020-09-24 11:50:00,11:50,23461825,13625475,-9836350,SELL
2020-09-24 11:51:00,11:51,23064325,13405225,-9659100,SELL
2020-09-24 11:52:00,11:52,22936900,13240850,-9696050,SELL
2020-09-24 11:53:00,11:53,23294450,13756425,-9538025,SELL
2020-09-24 11:54:00,11:54,22884625,13883750,-9000875,SELL
2020-09-24 11:55:00,11:55,22455175,14027725,-8427450,SELL
2020-09-24 11:56:00,11:56,23560025,13512675,-10047350,SELL
2020-09-24 11:57:00,11:57,23265550,13924625,-9340925,SELL
2020-09-24 11:58:00,11:58,22923750,13811375,-9112375,SELL
2020-09-24 11:59:00,11:59,23384825,13444125,-9940700,SELL
2020-09-24 12:00:00,12:00,23666800,14148300,-9518500,SELL
2020-09-24 12:01:00,12:01,23769400,14005700,-9763700,SELL
2020-09-24 12:02:00,12:02,23085375,14426150,-8659225,SELL
2020-09-24 12:03:00,12:03,23263350,14083750,-9179600,SELL
2020-09-24 12:04:00,12:04,23735700,13969975,-9765725,SELL
2020-09-24 12:05:00,12:05,23562975,13607525,-9955450,SELL
2020-09-24 12:06:00,12:06,22932900,14049575,-8883325,SELL
2020-09-24 12:07:00,12:07,23308650,13938575,-9370075,SELL
2020-09-24 12:08:00,12:08,23758175,14034575,-9723600,SELL
2020-09-24 12:09:00,12:09,22667500,13938100,-8729400,SELL
2020-09-24 12:10:00,12:10,21880750,14060050,-7820700,SELL
2020-09-24 12:11:00,12:11,23329675,14078575,-9251100,SELL
2020-09-24 12:12:00,12:12,23166025,13792625,-9373400,SELL
2020-09-24 12:13:00,12:13,22930100,13528475,-9401625,SELL
2020-09-24 12:14:00,12:14,23390100,14328375,-9061725,SELL
2020-09-24 12:15:00,12:15,23523000,13982900,-9540100,SELL
2020-09-24 12:16:00,12:16,23082500,13633725,-9448775,SELL
2020-09-24 12:17:00,12:17,22647325,13851300,-8796025,SELL
2020-09-24 12:18:00,12:18,23664550,14469425,-9195125,SELL
2020-09-24 12:19:00,12:19,23083375,14139150,-8944225,SELL
2020-09-24 12:20:00,12:20,23447350,14245675,-9201675,SELL
2020-09-24 12:21:00,12:21,22817100,13486500,-9330600,SELL
2020-09-24 12:22:00,12:22,23124500,13552300,-9572200,SELL
2020-09-24 12:23:00,12:23,22264000,13627525,-8636475,SELL
2020-09-24 12:24:00,12:24,23607525,13950150,-9657375,SELL
2020-09-24 12:25:00,12:25,23557625,13884575,-9673050,SELL
2020-09-24 12:26:00,12:26,23502600,13963525,-9539075,SELL
2020-09-24 12:27:00,12:27,22785900,13854525,-8931375,SELL
2020-09-24 12:28:00,12:28,23482350,13743175,-9739175,SELL
2020-09-24 12:29:00,12:29,23468050,13892500,-9575550,SELL
2020-09-24 12:30:00,12:30,23706275,13746675,-9959600,SELL
2020-09-24 12:31:00,12:31,23015350,14086750,-8928600,SELL
2020-09-24 12:32:00,12:32,23757950,13540475,-10217475,SELL
2020-09-24 12:33:00,12:33,23798025,13537150,-10260875,SELL
2020-09-24 12:34:00,12:34,22918600,12801575,-10117025,SELL
2020-09-24 12:35:00,12:35,24050575,13752425,-10298150,SELL
2020-09-24 12:36:00,12:36,23934500,13539875,-10394625,SELL
2020-09-24 12:37:00,12:37,24159575,14068700,-10090875,SELL
2020-09-24 12:38:00,12:38,23710250,13940575,-9769675,SELL
2020-09-24 12:39:00,12:39,23967275,13957450,-10009825,SELL
2020-09-24 12:40:00,12:40,23735650,13599200,-10136450,SELL
2020-09-24 12:41:00,12:41,22986150,13324025,-9662125,SELL
2020-09-24 12:42:00,12:42,23839175,13677525,-10161650,SELL
2020-09-24 12:43:00,12:43,22650150,13822825,-8827325,SELL
2020-09-24 12:44:00,12:44,23032525,13852350,-9180175,SELL
2020-09-24 12:45:00,12:45,23055275,13963450,-9091825,SELL
2020-09-24 12:46:00,12:46,22628750,13735725,-8893025,SELL
2020-09-24 12:47:00,12:47,22971050,13672825,-9298225,SELL
2020-09-24 12:48:00,12:48,22254850,13101050,-9153800,SELL
2020-09-24 12:49:00,12:49,23578375,14094350,-9484025,SELL
2020-09-24 12:50:00,12:50,23460500,14115225,-9345275,SELL
2020-09-24 12:51:00,12:51,24469700,13843775,-10625925,SELL
2020-09-24 12:52:00,12:52,24235675,14155350,-10080325,SELL
2020-09-24 12:53:00,12:53,23927150,14245425,-9681725,SELL
2020-09-24 12:54:00,12:54,23331975,14613300,-8718675,SELL
2020-09-24 12:55:00,12:55,24000900,13036650,-10964250,SELL
2020-09-24 12:56:00,12:56,23813800,14869325,-8944475,SELL
2020-09-24 12:57:00,12:57,24101775,14603225,-9498550,SELL
2020-09-24 12:58:00,12:58,22968925,14069200,-8899725,SELL
2020-09-24 12:59:00,12:59,24116225,14280800,-9835425,SELL
2020-09-24 13:00:00,13:00,22956450,14637700,-8318750,SELL
2020-09-24 13:01:00,13:01,23425925,14439700,-8986225,SELL
2020-09-24 13:02:00,13:02,23112600,14659850,-8452750,SELL
2020-09-24 13:03:00,13:03,24200625,14989675,-9210950,SELL
2020-09-24 13:04:00,13:04,23530450,14665050,-8865400,SELL
2020-09-24 13:05:00,13:05,23044300,14575425,-8468875,SELL
2020-09-24 13:06:00,13:06,23835525,14847450,-8988075,SELL
2020-09-24 13:07:00,13:07,23606100,13906125,-9699975,SELL
2020-09-24 13:08:00,13:08,23924900,14918025,-9006875,SELL
2020-09-24 13:09:00,13:09,24114825,14800975,-9313850,SELL
2020-09-24 13:10:00,13:10,23481150,14622875,-8858275,SELL
2020-09-24 13:11:00,13:11,22795775,14301225,-8494550,SELL
2020-09-24 13:12:00,13:12,23728075,14787525,-8940550,SELL
2020-09-24 13:13:00,13:13,23562475,14674150,-8888325,SELL
2020-09-24 13:14:00,13:14,24063200,14559675,-9503525,SELL
2020-09-24 13:15:00,13:15,23671675,14988350,-8683325,SELL
2020-09-24 13:16:00,13:16,23961400,14648975,-9312425,SELL
2020-09-24 13:17:00,13:17,24336475,15059750,-9276725,SELL
2020-09-24 13:18:00,13:18,22821250,14478225,-8343025,SELL
2020-09-24 13:19:00,13:19,23033625,14265175,-8768450,SELL
2020-09-24 13:20:00,13:20,22778125,14565700,-8212425,SELL
2020-09-24 13:21:00,13:21,23541350,14321425,-9219925,SELL
2020-09-24 13:22:00,13:22,22994475,14544875,-8449600,SELL
2020-09-24 13:23:00,13:23,22966125,13717075,-9249050,SELL
2020-09-24 13:24:00,13:24,24149925,14252100,-9897825,SELL
2020-09-24 13:25:00,13:25,23798500,14497175,-9301325,SELL
2020-09-24 13:26:00,13:26,23977325,14300425,-9676900,SELL
2020-09-24 13:27:00,13:27,23523625,14329425,-9194200,SELL
2020-09-24 13:28:00,13:28,23730925,13759700,-9971225,SELL
2020-09-24 13:29:00,13:29,23559450,14308450,-9251000,SELL
2020-09-24 13:30:00,13:30,23489575,14106300,-9383275,SELL
2020-09-24 13:31:00,13:31,23167250,14042125,-9125125,SELL
2020-09-24 13:32:00,13:32,24226975,14272075,-9954900,SELL
2020-09-24 13:33:00,13:33,23755225,14651000,-9104225,SELL
2020-09-24 13:34:00,13:34,22933925,13858100,-9075825,SELL
2020-09-24 13:35:00,13:35,23504350,14216425,-9287925,SELL
2020-09-24 13:36:00,13:36,23645600,13842175,-9803425,SELL
2020-09-24 13:37:00,13:37,23999900,13447275,-10552625,SELL
2020-09-24 13:38:00,13:38,24009875,13311750,-10698125,SELL
2020-09-24 13:39:00,13:39,22911000,13225250,-9685750,SELL
2020-09-24 13:40:00,13:40,23987500,14045575,-9941925,SELL
2020-09-24 13:41:00,13:41,24003000,13704875,-10298125,SELL
2020-09-24 13:42:00,13:42,24275925,13364850,-10911075,SELL
2020-09-24 13:43:00,13:43,23771200,13742625,-10028575,SELL
2020-09-24 13:44:00,13:44,24018250,13957825,-10060425,SELL
2020-09-24 13:45:00,13:45,24299450,13808025,-10491425,SELL
2020-09-24 13:46:00,13:46,24409825,12879725,-11530100,SELL
2020-09-24 13:47:00,13:47,22726450,13328075,-9398375,SELL
2020-09-24 13:48:00,13:48,23982375,13042225,-10940150,SELL
2020-09-24 13:49:00,13:49,24002025,13650275,-10351750,SELL
2020-09-24 13:50:00,13:50,24401850,13484200,-10917650,SELL
2020-09-24 13:51:00,13:51,22889600,13393825,-9495775,SELL
2020-09-24 13:52:00,13:52,24219200,13352625,-10866575,SELL
2020-09-24 13:53:00,13:53,24075250,13063100,-11012150,SELL
2020-09-24 13:54:00,13:54,24059325,13460325,-10599000,SELL
2020-09-24 13:55:00,13:55,23886625,13977775,-9908850,SELL
2020-09-24 13:56:00,13:56,24043550,13922700,-10120850,SELL
2020-09-24 13:57:00,13:57,24623400,12703050,-11920350,SELL
2020-09-24 13:58:00,13:58,24776300,12900900,-11875400,SELL
2020-09-24 13:59:00,13:59,24264925,12762625,-11502300,SELL
2020-09-24 14:00:00,14:00,24608550,12852350,-11756200,SELL
2020-09-24 14:01:00,14:01,25216175,12538475,-12677700,SELL
2020-09-24 14:02:00,14:02,24693700,12911050,-11782650,SELL
2020-09-24 14:03:00,14:03,24776325,12385175,-12391150,SELL
2020-09-24 14:04:00,14:04,24946575,12127200,-12819375,SELL
2020-09-24 14:05:00,14:05,25299300,11936250,-13363050,SELL
2020-09-24 14:06:00,14:06,25119950,12340275,-12779675,SELL
2020-09-24 14:07:00,14:07,25154050,12042575,-13111475,SELL
2020-09-24 14:08:00,14:08,25156625,12289150,-12867475,SELL
2020-09-24 14:09:00,14:09,24596350,12036425,-12559925,SELL
2020-09-24 14:10:00,14:10,24755675,12312325,-12443350,SELL
2020-09-24 14:11:00,14:11,24873700,12221450,-12652250,SELL
2020-09-24 14:12:00,14:12,23552400,12063800,-11488600,SELL
2020-09-24 14:13:00,14:13,25130850,12665150,-12465700,SELL
2020-09-24 14:14:00,14:14,24795725,12719125,-12076600,SELL
2020-09-24 14:15:00,14:15,24888700,13067850,-11820850,SELL
2020-09-24 14:16:00,14:16,24969125,13017475,-11951650,SELL
2020-09-24 14:17:00,14:17,24815450,13136500,-11678950,SELL
2020-09-24 14:18:00,14:18,24609125,12165600,-12443525,SELL
2020-09-24 14:19:00,14:19,24269875,12714350,-11555525,SELL
2020-09-24 14:20:00,14:20,24788750,13156625,-11632125,SELL
2020-09-24 14:21:00,14:21,23167400,12756300,-10411100,SELL
2020-09-24 14:22:00,14:22,23942525,12359000,-11583525,SELL
2020-09-24 14:23:00,14:23,23990375,12735100,-11255275,SELL
2020-09-24 14:24:00,14:24,24188275,12829200,-11359075,SELL
2020-09-24 14:25:00,14:25,23965525,13113575,-10851950,SELL
2020-09-24 14:26:00,14:26,23963675,12586675,-11377000,SELL
2020-09-24 14:27:00,14:27,24252900,12689200,-11563700,SELL
2020-09-24 14:28:00,14:28,24400075,12675675,-11724400,SELL
2020-09-24 14:29:00,14:29,23808175,12582600,-11225575,SELL
2020-09-24 14:30:00,14:30,24246525,12507725,-11738800,SELL
2020-09-24 14:31:00,14:31,24044275,12315300,-11728975,SELL
2020-09-24 14:32:00,14:32,24504250,12788400,-11715850,SELL
2020-09-24 14:33:00,14:33,24138525,13271500,-10867025,SELL
2020-09-24 14:34:00,14:34,24361000,12839225,-11521775,SELL
2020-09-24 14:35:00,14:35,24872175,13074050,-11798125,SELL
2020-09-24 14:36:00,14:36,24680075,12681775,-11998300,SELL
2020-09-24 14:37:00,14:37,23963175,12643475,-11319700,SELL
2020-09-24 14:38:00,14:38,24211100,12786675,-11424425,SELL
2020-09-24 14:39:00,14:39,24565475,13071875,-11493600,SELL
2020-09-24 14:40:00,14:40,24714125,12573750,-12140375,SELL
2020-09-24 14:41:00,14:41,23340900,12320150,-11020750,SELL
2020-09-24 14:42:00,14:42,23580900,12594425,-10986475,SELL
2020-09-24 14:43:00,14:43,23978175,12321575,-11656600,SELL
2020-09-24 14:44:00,14:44,24704650,12248225,-12456425,SELL
2020-09-24 14:45:00,14:45,24295275,12673300,-11621975,SELL
2020-09-24 14:46:00,14:46,24336100,12656750,-11679350,SELL
2020-09-24 14:47:00,14:47,24207450,12700850,-11506600,SELL
2020-09-24 14:48:00,14:48,24552175,12469175,-12083000,SELL
2020-09-24 14:49:00,14:49,24522800,12443775,-12079025,SELL
2020-09-24 14:50:00,14:50,24155500,12750650,-11404850,SELL
2020-09-24 14:51:00,14:51,23506050,12601275,-10904775,SELL
2020-09-24 14:52:00,14:52,24240000,12639975,-11600025,SELL
2020-09-24 14:53:00,14:53,24268375,12896875,-11371500,SELL
2020-09-24 14:54:00,14:54,24042000,12627975,-11414025,SELL
2020-09-24 14:55:00,14:55,23713000,12593700,-11119300,SELL
2020-09-24 14:56:00,14:56,24059425,12824125,-11235300,SELL
2020-09-24 14:57:00,14:57,23834450,11957625,-11876825,SELL
2020-09-24 14:58:00,14:58,23782200,11992675,-11789525,SELL
2020-09-24 14:59:00,14:59,23763725,11979650,-11784075,SELL
2020-09-24 15:00:00,15:00,23244425,11846300,-11398125,SELL
2020-09-24 15:01:00,15:01,23536225,11779975,-11756250,SELL
2020-09-24 15:02:00,15:02,23556975,11891475,-11665500,SELL
2020-09-24 15:03:00,15:03,23665625,12107925,-11557700,SELL
2020-09-24 15:04:00,15:04,23556025,12040275,-11515750,SELL
2020-09-24 15:05:00,15:05,23598850,11772650,-11826200,SELL
2020-09-24 15:06:00,15:06,23285125,11353950,-11931175,SELL
2020-09-24 15:07:00,15:07,23574825,11401100,-12173725,SELL
2020-09-24 15:08:00,15:08,23423850,11394475,-12029375,SELL
2020-09-24 15:09:00,15:09,23079550,10136725,-12942825,SELL
2020-09-24 15:10:00,15:10,23141175,9923825,-13217350,SELL
2020-09-24 15:11:00,15:11,22844675,8881750,-13962925,SELL
2020-09-24 15:12:00,15:12,22749850,9907175,-12842675,SELL
2020-09-24 15:13:00,15:13,22921500,9721850,-13199650,SELL
2020-09-24 15:14:00,15:14,23018875,9769650,-13249225,SELL
2020-09-24 15:15:00,15:15,22448725,9436575,-13012150,SELL
2020-09-24 15:16:00,15:16,22088450,9250400,-12838050,SELL
2020-09-24 15:17:00,15:17,22302600,9403650,-12898950,SELL
2020-09-24 15:18:00,15:18,21036625,8724550,-12312075,SELL
2020-09-24 15:19:00,15:19,21022800,8270400,-12752400,SELL
2020-09-24 15:20:00,15:20,20887175,8478025,-12409150,SELL
2020-09-24 15:21:00,15:21,18537625,7556200,-10981425,SELL
2020-09-24 15:22:00,15:22,18356850,7791825,-10565025,SELL
2020-09-24 15:23:00,15:23,18591100,6992500,-11598600,SELL
2020-09-24 15:24:00,15:24,17718975,6778475,-10940500,SELL
2020-09-24 15:25:00,15:25,17610600,7221225,-10389375,SELL
2020-09-24 15:26:00,15:26,17763250,6743050,-11020200,SELL
2020-09-24 15:27:00,15:27,15816075,6054225,-9761850,SELL
2020-09-24 15:28:00,15:28,16038100,6502350,-9535750,SELL
2020-09-24 15:29:00,15:29,15865525,6467925,-9397600,SELL
