,timestamp,call,put,diff,sellOrBuy
2020-09-25 09:15:00,09:15,4420200,2262225,-2157975,SELL
2020-09-25 09:16:00,09:16,4420200,2121425,-2298775,SELL
2020-09-25 09:17:00,09:17,4523975,2327150,-2196825,SELL
2020-09-25 09:18:00,09:18,4523025,2325750,-2197275,SELL
2020-09-25 09:19:00,09:19,4524425,2331050,-2193375,SELL
2020-09-25 09:20:00,09:20,4805325,2762425,-2042900,SELL
2020-09-25 09:21:00,09:21,4806725,2703775,-2102950,SELL
2020-09-25 09:22:00,09:22,4806725,2688275,-2118450,SELL
2020-09-25 09:23:00,09:23,4939825,2839850,-2099975,SELL
2020-09-25 09:24:00,09:24,4939800,2769925,-2169875,SELL
2020-09-25 09:25:00,09:25,4939800,2881850,-2057950,SELL
2020-09-25 09:26:00,09:26,5022725,2937950,-2084775,SELL
2020-09-25 09:27:00,09:27,5013925,2937225,-2076700,SELL
2020-09-25 09:28:00,09:28,5021675,2950900,-2070775,SELL
2020-09-25 09:29:00,09:29,5068975,3034425,-2034550,SELL
2020-09-25 09:30:00,09:30,5066875,3031550,-2035325,SELL
2020-09-25 09:31:00,09:31,5067375,3049775,-2017600,SELL
2020-09-25 09:32:00,09:32,5136925,3175575,-1961350,SELL
2020-09-25 09:33:00,09:33,5137400,3195300,-1942100,SELL
2020-09-25 09:34:00,09:34,5137425,3067675,-2069750,SELL
2020-09-25 09:35:00,09:35,5093750,3129350,-1964400,SELL
2020-09-25 09:36:00,09:36,5092125,3162775,-1929350,SELL
2020-09-25 09:37:00,09:37,5092125,3190025,-1902100,SELL
2020-09-25 09:38:00,09:38,5180725,3135375,-2045350,SELL
2020-09-25 09:39:00,09:39,5193125,3247075,-1946050,SELL
2020-09-25 09:40:00,09:40,5190875,3160675,-2030200,SELL
2020-09-25 09:41:00,09:41,5248900,3265075,-1983825,SELL
2020-09-25 09:42:00,09:42,5250025,3219175,-2030850,SELL
2020-09-25 09:43:00,09:43,5248400,3300675,-1947725,SELL
2020-09-25 09:44:00,09:44,5306325,3231175,-2075150,SELL
2020-09-25 09:45:00,09:45,5305350,3297550,-2007800,SELL
2020-09-25 09:46:00,09:46,5304175,3297750,-2006425,SELL
2020-09-25 09:47:00,09:47,5387625,3340400,-2047225,SELL
2020-09-25 09:48:00,09:48,5380400,3180275,-2200125,SELL
2020-09-25 09:49:00,09:49,5391275,3358050,-2033225,SELL
2020-09-25 09:50:00,09:50,5449750,3465300,-1984450,SELL
2020-09-25 09:51:00,09:51,5444725,3425450,-2019275,SELL
2020-09-25 09:52:00,09:52,5444725,3338675,-2106050,SELL
2020-09-25 09:53:00,09:53,5459850,3366950,-2092900,SELL
2020-09-25 09:54:00,09:54,5499025,3467475,-2031550,SELL
2020-09-25 09:55:00,09:55,5505275,3430975,-2074300,SELL
2020-09-25 09:56:00,09:56,5519725,3495925,-2023800,SELL
2020-09-25 09:57:00,09:57,5559025,3522525,-2036500,SELL
2020-09-25 09:58:00,09:58,5548150,3511950,-2036200,SELL
2020-09-25 09:59:00,09:59,5588975,3428050,-2160925,SELL
2020-09-25 10:00:00,10:00,5580850,3506075,-2074775,SELL
2020-09-25 10:01:00,10:01,5586100,3438775,-2147325,SELL
2020-09-25 10:02:00,10:02,5666450,3364225,-2302225,SELL
2020-09-25 10:03:00,10:03,5659350,3426375,-2232975,SELL
2020-09-25 10:04:00,10:04,5670375,3593025,-2077350,SELL
2020-09-25 10:05:00,10:05,5695750,3531750,-2164000,SELL
2020-09-25 10:06:00,10:06,5694525,3537775,-2156750,SELL
2020-09-25 10:07:00,10:07,5698775,3455000,-2243775,SELL
2020-09-25 10:08:00,10:08,5784950,3556250,-2228700,SELL
2020-09-25 10:09:00,10:09,5789075,3521525,-2267550,SELL
2020-09-25 10:10:00,10:10,5777775,3521525,-2256250,SELL
2020-09-25 10:11:00,10:11,5820775,3634075,-2186700,SELL
2020-09-25 10:12:00,10:12,5817175,3565575,-2251600,SELL
2020-09-25 10:13:00,10:13,5816525,3540225,-2276300,SELL
2020-09-25 10:14:00,10:14,5804575,3423350,-2381225,SELL
2020-09-25 10:15:00,10:15,5836625,3567450,-2269175,SELL
2020-09-25 10:16:00,10:16,5831000,3537175,-2293825,SELL
2020-09-25 10:17:00,10:17,5845975,3698425,-2147550,SELL
2020-09-25 10:18:00,10:18,5887675,3745950,-2141725,SELL
2020-09-25 10:19:00,10:19,5883325,3725750,-2157575,SELL
2020-09-25 10:20:00,10:20,5937350,3711200,-2226150,SELL
2020-09-25 10:21:00,10:21,5935925,3509000,-2426925,SELL
2020-09-25 10:22:00,10:22,5935925,3706125,-2229800,SELL
2020-09-25 10:23:00,10:23,5916025,3698875,-2217150,SELL
2020-09-25 10:24:00,10:24,5928150,3645125,-2283025,SELL
2020-09-25 10:25:00,10:25,5896825,3760875,-2135950,SELL
2020-09-25 10:26:00,10:26,5875350,3675975,-2199375,SELL
2020-09-25 10:27:00,10:27,5860100,3583250,-2276850,SELL
2020-09-25 10:28:00,10:28,5860100,3662350,-2197750,SELL
2020-09-25 10:29:00,10:29,5867950,3791450,-2076500,SELL
2020-09-25 10:30:00,10:30,5881275,3820075,-2061200,SELL
2020-09-25 10:31:00,10:31,5877600,3809475,-2068125,SELL
2020-09-25 10:32:00,10:32,5854025,3666600,-2187425,SELL
2020-09-25 10:33:00,10:33,5840375,3691625,-2148750,SELL
2020-09-25 10:34:00,10:34,5883100,3676375,-2206725,SELL
2020-09-25 10:35:00,10:35,5941450,3677700,-2263750,SELL
2020-09-25 10:36:00,10:36,5945825,3560800,-2385025,SELL
2020-09-25 10:37:00,10:37,5899450,3677700,-2221750,SELL
2020-09-25 10:38:00,10:38,5933725,3713625,-2220100,SELL
2020-09-25 10:39:00,10:39,5937950,3723375,-2214575,SELL
2020-09-25 10:40:00,10:40,5916500,3738825,-2177675,SELL
2020-09-25 10:41:00,10:41,5949100,3698425,-2250675,SELL
2020-09-25 10:42:00,10:42,5861350,3920300,-1941050,SELL
2020-09-25 10:43:00,10:43,5898550,3763075,-2135475,SELL
2020-09-25 10:44:00,10:44,5947075,3810200,-2136875,SELL
2020-09-25 10:45:00,10:45,5947950,3732950,-2215000,SELL
2020-09-25 10:46:00,10:46,5965150,3732950,-2232200,SELL
2020-09-25 10:47:00,10:47,5993975,3879325,-2114650,SELL
2020-09-25 10:48:00,10:48,5925650,3838875,-2086775,SELL
2020-09-25 10:49:00,10:49,5950050,3692225,-2257825,SELL
2020-09-25 10:50:00,10:50,5994700,3860075,-2134625,SELL
2020-09-25 10:51:00,10:51,5960800,3865325,-2095475,SELL
2020-09-25 10:52:00,10:52,6007100,3960900,-2046200,SELL
2020-09-25 10:53:00,10:53,6019175,3873350,-2145825,SELL
2020-09-25 10:54:00,10:54,5981350,3934200,-2047150,SELL
2020-09-25 10:55:00,10:55,6028325,3956925,-2071400,SELL
2020-09-25 10:56:00,10:56,5998200,3853225,-2144975,SELL
2020-09-25 10:57:00,10:57,5990275,4015475,-1974800,SELL
2020-09-25 10:58:00,10:58,5970825,3754150,-2216675,SELL
2020-09-25 10:59:00,10:59,6072275,3923075,-2149200,SELL
2020-09-25 11:00:00,11:00,6098850,3929775,-2169075,SELL
2020-09-25 11:01:00,11:01,6122400,3860675,-2261725,SELL
2020-09-25 11:02:00,11:02,6059300,4020700,-2038600,SELL
2020-09-25 11:03:00,11:03,6053350,3929850,-2123500,SELL
2020-09-25 11:04:00,11:04,6127000,3943500,-2183500,SELL
2020-09-25 11:05:00,11:05,6099275,3946350,-2152925,SELL
2020-09-25 11:06:00,11:06,6070025,3862500,-2207525,SELL
2020-09-25 11:07:00,11:07,6088125,4019750,-2068375,SELL
2020-09-25 11:08:00,11:08,6104525,4039625,-2064900,SELL
2020-09-25 11:09:00,11:09,6136250,4008925,-2127325,SELL
2020-09-25 11:10:00,11:10,6119800,4132225,-1987575,SELL
2020-09-25 11:11:00,11:11,6148725,4132275,-2016450,SELL
2020-09-25 11:12:00,11:12,6190125,4134250,-2055875,SELL
2020-09-25 11:13:00,11:13,6177800,4089375,-2088425,SELL
2020-09-25 11:14:00,11:14,6177200,4181475,-1995725,SELL
2020-09-25 11:15:00,11:15,6189600,4139550,-2050050,SELL
2020-09-25 11:16:00,11:16,6185925,4145150,-2040775,SELL
2020-09-25 11:17:00,11:17,6227700,4204575,-2023125,SELL
2020-09-25 11:18:00,11:18,6237525,4312275,-1925250,SELL
2020-09-25 11:19:00,11:19,6182100,4189150,-1992950,SELL
2020-09-25 11:20:00,11:20,6256525,4162325,-2094200,SELL
2020-09-25 11:21:00,11:21,6242525,4234850,-2007675,SELL
2020-09-25 11:22:00,11:22,6234275,4212125,-2022150,SELL
2020-09-25 11:23:00,11:23,6265625,4197425,-2068200,SELL
2020-09-25 11:24:00,11:24,6213200,4329425,-1883775,SELL
2020-09-25 11:25:00,11:25,6266225,4221925,-2044300,SELL
2020-09-25 11:26:00,11:26,6277475,4196650,-2080825,SELL
2020-09-25 11:27:00,11:27,6325175,4357775,-1967400,SELL
2020-09-25 11:28:00,11:28,6325050,4242600,-2082450,SELL
2020-09-25 11:29:00,11:29,6208950,4263825,-1945125,SELL
2020-09-25 11:30:00,11:30,6209025,4360800,-1848225,SELL
2020-09-25 11:31:00,11:31,6205575,4259075,-1946500,SELL
2020-09-25 11:32:00,11:32,6231975,4301425,-1930550,SELL
2020-09-25 11:33:00,11:33,6214775,4138350,-2076425,SELL
2020-09-25 11:34:00,11:34,6160950,4270000,-1890950,SELL
2020-09-25 11:35:00,11:35,6266650,4366825,-1899825,SELL
2020-09-25 11:36:00,11:36,6267925,4403450,-1864475,SELL
2020-09-25 11:37:00,11:37,6274650,4224350,-2050300,SELL
2020-09-25 11:38:00,11:38,6340950,4368425,-1972525,SELL
2020-09-25 11:39:00,11:39,6312775,4320225,-1992550,SELL
2020-09-25 11:40:00,11:40,6281600,4282200,-1999400,SELL
2020-09-25 11:41:00,11:41,6326075,4284500,-2041575,SELL
2020-09-25 11:42:00,11:42,6314750,4307025,-2007725,SELL
2020-09-25 11:43:00,11:43,6320775,4269525,-2051250,SELL
2020-09-25 11:44:00,11:44,6339925,4172600,-2167325,SELL
2020-09-25 11:45:00,11:45,6372550,4362725,-2009825,SELL
2020-09-25 11:46:00,11:46,6356500,4204375,-2152125,SELL
2020-09-25 11:47:00,11:47,6319825,4226625,-2093200,SELL
2020-09-25 11:48:00,11:48,6401600,4327125,-2074475,SELL
2020-09-25 11:49:00,11:49,6379525,4282425,-2097100,SELL
2020-09-25 11:50:00,11:50,6340700,4343775,-1996925,SELL
2020-09-25 11:51:00,11:51,6389675,4177450,-2212225,SELL
2020-09-25 11:52:00,11:52,6363500,4237225,-2126275,SELL
2020-09-25 11:53:00,11:53,6435250,4271650,-2163600,SELL
2020-09-25 11:54:00,11:54,6414575,4334300,-2080275,SELL
2020-09-25 11:55:00,11:55,6408450,4303700,-2104750,SELL
2020-09-25 11:56:00,11:56,6331500,4379925,-1951575,SELL
2020-09-25 11:57:00,11:57,6398575,4286025,-2112550,SELL
2020-09-25 11:58:00,11:58,6367625,4162450,-2205175,SELL
2020-09-25 11:59:00,11:59,6481850,4426225,-2055625,SELL
2020-09-25 12:00:00,12:00,6441025,4294550,-2146475,SELL
2020-09-25 12:01:00,12:01,6483175,4343400,-2139775,SELL
2020-09-25 12:02:00,12:02,6477375,4342675,-2134700,SELL
2020-09-25 12:03:00,12:03,6462450,4425250,-2037200,SELL
2020-09-25 12:04:00,12:04,6459725,4303725,-2156000,SELL
2020-09-25 12:05:00,12:05,6516675,4308225,-2208450,SELL
2020-09-25 12:06:00,12:06,6452700,4350625,-2102075,SELL
2020-09-25 12:07:00,12:07,6484200,4328325,-2155875,SELL
2020-09-25 12:08:00,12:08,6516950,4413100,-2103850,SELL
2020-09-25 12:09:00,12:09,6505325,4459525,-2045800,SELL
2020-09-25 12:10:00,12:10,6505325,4450550,-2054775,SELL
2020-09-25 12:11:00,12:11,6512925,4392925,-2120000,SELL
2020-09-25 12:12:00,12:12,6540350,4516625,-2023725,SELL
2020-09-25 12:13:00,12:13,6524200,4486025,-2038175,SELL
2020-09-25 12:14:00,12:14,6528025,4556000,-1972025,SELL
2020-09-25 12:15:00,12:15,6533775,4515750,-2018025,SELL
2020-09-25 12:16:00,12:16,6526425,4498325,-2028100,SELL
2020-09-25 12:17:00,12:17,6389325,4495075,-1894250,SELL
2020-09-25 12:18:00,12:18,6388875,4398450,-1990425,SELL
2020-09-25 12:19:00,12:19,6388050,4401050,-1987000,SELL
2020-09-25 12:20:00,12:20,6433425,4649675,-1783750,SELL
2020-09-25 12:21:00,12:21,6433425,4617275,-1816150,SELL
2020-09-25 12:22:00,12:22,6429025,4581950,-1847075,SELL
2020-09-25 12:23:00,12:23,6049075,4520025,-1529050,SELL
2020-09-25 12:24:00,12:24,6050950,4446700,-1604250,SELL
2020-09-25 12:25:00,12:25,6050950,4535325,-1515625,SELL
2020-09-25 12:26:00,12:26,6144300,4529525,-1614775,SELL
2020-09-25 12:27:00,12:27,6149950,4609350,-1540600,SELL
2020-09-25 12:28:00,12:28,6144725,4542300,-1602425,SELL
2020-09-25 12:29:00,12:29,5941375,4613375,-1328000,SELL
2020-09-25 12:30:00,12:30,5948575,4644100,-1304475,SELL
2020-09-25 12:31:00,12:31,5943975,4526050,-1417925,SELL
2020-09-25 12:32:00,12:32,6035825,4666350,-1369475,SELL
2020-09-25 12:33:00,12:33,6036775,4630850,-1405925,SELL
2020-09-25 12:34:00,12:34,6035800,4624250,-1411550,SELL
2020-09-25 12:35:00,12:35,6081700,4664475,-1417225,SELL
2020-09-25 12:36:00,12:36,6078100,4695100,-1383000,SELL
2020-09-25 12:37:00,12:37,6075475,4659575,-1415900,SELL
2020-09-25 12:38:00,12:38,6118600,4598900,-1519700,SELL
2020-09-25 12:39:00,12:39,6119050,4605125,-1513925,SELL
2020-09-25 12:40:00,12:40,6119050,4641425,-1477625,SELL
2020-09-25 12:41:00,12:41,6143350,4615000,-1528350,SELL
2020-09-25 12:42:00,12:42,6132850,4629575,-1503275,SELL
2020-09-25 12:43:00,12:43,6123450,4637000,-1486450,SELL
2020-09-25 12:44:00,12:44,6051450,4743900,-1307550,SELL
2020-09-25 12:45:00,12:45,6051300,4710675,-1340625,SELL
2020-09-25 12:46:00,12:46,6057150,4628425,-1428725,SELL
2020-09-25 12:47:00,12:47,6067300,4609775,-1457525,SELL
2020-09-25 12:48:00,12:48,6068900,4655425,-1413475,SELL
2020-09-25 12:49:00,12:49,6068900,4647250,-1421650,SELL
2020-09-25 12:50:00,12:50,6082525,4748075,-1334450,SELL
2020-09-25 12:51:00,12:51,6083525,4676475,-1407050,SELL
2020-09-25 12:52:00,12:52,6089050,4634550,-1454500,SELL
2020-09-25 12:53:00,12:53,6091425,4776625,-1314800,SELL
2020-09-25 12:54:00,12:54,6055925,4738825,-1317100,SELL
2020-09-25 12:55:00,12:55,6084900,4691100,-1393800,SELL
2020-09-25 12:56:00,12:56,6129400,4696950,-1432450,SELL
2020-09-25 12:57:00,12:57,6122825,4753450,-1369375,SELL
2020-09-25 12:58:00,12:58,6126125,4662125,-1464000,SELL
2020-09-25 12:59:00,12:59,6148275,4779950,-1368325,SELL
2020-09-25 13:00:00,13:00,6153300,4780300,-1373000,SELL
2020-09-25 13:01:00,13:01,6115350,4707925,-1407425,SELL
2020-09-25 13:02:00,13:02,6071500,4740150,-1331350,SELL
2020-09-25 13:03:00,13:03,6151000,4670425,-1480575,SELL
2020-09-25 13:04:00,13:04,6118325,4752275,-1366050,SELL
2020-09-25 13:05:00,13:05,6174150,4802850,-1371300,SELL
2020-09-25 13:06:00,13:06,6142875,4730075,-1412800,SELL
2020-09-25 13:07:00,13:07,6154325,4668250,-1486075,SELL
2020-09-25 13:08:00,13:08,6152825,4674975,-1477850,SELL
2020-09-25 13:09:00,13:09,6109875,4730500,-1379375,SELL
2020-09-25 13:10:00,13:10,6151450,4698375,-1453075,SELL
2020-09-25 13:11:00,13:11,6130050,4732975,-1397075,SELL
2020-09-25 13:12:00,13:12,6196725,4676700,-1520025,SELL
2020-09-25 13:13:00,13:13,6162825,4673850,-1488975,SELL
2020-09-25 13:14:00,13:14,6203400,4676275,-1527125,SELL
2020-09-25 13:15:00,13:15,6216900,4672475,-1544425,SELL
2020-09-25 13:16:00,13:16,6222975,4713250,-1509725,SELL
2020-09-25 13:17:00,13:17,6222975,4635825,-1587150,SELL
2020-09-25 13:18:00,13:18,6242400,4670100,-1572300,SELL
2020-09-25 13:19:00,13:19,6224625,4478675,-1745950,SELL
2020-09-25 13:20:00,13:20,6245750,4710025,-1535725,SELL
2020-09-25 13:21:00,13:21,6258600,4661250,-1597350,SELL
2020-09-25 13:22:00,13:22,6271175,4628750,-1642425,SELL
2020-09-25 13:23:00,13:23,6245175,4661250,-1583925,SELL
2020-09-25 13:24:00,13:24,6310025,4715400,-1594625,SELL
2020-09-25 13:25:00,13:25,6305575,4655850,-1649725,SELL
2020-09-25 13:26:00,13:26,6310025,4659650,-1650375,SELL
2020-09-25 13:27:00,13:27,6289675,4803775,-1485900,SELL
2020-09-25 13:28:00,13:28,6325050,4670975,-1654075,SELL
2020-09-25 13:29:00,13:29,6338625,4684725,-1653900,SELL
2020-09-25 13:30:00,13:30,6324825,4689350,-1635475,SELL
2020-09-25 13:31:00,13:31,6307325,4708775,-1598550,SELL
2020-09-25 13:32:00,13:32,6323775,4681550,-1642225,SELL
2020-09-25 13:33:00,13:33,6313725,4690975,-1622750,SELL
2020-09-25 13:34:00,13:34,6313725,4781525,-1532200,SELL
2020-09-25 13:35:00,13:35,6318225,4663775,-1654450,SELL
2020-09-25 13:36:00,13:36,6302850,4744550,-1558300,SELL
2020-09-25 13:37:00,13:37,6308525,4749650,-1558875,SELL
2020-09-25 13:38:00,13:38,6302850,4755950,-1546900,SELL
2020-09-25 13:39:00,13:39,6355200,4788825,-1566375,SELL
2020-09-25 13:40:00,13:40,6362975,4714750,-1648225,SELL
2020-09-25 13:41:00,13:41,6377650,4801350,-1576300,SELL
2020-09-25 13:42:00,13:42,6376850,4752500,-1624350,SELL
2020-09-25 13:43:00,13:43,6373700,4684275,-1689425,SELL
2020-09-25 13:44:00,13:44,6376850,4685025,-1691825,SELL
2020-09-25 13:45:00,13:45,6431875,4785250,-1646625,SELL
2020-09-25 13:46:00,13:46,6434550,4785250,-1649300,SELL
2020-09-25 13:47:00,13:47,6439450,4707525,-1731925,SELL
2020-09-25 13:48:00,13:48,6388550,4759175,-1629375,SELL
2020-09-25 13:49:00,13:49,6388550,4660175,-1728375,SELL
2020-09-25 13:50:00,13:50,6290550,4722275,-1568275,SELL
2020-09-25 13:51:00,13:51,6374625,4695550,-1679075,SELL
2020-09-25 13:52:00,13:52,6360025,4690400,-1669625,SELL
2020-09-25 13:53:00,13:53,6375375,4685200,-1690175,SELL
2020-09-25 13:54:00,13:54,6424500,4795275,-1629225,SELL
2020-09-25 13:55:00,13:55,6433400,4792350,-1641050,SELL
2020-09-25 13:56:00,13:56,6386450,4714300,-1672150,SELL
2020-09-25 13:57:00,13:57,6381325,4809100,-1572225,SELL
2020-09-25 13:58:00,13:58,6326075,4761850,-1564225,SELL
2020-09-25 13:59:00,13:59,6407900,4580700,-1827200,SELL
2020-09-25 14:00:00,14:00,6453350,4794725,-1658625,SELL
2020-09-25 14:01:00,14:01,6445675,4720550,-1725125,SELL
2020-09-25 14:02:00,14:02,6445675,4818875,-1626800,SELL
2020-09-25 14:03:00,14:03,6397650,4820250,-1577400,SELL
2020-09-25 14:04:00,14:04,6380950,4803175,-1577775,SELL
2020-09-25 14:05:00,14:05,6447925,4737225,-1710700,SELL
2020-09-25 14:06:00,14:06,6390925,4769425,-1621500,SELL
2020-09-25 14:07:00,14:07,6415975,4781000,-1634975,SELL
2020-09-25 14:08:00,14:08,6360375,4894100,-1466275,SELL
2020-09-25 14:09:00,14:09,6419075,4794000,-1625075,SELL
2020-09-25 14:10:00,14:10,6475800,4913850,-1561950,SELL
2020-09-25 14:11:00,14:11,6475500,4911200,-1564300,SELL
2020-09-25 14:12:00,14:12,6347700,4729900,-1617800,SELL
2020-09-25 14:13:00,14:13,6345125,4810100,-1535025,SELL
2020-09-25 14:14:00,14:14,6353875,4810200,-1543675,SELL
2020-09-25 14:15:00,14:15,6337975,4889375,-1448600,SELL
2020-09-25 14:16:00,14:16,6330375,4846825,-1483550,SELL
2020-09-25 14:17:00,14:17,6325275,4879625,-1445650,SELL
2020-09-25 14:18:00,14:18,6316100,4863225,-1452875,SELL
2020-09-25 14:19:00,14:19,6317275,4864550,-1452725,SELL
2020-09-25 14:20:00,14:20,6309700,4780850,-1528850,SELL
2020-09-25 14:21:00,14:21,6340525,4912075,-1428450,SELL
2020-09-25 14:22:00,14:22,6340525,4877400,-1463125,SELL
2020-09-25 14:23:00,14:23,6308175,4853025,-1455150,SELL
2020-09-25 14:24:00,14:24,6357250,4915375,-1441875,SELL
2020-09-25 14:25:00,14:25,6349625,4830150,-1519475,SELL
2020-09-25 14:26:00,14:26,6358600,4951550,-1407050,SELL
2020-09-25 14:27:00,14:27,6277125,4932775,-1344350,SELL
2020-09-25 14:28:00,14:28,6269550,4962575,-1306975,SELL
2020-09-25 14:29:00,14:29,6277450,5000725,-1276725,SELL
2020-09-25 14:30:00,14:30,6229675,4983150,-1246525,SELL
2020-09-25 14:31:00,14:31,6236175,4982600,-1253575,SELL
2020-09-25 14:32:00,14:32,6236175,4950475,-1285700,SELL
2020-09-25 14:33:00,14:33,6268900,4958475,-1310425,SELL
2020-09-25 14:34:00,14:34,6261325,4912250,-1349075,SELL
2020-09-25 14:35:00,14:35,6271250,4949100,-1322150,SELL
2020-09-25 14:36:00,14:36,6285725,4957950,-1327775,SELL
2020-09-25 14:37:00,14:37,6280150,4957525,-1322625,SELL
2020-09-25 14:38:00,14:38,6288050,4961825,-1326225,SELL
2020-09-25 14:39:00,14:39,6320325,4997175,-1323150,SELL
2020-09-25 14:40:00,14:40,6328875,5051325,-1277550,SELL
2020-09-25 14:41:00,14:41,6328875,5012475,-1316400,SELL
2020-09-25 14:42:00,14:42,6157600,4912825,-1244775,SELL
2020-09-25 14:43:00,14:43,6147750,4973775,-1173975,SELL
2020-09-25 14:44:00,14:44,6141650,4973550,-1168100,SELL
2020-09-25 14:45:00,14:45,6218250,4817875,-1400375,SELL
2020-09-25 14:46:00,14:46,6211225,4804350,-1406875,SELL
2020-09-25 14:47:00,14:47,6206275,4813775,-1392500,SELL
2020-09-25 14:48:00,14:48,6305900,4756425,-1549475,SELL
2020-09-25 14:49:00,14:49,6264350,4819300,-1445050,SELL
2020-09-25 14:50:00,14:50,6287850,4756475,-1531375,SELL
2020-09-25 14:51:00,14:51,6323125,4707850,-1615275,SELL
2020-09-25 14:52:00,14:52,6323200,4778575,-1544625,SELL
2020-09-25 14:53:00,14:53,6307225,4735875,-1571350,SELL
2020-09-25 14:54:00,14:54,6312250,4701300,-1610950,SELL
2020-09-25 14:55:00,14:55,6318575,4732300,-1586275,SELL
2020-09-25 14:56:00,14:56,6318575,4650925,-1667650,SELL
2020-09-25 14:57:00,14:57,6328400,4728875,-1599525,SELL
2020-09-25 14:58:00,14:58,6330200,4690800,-1639400,SELL
2020-09-25 14:59:00,14:59,6329450,4695425,-1634025,SELL
2020-09-25 15:00:00,15:00,6319950,4689775,-1630175,SELL
2020-09-25 15:01:00,15:01,6326400,4651725,-1674675,SELL
2020-09-25 15:02:00,15:02,6323100,4685250,-1637850,SELL
2020-09-25 15:03:00,15:03,6237400,4541525,-1695875,SELL
2020-09-25 15:04:00,15:04,6226075,4500275,-1725800,SELL
2020-09-25 15:05:00,15:05,6225675,4538100,-1687575,SELL
2020-09-25 15:06:00,15:06,6207275,4529250,-1678025,SELL
2020-09-25 15:07:00,15:07,6214700,4539200,-1675500,SELL
2020-09-25 15:08:00,15:08,6211575,4533900,-1677675,SELL
2020-09-25 15:09:00,15:09,6186350,4440575,-1745775,SELL
2020-09-25 15:10:00,15:10,6165450,4543575,-1621875,SELL
2020-09-25 15:11:00,15:11,6186550,4437225,-1749325,SELL
2020-09-25 15:12:00,15:12,6187650,4555550,-1632100,SELL
2020-09-25 15:13:00,15:13,6192025,4488700,-1703325,SELL
2020-09-25 15:14:00,15:14,6195350,4486375,-1708975,SELL
2020-09-25 15:15:00,15:15,6129450,4433375,-1696075,SELL
2020-09-25 15:16:00,15:16,6129325,4430300,-1699025,SELL
2020-09-25 15:17:00,15:17,6132125,4437775,-1694350,SELL
2020-09-25 15:18:00,15:18,6065350,4370000,-1695350,SELL
2020-09-25 15:19:00,15:19,6057925,4373950,-1683975,SELL
2020-09-25 15:20:00,15:20,6078675,4399925,-1678750,SELL
2020-09-25 15:21:00,15:21,5961025,4297575,-1663450,SELL
2020-09-25 15:22:00,15:22,5953475,4269875,-1683600,SELL
2020-09-25 15:23:00,15:23,5935250,4256025,-1679225,SELL
2020-09-25 15:24:00,15:24,5905150,4260300,-1644850,SELL
2020-09-25 15:25:00,15:25,5917300,4298425,-1618875,SELL
2020-09-25 15:26:00,15:26,5903625,4208775,-1694850,SELL
2020-09-25 15:27:00,15:27,5829175,4215175,-1614000,SELL
2020-09-25 15:28:00,15:28,5840825,4205575,-1635250,SELL
2020-09-25 15:29:00,15:29,5840825,4243500,-1597325,SELL
2020-09-28 09:15:00,09:15,5599375,3939275,-1660100,SELL
2020-09-28 09:16:00,09:16,5601275,3966825,-1634450,SELL
2020-09-28 09:17:00,09:17,5638375,4177325,-1461050,SELL
2020-09-28 09:18:00,09:18,5638375,4176425,-1461950,SELL
2020-09-28 09:19:00,09:19,5630825,4177100,-1453725,SELL
2020-09-28 09:20:00,09:20,5829125,4485700,-1343425,SELL
2020-09-28 09:21:00,09:21,5812725,4483225,-1329500,SELL
2020-09-28 09:22:00,09:22,5819400,4480325,-1339075,SELL
2020-09-28 09:23:00,09:23,5995525,4620350,-1375175,SELL
2020-09-28 09:24:00,09:24,5985900,4620350,-1365550,SELL
2020-09-28 09:25:00,09:25,5984800,4622275,-1362525,SELL
2020-09-28 09:26:00,09:26,5985525,4759325,-1226200,SELL
2020-09-28 09:27:00,09:27,5993100,4737375,-1255725,SELL
2020-09-28 09:28:00,09:28,5985525,4732250,-1253275,SELL
2020-09-28 09:29:00,09:29,6114950,4782575,-1332375,SELL
2020-09-28 09:30:00,09:30,6113600,4830050,-1283550,SELL
2020-09-28 09:31:00,09:31,6121125,4857325,-1263800,SELL
2020-09-28 09:32:00,09:32,6028025,4920150,-1107875,SELL
2020-09-28 09:33:00,09:33,6062375,4929125,-1133250,SELL
2020-09-28 09:34:00,09:34,6061850,4923250,-1138600,SELL
2020-09-28 09:35:00,09:35,5960950,4978625,-982325,SELL
2020-09-28 09:36:00,09:36,5961825,4943725,-1018100,SELL
2020-09-28 09:37:00,09:37,5944200,4952850,-991350,SELL
2020-09-28 09:38:00,09:38,6001875,5081100,-920775,SELL
2020-09-28 09:39:00,09:39,5984950,5078875,-906075,SELL
2020-09-28 09:40:00,09:40,6005900,5149575,-856325,SELL
2020-09-28 09:41:00,09:41,5911875,5269875,-642000,SELL
2020-09-28 09:42:00,09:42,5928550,5269875,-658675,SELL
2020-09-28 09:43:00,09:43,5918525,5269875,-648650,SELL
2020-09-28 09:44:00,09:44,6064125,5371275,-692850,SELL
2020-09-28 09:45:00,09:45,6052325,5405700,-646625,SELL
2020-09-28 09:46:00,09:46,6052325,5375425,-676900,SELL
2020-09-28 09:47:00,09:47,6084300,5421850,-662450,SELL
2020-09-28 09:48:00,09:48,6078100,5423625,-654475,SELL
2020-09-28 09:49:00,09:49,6091775,5480650,-611125,SELL
2020-09-28 09:50:00,09:50,6002525,5478275,-524250,SELL
2020-09-28 09:51:00,09:51,6047150,5481075,-566075,SELL
2020-09-28 09:52:00,09:52,6047700,5531375,-516325,SELL
2020-09-28 09:53:00,09:53,6083750,5515550,-568200,SELL
2020-09-28 09:54:00,09:54,6083750,5571125,-512625,SELL
2020-09-28 09:55:00,09:55,6100325,5516525,-583800,SELL
2020-09-28 09:56:00,09:56,6184475,5600425,-584050,SELL
2020-09-28 09:57:00,09:57,6170800,5573650,-597150,SELL
2020-09-28 09:58:00,09:58,6071600,5569375,-502225,SELL
2020-09-28 09:59:00,09:59,6188125,5591225,-596900,SELL
2020-09-28 10:00:00,10:00,6215175,5603600,-611575,SELL
2020-09-28 10:01:00,10:01,6241600,5599325,-642275,SELL
2020-09-28 10:02:00,10:02,6177600,5645575,-532025,SELL
2020-09-28 10:03:00,10:03,6194550,5645575,-548975,SELL
2020-09-28 10:04:00,10:04,6244600,5646250,-598350,SELL
2020-09-28 10:05:00,10:05,6205425,5623750,-581675,SELL
2020-09-28 10:06:00,10:06,6184650,5621725,-562925,SELL
2020-09-28 10:07:00,10:07,6282225,5654025,-628200,SELL
2020-09-28 10:08:00,10:08,6273875,5721300,-552575,SELL
2020-09-28 10:09:00,10:09,6264675,5707325,-557350,SELL
2020-09-28 10:10:00,10:10,6274725,5771275,-503450,SELL
2020-09-28 10:11:00,10:11,6323225,5820075,-503150,SELL
2020-09-28 10:12:00,10:12,6287200,5792500,-494700,SELL
2020-09-28 10:13:00,10:13,6197475,5789050,-408425,SELL
2020-09-28 10:14:00,10:14,6319600,5858225,-461375,SELL
2020-09-28 10:15:00,10:15,6319600,5857925,-461675,SELL
2020-09-28 10:16:00,10:16,6348475,5828325,-520150,SELL
2020-09-28 10:17:00,10:17,6420475,5902350,-518125,SELL
2020-09-28 10:18:00,10:18,6417500,5923850,-493650,SELL
2020-09-28 10:19:00,10:19,6346075,5917100,-428975,SELL
2020-09-28 10:20:00,10:20,6350225,5882250,-467975,SELL
2020-09-28 10:21:00,10:21,6314375,5824175,-490200,SELL
2020-09-28 10:22:00,10:22,6330625,5860025,-470600,SELL
2020-09-28 10:23:00,10:23,6331150,5908500,-422650,SELL
2020-09-28 10:24:00,10:24,6353800,5908775,-445025,SELL
2020-09-28 10:25:00,10:25,6330900,5904850,-426050,SELL
2020-09-28 10:26:00,10:26,6356000,5906800,-449200,SELL
2020-09-28 10:27:00,10:27,6347025,5846925,-500100,SELL
2020-09-28 10:28:00,10:28,6373800,5843125,-530675,SELL
2020-09-28 10:29:00,10:29,6386925,5903600,-483325,SELL
2020-09-28 10:30:00,10:30,6418700,5913125,-505575,SELL
2020-09-28 10:31:00,10:31,6287800,5914175,-373625,SELL
2020-09-28 10:32:00,10:32,6382200,5947150,-435050,SELL
2020-09-28 10:33:00,10:33,6379225,5970425,-408800,SELL
2020-09-28 10:34:00,10:34,6402025,5927025,-475000,SELL
2020-09-28 10:35:00,10:35,6400900,5952700,-448200,SELL
2020-09-28 10:36:00,10:36,6333100,5952700,-380400,SELL
2020-09-28 10:37:00,10:37,6373675,5945950,-427725,SELL
2020-09-28 10:38:00,10:38,6416300,6021150,-395150,SELL
2020-09-28 10:39:00,10:39,6437075,6050250,-386825,SELL
2020-09-28 10:40:00,10:40,6435925,5990375,-445550,SELL
2020-09-28 10:41:00,10:41,6381025,6049025,-332000,SELL
2020-09-28 10:42:00,10:42,6345475,6042225,-303250,SELL
2020-09-28 10:43:00,10:43,6204425,6018575,-185850,SELL
2020-09-28 10:44:00,10:44,6305050,6049200,-255850,SELL
2020-09-28 10:45:00,10:45,6490575,6049200,-441375,SELL
2020-09-28 10:46:00,10:46,6463800,6042375,-421425,SELL
2020-09-28 10:47:00,10:47,6491625,6045925,-445700,SELL
2020-09-28 10:48:00,10:48,6533575,6195775,-337800,SELL
2020-09-28 10:49:00,10:49,6500425,6164450,-335975,SELL
2020-09-28 10:50:00,10:50,6368775,6176050,-192725,SELL
2020-09-28 10:51:00,10:51,6384350,6209975,-174375,SELL
2020-09-28 10:52:00,10:52,6363175,6174475,-188700,SELL
2020-09-28 10:53:00,10:53,6274600,6247300,-27300,SELL
2020-09-28 10:54:00,10:54,6267850,6312950,45100,BUY
2020-09-28 10:55:00,10:55,6259050,6250450,-8600,SELL
2020-09-28 10:56:00,10:56,6366300,6386600,20300,BUY
2020-09-28 10:57:00,10:57,6332675,6392125,59450,BUY
2020-09-28 10:58:00,10:58,6299825,6354050,54225,BUY
2020-09-28 10:59:00,10:59,6423800,6405050,-18750,SELL
2020-09-28 11:00:00,11:00,6440150,6404025,-36125,SELL
2020-09-28 11:01:00,11:01,6443100,6433600,-9500,SELL
2020-09-28 11:02:00,11:02,6443625,6469475,25850,BUY
2020-09-28 11:03:00,11:03,6431125,6504625,73500,BUY
2020-09-28 11:04:00,11:04,6443625,6507400,63775,BUY
2020-09-28 11:05:00,11:05,6459500,6587925,128425,BUY
2020-09-28 11:06:00,11:06,6425200,6517175,91975,BUY
2020-09-28 11:07:00,11:07,6421600,6547725,126125,BUY
2020-09-28 11:08:00,11:08,6562525,6604175,41650,BUY
2020-09-28 11:09:00,11:09,6550025,6640750,90725,BUY
2020-09-28 11:10:00,11:10,6576325,6641725,65400,BUY
2020-09-28 11:11:00,11:11,6514950,6680025,165075,BUY
2020-09-28 11:12:00,11:12,6463850,6651250,187400,BUY
2020-09-28 11:13:00,11:13,6496300,6649450,153150,BUY
2020-09-28 11:14:00,11:14,6561075,6708150,147075,BUY
2020-09-28 11:15:00,11:15,6513500,6701225,187725,BUY
2020-09-28 11:16:00,11:16,6561075,6704675,143600,BUY
2020-09-28 11:17:00,11:17,6575050,6776350,201300,BUY
2020-09-28 11:18:00,11:18,6606325,6776350,170025,BUY
2020-09-28 11:19:00,11:19,6611425,6810625,199200,BUY
2020-09-28 11:20:00,11:20,6590825,6810325,219500,BUY
2020-09-28 11:21:00,11:21,6616150,6776900,160750,BUY
2020-09-28 11:22:00,11:22,6611100,6780250,169150,BUY
2020-09-28 11:23:00,11:23,6631575,6821425,189850,BUY
2020-09-28 11:24:00,11:24,6633150,6855775,222625,BUY
2020-09-28 11:25:00,11:25,6612025,6857450,245425,BUY
2020-09-28 11:26:00,11:26,6611525,6940575,329050,BUY
2020-09-28 11:27:00,11:27,6583400,6956900,373500,BUY
2020-09-28 11:28:00,11:28,6614800,6934275,319475,BUY
2020-09-28 11:29:00,11:29,6361975,6956450,594475,BUY
2020-09-28 11:30:00,11:30,6310600,6891100,580500,BUY
2020-09-28 11:31:00,11:31,6358375,6926750,568375,BUY
2020-09-28 11:32:00,11:32,6414850,7023700,608850,BUY
2020-09-28 11:33:00,11:33,6412025,6991150,579125,BUY
2020-09-28 11:34:00,11:34,6403300,6991150,587850,BUY
2020-09-28 11:35:00,11:35,6422750,7053675,630925,BUY
2020-09-28 11:36:00,11:36,6460850,7059400,598550,BUY
2020-09-28 11:37:00,11:37,6446000,7125525,679525,BUY
2020-09-28 11:38:00,11:38,6511125,7085200,574075,BUY
2020-09-28 11:39:00,11:39,6489375,7085200,595825,BUY
2020-09-28 11:40:00,11:40,6486675,7118000,631325,BUY
2020-09-28 11:41:00,11:41,6462150,7159325,697175,BUY
2020-09-28 11:42:00,11:42,6486175,7156050,669875,BUY
2020-09-28 11:43:00,11:43,6547300,7126525,579225,BUY
2020-09-28 11:44:00,11:44,6503000,7158550,655550,BUY
2020-09-28 11:45:00,11:45,6511150,7180550,669400,BUY
2020-09-28 11:46:00,11:46,6457875,7157550,699675,BUY
2020-09-28 11:47:00,11:47,6492775,7171225,678450,BUY
2020-09-28 11:48:00,11:48,6403575,7106325,702750,BUY
2020-09-28 11:49:00,11:49,6460650,7140500,679850,BUY
2020-09-28 11:50:00,11:50,6548525,7124700,576175,BUY
2020-09-28 11:51:00,11:51,6454950,7158725,703775,BUY
2020-09-28 11:52:00,11:52,6454950,7152525,697575,BUY
2020-09-28 11:53:00,11:53,6600400,7108375,507975,BUY
2020-09-28 11:54:00,11:54,6588975,7065925,476950,BUY
2020-09-28 11:55:00,11:55,6519975,7065925,545950,BUY
2020-09-28 11:56:00,11:56,6638725,7055100,416375,BUY
2020-09-28 11:57:00,11:57,6645625,7089500,443875,BUY
2020-09-28 11:58:00,11:58,6539400,7041075,501675,BUY
2020-09-28 11:59:00,11:59,6636725,7115200,478475,BUY
2020-09-28 12:00:00,12:00,6636775,7053550,416775,BUY
2020-09-28 12:01:00,12:01,6624450,7091075,466625,BUY
2020-09-28 12:02:00,12:02,6679075,7090100,411025,BUY
2020-09-28 12:03:00,12:03,6655475,7090100,434625,BUY
2020-09-28 12:04:00,12:04,6655475,7059500,404025,BUY
2020-09-28 12:05:00,12:05,6636175,7050125,413950,BUY
2020-09-28 12:06:00,12:06,6642050,7037750,395700,BUY
2020-09-28 12:07:00,12:07,6578325,7051950,473625,BUY
2020-09-28 12:08:00,12:08,6645850,7091950,446100,BUY
2020-09-28 12:09:00,12:09,6584050,7092050,508000,BUY
2020-09-28 12:10:00,12:10,6565000,7123850,558850,BUY
2020-09-28 12:11:00,12:11,6564300,7079500,515200,BUY
2020-09-28 12:12:00,12:12,6621300,7117250,495950,BUY
2020-09-28 12:13:00,12:13,6570750,7105800,535050,BUY
2020-09-28 12:14:00,12:14,6630950,7164225,533275,BUY
2020-09-28 12:15:00,12:15,6641900,7130700,488800,BUY
2020-09-28 12:16:00,12:16,6672125,7128225,456100,BUY
2020-09-28 12:17:00,12:17,6672225,7182175,509950,BUY
2020-09-28 12:18:00,12:18,6632475,7124600,492125,BUY
2020-09-28 12:19:00,12:19,6568700,7119900,551200,BUY
2020-09-28 12:20:00,12:20,6638475,7129125,490650,BUY
2020-09-28 12:21:00,12:21,6389150,7149875,760725,BUY
2020-09-28 12:22:00,12:22,6581425,7131000,549575,BUY
2020-09-28 12:23:00,12:23,6640250,7140050,499800,BUY
2020-09-28 12:24:00,12:24,6655375,7109900,454525,BUY
2020-09-28 12:25:00,12:25,6592125,7109900,517775,BUY
2020-09-28 12:26:00,12:26,6409975,7213125,803150,BUY
2020-09-28 12:27:00,12:27,6676150,7182800,506650,BUY
2020-09-28 12:28:00,12:28,6652600,7150825,498225,BUY
2020-09-28 12:29:00,12:29,6655375,7157375,502000,BUY
2020-09-28 12:30:00,12:30,6660400,7188675,528275,BUY
2020-09-28 12:31:00,12:31,6660400,7147725,487325,BUY
2020-09-28 12:32:00,12:32,6592275,7182375,590100,BUY
2020-09-28 12:33:00,12:33,6646425,7198050,551625,BUY
2020-09-28 12:34:00,12:34,6646425,7204725,558300,BUY
2020-09-28 12:35:00,12:35,6714475,7218625,504150,BUY
2020-09-28 12:36:00,12:36,6648825,7174900,526075,BUY
2020-09-28 12:37:00,12:37,6685525,7188650,503125,BUY
2020-09-28 12:38:00,12:38,6613725,7193275,579550,BUY
2020-09-28 12:39:00,12:39,6604500,7184875,580375,BUY
2020-09-28 12:40:00,12:40,6613625,7210400,596775,BUY
2020-09-28 12:41:00,12:41,6396500,7222800,826300,BUY
2020-09-28 12:42:00,12:42,6747900,7267175,519275,BUY
2020-09-28 12:43:00,12:43,6737825,7255775,517950,BUY
2020-09-28 12:44:00,12:44,6680125,7184725,504600,BUY
2020-09-28 12:45:00,12:45,6688450,7212500,524050,BUY
2020-09-28 12:46:00,12:46,6686300,7239475,553175,BUY
2020-09-28 12:47:00,12:47,6693550,7213125,519575,BUY
2020-09-28 12:48:00,12:48,6663500,7173575,510075,BUY
2020-09-28 12:49:00,12:49,6716875,7201525,484650,BUY
2020-09-28 12:50:00,12:50,6716525,7207775,491250,BUY
2020-09-28 12:51:00,12:51,6684175,7173775,489600,BUY
2020-09-28 12:52:00,12:52,6582225,7208250,626025,BUY
2020-09-28 12:53:00,12:53,6764800,7183625,418825,BUY
2020-09-28 12:54:00,12:54,6692475,7183625,491150,BUY
2020-09-28 12:55:00,12:55,6732350,7188500,456150,BUY
2020-09-28 12:56:00,12:56,6736050,7259150,523100,BUY
2020-09-28 12:57:00,12:57,6712250,7260425,548175,BUY
2020-09-28 12:58:00,12:58,6771100,7272700,501600,BUY
2020-09-28 12:59:00,12:59,6750900,7263025,512125,BUY
2020-09-28 13:00:00,13:00,6705750,7293250,587500,BUY
2020-09-28 13:01:00,13:01,6728775,7234250,505475,BUY
2020-09-28 13:02:00,13:02,6686225,7273475,587250,BUY
2020-09-28 13:03:00,13:03,6682225,7238925,556700,BUY
2020-09-28 13:04:00,13:04,6673100,7263225,590125,BUY
2020-09-28 13:05:00,13:05,6719300,7276075,556775,BUY
2020-09-28 13:06:00,13:06,6684200,7311675,627475,BUY
2020-09-28 13:07:00,13:07,6681700,7306275,624575,BUY
2020-09-28 13:08:00,13:08,6729350,7239800,510450,BUY
2020-09-28 13:09:00,13:09,6618475,7253725,635250,BUY
2020-09-28 13:10:00,13:10,6690225,7251450,561225,BUY
2020-09-28 13:11:00,13:11,6670900,7303350,632450,BUY
2020-09-28 13:12:00,13:12,6682600,7313300,630700,BUY
2020-09-28 13:13:00,13:13,6533125,7313300,780175,BUY
2020-09-28 13:14:00,13:14,6677300,7291375,614075,BUY
2020-09-28 13:15:00,13:15,6756050,7307425,551375,BUY
2020-09-28 13:16:00,13:16,6706475,7332625,626150,BUY
2020-09-28 13:17:00,13:17,6768850,7301925,533075,BUY
2020-09-28 13:18:00,13:18,6680775,7369300,688525,BUY
2020-09-28 13:19:00,13:19,6768575,7388650,620075,BUY
2020-09-28 13:20:00,13:20,6679425,7380100,700675,BUY
2020-09-28 13:21:00,13:21,6699825,7337700,637875,BUY
2020-09-28 13:22:00,13:22,6661600,7337700,676100,BUY
2020-09-28 13:23:00,13:23,6677875,7408525,730650,BUY
2020-09-28 13:24:00,13:24,6661450,7410000,748550,BUY
2020-09-28 13:25:00,13:25,6676350,7453075,776725,BUY
2020-09-28 13:26:00,13:26,6578225,7434425,856200,BUY
2020-09-28 13:27:00,13:27,6592650,7424925,832275,BUY
2020-09-28 13:28:00,13:28,6586100,7390525,804425,BUY
2020-09-28 13:29:00,13:29,6525125,7428125,903000,BUY
2020-09-28 13:30:00,13:30,6583075,7448675,865600,BUY
2020-09-28 13:31:00,13:31,6583075,7477925,894850,BUY
2020-09-28 13:32:00,13:32,6461075,7463975,1002900,BUY
2020-09-28 13:33:00,13:33,6564800,7469225,904425,BUY
2020-09-28 13:34:00,13:34,6472700,7434450,961750,BUY
2020-09-28 13:35:00,13:35,6244200,7467150,1222950,BUY
2020-09-28 13:36:00,13:36,6571750,7488500,916750,BUY
2020-09-28 13:37:00,13:37,6523950,7455900,931950,BUY
2020-09-28 13:38:00,13:38,6547700,7497400,949700,BUY
2020-09-28 13:39:00,13:39,6499600,7483350,983750,BUY
2020-09-28 13:40:00,13:40,6559725,7551150,991425,BUY
2020-09-28 13:41:00,13:41,6374600,7509525,1134925,BUY
2020-09-28 13:42:00,13:42,6346050,7502525,1156475,BUY
2020-09-28 13:43:00,13:43,6583900,7540300,956400,BUY
2020-09-28 13:44:00,13:44,6602775,7507450,904675,BUY
2020-09-28 13:45:00,13:45,6613300,7503675,890375,BUY
2020-09-28 13:46:00,13:46,6589175,7538400,949225,BUY
2020-09-28 13:47:00,13:47,6559475,7541475,982000,BUY
2020-09-28 13:48:00,13:48,6607750,7556225,948475,BUY
2020-09-28 13:49:00,13:49,6497525,7510325,1012800,BUY
2020-09-28 13:50:00,13:50,6551125,7547400,996275,BUY
2020-09-28 13:51:00,13:51,6448450,7500175,1051725,BUY
2020-09-28 13:52:00,13:52,6563125,7513500,950375,BUY
2020-09-28 13:53:00,13:53,6634575,7583975,949400,BUY
2020-09-28 13:54:00,13:54,6556125,7511350,955225,BUY
2020-09-28 13:55:00,13:55,6644450,7548550,904100,BUY
2020-09-28 13:56:00,13:56,6612175,7542675,930500,BUY
2020-09-28 13:57:00,13:57,6517350,7543100,1025750,BUY
2020-09-28 13:58:00,13:58,6589100,7580450,991350,BUY
2020-09-28 13:59:00,13:59,6582575,7546825,964250,BUY
2020-09-28 14:00:00,14:00,6506575,7563725,1057150,BUY
2020-09-28 14:01:00,14:01,6574875,7610775,1035900,BUY
2020-09-28 14:02:00,14:02,6560100,7563725,1003625,BUY
2020-09-28 14:03:00,14:03,6590175,7614350,1024175,BUY
2020-09-28 14:04:00,14:04,6583650,7581675,998025,BUY
2020-09-28 14:05:00,14:05,6606900,7614350,1007450,BUY
2020-09-28 14:06:00,14:06,6618825,7665300,1046475,BUY
2020-09-28 14:07:00,14:07,6558025,7663500,1105475,BUY
2020-09-28 14:08:00,14:08,6630775,7685350,1054575,BUY
2020-09-28 14:09:00,14:09,6570675,7594775,1024100,BUY
2020-09-28 14:10:00,14:10,6678500,7656900,978400,BUY
2020-09-28 14:11:00,14:11,6593950,7637225,1043275,BUY
2020-09-28 14:12:00,14:12,6595000,7616775,1021775,BUY
2020-09-28 14:13:00,14:13,6561925,7633950,1072025,BUY
2020-09-28 14:14:00,14:14,6485450,7610000,1124550,BUY
2020-09-28 14:15:00,14:15,6593700,7669450,1075750,BUY
2020-09-28 14:16:00,14:16,6596325,7634675,1038350,BUY
2020-09-28 14:17:00,14:17,6596325,7634675,1038350,BUY
2020-09-28 14:18:00,14:18,6682700,7689875,1007175,BUY
2020-09-28 14:19:00,14:19,6719675,7688075,968400,BUY
2020-09-28 14:20:00,14:20,6640450,7653250,1012800,BUY
2020-09-28 14:21:00,14:21,6530950,7749300,1218350,BUY
2020-09-28 14:22:00,14:22,6570425,7677050,1106625,BUY
2020-09-28 14:23:00,14:23,6669550,7677050,1007500,BUY
2020-09-28 14:24:00,14:24,6706225,7687325,981100,BUY
2020-09-28 14:25:00,14:25,6696350,7764525,1068175,BUY
2020-09-28 14:26:00,14:26,6687325,7731875,1044550,BUY
2020-09-28 14:27:00,14:27,6698775,7729175,1030400,BUY
2020-09-28 14:28:00,14:28,6580600,7724700,1144100,BUY
2020-09-28 14:29:00,14:29,6701100,7750550,1049450,BUY
2020-09-28 14:30:00,14:30,6654725,7765000,1110275,BUY
2020-09-28 14:31:00,14:31,6747900,7799750,1051850,BUY
2020-09-28 14:32:00,14:32,6784900,7833675,1048775,BUY
2020-09-28 14:33:00,14:33,6631500,7803475,1171975,BUY
2020-09-28 14:34:00,14:34,6735450,7803475,1068025,BUY
2020-09-28 14:35:00,14:35,6716575,7824900,1108325,BUY
2020-09-28 14:36:00,14:36,6761200,7850575,1089375,BUY
2020-09-28 14:37:00,14:37,6763600,7855600,1092000,BUY
2020-09-28 14:38:00,14:38,6784425,7847025,1062600,BUY
2020-09-28 14:39:00,14:39,6819600,7895375,1075775,BUY
2020-09-28 14:40:00,14:40,6842825,7898075,1055250,BUY
2020-09-28 14:41:00,14:41,6805825,7894475,1088650,BUY
2020-09-28 14:42:00,14:42,6761975,7873575,1111600,BUY
2020-09-28 14:43:00,14:43,6778875,7876200,1097325,BUY
2020-09-28 14:44:00,14:44,6642650,7884225,1241575,BUY
2020-09-28 14:45:00,14:45,6769625,7841000,1071375,BUY
2020-09-28 14:46:00,14:46,6836250,7885750,1049500,BUY
2020-09-28 14:47:00,14:47,6902775,7890750,987975,BUY
2020-09-28 14:48:00,14:48,6851125,7881425,1030300,BUY
2020-09-28 14:49:00,14:49,6864950,7883275,1018325,BUY
2020-09-28 14:50:00,14:50,6827975,7907500,1079525,BUY
2020-09-28 14:51:00,14:51,6838125,7810075,971950,BUY
2020-09-28 14:52:00,14:52,6666250,7853550,1187300,BUY
2020-09-28 14:53:00,14:53,6611050,7855375,1244325,BUY
2020-09-28 14:54:00,14:54,6814300,7840525,1026225,BUY
2020-09-28 14:55:00,14:55,6800550,7843925,1043375,BUY
2020-09-28 14:56:00,14:56,6899300,7868150,968850,BUY
2020-09-28 14:57:00,14:57,6879225,7798875,919650,BUY
2020-09-28 14:58:00,14:58,6792900,7798875,1005975,BUY
2020-09-28 14:59:00,14:59,6870250,7792125,921875,BUY
2020-09-28 15:00:00,15:00,6868750,7813875,945125,BUY
2020-09-28 15:01:00,15:01,6892250,7846725,954475,BUY
2020-09-28 15:02:00,15:02,6868750,7820675,951925,BUY
2020-09-28 15:03:00,15:03,6699950,7656675,956725,BUY
2020-09-28 15:04:00,15:04,6714525,7623075,908550,BUY
2020-09-28 15:05:00,15:05,6660850,7652775,991925,BUY
2020-09-28 15:06:00,15:06,6683900,7603500,919600,BUY
2020-09-28 15:07:00,15:07,6632375,7591825,959450,BUY
2020-09-28 15:08:00,15:08,6690450,7627075,936625,BUY
2020-09-28 15:09:00,15:09,6625625,7526975,901350,BUY
2020-09-28 15:10:00,15:10,6671525,7524300,852775,BUY
2020-09-28 15:11:00,15:11,6474125,7494875,1020750,BUY
2020-09-28 15:12:00,15:12,6673650,7537000,863350,BUY
2020-09-28 15:13:00,15:13,6682850,7566625,883775,BUY
2020-09-28 15:14:00,15:14,6685800,7500475,814675,BUY
2020-09-28 15:15:00,15:15,6579800,7439625,859825,BUY
2020-09-28 15:16:00,15:16,6367725,7403100,1035375,BUY
2020-09-28 15:17:00,15:17,6564475,7404825,840350,BUY
2020-09-28 15:18:00,15:18,6529925,7289525,759600,BUY
2020-09-28 15:19:00,15:19,6498775,7277675,778900,BUY
2020-09-28 15:20:00,15:20,6510875,7281375,770500,BUY
2020-09-28 15:21:00,15:21,6362825,7169600,806775,BUY
2020-09-28 15:22:00,15:22,6201925,7165025,963100,BUY
2020-09-28 15:23:00,15:23,6199625,7158700,959075,BUY
2020-09-28 15:24:00,15:24,6318625,7072825,754200,BUY
2020-09-28 15:25:00,15:25,6349800,7087800,738000,BUY
2020-09-28 15:26:00,15:26,6312225,7083625,771400,BUY
2020-09-28 15:27:00,15:27,6180800,6983400,802600,BUY
2020-09-28 15:28:00,15:28,6195100,6976275,781175,BUY
2020-09-28 15:29:00,15:29,6203875,7004475,800600,BUY
2020-09-29 09:15:00,09:15,5856450,6687800,831350,BUY
2020-09-29 09:16:00,09:16,5896550,6690100,793550,BUY
2020-09-29 09:17:00,09:17,6441425,7014400,572975,BUY
2020-09-29 09:18:00,09:18,6450225,7011025,560800,BUY
2020-09-29 09:19:00,09:19,6410125,7040125,630000,BUY
2020-09-29 09:20:00,09:20,6773725,7304900,531175,BUY
2020-09-29 09:21:00,09:21,6773750,7299350,525600,BUY
2020-09-29 09:22:00,09:22,6800850,7303875,503025,BUY
2020-09-29 09:23:00,09:23,7141450,7495075,353625,BUY
2020-09-29 09:24:00,09:24,6999825,7498175,498350,BUY
2020-09-29 09:25:00,09:25,7137025,7500775,363750,BUY
2020-09-29 09:26:00,09:26,7380950,7609825,228875,BUY
2020-09-29 09:27:00,09:27,7332725,7616625,283900,BUY
2020-09-29 09:28:00,09:28,7400250,7643850,243600,BUY
2020-09-29 09:29:00,09:29,7465600,7574025,108425,BUY
2020-09-29 09:30:00,09:30,7499325,7575325,76000,BUY
2020-09-29 09:31:00,09:31,7476500,7572725,96225,BUY
2020-09-29 09:32:00,09:32,7574350,7688925,114575,BUY
2020-09-29 09:33:00,09:33,7597525,7681775,84250,BUY
2020-09-29 09:34:00,09:34,7596475,7715225,118750,BUY
2020-09-29 09:35:00,09:35,7631050,7700450,69400,BUY
2020-09-29 09:36:00,09:36,7644425,7709075,64650,BUY
2020-09-29 09:37:00,09:37,7644425,7704200,59775,BUY
2020-09-29 09:38:00,09:38,7736600,7715950,-20650,SELL
2020-09-29 09:39:00,09:39,7700175,7691625,-8550,SELL
2020-09-29 09:40:00,09:40,7755600,7694050,-61550,SELL
2020-09-29 09:41:00,09:41,7883275,7797200,-86075,SELL
2020-09-29 09:42:00,09:42,7860125,7797200,-62925,SELL
2020-09-29 09:43:00,09:43,7860125,7797200,-62925,SELL
2020-09-29 09:44:00,09:44,7911550,7872950,-38600,SELL
2020-09-29 09:45:00,09:45,7950400,7836425,-113975,SELL
2020-09-29 09:46:00,09:46,7860425,7878150,17725,BUY
2020-09-29 09:47:00,09:47,8067050,7967975,-99075,SELL
2020-09-29 09:48:00,09:48,8053800,7966025,-87775,SELL
2020-09-29 09:49:00,09:49,7914975,7962425,47450,BUY
2020-09-29 09:50:00,09:50,8032900,7977275,-55625,SELL
2020-09-29 09:51:00,09:51,8070450,7974425,-96025,SELL
2020-09-29 09:52:00,09:52,8122125,8005600,-116525,SELL
2020-09-29 09:53:00,09:53,8124525,7958450,-166075,SELL
2020-09-29 09:54:00,09:54,8016925,7959500,-57425,SELL
2020-09-29 09:55:00,09:55,8132425,7931175,-201250,SELL
2020-09-29 09:56:00,09:56,8114725,7920800,-193925,SELL
2020-09-29 09:57:00,09:57,8104750,7920750,-184000,SELL
2020-09-29 09:58:00,09:58,8044325,7950850,-93475,SELL
2020-09-29 09:59:00,09:59,8038725,8050650,11925,BUY
2020-09-29 10:00:00,10:00,8122575,8047775,-74800,SELL
2020-09-29 10:01:00,10:01,8065600,8023275,-42325,SELL
2020-09-29 10:02:00,10:02,8213925,8088600,-125325,SELL
2020-09-29 10:03:00,10:03,8285925,8092450,-193475,SELL
2020-09-29 10:04:00,10:04,8160025,8091400,-68625,SELL
2020-09-29 10:05:00,10:05,8286150,8187575,-98575,SELL
2020-09-29 10:06:00,10:06,8286675,8192900,-93775,SELL
2020-09-29 10:07:00,10:07,8252325,8192900,-59425,SELL
2020-09-29 10:08:00,10:08,8371450,8279075,-92375,SELL
2020-09-29 10:09:00,10:09,8418200,8304200,-114000,SELL
2020-09-29 10:10:00,10:10,8424550,8261975,-162575,SELL
2020-09-29 10:11:00,10:11,8563425,8205325,-358100,SELL
2020-09-29 10:12:00,10:12,8462400,8209850,-252550,SELL
2020-09-29 10:13:00,10:13,8470675,8256775,-213900,SELL
2020-09-29 10:14:00,10:14,8567775,8328625,-239150,SELL
2020-09-29 10:15:00,10:15,8590675,8316100,-274575,SELL
2020-09-29 10:16:00,10:16,8544400,8328425,-215975,SELL
2020-09-29 10:17:00,10:17,8741400,8358725,-382675,SELL
2020-09-29 10:18:00,10:18,8649250,8361075,-288175,SELL
2020-09-29 10:19:00,10:19,8748625,8358650,-389975,SELL
2020-09-29 10:20:00,10:20,8776700,8270675,-506025,SELL
2020-09-29 10:21:00,10:21,8776700,8247800,-528900,SELL
2020-09-29 10:22:00,10:22,8622750,8242425,-380325,SELL
2020-09-29 10:23:00,10:23,8705700,8200825,-504875,SELL
2020-09-29 10:24:00,10:24,8577200,8179000,-398200,SELL
2020-09-29 10:25:00,10:25,8731025,8191200,-539825,SELL
2020-09-29 10:26:00,10:26,8745475,8242450,-503025,SELL
2020-09-29 10:27:00,10:27,8744250,8200675,-543575,SELL
2020-09-29 10:28:00,10:28,8761325,8246800,-514525,SELL
2020-09-29 10:29:00,10:29,8888525,8297700,-590825,SELL
2020-09-29 10:30:00,10:30,8585500,8297775,-287725,SELL
2020-09-29 10:31:00,10:31,8783550,8300175,-483375,SELL
2020-09-29 10:32:00,10:32,8859100,8350625,-508475,SELL
2020-09-29 10:33:00,10:33,8715150,8336925,-378225,SELL
2020-09-29 10:34:00,10:34,8883050,8338575,-544475,SELL
2020-09-29 10:35:00,10:35,8722200,8384625,-337575,SELL
2020-09-29 10:36:00,10:36,8874425,8367075,-507350,SELL
2020-09-29 10:37:00,10:37,8845350,8404575,-440775,SELL
2020-09-29 10:38:00,10:38,8956325,8375075,-581250,SELL
2020-09-29 10:39:00,10:39,8956325,8375325,-581000,SELL
2020-09-29 10:40:00,10:40,8909600,8375325,-534275,SELL
2020-09-29 10:41:00,10:41,8947725,8385750,-561975,SELL
2020-09-29 10:42:00,10:42,8793675,8390825,-402850,SELL
2020-09-29 10:43:00,10:43,8993875,8367850,-626025,SELL
2020-09-29 10:44:00,10:44,8887375,8406350,-481025,SELL
2020-09-29 10:45:00,10:45,9055850,8429425,-626425,SELL
2020-09-29 10:46:00,10:46,9069625,8430250,-639375,SELL
2020-09-29 10:47:00,10:47,9052000,8264575,-787425,SELL
2020-09-29 10:48:00,10:48,9051850,8270125,-781725,SELL
2020-09-29 10:49:00,10:49,8972825,8291850,-680975,SELL
2020-09-29 10:50:00,10:50,9023250,8188000,-835250,SELL
2020-09-29 10:51:00,10:51,9036725,8193575,-843150,SELL
2020-09-29 10:52:00,10:52,8960000,8137375,-822625,SELL
2020-09-29 10:53:00,10:53,9006325,8169375,-836950,SELL
2020-09-29 10:54:00,10:54,9055450,8118725,-936725,SELL
2020-09-29 10:55:00,10:55,9064150,8116700,-947450,SELL
2020-09-29 10:56:00,10:56,9045125,8160275,-884850,SELL
2020-09-29 10:57:00,10:57,9070225,8153525,-916700,SELL
2020-09-29 10:58:00,10:58,9090875,8166900,-923975,SELL
2020-09-29 10:59:00,10:59,9160175,8176450,-983725,SELL
2020-09-29 11:00:00,11:00,8998125,8150400,-847725,SELL
2020-09-29 11:01:00,11:01,9151600,8222500,-929100,SELL
2020-09-29 11:02:00,11:02,9060400,8124875,-935525,SELL
2020-09-29 11:03:00,11:03,9110000,8160975,-949025,SELL
2020-09-29 11:04:00,11:04,9238375,8190125,-1048250,SELL
2020-09-29 11:05:00,11:05,9146475,8004600,-1141875,SELL
2020-09-29 11:06:00,11:06,9067200,7957000,-1110200,SELL
2020-09-29 11:07:00,11:07,9159550,8033100,-1126450,SELL
2020-09-29 11:08:00,11:08,9137425,7944275,-1193150,SELL
2020-09-29 11:09:00,11:09,9088850,7963475,-1125375,SELL
2020-09-29 11:10:00,11:10,9101100,7966525,-1134575,SELL
2020-09-29 11:11:00,11:11,9144250,7946275,-1197975,SELL
2020-09-29 11:12:00,11:12,9061925,7891825,-1170100,SELL
2020-09-29 11:13:00,11:13,9173825,7880975,-1292850,SELL
2020-09-29 11:14:00,11:14,9010850,7993250,-1017600,SELL
2020-09-29 11:15:00,11:15,9122800,8014225,-1108575,SELL
2020-09-29 11:16:00,11:16,9139800,8024775,-1115025,SELL
2020-09-29 11:17:00,11:17,8993875,8011350,-982525,SELL
2020-09-29 11:18:00,11:18,9103700,7968875,-1134825,SELL
2020-09-29 11:19:00,11:19,9012325,7952950,-1059375,SELL
2020-09-29 11:20:00,11:20,9167675,8021725,-1145950,SELL
2020-09-29 11:21:00,11:21,9040525,7975650,-1064875,SELL
2020-09-29 11:22:00,11:22,9166975,7986500,-1180475,SELL
2020-09-29 11:23:00,11:23,9163950,8064600,-1099350,SELL
2020-09-29 11:24:00,11:24,9202550,8039850,-1162700,SELL
2020-09-29 11:25:00,11:25,9277775,8034525,-1243250,SELL
2020-09-29 11:26:00,11:26,9191975,8066550,-1125425,SELL
2020-09-29 11:27:00,11:27,9146300,8082875,-1063425,SELL
2020-09-29 11:28:00,11:28,9237050,8017725,-1219325,SELL
2020-09-29 11:29:00,11:29,9023400,8093125,-930275,SELL
2020-09-29 11:30:00,11:30,9148700,8052800,-1095900,SELL
2020-09-29 11:31:00,11:31,9179400,8063650,-1115750,SELL
2020-09-29 11:32:00,11:32,9104225,8121525,-982700,SELL
2020-09-29 11:33:00,11:33,9195425,8110450,-1084975,SELL
2020-09-29 11:34:00,11:34,9148850,8072100,-1076750,SELL
2020-09-29 11:35:00,11:35,9323100,8091300,-1231800,SELL
2020-09-29 11:36:00,11:36,9306425,8129525,-1176900,SELL
2020-09-29 11:37:00,11:37,9197800,8116400,-1081400,SELL
2020-09-29 11:38:00,11:38,9284825,8160275,-1124550,SELL
2020-09-29 11:39:00,11:39,9284550,8184950,-1099600,SELL
2020-09-29 11:40:00,11:40,9307675,8165700,-1141975,SELL
2020-09-29 11:41:00,11:41,9168150,8061250,-1106900,SELL
2020-09-29 11:42:00,11:42,8994350,7995700,-998650,SELL
2020-09-29 11:43:00,11:43,9066600,8036600,-1030000,SELL
2020-09-29 11:44:00,11:44,8999850,8075625,-924225,SELL
2020-09-29 11:45:00,11:45,9151425,8055000,-1096425,SELL
2020-09-29 11:46:00,11:46,9107875,8032525,-1075350,SELL
2020-09-29 11:47:00,11:47,8863925,8036725,-827200,SELL
2020-09-29 11:48:00,11:48,9173775,8087825,-1085950,SELL
2020-09-29 11:49:00,11:49,9217325,8117925,-1099400,SELL
2020-09-29 11:50:00,11:50,9190975,8138625,-1052350,SELL
2020-09-29 11:51:00,11:51,9147550,8121300,-1026250,SELL
2020-09-29 11:52:00,11:52,9192725,8158275,-1034450,SELL
2020-09-29 11:53:00,11:53,9026300,8145150,-881150,SELL
2020-09-29 11:54:00,11:54,9204900,8146950,-1057950,SELL
2020-09-29 11:55:00,11:55,9204900,8128425,-1076475,SELL
2020-09-29 11:56:00,11:56,9172775,8160050,-1012725,SELL
2020-09-29 11:57:00,11:57,9165925,8154350,-1011575,SELL
2020-09-29 11:58:00,11:58,9185250,8118700,-1066550,SELL
2020-09-29 11:59:00,11:59,9010075,8163675,-846400,SELL
2020-09-29 12:00:00,12:00,9163325,8175625,-987700,SELL
2020-09-29 12:01:00,12:01,9261175,8188475,-1072700,SELL
2020-09-29 12:02:00,12:02,9201175,8172825,-1028350,SELL
2020-09-29 12:03:00,12:03,9155975,8221275,-934700,SELL
2020-09-29 12:04:00,12:04,9157550,8219400,-938150,SELL
2020-09-29 12:05:00,12:05,9334300,8241300,-1093000,SELL
2020-09-29 12:06:00,12:06,9334100,8252150,-1081950,SELL
2020-09-29 12:07:00,12:07,9125275,8192725,-932550,SELL
2020-09-29 12:08:00,12:08,9136100,8134200,-1001900,SELL
2020-09-29 12:09:00,12:09,9136150,8213325,-922825,SELL
2020-09-29 12:10:00,12:10,9314000,8246425,-1067575,SELL
2020-09-29 12:11:00,12:11,9336900,8194975,-1141925,SELL
2020-09-29 12:12:00,12:12,9311875,8152325,-1159550,SELL
2020-09-29 12:13:00,12:13,9333100,8069400,-1263700,SELL
2020-09-29 12:14:00,12:14,9325700,8148350,-1177350,SELL
2020-09-29 12:15:00,12:15,9289500,8158375,-1131125,SELL
2020-09-29 12:16:00,12:16,9219025,8152750,-1066275,SELL
2020-09-29 12:17:00,12:17,9195350,8211275,-984075,SELL
2020-09-29 12:18:00,12:18,9351725,8213725,-1138000,SELL
2020-09-29 12:19:00,12:19,9364450,8175525,-1188925,SELL
2020-09-29 12:20:00,12:20,9325075,8202250,-1122825,SELL
2020-09-29 12:21:00,12:21,9381450,8214900,-1166550,SELL
2020-09-29 12:22:00,12:22,9262075,8214900,-1047175,SELL
2020-09-29 12:23:00,12:23,9275300,8167750,-1107550,SELL
2020-09-29 12:24:00,12:24,9337625,8149250,-1188375,SELL
2020-09-29 12:25:00,12:25,9425600,8182825,-1242775,SELL
2020-09-29 12:26:00,12:26,9262700,8193075,-1069625,SELL
2020-09-29 12:27:00,12:27,9199725,8208125,-991600,SELL
2020-09-29 12:28:00,12:28,9326225,8193025,-1133200,SELL
2020-09-29 12:29:00,12:29,9193000,8204225,-988775,SELL
2020-09-29 12:30:00,12:30,9191150,8138575,-1052575,SELL
2020-09-29 12:31:00,12:31,9191150,8198275,-992875,SELL
2020-09-29 12:32:00,12:32,9233300,8218075,-1015225,SELL
2020-09-29 12:33:00,12:33,9365550,8204450,-1161100,SELL
2020-09-29 12:34:00,12:34,9297225,8206975,-1090250,SELL
2020-09-29 12:35:00,12:35,9212875,8231000,-981875,SELL
2020-09-29 12:36:00,12:36,9389250,8309075,-1080175,SELL
2020-09-29 12:37:00,12:37,9344400,8309075,-1035325,SELL
2020-09-29 12:38:00,12:38,9366675,8224550,-1142125,SELL
2020-09-29 12:39:00,12:39,9277650,8278850,-998800,SELL
2020-09-29 12:40:00,12:40,9279700,8320175,-959525,SELL
2020-09-29 12:41:00,12:41,9385850,8303900,-1081950,SELL
2020-09-29 12:42:00,12:42,9447175,8238200,-1208975,SELL
2020-09-29 12:43:00,12:43,9291250,8292250,-999000,SELL
2020-09-29 12:44:00,12:44,9427050,8288675,-1138375,SELL
2020-09-29 12:45:00,12:45,9489400,8324150,-1165250,SELL
2020-09-29 12:46:00,12:46,9471525,8348975,-1122550,SELL
2020-09-29 12:47:00,12:47,9452250,8235300,-1216950,SELL
2020-09-29 12:48:00,12:48,9370375,8282775,-1087600,SELL
2020-09-29 12:49:00,12:49,9431250,8282775,-1148475,SELL
2020-09-29 12:50:00,12:50,9442300,8207725,-1234575,SELL
2020-09-29 12:51:00,12:51,9443825,8205925,-1237900,SELL
2020-09-29 12:52:00,12:52,9500550,8187775,-1312775,SELL
2020-09-29 12:53:00,12:53,9198575,8245200,-953375,SELL
2020-09-29 12:54:00,12:54,9450025,8269525,-1180500,SELL
2020-09-29 12:55:00,12:55,9384050,8227350,-1156700,SELL
2020-09-29 12:56:00,12:56,9390325,8231650,-1158675,SELL
2020-09-29 12:57:00,12:57,9230300,8207000,-1023300,SELL
2020-09-29 12:58:00,12:58,9238750,8284875,-953875,SELL
2020-09-29 12:59:00,12:59,9291950,8269925,-1022025,SELL
2020-09-29 13:00:00,13:00,9392375,8244525,-1147850,SELL
2020-09-29 13:01:00,13:01,9286650,8244525,-1042125,SELL
2020-09-29 13:02:00,13:02,9380025,8351925,-1028100,SELL
2020-09-29 13:03:00,13:03,9239325,8320150,-919175,SELL
2020-09-29 13:04:00,13:04,9237275,8310800,-926475,SELL
2020-09-29 13:05:00,13:05,9381350,8344500,-1036850,SELL
2020-09-29 13:06:00,13:06,9447325,8350500,-1096825,SELL
2020-09-29 13:07:00,13:07,9336100,8337925,-998175,SELL
2020-09-29 13:08:00,13:08,9243100,8290600,-952500,SELL
2020-09-29 13:09:00,13:09,9362300,8338250,-1024050,SELL
2020-09-29 13:10:00,13:10,9405625,8335250,-1070375,SELL
2020-09-29 13:11:00,13:11,9234175,8370625,-863550,SELL
2020-09-29 13:12:00,13:12,9194450,8276850,-917600,SELL
2020-09-29 13:13:00,13:13,9325375,8276850,-1048525,SELL
2020-09-29 13:14:00,13:14,9219450,8276850,-942600,SELL
2020-09-29 13:15:00,13:15,9442650,8325900,-1116750,SELL
2020-09-29 13:16:00,13:16,9369300,8324500,-1044800,SELL
2020-09-29 13:17:00,13:17,9085100,8273550,-811550,SELL
2020-09-29 13:18:00,13:18,9455450,8259525,-1195925,SELL
2020-09-29 13:19:00,13:19,9420975,8276775,-1144200,SELL
2020-09-29 13:20:00,13:20,9311825,8283650,-1028175,SELL
2020-09-29 13:21:00,13:21,9315125,8307225,-1007900,SELL
2020-09-29 13:22:00,13:22,9357150,8259775,-1097375,SELL
2020-09-29 13:23:00,13:23,9465100,8294775,-1170325,SELL
2020-09-29 13:24:00,13:24,9549800,8338575,-1211225,SELL
2020-09-29 13:25:00,13:25,9541475,8297100,-1244375,SELL
2020-09-29 13:26:00,13:26,9450375,8337575,-1112800,SELL
2020-09-29 13:27:00,13:27,9492425,8277725,-1214700,SELL
2020-09-29 13:28:00,13:28,9250375,8272200,-978175,SELL
2020-09-29 13:29:00,13:29,9275450,8272200,-1003250,SELL
2020-09-29 13:30:00,13:30,9242075,8315125,-926950,SELL
2020-09-29 13:31:00,13:31,9448875,8368675,-1080200,SELL
2020-09-29 13:32:00,13:32,9462425,8334850,-1127575,SELL
2020-09-29 13:33:00,13:33,9546225,8262350,-1283875,SELL
2020-09-29 13:34:00,13:34,9486475,8218400,-1268075,SELL
2020-09-29 13:35:00,13:35,9444375,8212375,-1232000,SELL
2020-09-29 13:36:00,13:36,9448050,8186250,-1261800,SELL
2020-09-29 13:37:00,13:37,9405075,8180775,-1224300,SELL
2020-09-29 13:38:00,13:38,9448050,8227200,-1220850,SELL
2020-09-29 13:39:00,13:39,9428475,8212750,-1215725,SELL
2020-09-29 13:40:00,13:40,9384300,8271925,-1112375,SELL
2020-09-29 13:41:00,13:41,9408700,8293650,-1115050,SELL
2020-09-29 13:42:00,13:42,9431475,8277525,-1153950,SELL
2020-09-29 13:43:00,13:43,9418875,8290350,-1128525,SELL
2020-09-29 13:44:00,13:44,9374650,8301875,-1072775,SELL
2020-09-29 13:45:00,13:45,9363600,8316000,-1047600,SELL
2020-09-29 13:46:00,13:46,9473425,8362775,-1110650,SELL
2020-09-29 13:47:00,13:47,9481725,8306750,-1174975,SELL
2020-09-29 13:48:00,13:48,9183000,8222175,-960825,SELL
2020-09-29 13:49:00,13:49,9350525,8288600,-1061925,SELL
2020-09-29 13:50:00,13:50,9297150,8293300,-1003850,SELL
2020-09-29 13:51:00,13:51,9281450,8289200,-992250,SELL
2020-09-29 13:52:00,13:52,9119975,8235800,-884175,SELL
2020-09-29 13:53:00,13:53,9313475,8299000,-1014475,SELL
2020-09-29 13:54:00,13:54,9343225,8393575,-949650,SELL
2020-09-29 13:55:00,13:55,9320225,8385475,-934750,SELL
2020-09-29 13:56:00,13:56,9296700,8288025,-1008675,SELL
2020-09-29 13:57:00,13:57,9106925,8297325,-809600,SELL
2020-09-29 13:58:00,13:58,9120425,8278675,-841750,SELL
2020-09-29 13:59:00,13:59,9182025,8291625,-890400,SELL
2020-09-29 14:00:00,14:00,9306875,8347825,-959050,SELL
2020-09-29 14:01:00,14:01,9264075,8342675,-921400,SELL
2020-09-29 14:02:00,14:02,9220225,8311225,-909000,SELL
2020-09-29 14:03:00,14:03,9185400,8327425,-857975,SELL
2020-09-29 14:04:00,14:04,9161375,8313750,-847625,SELL
2020-09-29 14:05:00,14:05,9253275,8299300,-953975,SELL
2020-09-29 14:06:00,14:06,9175650,8341600,-834050,SELL
2020-09-29 14:07:00,14:07,9345775,8334825,-1010950,SELL
2020-09-29 14:08:00,14:08,9322900,8348500,-974400,SELL
2020-09-29 14:09:00,14:09,9290550,8391925,-898625,SELL
2020-09-29 14:10:00,14:10,9290550,8350075,-940475,SELL
2020-09-29 14:11:00,14:11,9142350,8313025,-829325,SELL
2020-09-29 14:12:00,14:12,9017450,8290075,-727375,SELL
2020-09-29 14:13:00,14:13,9252475,8379600,-872875,SELL
2020-09-29 14:14:00,14:14,9357800,8367375,-990425,SELL
2020-09-29 14:15:00,14:15,9379425,8459225,-920200,SELL
2020-09-29 14:16:00,14:16,9379425,8459275,-920150,SELL
2020-09-29 14:17:00,14:17,9344025,8452700,-891325,SELL
2020-09-29 14:18:00,14:18,8862350,8106675,-755675,SELL
2020-09-29 14:19:00,14:19,8843600,8109725,-733875,SELL
2020-09-29 14:20:00,14:20,8799725,8135850,-663875,SELL
2020-09-29 14:21:00,14:21,8768675,8115850,-652825,SELL
2020-09-29 14:22:00,14:22,8636550,8114400,-522150,SELL
2020-09-29 14:23:00,14:23,8814775,8115850,-698925,SELL
2020-09-29 14:24:00,14:24,8783050,8116450,-666600,SELL
2020-09-29 14:25:00,14:25,8795450,8089000,-706450,SELL
2020-09-29 14:26:00,14:26,8633775,8089000,-544775,SELL
2020-09-29 14:27:00,14:27,8817925,8121600,-696325,SELL
2020-09-29 14:28:00,14:28,8672000,8097125,-574875,SELL
2020-09-29 14:29:00,14:29,8744500,8053275,-691225,SELL
2020-09-29 14:30:00,14:30,8842200,8070675,-771525,SELL
2020-09-29 14:31:00,14:31,8793725,8048500,-745225,SELL
2020-09-29 14:32:00,14:32,8793725,8045025,-748700,SELL
2020-09-29 14:33:00,14:33,8771750,7880825,-890925,SELL
2020-09-29 14:34:00,14:34,8796800,7944425,-852375,SELL
2020-09-29 14:35:00,14:35,8767000,7903350,-863650,SELL
2020-09-29 14:36:00,14:36,8798300,7860600,-937700,SELL
2020-09-29 14:37:00,14:37,8779700,7852825,-926875,SELL
2020-09-29 14:38:00,14:38,8835350,7864650,-970700,SELL
2020-09-29 14:39:00,14:39,8689350,7852525,-836825,SELL
2020-09-29 14:40:00,14:40,8816100,7852450,-963650,SELL
2020-09-29 14:41:00,14:41,8653000,7798925,-854075,SELL
2020-09-29 14:42:00,14:42,8774350,7813325,-961025,SELL
2020-09-29 14:43:00,14:43,8741350,7819175,-922175,SELL
2020-09-29 14:44:00,14:44,8778550,7813225,-965325,SELL
2020-09-29 14:45:00,14:45,8827850,7731650,-1096200,SELL
2020-09-29 14:46:00,14:46,8814250,7725725,-1088525,SELL
2020-09-29 14:47:00,14:47,8790925,7725725,-1065200,SELL
2020-09-29 14:48:00,14:48,8742750,7714425,-1028325,SELL
2020-09-29 14:49:00,14:49,8557225,7647525,-909700,SELL
2020-09-29 14:50:00,14:50,8723750,7683300,-1040450,SELL
2020-09-29 14:51:00,14:51,8652300,7675700,-976600,SELL
2020-09-29 14:52:00,14:52,8601475,7620525,-980950,SELL
2020-09-29 14:53:00,14:53,8812400,7701975,-1110425,SELL
2020-09-29 14:54:00,14:54,8734575,7578500,-1156075,SELL
2020-09-29 14:55:00,14:55,8766975,7584475,-1182500,SELL
2020-09-29 14:56:00,14:56,8706375,7580950,-1125425,SELL
2020-09-29 14:57:00,14:57,8572825,7325300,-1247525,SELL
2020-09-29 14:58:00,14:58,8633375,7371950,-1261425,SELL
2020-09-29 14:59:00,14:59,8647075,7367300,-1279775,SELL
2020-09-29 15:00:00,15:00,8622275,7297650,-1324625,SELL
2020-09-29 15:01:00,15:01,8640375,7301125,-1339250,SELL
2020-09-29 15:02:00,15:02,8658950,7295150,-1363800,SELL
2020-09-29 15:03:00,15:03,8526900,7416350,-1110550,SELL
2020-09-29 15:04:00,15:04,8509225,7418525,-1090700,SELL
2020-09-29 15:05:00,15:05,8575175,7375575,-1199600,SELL
2020-09-29 15:06:00,15:06,8483650,7360400,-1123250,SELL
2020-09-29 15:07:00,15:07,8483375,7378325,-1105050,SELL
2020-09-29 15:08:00,15:08,8422850,7375625,-1047225,SELL
2020-09-29 15:09:00,15:09,8492675,7288750,-1203925,SELL
2020-09-29 15:10:00,15:10,8407300,7285050,-1122250,SELL
2020-09-29 15:11:00,15:11,8454675,7278350,-1176325,SELL
2020-09-29 15:12:00,15:12,8360625,7167725,-1192900,SELL
2020-09-29 15:13:00,15:13,8273550,7202750,-1070800,SELL
2020-09-29 15:14:00,15:14,8426875,7208675,-1218200,SELL
2020-09-29 15:15:00,15:15,8365350,7121775,-1243575,SELL
2020-09-29 15:16:00,15:16,8308500,7095750,-1212750,SELL
2020-09-29 15:17:00,15:17,8364750,7101900,-1262850,SELL
2020-09-29 15:18:00,15:18,8144725,6983675,-1161050,SELL
2020-09-29 15:19:00,15:19,8167675,6983550,-1184125,SELL
2020-09-29 15:20:00,15:20,8125100,7023150,-1101950,SELL
2020-09-29 15:21:00,15:21,8090025,6909050,-1180975,SELL
2020-09-29 15:22:00,15:22,8060800,6896800,-1164000,SELL
2020-09-29 15:23:00,15:23,8116550,6911525,-1205025,SELL
2020-09-29 15:24:00,15:24,8037850,6875775,-1162075,SELL
2020-09-29 15:25:00,15:25,8056625,6868950,-1187675,SELL
2020-09-29 15:26:00,15:26,7930850,6834000,-1096850,SELL
2020-09-29 15:27:00,15:27,7880450,6701675,-1178775,SELL
2020-09-29 15:28:00,15:28,7843975,6680700,-1163275,SELL
2020-09-29 15:29:00,15:29,7856100,6703100,-1153000,SELL
2020-09-30 09:15:00,09:15,7697750,6437550,-1260200,SELL
2020-09-30 09:16:00,09:16,7705975,6455025,-1250950,SELL
2020-09-30 09:17:00,09:17,8024850,6857050,-1167800,SELL
2020-09-30 09:18:00,09:18,8021575,6832450,-1189125,SELL
2020-09-30 09:19:00,09:19,8024850,6781000,-1243850,SELL
2020-09-30 09:20:00,09:20,8462750,7246000,-1216750,SELL
2020-09-30 09:21:00,09:21,8462750,7248350,-1214400,SELL
2020-09-30 09:22:00,09:22,8462825,7264950,-1197875,SELL
2020-09-30 09:23:00,09:23,8634925,7267350,-1367575,SELL
2020-09-30 09:24:00,09:24,8635300,7217325,-1417975,SELL
2020-09-30 09:25:00,09:25,8648850,7253575,-1395275,SELL
2020-09-30 09:26:00,09:26,8848925,7502575,-1346350,SELL
2020-09-30 09:27:00,09:27,8856975,7516775,-1340200,SELL
2020-09-30 09:28:00,09:28,8848925,7494550,-1354375,SELL
2020-09-30 09:29:00,09:29,9041850,7608525,-1433325,SELL
2020-09-30 09:30:00,09:30,9052450,7682325,-1370125,SELL
2020-09-30 09:31:00,09:31,9028825,7631225,-1397600,SELL
2020-09-30 09:32:00,09:32,9160725,7846375,-1314350,SELL
2020-09-30 09:33:00,09:33,9104350,7844600,-1259750,SELL
2020-09-30 09:34:00,09:34,9145050,7871175,-1273875,SELL
2020-09-30 09:35:00,09:35,9310075,7979300,-1330775,SELL
2020-09-30 09:36:00,09:36,9330300,8002975,-1327325,SELL
2020-09-30 09:37:00,09:37,9310075,8013775,-1296300,SELL
2020-09-30 09:38:00,09:38,9407000,8021450,-1385550,SELL
2020-09-30 09:39:00,09:39,9426200,8059400,-1366800,SELL
2020-09-30 09:40:00,09:40,9412700,8036275,-1376425,SELL
2020-09-30 09:41:00,09:41,9561550,8213025,-1348525,SELL
2020-09-30 09:42:00,09:42,9542300,8200400,-1341900,SELL
2020-09-30 09:43:00,09:43,9528825,8218550,-1310275,SELL
2020-09-30 09:44:00,09:44,9598175,8203825,-1394350,SELL
2020-09-30 09:45:00,09:45,9630800,8225875,-1404925,SELL
2020-09-30 09:46:00,09:46,9623725,8264850,-1358875,SELL
2020-09-30 09:47:00,09:47,9724250,8152325,-1571925,SELL
2020-09-30 09:48:00,09:48,9716225,8176725,-1539500,SELL
2020-09-30 09:49:00,09:49,9688625,8152325,-1536300,SELL
2020-09-30 09:50:00,09:50,9718625,8297825,-1420800,SELL
2020-09-30 09:51:00,09:51,9736925,8311375,-1425550,SELL
2020-09-30 09:52:00,09:52,9761250,8285125,-1476125,SELL
2020-09-30 09:53:00,09:53,9892850,8354775,-1538075,SELL
2020-09-30 09:54:00,09:54,9930350,8394700,-1535650,SELL
2020-09-30 09:55:00,09:55,9905900,8379500,-1526400,SELL
2020-09-30 09:56:00,09:56,10005750,8462600,-1543150,SELL
2020-09-30 09:57:00,09:57,9992850,8498900,-1493950,SELL
2020-09-30 09:58:00,09:58,9986475,8458700,-1527775,SELL
2020-09-30 09:59:00,09:59,10071200,8332650,-1738550,SELL
2020-09-30 10:00:00,10:00,10103050,8332650,-1770400,SELL
2020-09-30 10:01:00,10:01,10098175,8356000,-1742175,SELL
2020-09-30 10:02:00,10:02,10144300,8432500,-1711800,SELL
2020-09-30 10:03:00,10:03,10124325,8466575,-1657750,SELL
2020-09-30 10:04:00,10:04,10137775,8416025,-1721750,SELL
2020-09-30 10:05:00,10:05,10225700,8559100,-1666600,SELL
2020-09-30 10:06:00,10:06,10262775,8498375,-1764400,SELL
2020-09-30 10:07:00,10:07,10233800,8547350,-1686450,SELL
2020-09-30 10:08:00,10:08,10171325,8528250,-1643075,SELL
2020-09-30 10:09:00,10:09,10211725,8563975,-1647750,SELL
2020-09-30 10:10:00,10:10,10183750,8568675,-1615075,SELL
2020-09-30 10:11:00,10:11,10314375,8611800,-1702575,SELL
2020-09-30 10:12:00,10:12,10286650,8575975,-1710675,SELL
2020-09-30 10:13:00,10:13,10246025,8554025,-1692000,SELL
2020-09-30 10:14:00,10:14,10330375,8612600,-1717775,SELL
2020-09-30 10:15:00,10:15,10323350,8625725,-1697625,SELL
2020-09-30 10:16:00,10:16,10270300,8623900,-1646400,SELL
2020-09-30 10:17:00,10:17,10304675,8756125,-1548550,SELL
2020-09-30 10:18:00,10:18,10372975,8731425,-1641550,SELL
2020-09-30 10:19:00,10:19,10360750,8775900,-1584850,SELL
2020-09-30 10:20:00,10:20,10359275,8781300,-1577975,SELL
2020-09-30 10:21:00,10:21,10322700,8781850,-1540850,SELL
2020-09-30 10:22:00,10:22,10326900,8759300,-1567600,SELL
2020-09-30 10:23:00,10:23,10430300,8834875,-1595425,SELL
2020-09-30 10:24:00,10:24,10430325,8845300,-1585025,SELL
2020-09-30 10:25:00,10:25,10211275,8796125,-1415150,SELL
2020-09-30 10:26:00,10:26,10410725,8943600,-1467125,SELL
2020-09-30 10:27:00,10:27,10451325,8968800,-1482525,SELL
2020-09-30 10:28:00,10:28,10463700,8897950,-1565750,SELL
2020-09-30 10:29:00,10:29,10347575,9056675,-1290900,SELL
2020-09-30 10:30:00,10:30,10337000,9028675,-1308325,SELL
2020-09-30 10:31:00,10:31,10327650,9027475,-1300175,SELL
2020-09-30 10:32:00,10:32,9354475,8683225,-671250,SELL
2020-09-30 10:33:00,10:33,9322800,8644075,-678725,SELL
2020-09-30 10:34:00,10:34,9337475,8683175,-654300,SELL
2020-09-30 10:35:00,10:35,9250900,8676250,-574650,SELL
2020-09-30 10:36:00,10:36,9232250,8621250,-611000,SELL
2020-09-30 10:37:00,10:37,9244575,8625825,-618750,SELL
2020-09-30 10:38:00,10:38,9314550,8753125,-561425,SELL
2020-09-30 10:39:00,10:39,9346900,8801925,-544975,SELL
2020-09-30 10:40:00,10:40,9364925,8812650,-552275,SELL
2020-09-30 10:41:00,10:41,9281700,8832850,-448850,SELL
2020-09-30 10:42:00,10:42,9279425,8818775,-460650,SELL
2020-09-30 10:43:00,10:43,9248500,8803875,-444625,SELL
2020-09-30 10:44:00,10:44,9301675,8773725,-527950,SELL
2020-09-30 10:45:00,10:45,9307475,8808575,-498900,SELL
2020-09-30 10:46:00,10:46,9307475,8837525,-469950,SELL
2020-09-30 10:47:00,10:47,9388800,8885325,-503475,SELL
2020-09-30 10:48:00,10:48,9422000,8899375,-522625,SELL
2020-09-30 10:49:00,10:49,9422000,8885325,-536675,SELL
2020-09-30 10:50:00,10:50,9510975,8987625,-523350,SELL
2020-09-30 10:51:00,10:51,9533375,9043250,-490125,SELL
2020-09-30 10:52:00,10:52,9515075,9046475,-468600,SELL
2020-09-30 10:53:00,10:53,9525850,9145600,-380250,SELL
2020-09-30 10:54:00,10:54,9481950,9169925,-312025,SELL
2020-09-30 10:55:00,10:55,9549025,9201300,-347725,SELL
2020-09-30 10:56:00,10:56,9491250,9278675,-212575,SELL
2020-09-30 10:57:00,10:57,9491275,9250925,-240350,SELL
2020-09-30 10:58:00,10:58,9418100,9244175,-173925,SELL
2020-09-30 10:59:00,10:59,9243050,9283350,40300,BUY
2020-09-30 11:00:00,11:00,9248700,9267700,19000,BUY
2020-09-30 11:01:00,11:01,9208700,9300775,92075,BUY
2020-09-30 11:02:00,11:02,9252075,9258600,6525,BUY
2020-09-30 11:03:00,11:03,9262800,9298050,35250,BUY
2020-09-30 11:04:00,11:04,9264700,9232825,-31875,SELL
2020-09-30 11:05:00,11:05,9396600,9219150,-177450,SELL
2020-09-30 11:06:00,11:06,9353675,9157150,-196525,SELL
2020-09-30 11:07:00,11:07,9361000,9194000,-167000,SELL
2020-09-30 11:08:00,11:08,9422925,9226075,-196850,SELL
2020-09-30 11:09:00,11:09,9443150,9226300,-216850,SELL
2020-09-30 11:10:00,11:10,9422925,9226300,-196625,SELL
2020-09-30 11:11:00,11:11,9543050,9265725,-277325,SELL
2020-09-30 11:12:00,11:12,9540050,9295800,-244250,SELL
2020-09-30 11:13:00,11:13,9541250,9281550,-259700,SELL
2020-09-30 11:14:00,11:14,9501550,9318150,-183400,SELL
2020-09-30 11:15:00,11:15,9623250,9283550,-339700,SELL
2020-09-30 11:16:00,11:16,9610375,9349000,-261375,SELL
2020-09-30 11:17:00,11:17,9567900,9365625,-202275,SELL
2020-09-30 11:18:00,11:18,9580725,9379400,-201325,SELL
2020-09-30 11:19:00,11:19,9590300,9414425,-175875,SELL
2020-09-30 11:20:00,11:20,9616025,9325125,-290900,SELL
2020-09-30 11:21:00,11:21,9636175,9273700,-362475,SELL
2020-09-30 11:22:00,11:22,9581700,9276075,-305625,SELL
2020-09-30 11:23:00,11:23,9617500,9263025,-354475,SELL
2020-09-30 11:24:00,11:24,9619525,9298100,-321425,SELL
2020-09-30 11:25:00,11:25,9673975,9246725,-427250,SELL
2020-09-30 11:26:00,11:26,9648200,9323250,-324950,SELL
2020-09-30 11:27:00,11:27,9719675,9346125,-373550,SELL
2020-09-30 11:28:00,11:28,9720375,9378600,-341775,SELL
2020-09-30 11:29:00,11:29,9697250,9066475,-630775,SELL
2020-09-30 11:30:00,11:30,9720700,9095950,-624750,SELL
2020-09-30 11:31:00,11:31,9697475,9062550,-634925,SELL
2020-09-30 11:32:00,11:32,9753125,8872050,-881075,SELL
2020-09-30 11:33:00,11:33,9758500,8877900,-880600,SELL
2020-09-30 11:34:00,11:34,9748725,8868250,-880475,SELL
2020-09-30 11:35:00,11:35,9776900,8898475,-878425,SELL
2020-09-30 11:36:00,11:36,9764175,8895050,-869125,SELL
2020-09-30 11:37:00,11:37,9823975,8895050,-928925,SELL
2020-09-30 11:38:00,11:38,9849375,8880000,-969375,SELL
2020-09-30 11:39:00,11:39,9862925,8879825,-983100,SELL
2020-09-30 11:40:00,11:40,9873500,8870100,-1003400,SELL
2020-09-30 11:41:00,11:41,9768575,8874150,-894425,SELL
2020-09-30 11:42:00,11:42,9914225,8822725,-1091500,SELL
2020-09-30 11:43:00,11:43,9867575,8809525,-1058050,SELL
2020-09-30 11:44:00,11:44,9891325,8816175,-1075150,SELL
2020-09-30 11:45:00,11:45,9900625,8809725,-1090900,SELL
2020-09-30 11:46:00,11:46,9852700,8803050,-1049650,SELL
2020-09-30 11:47:00,11:47,9933575,8828225,-1105350,SELL
2020-09-30 11:48:00,11:48,9915900,8864000,-1051900,SELL
2020-09-30 11:49:00,11:49,9879425,8828150,-1051275,SELL
2020-09-30 11:50:00,11:50,9944600,8858925,-1085675,SELL
2020-09-30 11:51:00,11:51,9926950,8900550,-1026400,SELL
2020-09-30 11:52:00,11:52,9909375,8871950,-1037425,SELL
2020-09-30 11:53:00,11:53,9933775,8795875,-1137900,SELL
2020-09-30 11:54:00,11:54,9841675,8810950,-1030725,SELL
2020-09-30 11:55:00,11:55,9932925,8797975,-1134950,SELL
2020-09-30 11:56:00,11:56,9818900,8673225,-1145675,SELL
2020-09-30 11:57:00,11:57,9919150,8737600,-1181550,SELL
2020-09-30 11:58:00,11:58,9963525,8779475,-1184050,SELL
2020-09-30 11:59:00,11:59,10020775,8949200,-1071575,SELL
2020-09-30 12:00:00,12:00,9994875,8882175,-1112700,SELL
2020-09-30 12:01:00,12:01,9953375,8869300,-1084075,SELL
2020-09-30 12:02:00,12:02,9968775,8821000,-1147775,SELL
2020-09-30 12:03:00,12:03,10024925,8820000,-1204925,SELL
2020-09-30 12:04:00,12:04,9994750,8851650,-1143100,SELL
2020-09-30 12:05:00,12:05,10008575,8768425,-1240150,SELL
2020-09-30 12:06:00,12:06,10069825,8789250,-1280575,SELL
2020-09-30 12:07:00,12:07,10044650,8864300,-1180350,SELL
2020-09-30 12:08:00,12:08,10040050,8857050,-1183000,SELL
2020-09-30 12:09:00,12:09,10050875,8854750,-1196125,SELL
2020-09-30 12:10:00,12:10,10004200,8908300,-1095900,SELL
2020-09-30 12:11:00,12:11,10046325,8961375,-1084950,SELL
2020-09-30 12:12:00,12:12,9966550,8853175,-1113375,SELL
2020-09-30 12:13:00,12:13,9950275,8920200,-1030075,SELL
2020-09-30 12:14:00,12:14,10137500,8880375,-1257125,SELL
2020-09-30 12:15:00,12:15,10122700,8874775,-1247925,SELL
2020-09-30 12:16:00,12:16,10047725,8833100,-1214625,SELL
2020-09-30 12:17:00,12:17,10222950,8898025,-1324925,SELL
2020-09-30 12:18:00,12:18,10206525,8831375,-1375150,SELL
2020-09-30 12:19:00,12:19,10206525,8876250,-1330275,SELL
2020-09-30 12:20:00,12:20,10311450,8909650,-1401800,SELL
2020-09-30 12:21:00,12:21,10304850,8929475,-1375375,SELL
2020-09-30 12:22:00,12:22,10304850,8948250,-1356600,SELL
2020-09-30 12:23:00,12:23,10301500,8945975,-1355525,SELL
2020-09-30 12:24:00,12:24,10297475,8916050,-1381425,SELL
2020-09-30 12:25:00,12:25,10279850,8885250,-1394600,SELL
2020-09-30 12:26:00,12:26,10292575,8999625,-1292950,SELL
2020-09-30 12:27:00,12:27,9463725,8909550,-554175,SELL
2020-09-30 12:28:00,12:28,10289100,9022125,-1266975,SELL
2020-09-30 12:29:00,12:29,10309375,9062775,-1246600,SELL
2020-09-30 12:30:00,12:30,10292675,9034675,-1258000,SELL
2020-09-30 12:31:00,12:31,10310350,9021675,-1288675,SELL
2020-09-30 12:32:00,12:32,10317225,9121075,-1196150,SELL
2020-09-30 12:33:00,12:33,10326225,9076750,-1249475,SELL
2020-09-30 12:34:00,12:34,10349175,9128550,-1220625,SELL
2020-09-30 12:35:00,12:35,10225575,9179175,-1046400,SELL
2020-09-30 12:36:00,12:36,10175725,9151975,-1023750,SELL
2020-09-30 12:37:00,12:37,10173750,9203325,-970425,SELL
2020-09-30 12:38:00,12:38,10202950,9195675,-1007275,SELL
2020-09-30 12:39:00,12:39,10242325,9194225,-1048100,SELL
2020-09-30 12:40:00,12:40,10272700,9228875,-1043825,SELL
2020-09-30 12:41:00,12:41,10210500,9205600,-1004900,SELL
2020-09-30 12:42:00,12:42,10126300,9184875,-941425,SELL
2020-09-30 12:43:00,12:43,10191000,9167650,-1023350,SELL
2020-09-30 12:44:00,12:44,10212300,9231975,-980325,SELL
2020-09-30 12:45:00,12:45,10253250,9221925,-1031325,SELL
2020-09-30 12:46:00,12:46,10261675,9225900,-1035775,SELL
2020-09-30 12:47:00,12:47,10147725,9335000,-812725,SELL
2020-09-30 12:48:00,12:48,10214650,9283275,-931375,SELL
2020-09-30 12:49:00,12:49,10214650,9252600,-962050,SELL
2020-09-30 12:50:00,12:50,10219600,9267175,-952425,SELL
2020-09-30 12:51:00,12:51,10230450,9275675,-954775,SELL
2020-09-30 12:52:00,12:52,10189350,9299900,-889450,SELL
2020-09-30 12:53:00,12:53,10199950,9335200,-864750,SELL
2020-09-30 12:54:00,12:54,10293800,9381625,-912175,SELL
2020-09-30 12:55:00,12:55,10235075,9318700,-916375,SELL
2020-09-30 12:56:00,12:56,10288525,9329175,-959350,SELL
2020-09-30 12:57:00,12:57,10308050,9265825,-1042225,SELL
2020-09-30 12:58:00,12:58,10266850,9265675,-1001175,SELL
2020-09-30 12:59:00,12:59,10310000,9275800,-1034200,SELL
2020-09-30 13:00:00,13:00,10297000,9397350,-899650,SELL
2020-09-30 13:01:00,13:01,10314525,9322500,-992025,SELL
2020-09-30 13:02:00,13:02,10315200,9311625,-1003575,SELL
2020-09-30 13:03:00,13:03,10232850,9420950,-811900,SELL
2020-09-30 13:04:00,13:04,10304225,9502650,-801575,SELL
2020-09-30 13:05:00,13:05,10291500,9478950,-812550,SELL
2020-09-30 13:06:00,13:06,9978625,9509875,-468750,SELL
2020-09-30 13:07:00,13:07,9937400,9462375,-475025,SELL
2020-09-30 13:08:00,13:08,9978625,9459900,-518725,SELL
2020-09-30 13:09:00,13:09,10033175,9467900,-565275,SELL
2020-09-30 13:10:00,13:10,9997075,9503650,-493425,SELL
2020-09-30 13:11:00,13:11,9979375,9460375,-519000,SELL
2020-09-30 13:12:00,13:12,10031850,9419725,-612125,SELL
2020-09-30 13:13:00,13:13,10072925,9350225,-722700,SELL
2020-09-30 13:14:00,13:14,10072925,9415325,-657600,SELL
2020-09-30 13:15:00,13:15,10132750,9398475,-734275,SELL
2020-09-30 13:16:00,13:16,10158750,9416100,-742650,SELL
2020-09-30 13:17:00,13:17,10091625,9397875,-693750,SELL
2020-09-30 13:18:00,13:18,10167575,9315000,-852575,SELL
2020-09-30 13:19:00,13:19,10083325,9379750,-703575,SELL
2020-09-30 13:20:00,13:20,10143975,9366700,-777275,SELL
2020-09-30 13:21:00,13:21,10236925,9409225,-827700,SELL
2020-09-30 13:22:00,13:22,10169725,9429325,-740400,SELL
2020-09-30 13:23:00,13:23,9955525,9408375,-547150,SELL
2020-09-30 13:24:00,13:24,10091525,9401850,-689675,SELL
2020-09-30 13:25:00,13:25,10166550,9414825,-751725,SELL
2020-09-30 13:26:00,13:26,10225300,9401800,-823500,SELL
2020-09-30 13:27:00,13:27,10239150,9497175,-741975,SELL
2020-09-30 13:28:00,13:28,10249525,9484825,-764700,SELL
2020-09-30 13:29:00,13:29,10172075,9420125,-751950,SELL
2020-09-30 13:30:00,13:30,10149250,9346000,-803250,SELL
2020-09-30 13:31:00,13:31,10149250,9358900,-790350,SELL
2020-09-30 13:32:00,13:32,10172550,9348925,-823625,SELL
2020-09-30 13:33:00,13:33,10198300,9311125,-887175,SELL
2020-09-30 13:34:00,13:34,10171050,9328250,-842800,SELL
2020-09-30 13:35:00,13:35,10198300,9311125,-887175,SELL
2020-09-30 13:36:00,13:36,10178325,9383050,-795275,SELL
2020-09-30 13:37:00,13:37,10178325,9396000,-782325,SELL
2020-09-30 13:38:00,13:38,10178325,9400150,-778175,SELL
2020-09-30 13:39:00,13:39,9992975,9415500,-577475,SELL
2020-09-30 13:40:00,13:40,10115125,9392275,-722850,SELL
2020-09-30 13:41:00,13:41,10199750,9405200,-794550,SELL
2020-09-30 13:42:00,13:42,10310125,9383850,-926275,SELL
2020-09-30 13:43:00,13:43,10256550,9400950,-855600,SELL
2020-09-30 13:44:00,13:44,10212800,9337300,-875500,SELL
2020-09-30 13:45:00,13:45,10277400,9456175,-821225,SELL
2020-09-30 13:46:00,13:46,10266425,9359225,-907200,SELL
2020-09-30 13:47:00,13:47,10279125,9439075,-840050,SELL
2020-09-30 13:48:00,13:48,10338200,9474750,-863450,SELL
2020-09-30 13:49:00,13:49,10296675,9491900,-804775,SELL
2020-09-30 13:50:00,13:50,10266325,9488350,-777975,SELL
2020-09-30 13:51:00,13:51,10231375,9599325,-632050,SELL
2020-09-30 13:52:00,13:52,10311475,9623325,-688150,SELL
2020-09-30 13:53:00,13:53,10272450,9566425,-706025,SELL
2020-09-30 13:54:00,13:54,10165300,9659950,-505350,SELL
2020-09-30 13:55:00,13:55,10206400,9623950,-582450,SELL
2020-09-30 13:56:00,13:56,10232725,9594425,-638300,SELL
2020-09-30 13:57:00,13:57,10190650,9675250,-515400,SELL
2020-09-30 13:58:00,13:58,10175475,9664475,-511000,SELL
2020-09-30 13:59:00,13:59,10203300,9599750,-603550,SELL
2020-09-30 14:00:00,14:00,10194575,9728975,-465600,SELL
2020-09-30 14:01:00,14:01,10247800,9746725,-501075,SELL
2020-09-30 14:02:00,14:02,10222925,9709325,-513600,SELL
2020-09-30 14:03:00,14:03,10182525,9713525,-469000,SELL
2020-09-30 14:04:00,14:04,10223500,9624300,-599200,SELL
2020-09-30 14:05:00,14:05,10182525,9666225,-516300,SELL
2020-09-30 14:06:00,14:06,10175575,9741250,-434325,SELL
2020-09-30 14:07:00,14:07,10241400,9712800,-528600,SELL
2020-09-30 14:08:00,14:08,10233125,9707700,-525425,SELL
2020-09-30 14:09:00,14:09,10253375,9820200,-433175,SELL
2020-09-30 14:10:00,14:10,10217775,9831700,-386075,SELL
2020-09-30 14:11:00,14:11,10217775,9789675,-428100,SELL
2020-09-30 14:12:00,14:12,9889425,9733725,-155700,SELL
2020-09-30 14:13:00,14:13,9882075,9774075,-108000,SELL
2020-09-30 14:14:00,14:14,9907625,9799625,-108000,SELL
2020-09-30 14:15:00,14:15,9437650,9850050,412400,BUY
2020-09-30 14:16:00,14:16,9437650,9797525,359875,BUY
2020-09-30 14:17:00,14:17,9383425,9762950,379525,BUY
2020-09-30 14:18:00,14:18,9240500,9734050,493550,BUY
2020-09-30 14:19:00,14:19,9181275,9720625,539350,BUY
2020-09-30 14:20:00,14:20,9258575,9770225,511650,BUY
2020-09-30 14:21:00,14:21,9272225,9774800,502575,BUY
2020-09-30 14:22:00,14:22,9243350,9735350,492000,BUY
2020-09-30 14:23:00,14:23,9243350,9748325,504975,BUY
2020-09-30 14:24:00,14:24,9323675,9785900,462225,BUY
2020-09-30 14:25:00,14:25,9331050,9763425,432375,BUY
2020-09-30 14:26:00,14:26,9331050,9796625,465575,BUY
2020-09-30 14:27:00,14:27,9293100,9778625,485525,BUY
2020-09-30 14:28:00,14:28,9293025,9789875,496850,BUY
2020-09-30 14:29:00,14:29,9248100,9789875,541775,BUY
2020-09-30 14:30:00,14:30,9396700,9772425,375725,BUY
2020-09-30 14:31:00,14:31,9425400,9772425,347025,BUY
2020-09-30 14:32:00,14:32,9443050,9804300,361250,BUY
2020-09-30 14:33:00,14:33,9242525,9845625,603100,BUY
2020-09-30 14:34:00,14:34,9261025,9853625,592600,BUY
2020-09-30 14:35:00,14:35,9261025,9853625,592600,BUY
2020-09-30 14:36:00,14:36,9107575,9751625,644050,BUY
2020-09-30 14:37:00,14:37,9103075,9767925,664850,BUY
2020-09-30 14:38:00,14:38,9090325,9781050,690725,BUY
2020-09-30 14:39:00,14:39,9137500,9710800,573300,BUY
2020-09-30 14:40:00,14:40,9137550,9739425,601875,BUY
2020-09-30 14:41:00,14:41,9137550,9769475,631925,BUY
2020-09-30 14:42:00,14:42,9168275,9693675,525400,BUY
2020-09-30 14:43:00,14:43,9098150,9705175,607025,BUY
2020-09-30 14:44:00,14:44,9110950,9712650,601700,BUY
2020-09-30 14:45:00,14:45,9167925,9650025,482100,BUY
2020-09-30 14:46:00,14:46,9237800,9725600,487800,BUY
2020-09-30 14:47:00,14:47,9161075,9682875,521800,BUY
2020-09-30 14:48:00,14:48,9277325,9709075,431750,BUY
2020-09-30 14:49:00,14:49,9178725,9640275,461550,BUY
2020-09-30 14:50:00,14:50,9264625,9696025,431400,BUY
2020-09-30 14:51:00,14:51,9264050,9735075,471025,BUY
2020-09-30 14:52:00,14:52,9276800,9740975,464175,BUY
2020-09-30 14:53:00,14:53,9178075,9688525,510450,BUY
2020-09-30 14:54:00,14:54,9224000,9603550,379550,BUY
2020-09-30 14:55:00,14:55,9241350,9592900,351550,BUY
2020-09-30 14:56:00,14:56,9211175,9604425,393250,BUY
2020-09-30 14:57:00,14:57,9121150,9556850,435700,BUY
2020-09-30 14:58:00,14:58,9092400,9549075,456675,BUY
2020-09-30 14:59:00,14:59,9152275,9621225,468950,BUY
2020-09-30 15:00:00,15:00,9006525,9433575,427050,BUY
2020-09-30 15:01:00,15:01,8925075,9470150,545075,BUY
2020-09-30 15:02:00,15:02,8998325,9426875,428550,BUY
2020-09-30 15:03:00,15:03,8902525,9404450,501925,BUY
2020-09-30 15:04:00,15:04,8902475,9404150,501675,BUY
2020-09-30 15:05:00,15:05,8931225,9337800,406575,BUY
2020-09-30 15:06:00,15:06,8817425,9315250,497825,BUY
2020-09-30 15:07:00,15:07,8846175,9311875,465700,BUY
2020-09-30 15:08:00,15:08,8802000,9342325,540325,BUY
2020-09-30 15:09:00,15:09,8708575,9274400,565825,BUY
2020-09-30 15:10:00,15:10,8780875,9313700,532825,BUY
2020-09-30 15:11:00,15:11,8780875,9260375,479500,BUY
2020-09-30 15:12:00,15:12,8577775,9143150,565375,BUY
2020-09-30 15:13:00,15:13,8747650,9189125,441475,BUY
2020-09-30 15:14:00,15:14,8675275,9184775,509500,BUY
2020-09-30 15:15:00,15:15,8653125,9159050,505925,BUY
2020-09-30 15:16:00,15:16,8594325,9110275,515950,BUY
2020-09-30 15:17:00,15:17,8656650,9154550,497900,BUY
2020-09-30 15:18:00,15:18,8448025,8947500,499475,BUY
2020-09-30 15:19:00,15:19,8416825,8998850,582025,BUY
2020-09-30 15:20:00,15:20,8492075,8965525,473450,BUY
2020-09-30 15:21:00,15:21,8189750,8701450,511700,BUY
2020-09-30 15:22:00,15:22,8199950,8661300,461350,BUY
2020-09-30 15:23:00,15:23,8025450,8687975,662525,BUY
2020-09-30 15:24:00,15:24,7925875,8517750,591875,BUY
2020-09-30 15:25:00,15:25,8040050,8580400,540350,BUY
2020-09-30 15:26:00,15:26,7938250,8543175,604925,BUY
2020-09-30 15:27:00,15:27,7762750,8178950,416200,BUY
2020-09-30 15:28:00,15:28,7687300,8163775,476475,BUY
2020-09-30 15:29:00,15:29,7787675,8136700,349025,BUY
2020-10-01 09:15:00,09:15,7544350,7907600,363250,BUY
2020-10-01 09:16:00,09:16,7536250,7928875,392625,BUY
2020-10-01 09:17:00,09:17,7915600,8424300,508700,BUY
2020-10-01 09:18:00,09:18,7907450,8404175,496725,BUY
2020-10-01 09:19:00,09:19,7866800,8423325,556525,BUY
2020-10-01 09:20:00,09:20,8820925,10490575,1669650,BUY
2020-10-01 09:21:00,09:21,8856000,10509475,1653475,BUY
2020-10-01 09:22:00,09:22,8873325,10489550,1616225,BUY
2020-10-01 09:23:00,09:23,9391375,11394925,2003550,BUY
2020-10-01 09:24:00,09:24,9335900,11418350,2082450,BUY
2020-10-01 09:25:00,09:25,9399525,11421725,2022200,BUY
2020-10-01 09:26:00,09:26,9594375,12545725,2951350,BUY
2020-10-01 09:27:00,09:27,9586150,12521550,2935400,BUY
2020-10-01 09:28:00,09:28,9580575,12544650,2964075,BUY
2020-10-01 09:29:00,09:29,9935650,13201925,3266275,BUY
2020-10-01 09:30:00,09:30,9820975,13216225,3395250,BUY
2020-10-01 09:31:00,09:31,9841850,13212000,3370150,BUY
2020-10-01 09:32:00,09:32,10371875,13652800,3280925,BUY
2020-10-01 09:33:00,09:33,10341250,13673200,3331950,BUY
2020-10-01 09:34:00,09:34,10432525,13673200,3240675,BUY
2020-10-01 09:35:00,09:35,10706150,14204800,3498650,BUY
2020-10-01 09:36:00,09:36,10633600,14184250,3550650,BUY
2020-10-01 09:37:00,09:37,10549925,14145525,3595600,BUY
2020-10-01 09:38:00,09:38,10749125,14551750,3802625,BUY
2020-10-01 09:39:00,09:39,10829850,14465450,3635600,BUY
2020-10-01 09:40:00,09:40,10860175,14550700,3690525,BUY
2020-10-01 09:41:00,09:41,11208600,14902025,3693425,BUY
2020-10-01 09:42:00,09:42,11232600,14877450,3644850,BUY
2020-10-01 09:43:00,09:43,11224375,14934300,3709925,BUY
2020-10-01 09:44:00,09:44,11452100,15254925,3802825,BUY
2020-10-01 09:45:00,09:45,11523650,15234625,3710975,BUY
2020-10-01 09:46:00,09:46,11354750,14808100,3453350,BUY
2020-10-01 09:47:00,09:47,11643575,15468900,3825325,BUY
2020-10-01 09:48:00,09:48,11604050,15618200,4014150,BUY
2020-10-01 09:49:00,09:49,11662500,15622175,3959675,BUY
2020-10-01 09:50:00,09:50,11766950,16104600,4337650,BUY
2020-10-01 09:51:00,09:51,11871450,16101650,4230200,BUY
2020-10-01 09:52:00,09:52,11541050,16026775,4485725,BUY
2020-10-01 09:53:00,09:53,11958400,16200575,4242175,BUY
2020-10-01 09:54:00,09:54,12037225,16215150,4177925,BUY
2020-10-01 09:55:00,09:55,12166025,16194675,4028650,BUY
2020-10-01 09:56:00,09:56,12102000,16227825,4125825,BUY
2020-10-01 09:57:00,09:57,12022775,15887975,3865200,BUY
2020-10-01 09:58:00,09:58,12280450,16226200,3945750,BUY
2020-10-01 09:59:00,09:59,12319400,16444700,4125300,BUY
2020-10-01 10:00:00,10:00,12495750,16436150,3940400,BUY
2020-10-01 10:01:00,10:01,12435750,16447650,4011900,BUY
2020-10-01 10:02:00,10:02,12318550,16613150,4294600,BUY
2020-10-01 10:03:00,10:03,12238500,16612875,4374375,BUY
2020-10-01 10:04:00,10:04,12241675,16633100,4391425,BUY
2020-10-01 10:05:00,10:05,12190325,16706175,4515850,BUY
2020-10-01 10:06:00,10:06,12333375,16719975,4386600,BUY
2020-10-01 10:07:00,10:07,12246950,16678600,4431650,BUY
2020-10-01 10:08:00,10:08,12638900,17059025,4420125,BUY
2020-10-01 10:09:00,10:09,12470700,16397075,3926375,BUY
2020-10-01 10:10:00,10:10,12649675,17039000,4389325,BUY
2020-10-01 10:11:00,10:11,12369200,17275525,4906325,BUY
2020-10-01 10:12:00,10:12,12361850,17243325,4881475,BUY
2020-10-01 10:13:00,10:13,12485775,17241650,4755875,BUY
2020-10-01 10:14:00,10:14,12737300,17439050,4701750,BUY
2020-10-01 10:15:00,10:15,12763400,17439425,4676025,BUY
2020-10-01 10:16:00,10:16,12891500,17441625,4550125,BUY
2020-10-01 10:17:00,10:17,12882100,17606150,4724050,BUY
2020-10-01 10:18:00,10:18,12887400,17604650,4717250,BUY
2020-10-01 10:19:00,10:19,12869700,17502250,4632550,BUY
2020-10-01 10:20:00,10:20,13056900,17702475,4645575,BUY
2020-10-01 10:21:00,10:21,12801325,17597500,4796175,BUY
2020-10-01 10:22:00,10:22,13020650,17516225,4495575,BUY
2020-10-01 10:23:00,10:23,13082500,17927425,4844925,BUY
2020-10-01 10:24:00,10:24,13070325,17541900,4471575,BUY
2020-10-01 10:25:00,10:25,13070325,17949075,4878750,BUY
2020-10-01 10:26:00,10:26,13044500,18211850,5167350,BUY
2020-10-01 10:27:00,10:27,13228625,18214225,4985600,BUY
2020-10-01 10:28:00,10:28,13183775,18020975,4837200,BUY
2020-10-01 10:29:00,10:29,13281350,18526025,5244675,BUY
2020-10-01 10:30:00,10:30,13241425,18544350,5302925,BUY
2020-10-01 10:31:00,10:31,13283950,18184925,4900975,BUY
2020-10-01 10:32:00,10:32,13343300,18506450,5163150,BUY
2020-10-01 10:33:00,10:33,13130925,18403700,5272775,BUY
2020-10-01 10:34:00,10:34,13154925,18716200,5561275,BUY
2020-10-01 10:35:00,10:35,13421000,18833650,5412650,BUY
2020-10-01 10:36:00,10:36,13271725,18159975,4888250,BUY
2020-10-01 10:37:00,10:37,13356525,18830100,5473575,BUY
2020-10-01 10:38:00,10:38,13326250,18246800,4920550,BUY
2020-10-01 10:39:00,10:39,13611675,18974375,5362700,BUY
2020-10-01 10:40:00,10:40,13519550,18932300,5412750,BUY
2020-10-01 10:41:00,10:41,12913450,19177175,6263725,BUY
2020-10-01 10:42:00,10:42,12927100,19177800,6250700,BUY
2020-10-01 10:43:00,10:43,12898725,19177800,6279075,BUY
2020-10-01 10:44:00,10:44,11258725,19438175,8179450,BUY
2020-10-01 10:45:00,10:45,11132325,19429375,8297050,BUY
2020-10-01 10:46:00,10:46,11058800,19476975,8418175,BUY
2020-10-01 10:47:00,10:47,11554400,19690275,8135875,BUY
2020-10-01 10:48:00,10:48,11386850,19655400,8268550,BUY
2020-10-01 10:49:00,10:49,11335200,19621075,8285875,BUY
2020-10-01 10:50:00,10:50,11638550,19868950,8230400,BUY
2020-10-01 10:51:00,10:51,11714675,19874875,8160200,BUY
2020-10-01 10:52:00,10:52,11731450,19800850,8069400,BUY
2020-10-01 10:53:00,10:53,12147000,19992200,7845200,BUY
2020-10-01 10:54:00,10:54,11993325,19991350,7998025,BUY
2020-10-01 10:55:00,10:55,11928025,19898250,7970225,BUY
2020-10-01 10:56:00,10:56,12170925,20181600,8010675,BUY
2020-10-01 10:57:00,10:57,12150850,20177600,8026750,BUY
2020-10-01 10:58:00,10:58,12385000,20195725,7810725,BUY
2020-10-01 10:59:00,10:59,12550475,20325675,7775200,BUY
2020-10-01 11:00:00,11:00,12471825,20350075,7878250,BUY
2020-10-01 11:01:00,11:01,12482925,20301600,7818675,BUY
2020-10-01 11:02:00,11:02,12571975,20530575,7958600,BUY
2020-10-01 11:03:00,11:03,12600650,20455825,7855175,BUY
2020-10-01 11:04:00,11:04,12844025,20555925,7711900,BUY
2020-10-01 11:05:00,11:05,12628250,20442575,7814325,BUY
2020-10-01 11:06:00,11:06,12660075,20426875,7766800,BUY
2020-10-01 11:07:00,11:07,12765425,20427400,7661975,BUY
2020-10-01 11:08:00,11:08,13006000,20535750,7529750,BUY
2020-10-01 11:09:00,11:09,12966400,20567125,7600725,BUY
2020-10-01 11:10:00,11:10,12892575,20623150,7730575,BUY
2020-10-01 11:11:00,11:11,12841050,19676600,6835550,BUY
2020-10-01 11:12:00,11:12,12793150,20579350,7786200,BUY
2020-10-01 11:13:00,11:13,12876350,20222200,7345850,BUY
2020-10-01 11:14:00,11:14,12846225,20535525,7689300,BUY
2020-10-01 11:15:00,11:15,12958050,20157675,7199625,BUY
2020-10-01 11:16:00,11:16,12932900,20613575,7680675,BUY
2020-10-01 11:17:00,11:17,12988125,20832625,7844500,BUY
2020-10-01 11:18:00,11:18,13089100,20838050,7748950,BUY
2020-10-01 11:19:00,11:19,13166150,20886975,7720825,BUY
2020-10-01 11:20:00,11:20,13335025,20591025,7256000,BUY
2020-10-01 11:21:00,11:21,13297700,20844275,7546575,BUY
2020-10-01 11:22:00,11:22,13285350,20912200,7626850,BUY
2020-10-01 11:23:00,11:23,13075675,21001425,7925750,BUY
2020-10-01 11:24:00,11:24,13201775,20998150,7796375,BUY
2020-10-01 11:25:00,11:25,13301775,20837775,7536000,BUY
2020-10-01 11:26:00,11:26,13514825,20804750,7289925,BUY
2020-10-01 11:27:00,11:27,13430275,20394550,6964275,BUY
2020-10-01 11:28:00,11:28,13532175,20838325,7306150,BUY
2020-10-01 11:29:00,11:29,13686575,20841250,7154675,BUY
2020-10-01 11:30:00,11:30,13804875,20985450,7180575,BUY
2020-10-01 11:31:00,11:31,13723900,20982925,7259025,BUY
2020-10-01 11:32:00,11:32,13667100,20949700,7282600,BUY
2020-10-01 11:33:00,11:33,13756600,20834925,7078325,BUY
2020-10-01 11:34:00,11:34,13708500,20248075,6539575,BUY
2020-10-01 11:35:00,11:35,13741425,20539425,6798000,BUY
2020-10-01 11:36:00,11:36,13692350,20593625,6901275,BUY
2020-10-01 11:37:00,11:37,13633275,20884000,7250725,BUY
2020-10-01 11:38:00,11:38,13881825,21166825,7285000,BUY
2020-10-01 11:39:00,11:39,13820675,21142775,7322100,BUY
2020-10-01 11:40:00,11:40,13882950,21163000,7280050,BUY
2020-10-01 11:41:00,11:41,13763700,20956525,7192825,BUY
2020-10-01 11:42:00,11:42,13692475,21025275,7332800,BUY
2020-10-01 11:43:00,11:43,13711175,21124600,7413425,BUY
2020-10-01 11:44:00,11:44,13892550,21174375,7281825,BUY
2020-10-01 11:45:00,11:45,13998750,21001675,7002925,BUY
2020-10-01 11:46:00,11:46,13962625,21225600,7262975,BUY
2020-10-01 11:47:00,11:47,14023250,21218100,7194850,BUY
2020-10-01 11:48:00,11:48,14030250,21214650,7184400,BUY
2020-10-01 11:49:00,11:49,13765225,21228800,7463575,BUY
2020-10-01 11:50:00,11:50,13925175,21250975,7325800,BUY
2020-10-01 11:51:00,11:51,13839925,20868700,7028775,BUY
2020-10-01 11:52:00,11:52,13912225,20790825,6878600,BUY
2020-10-01 11:53:00,11:53,14203725,20963800,6760075,BUY
2020-10-01 11:54:00,11:54,14061225,21295650,7234425,BUY
2020-10-01 11:55:00,11:55,13771150,21218975,7447825,BUY
2020-10-01 11:56:00,11:56,13975375,21232825,7257450,BUY
2020-10-01 11:57:00,11:57,14116225,21185800,7069575,BUY
2020-10-01 11:58:00,11:58,14016850,21133400,7116550,BUY
2020-10-01 11:59:00,11:59,14104125,21270675,7166550,BUY
2020-10-01 12:00:00,12:00,14252400,21227475,6975075,BUY
2020-10-01 12:01:00,12:01,14250850,21308525,7057675,BUY
2020-10-01 12:02:00,12:02,14101750,21346800,7245050,BUY
2020-10-01 12:03:00,12:03,14350600,21361825,7011225,BUY
2020-10-01 12:04:00,12:04,14353800,20886075,6532275,BUY
2020-10-01 12:05:00,12:05,14383325,21490650,7107325,BUY
2020-10-01 12:06:00,12:06,14368875,21504125,7135250,BUY
2020-10-01 12:07:00,12:07,14345475,21456300,7110825,BUY
2020-10-01 12:08:00,12:08,14576075,21204400,6628325,BUY
2020-10-01 12:09:00,12:09,14495350,21335450,6840100,BUY
2020-10-01 12:10:00,12:10,14458450,21558025,7099575,BUY
2020-10-01 12:11:00,12:11,14447825,21719100,7271275,BUY
2020-10-01 12:12:00,12:12,14295425,21572750,7277325,BUY
2020-10-01 12:13:00,12:13,14389500,20908850,6519350,BUY
2020-10-01 12:14:00,12:14,14620250,21383200,6762950,BUY
2020-10-01 12:15:00,12:15,14548075,21654100,7106025,BUY
2020-10-01 12:16:00,12:16,14532600,20584475,6051875,BUY
2020-10-01 12:17:00,12:17,14366975,21055250,6688275,BUY
2020-10-01 12:18:00,12:18,14489400,22026725,7537325,BUY
2020-10-01 12:19:00,12:19,14425875,21531875,7106000,BUY
2020-10-01 12:20:00,12:20,14362325,21798450,7436125,BUY
2020-10-01 12:21:00,12:21,14512150,22004175,7492025,BUY
2020-10-01 12:22:00,12:22,14521525,22189150,7667625,BUY
2020-10-01 12:23:00,12:23,14762325,22169025,7406700,BUY
2020-10-01 12:24:00,12:24,14437500,22126150,7688650,BUY
2020-10-01 12:25:00,12:25,14419425,22131900,7712475,BUY
2020-10-01 12:26:00,12:26,14784675,22198925,7414250,BUY
2020-10-01 12:27:00,12:27,14631875,22183975,7552100,BUY
2020-10-01 12:28:00,12:28,14657575,21868000,7210425,BUY
2020-10-01 12:29:00,12:29,14693925,21834250,7140325,BUY
2020-10-01 12:30:00,12:30,14828075,22325650,7497575,BUY
2020-10-01 12:31:00,12:31,14835275,22108175,7272900,BUY
2020-10-01 12:32:00,12:32,14805325,22421950,7616625,BUY
2020-10-01 12:33:00,12:33,14905175,22431900,7526725,BUY
2020-10-01 12:34:00,12:34,14879200,22093800,7214600,BUY
2020-10-01 12:35:00,12:35,15045100,22468625,7423525,BUY
2020-10-01 12:36:00,12:36,15058775,21827575,6768800,BUY
2020-10-01 12:37:00,12:37,14868900,22231925,7363025,BUY
2020-10-01 12:38:00,12:38,15128375,22459100,7330725,BUY
2020-10-01 12:39:00,12:39,15050200,22539950,7489750,BUY
2020-10-01 12:40:00,12:40,14800725,22533425,7732700,BUY
2020-10-01 12:41:00,12:41,14392525,22306525,7914000,BUY
2020-10-01 12:42:00,12:42,14284225,22243700,7959475,BUY
2020-10-01 12:43:00,12:43,14521225,22413525,7892300,BUY
2020-10-01 12:44:00,12:44,14243375,22387800,8144425,BUY
2020-10-01 12:45:00,12:45,14480400,21605225,7124825,BUY
2020-10-01 12:46:00,12:46,14306850,22100325,7793475,BUY
2020-10-01 12:47:00,12:47,14406575,22124900,7718325,BUY
2020-10-01 12:48:00,12:48,14560975,22111450,7550475,BUY
2020-10-01 12:49:00,12:49,14468400,22072350,7603950,BUY
2020-10-01 12:50:00,12:50,14681575,22148875,7467300,BUY
2020-10-01 12:51:00,12:51,14686900,22021550,7334650,BUY
2020-10-01 12:52:00,12:52,14585850,22089400,7503550,BUY
2020-10-01 12:53:00,12:53,14731975,21970525,7238550,BUY
2020-10-01 12:54:00,12:54,14839850,22022975,7183125,BUY
2020-10-01 12:55:00,12:55,14618850,21796450,7177600,BUY
2020-10-01 12:56:00,12:56,14705000,22067375,7362375,BUY
2020-10-01 12:57:00,12:57,14831225,21935475,7104250,BUY
2020-10-01 12:58:00,12:58,14929075,21935475,7006400,BUY
2020-10-01 12:59:00,12:59,14817050,21936250,7119200,BUY
2020-10-01 13:00:00,13:00,15146975,21532725,6385750,BUY
2020-10-01 13:01:00,13:01,15009175,21885775,6876600,BUY
2020-10-01 13:02:00,13:02,14996925,21883475,6886550,BUY
2020-10-01 13:03:00,13:03,15108125,21805700,6697575,BUY
2020-10-01 13:04:00,13:04,15054475,21753875,6699400,BUY
2020-10-01 13:05:00,13:05,15153175,21789975,6636800,BUY
2020-10-01 13:06:00,13:06,15321125,21560175,6239050,BUY
2020-10-01 13:07:00,13:07,15274775,21560175,6285400,BUY
2020-10-01 13:08:00,13:08,14972350,21287400,6315050,BUY
2020-10-01 13:09:00,13:09,15112050,21621025,6508975,BUY
2020-10-01 13:10:00,13:10,15078500,21453125,6374625,BUY
2020-10-01 13:11:00,13:11,15087100,21594775,6507675,BUY
2020-10-01 13:12:00,13:12,15089950,21673825,6583875,BUY
2020-10-01 13:13:00,13:13,15175850,21741500,6565650,BUY
2020-10-01 13:14:00,13:14,15247075,21726725,6479650,BUY
2020-10-01 13:15:00,13:15,15201625,21771300,6569675,BUY
2020-10-01 13:16:00,13:16,15216725,21767875,6551150,BUY
2020-10-01 13:17:00,13:17,15313825,21767875,6454050,BUY
2020-10-01 13:18:00,13:18,15450800,21885100,6434300,BUY
2020-10-01 13:19:00,13:19,15138500,21865825,6727325,BUY
2020-10-01 13:20:00,13:20,15314725,21887400,6572675,BUY
2020-10-01 13:21:00,13:21,15470725,21845700,6374975,BUY
2020-10-01 13:22:00,13:22,15539175,21861900,6322725,BUY
2020-10-01 13:23:00,13:23,15426325,21684925,6258600,BUY
2020-10-01 13:24:00,13:24,15544450,21893750,6349300,BUY
2020-10-01 13:25:00,13:25,15621850,21902925,6281075,BUY
2020-10-01 13:26:00,13:26,15641475,21925850,6284375,BUY
2020-10-01 13:27:00,13:27,15749525,21817825,6068300,BUY
2020-10-01 13:28:00,13:28,15717475,21816000,6098525,BUY
2020-10-01 13:29:00,13:29,15829700,21794775,5965075,BUY
2020-10-01 13:30:00,13:30,15692825,21962725,6269900,BUY
2020-10-01 13:31:00,13:31,15789825,21958825,6169000,BUY
2020-10-01 13:32:00,13:32,15714500,21940625,6226125,BUY
2020-10-01 13:33:00,13:33,15957275,22081725,6124450,BUY
2020-10-01 13:34:00,13:34,16028225,22088875,6060650,BUY
2020-10-01 13:35:00,13:35,15803925,22046825,6242900,BUY
2020-10-01 13:36:00,13:36,15301625,21801375,6499750,BUY
2020-10-01 13:37:00,13:37,15162925,21985100,6822175,BUY
2020-10-01 13:38:00,13:38,15269825,21985100,6715275,BUY
2020-10-01 13:39:00,13:39,15422050,22169950,6747900,BUY
2020-10-01 13:40:00,13:40,15491125,21728550,6237425,BUY
2020-10-01 13:41:00,13:41,15528950,21858550,6329600,BUY
2020-10-01 13:42:00,13:42,15552475,21478075,5925600,BUY
2020-10-01 13:43:00,13:43,15385325,22114525,6729200,BUY
2020-10-01 13:44:00,13:44,15555525,22170025,6614500,BUY
2020-10-01 13:45:00,13:45,15381975,22242050,6860075,BUY
2020-10-01 13:46:00,13:46,15329100,22216500,6887400,BUY
2020-10-01 13:47:00,13:47,15322625,22217850,6895225,BUY
2020-10-01 13:48:00,13:48,15246100,22173550,6927450,BUY
2020-10-01 13:49:00,13:49,15118125,21739925,6621800,BUY
2020-10-01 13:50:00,13:50,15259225,21756150,6496925,BUY
2020-10-01 13:51:00,13:51,15338125,22213225,6875100,BUY
2020-10-01 13:52:00,13:52,15435875,21918600,6482725,BUY
2020-10-01 13:53:00,13:53,15346675,22207850,6861175,BUY
2020-10-01 13:54:00,13:54,15461775,21985050,6523275,BUY
2020-10-01 13:55:00,13:55,15669150,22265025,6595875,BUY
2020-10-01 13:56:00,13:56,15758250,22331875,6573625,BUY
2020-10-01 13:57:00,13:57,15689775,22230125,6540350,BUY
2020-10-01 13:58:00,13:58,15520000,22248100,6728100,BUY
2020-10-01 13:59:00,13:59,15605725,22207975,6602250,BUY
2020-10-01 14:00:00,14:00,15799000,22230775,6431775,BUY
2020-10-01 14:01:00,14:01,15619600,21916250,6296650,BUY
2020-10-01 14:02:00,14:02,15635100,22233475,6598375,BUY
2020-10-01 14:03:00,14:03,14941625,22023700,7082075,BUY
2020-10-01 14:04:00,14:04,14960150,22037800,7077650,BUY
2020-10-01 14:05:00,14:05,14874750,22000375,7125625,BUY
2020-10-01 14:06:00,14:06,15329200,22041475,6712275,BUY
2020-10-01 14:07:00,14:07,15087825,22070575,6982750,BUY
2020-10-01 14:08:00,14:08,15284775,21965850,6681075,BUY
2020-10-01 14:09:00,14:09,15433175,22092050,6658875,BUY
2020-10-01 14:10:00,14:10,15321025,21918950,6597925,BUY
2020-10-01 14:11:00,14:11,15286100,22136750,6850650,BUY
2020-10-01 14:12:00,14:12,15423175,21728950,6305775,BUY
2020-10-01 14:13:00,14:13,15416425,22211725,6795300,BUY
2020-10-01 14:14:00,14:14,15453575,21947450,6493875,BUY
2020-10-01 14:15:00,14:15,13691975,21534150,7842175,BUY
2020-10-01 14:16:00,14:16,13550250,21816900,8266650,BUY
2020-10-01 14:17:00,14:17,13537300,21549950,8012650,BUY
2020-10-01 14:18:00,14:18,12440425,21711225,9270800,BUY
2020-10-01 14:19:00,14:19,12587525,21711275,9123750,BUY
2020-10-01 14:20:00,14:20,12601900,21668450,9066550,BUY
2020-10-01 14:21:00,14:21,12208825,21800075,9591250,BUY
2020-10-01 14:22:00,14:22,12342575,21667175,9324600,BUY
2020-10-01 14:23:00,14:23,12233950,21710875,9476925,BUY
2020-10-01 14:24:00,14:24,12595925,21722625,9126700,BUY
2020-10-01 14:25:00,14:25,12541250,21456125,8914875,BUY
2020-10-01 14:26:00,14:26,12758475,21419300,8660825,BUY
2020-10-01 14:27:00,14:27,12533375,20963775,8430400,BUY
2020-10-01 14:28:00,14:28,12687250,21479825,8792575,BUY
2020-10-01 14:29:00,14:29,12565350,21607950,9042600,BUY
2020-10-01 14:30:00,14:30,12820525,21803525,8983000,BUY
2020-10-01 14:31:00,14:31,12692675,21131700,8439025,BUY
2020-10-01 14:32:00,14:32,12602350,21802300,9199950,BUY
2020-10-01 14:33:00,14:33,12927850,21658150,8730300,BUY
2020-10-01 14:34:00,14:34,12909300,21671775,8762475,BUY
2020-10-01 14:35:00,14:35,12886550,21692375,8805825,BUY
2020-10-01 14:36:00,14:36,13212225,21276450,8064225,BUY
2020-10-01 14:37:00,14:37,13318400,21673900,8355500,BUY
2020-10-01 14:38:00,14:38,13231825,21543400,8311575,BUY
2020-10-01 14:39:00,14:39,13446550,21481375,8034825,BUY
2020-10-01 14:40:00,14:40,13337250,21432275,8095025,BUY
2020-10-01 14:41:00,14:41,13231575,21177350,7945775,BUY
2020-10-01 14:42:00,14:42,13311700,21639000,8327300,BUY
2020-10-01 14:43:00,14:43,13397500,21373275,7975775,BUY
2020-10-01 14:44:00,14:44,13331525,21253450,7921925,BUY
2020-10-01 14:45:00,14:45,13684275,21382150,7697875,BUY
2020-10-01 14:46:00,14:46,13584775,21450125,7865350,BUY
2020-10-01 14:47:00,14:47,13712925,21511975,7799050,BUY
2020-10-01 14:48:00,14:48,13023125,20912800,7889675,BUY
2020-10-01 14:49:00,14:49,13015775,21264525,8248750,BUY
2020-10-01 14:50:00,14:50,13145225,20817375,7672150,BUY
2020-10-01 14:51:00,14:51,13371850,21174250,7802400,BUY
2020-10-01 14:52:00,14:52,13206150,21087075,7880925,BUY
2020-10-01 14:53:00,14:53,13428500,21201025,7772525,BUY
2020-10-01 14:54:00,14:54,13665700,20888200,7222500,BUY
2020-10-01 14:55:00,14:55,13400775,20807800,7407025,BUY
2020-10-01 14:56:00,14:56,13482150,20816225,7334075,BUY
2020-10-01 14:57:00,14:57,13703525,20309075,6605550,BUY
2020-10-01 14:58:00,14:58,13571075,20281625,6710550,BUY
2020-10-01 14:59:00,14:59,13681450,20174525,6493075,BUY
2020-10-01 15:00:00,15:00,13464725,20344750,6880025,BUY
2020-10-01 15:01:00,15:01,13487900,20158100,6670200,BUY
2020-10-01 15:02:00,15:02,13486625,20243725,6757100,BUY
2020-10-01 15:03:00,15:03,13478175,19535900,6057725,BUY
2020-10-01 15:04:00,15:04,13500275,19577950,6077675,BUY
2020-10-01 15:05:00,15:05,13563675,19755125,6191450,BUY
2020-10-01 15:06:00,15:06,13630100,19157725,5527625,BUY
2020-10-01 15:07:00,15:07,13505775,19327325,5821550,BUY
2020-10-01 15:08:00,15:08,13521175,18985375,5464200,BUY
2020-10-01 15:09:00,15:09,13112250,18873575,5761325,BUY
2020-10-01 15:10:00,15:10,12943975,18845650,5901675,BUY
2020-10-01 15:11:00,15:11,13004475,18847475,5843000,BUY
2020-10-01 15:12:00,15:12,12250900,17991550,5740650,BUY
2020-10-01 15:13:00,15:13,12354500,17713975,5359475,BUY
2020-10-01 15:14:00,15:14,12371925,18026125,5654200,BUY
2020-10-01 15:15:00,15:15,12125550,17097825,4972275,BUY
2020-10-01 15:16:00,15:16,12034825,17140500,5105675,BUY
2020-10-01 15:17:00,15:17,12080075,17222475,5142400,BUY
2020-10-01 15:18:00,15:18,11682425,16301350,4618925,BUY
2020-10-01 15:19:00,15:19,11677050,16025650,4348600,BUY
2020-10-01 15:20:00,15:20,11507750,15813575,4305825,BUY
2020-10-01 15:21:00,15:21,10818375,15171775,4353400,BUY
2020-10-01 15:22:00,15:22,10604475,15024850,4420375,BUY
2020-10-01 15:23:00,15:23,10588950,15117075,4528125,BUY
2020-10-01 15:24:00,15:24,9485625,13671775,4186150,BUY
2020-10-01 15:25:00,15:25,9771450,14213175,4441725,BUY
2020-10-01 15:26:00,15:26,9593925,14027475,4433550,BUY
2020-10-01 15:27:00,15:27,7749500,12736225,4986725,BUY
2020-10-01 15:28:00,15:28,7880400,12882900,5002500,BUY
2020-10-01 15:29:00,15:29,7885475,12596575,4711100,BUY
