,timestamp,call,put,diff,sellOrBuy
2020-11-06 09:15:00,09:15,2505250,3545375,1040125,BUY
2020-11-06 09:16:00,09:16,2474200,3537150,1062950,BUY
2020-11-06 09:17:00,09:17,2662375,3712650,1050275,BUY
2020-11-06 09:18:00,09:18,2599625,3698200,1098575,BUY
2020-11-06 09:19:00,09:19,2574575,3705150,1130575,BUY
2020-11-06 09:20:00,09:20,3105675,4190850,1085175,BUY
2020-11-06 09:21:00,09:21,3101300,4181625,1080325,BUY
2020-11-06 09:22:00,09:22,3122500,4193900,1071400,BUY
2020-11-06 09:23:00,09:23,3512950,4618350,1105400,BUY
2020-11-06 09:24:00,09:24,3465150,4615800,1150650,BUY
2020-11-06 09:25:00,09:25,3503250,4600275,1097025,BUY
2020-11-06 09:26:00,09:26,3763000,4861950,1098950,BUY
2020-11-06 09:27:00,09:27,3717950,4861950,1144000,BUY
2020-11-06 09:28:00,09:28,3669025,4882225,1213200,BUY
2020-11-06 09:29:00,09:29,3807825,5049775,1241950,BUY
2020-11-06 09:30:00,09:30,3816550,5075775,1259225,BUY
2020-11-06 09:31:00,09:31,3820700,5075775,1255075,BUY
2020-11-06 09:32:00,09:32,3991000,5206825,1215825,BUY
2020-11-06 09:33:00,09:33,4006250,5195575,1189325,BUY
2020-11-06 09:34:00,09:34,3902375,5214100,1311725,BUY
2020-11-06 09:35:00,09:35,4015350,5293275,1277925,BUY
2020-11-06 09:36:00,09:36,4046150,5318100,1271950,BUY
2020-11-06 09:37:00,09:37,4033950,5298125,1264175,BUY
2020-11-06 09:38:00,09:38,4136425,5311825,1175400,BUY
2020-11-06 09:39:00,09:39,4107825,5324625,1216800,BUY
2020-11-06 09:40:00,09:40,4103475,5345450,1241975,BUY
2020-11-06 09:41:00,09:41,4167225,5447225,1280000,BUY
2020-11-06 09:42:00,09:42,4199275,5430450,1231175,BUY
2020-11-06 09:43:00,09:43,4202500,5437550,1235050,BUY
2020-11-06 09:44:00,09:44,4238625,5461400,1222775,BUY
2020-11-06 09:45:00,09:45,4193875,5465850,1271975,BUY
2020-11-06 09:46:00,09:46,4188125,5457250,1269125,BUY
2020-11-06 09:47:00,09:47,4338400,5477275,1138875,BUY
2020-11-06 09:48:00,09:48,4332200,5462175,1129975,BUY
2020-11-06 09:49:00,09:49,4405225,5466575,1061350,BUY
2020-11-06 09:50:00,09:50,4413375,5519700,1106325,BUY
2020-11-06 09:51:00,09:51,4356825,5536000,1179175,BUY
2020-11-06 09:52:00,09:52,4379725,5495825,1116100,BUY
2020-11-06 09:53:00,09:53,4454225,5507025,1052800,BUY
2020-11-06 09:54:00,09:54,4446700,5518375,1071675,BUY
2020-11-06 09:55:00,09:55,4420950,5535825,1114875,BUY
2020-11-06 09:56:00,09:56,4484725,5606650,1121925,BUY
2020-11-06 09:57:00,09:57,4544375,5596575,1052200,BUY
2020-11-06 09:58:00,09:58,4487950,5551650,1063700,BUY
2020-11-06 09:59:00,09:59,4507675,5643725,1136050,BUY
2020-11-06 10:00:00,10:00,4548300,5624100,1075800,BUY
2020-11-06 10:01:00,10:01,4528400,5627075,1098675,BUY
2020-11-06 10:02:00,10:02,4596375,5723575,1127200,BUY
2020-11-06 10:03:00,10:03,4634525,5753850,1119325,BUY
2020-11-06 10:04:00,10:04,4649975,5744875,1094900,BUY
2020-11-06 10:05:00,10:05,4519675,5806050,1286375,BUY
2020-11-06 10:06:00,10:06,4564425,5807575,1243150,BUY
2020-11-06 10:07:00,10:07,4476900,5796750,1319850,BUY
2020-11-06 10:08:00,10:08,4432375,5839750,1407375,BUY
2020-11-06 10:09:00,10:09,4414950,5842300,1427350,BUY
2020-11-06 10:10:00,10:10,4393275,5846325,1453050,BUY
2020-11-06 10:11:00,10:11,4538525,5924475,1385950,BUY
2020-11-06 10:12:00,10:12,4503775,5914125,1410350,BUY
2020-11-06 10:13:00,10:13,4531950,5939300,1407350,BUY
2020-11-06 10:14:00,10:14,4610400,5937650,1327250,BUY
2020-11-06 10:15:00,10:15,4650300,5977800,1327500,BUY
2020-11-06 10:16:00,10:16,4625950,5948375,1322425,BUY
2020-11-06 10:17:00,10:17,4708725,6021575,1312850,BUY
2020-11-06 10:18:00,10:18,4699625,6006775,1307150,BUY
2020-11-06 10:19:00,10:19,4751650,6004625,1252975,BUY
2020-11-06 10:20:00,10:20,4721425,6080650,1359225,BUY
2020-11-06 10:21:00,10:21,4723475,6038325,1314850,BUY
2020-11-06 10:22:00,10:22,4725550,6051675,1326125,BUY
2020-11-06 10:23:00,10:23,4745150,6087700,1342550,BUY
2020-11-06 10:24:00,10:24,4783725,6072000,1288275,BUY
2020-11-06 10:25:00,10:25,4785850,6098150,1312300,BUY
2020-11-06 10:26:00,10:26,4809500,6113650,1304150,BUY
2020-11-06 10:27:00,10:27,4665150,6093400,1428250,BUY
2020-11-06 10:28:00,10:28,4693850,6116375,1422525,BUY
2020-11-06 10:29:00,10:29,4665475,6135350,1469875,BUY
2020-11-06 10:30:00,10:30,4816750,6135300,1318550,BUY
2020-11-06 10:31:00,10:31,4827550,6112850,1285300,BUY
2020-11-06 10:32:00,10:32,4849475,6150650,1301175,BUY
2020-11-06 10:33:00,10:33,4863800,6058825,1195025,BUY
2020-11-06 10:34:00,10:34,4905075,6170475,1265400,BUY
2020-11-06 10:35:00,10:35,4855125,6192100,1336975,BUY
2020-11-06 10:36:00,10:36,4853800,6173150,1319350,BUY
2020-11-06 10:37:00,10:37,4861750,6173800,1312050,BUY
2020-11-06 10:38:00,10:38,4846125,6246175,1400050,BUY
2020-11-06 10:39:00,10:39,4987600,6236075,1248475,BUY
2020-11-06 10:40:00,10:40,4948850,6205975,1257125,BUY
2020-11-06 10:41:00,10:41,4977800,6208850,1231050,BUY
2020-11-06 10:42:00,10:42,4943375,6164475,1221100,BUY
2020-11-06 10:43:00,10:43,4944500,6187125,1242625,BUY
2020-11-06 10:44:00,10:44,4986225,6246425,1260200,BUY
2020-11-06 10:45:00,10:45,5044375,6288825,1244450,BUY
2020-11-06 10:46:00,10:46,5006225,6279325,1273100,BUY
2020-11-06 10:47:00,10:47,4958750,6308150,1349400,BUY
2020-11-06 10:48:00,10:48,4947750,6317500,1369750,BUY
2020-11-06 10:49:00,10:49,4889400,6308625,1419225,BUY
2020-11-06 10:50:00,10:50,5049300,6354375,1305075,BUY
2020-11-06 10:51:00,10:51,5038550,6368200,1329650,BUY
2020-11-06 10:52:00,10:52,5004325,6360875,1356550,BUY
2020-11-06 10:53:00,10:53,5080100,6288525,1208425,BUY
2020-11-06 10:54:00,10:54,4999475,6283275,1283800,BUY
2020-11-06 10:55:00,10:55,5038900,6290300,1251400,BUY
2020-11-06 10:56:00,10:56,5045375,6356400,1311025,BUY
2020-11-06 10:57:00,10:57,5030800,6322825,1292025,BUY
2020-11-06 10:58:00,10:58,5094300,6354450,1260150,BUY
2020-11-06 10:59:00,10:59,5120000,6394900,1274900,BUY
2020-11-06 11:00:00,11:00,5028925,6364475,1335550,BUY
2020-11-06 11:01:00,11:01,5044925,6430800,1385875,BUY
2020-11-06 11:02:00,11:02,5092475,6421700,1329225,BUY
2020-11-06 11:03:00,11:03,5027925,6420850,1392925,BUY
2020-11-06 11:04:00,11:04,5070600,6439575,1368975,BUY
2020-11-06 11:05:00,11:05,4960950,6499600,1538650,BUY
2020-11-06 11:06:00,11:06,4998400,6483075,1484675,BUY
2020-11-06 11:07:00,11:07,5028950,6470550,1441600,BUY
2020-11-06 11:08:00,11:08,5005150,6505425,1500275,BUY
2020-11-06 11:09:00,11:09,5047400,6538925,1491525,BUY
2020-11-06 11:10:00,11:10,4989350,6528500,1539150,BUY
2020-11-06 11:11:00,11:11,4952550,6566800,1614250,BUY
2020-11-06 11:12:00,11:12,5139850,6588850,1449000,BUY
2020-11-06 11:13:00,11:13,5086750,6535650,1448900,BUY
2020-11-06 11:14:00,11:14,5075775,6550175,1474400,BUY
2020-11-06 11:15:00,11:15,5003700,6588050,1584350,BUY
2020-11-06 11:16:00,11:16,5114025,6540075,1426050,BUY
2020-11-06 11:17:00,11:17,4982825,6565225,1582400,BUY
2020-11-06 11:18:00,11:18,5101325,6573025,1471700,BUY
2020-11-06 11:19:00,11:19,5059550,6555350,1495800,BUY
2020-11-06 11:20:00,11:20,5114175,6629875,1515700,BUY
2020-11-06 11:21:00,11:21,5034875,6547750,1512875,BUY
2020-11-06 11:22:00,11:22,5050425,6592575,1542150,BUY
2020-11-06 11:23:00,11:23,4997550,6668000,1670450,BUY
2020-11-06 11:24:00,11:24,5129850,6665900,1536050,BUY
2020-11-06 11:25:00,11:25,4970625,6565725,1595100,BUY
2020-11-06 11:26:00,11:26,5155025,6670725,1515700,BUY
2020-11-06 11:27:00,11:27,5085875,6667175,1581300,BUY
2020-11-06 11:28:00,11:28,5201275,6668100,1466825,BUY
2020-11-06 11:29:00,11:29,5193275,6789300,1596025,BUY
2020-11-06 11:30:00,11:30,5154300,6779325,1625025,BUY
2020-11-06 11:31:00,11:31,5082900,6779325,1696425,BUY
2020-11-06 11:32:00,11:32,5229075,6794100,1565025,BUY
2020-11-06 11:33:00,11:33,5079225,6755725,1676500,BUY
2020-11-06 11:34:00,11:34,4979625,6804125,1824500,BUY
2020-11-06 11:35:00,11:35,5094400,6836175,1741775,BUY
2020-11-06 11:36:00,11:36,5150550,6791300,1640750,BUY
2020-11-06 11:37:00,11:37,5262300,6872925,1610625,BUY
2020-11-06 11:38:00,11:38,5276950,6927700,1650750,BUY
2020-11-06 11:39:00,11:39,5262925,6881900,1618975,BUY
2020-11-06 11:40:00,11:40,5145875,6866100,1720225,BUY
2020-11-06 11:41:00,11:41,5212800,6920200,1707400,BUY
2020-11-06 11:42:00,11:42,5132150,6942925,1810775,BUY
2020-11-06 11:43:00,11:43,5101975,6888225,1786250,BUY
2020-11-06 11:44:00,11:44,5138450,6991200,1852750,BUY
2020-11-06 11:45:00,11:45,5211075,6935150,1724075,BUY
2020-11-06 11:46:00,11:46,5290000,6932475,1642475,BUY
2020-11-06 11:47:00,11:47,5111350,6924400,1813050,BUY
2020-11-06 11:48:00,11:48,5318175,6996975,1678800,BUY
2020-11-06 11:49:00,11:49,5324775,6961875,1637100,BUY
2020-11-06 11:50:00,11:50,5270775,6931250,1660475,BUY
2020-11-06 11:51:00,11:51,5071000,6987100,1916100,BUY
2020-11-06 11:52:00,11:52,5218500,7025325,1806825,BUY
2020-11-06 11:53:00,11:53,5328300,7030650,1702350,BUY
2020-11-06 11:54:00,11:54,5266825,6974775,1707950,BUY
2020-11-06 11:55:00,11:55,5363050,7010300,1647250,BUY
2020-11-06 11:56:00,11:56,5394350,7010475,1616125,BUY
2020-11-06 11:57:00,11:57,5403050,6975350,1572300,BUY
2020-11-06 11:58:00,11:58,5405100,6927950,1522850,BUY
2020-11-06 11:59:00,11:59,5310825,6945850,1635025,BUY
2020-11-06 12:00:00,12:00,5310600,6982275,1671675,BUY
2020-11-06 12:01:00,12:01,5361975,7003175,1641200,BUY
2020-11-06 12:02:00,12:02,5440050,6962725,1522675,BUY
2020-11-06 12:03:00,12:03,5438125,6989525,1551400,BUY
2020-11-06 12:04:00,12:04,5376775,7022400,1645625,BUY
2020-11-06 12:05:00,12:05,5526550,7118150,1591600,BUY
2020-11-06 12:06:00,12:06,5521550,7043525,1521975,BUY
2020-11-06 12:07:00,12:07,5498675,7035900,1537225,BUY
2020-11-06 12:08:00,12:08,5479050,7082700,1603650,BUY
2020-11-06 12:09:00,12:09,5495975,7118825,1622850,BUY
2020-11-06 12:10:00,12:10,5454025,7108850,1654825,BUY
2020-11-06 12:11:00,12:11,5542925,7112075,1569150,BUY
2020-11-06 12:12:00,12:12,5513775,7196725,1682950,BUY
2020-11-06 12:13:00,12:13,5494800,7148000,1653200,BUY
2020-11-06 12:14:00,12:14,5304650,7131375,1826725,BUY
2020-11-06 12:15:00,12:15,5374850,7115000,1740150,BUY
2020-11-06 12:16:00,12:16,5350925,7058575,1707650,BUY
2020-11-06 12:17:00,12:17,5469475,7197150,1727675,BUY
2020-11-06 12:18:00,12:18,5458800,7277925,1819125,BUY
2020-11-06 12:19:00,12:19,5418475,7238825,1820350,BUY
2020-11-06 12:20:00,12:20,5441550,7395450,1953900,BUY
2020-11-06 12:21:00,12:21,5373225,7387775,2014550,BUY
2020-11-06 12:22:00,12:22,5459125,7484850,2025725,BUY
2020-11-06 12:23:00,12:23,5507200,7567525,2060325,BUY
2020-11-06 12:24:00,12:24,5531050,7569625,2038575,BUY
2020-11-06 12:25:00,12:25,5542525,7582975,2040450,BUY
2020-11-06 12:26:00,12:26,5455850,7602925,2147075,BUY
2020-11-06 12:27:00,12:27,5424425,7605850,2181425,BUY
2020-11-06 12:28:00,12:28,5355125,7542550,2187425,BUY
2020-11-06 12:29:00,12:29,5408175,7582225,2174050,BUY
2020-11-06 12:30:00,12:30,5438975,7584825,2145850,BUY
2020-11-06 12:31:00,12:31,5442775,7572150,2129375,BUY
2020-11-06 12:32:00,12:32,5446025,7660225,2214200,BUY
2020-11-06 12:33:00,12:33,5488525,7568200,2079675,BUY
2020-11-06 12:34:00,12:34,5444450,7642750,2198300,BUY
2020-11-06 12:35:00,12:35,5512400,7706775,2194375,BUY
2020-11-06 12:36:00,12:36,5508650,7602750,2094100,BUY
2020-11-06 12:37:00,12:37,5472975,7669025,2196050,BUY
2020-11-06 12:38:00,12:38,5493825,7666100,2172275,BUY
2020-11-06 12:39:00,12:39,5502450,7474575,1972125,BUY
2020-11-06 12:40:00,12:40,5576825,7675200,2098375,BUY
2020-11-06 12:41:00,12:41,5472525,7743325,2270800,BUY
2020-11-06 12:42:00,12:42,5411400,7739575,2328175,BUY
2020-11-06 12:43:00,12:43,5446275,7776550,2330275,BUY
2020-11-06 12:44:00,12:44,5467550,7826125,2358575,BUY
2020-11-06 12:45:00,12:45,5471400,7787850,2316450,BUY
2020-11-06 12:46:00,12:46,5434650,7812750,2378100,BUY
2020-11-06 12:47:00,12:47,5513650,7845325,2331675,BUY
2020-11-06 12:48:00,12:48,5517975,7878525,2360550,BUY
2020-11-06 12:49:00,12:49,5531700,7934475,2402775,BUY
2020-11-06 12:50:00,12:50,5522875,7863475,2340600,BUY
2020-11-06 12:51:00,12:51,5531725,7928150,2396425,BUY
2020-11-06 12:52:00,12:52,5466000,7902300,2436300,BUY
2020-11-06 12:53:00,12:53,5420300,7967500,2547200,BUY
2020-11-06 12:54:00,12:54,5623800,7910775,2286975,BUY
2020-11-06 12:55:00,12:55,5642600,7997175,2354575,BUY
2020-11-06 12:56:00,12:56,5290150,8020450,2730300,BUY
2020-11-06 12:57:00,12:57,5291200,7994250,2703050,BUY
2020-11-06 12:58:00,12:58,5312300,7926125,2613825,BUY
2020-11-06 12:59:00,12:59,5296150,7931000,2634850,BUY
2020-11-06 13:00:00,13:00,5301750,7890675,2588925,BUY
2020-11-06 13:01:00,13:01,5343750,7906500,2562750,BUY
2020-11-06 13:02:00,13:02,5352575,7967400,2614825,BUY
2020-11-06 13:03:00,13:03,5417800,8002300,2584500,BUY
2020-11-06 13:04:00,13:04,5361175,7959250,2598075,BUY
2020-11-06 13:05:00,13:05,5467800,7999950,2532150,BUY
2020-11-06 13:06:00,13:06,5454450,7962525,2508075,BUY
2020-11-06 13:07:00,13:07,5456325,7956625,2500300,BUY
2020-11-06 13:08:00,13:08,5489375,7993425,2504050,BUY
2020-11-06 13:09:00,13:09,5445425,8034050,2588625,BUY
2020-11-06 13:10:00,13:10,5463975,8054500,2590525,BUY
2020-11-06 13:11:00,13:11,5540550,8032650,2492100,BUY
2020-11-06 13:12:00,13:12,5543525,8050400,2506875,BUY
2020-11-06 13:13:00,13:13,5539650,8056100,2516450,BUY
2020-11-06 13:14:00,13:14,5551425,8014150,2462725,BUY
2020-11-06 13:15:00,13:15,5558775,8042775,2484000,BUY
2020-11-06 13:16:00,13:16,5569650,8017025,2447375,BUY
2020-11-06 13:17:00,13:17,5646700,8069600,2422900,BUY
2020-11-06 13:18:00,13:18,5617375,8058225,2440850,BUY
2020-11-06 13:19:00,13:19,5657225,8066000,2408775,BUY
2020-11-06 13:20:00,13:20,5674275,8060350,2386075,BUY
2020-11-06 13:21:00,13:21,5592750,8014775,2422025,BUY
2020-11-06 13:22:00,13:22,5542275,8023225,2480950,BUY
2020-11-06 13:23:00,13:23,5636775,8068300,2431525,BUY
2020-11-06 13:24:00,13:24,5594575,8045025,2450450,BUY
2020-11-06 13:25:00,13:25,5573400,8053400,2480000,BUY
2020-11-06 13:26:00,13:26,5683150,8100700,2417550,BUY
2020-11-06 13:27:00,13:27,5605850,8036050,2430200,BUY
2020-11-06 13:28:00,13:28,5689800,8068950,2379150,BUY
2020-11-06 13:29:00,13:29,5769850,8166400,2396550,BUY
2020-11-06 13:30:00,13:30,5790025,8183150,2393125,BUY
2020-11-06 13:31:00,13:31,5662300,8120950,2458650,BUY
2020-11-06 13:32:00,13:32,5672650,8177400,2504750,BUY
2020-11-06 13:33:00,13:33,5655850,8148475,2492625,BUY
2020-11-06 13:34:00,13:34,5707600,8206425,2498825,BUY
2020-11-06 13:35:00,13:35,5764500,8208125,2443625,BUY
2020-11-06 13:36:00,13:36,5727550,8235850,2508300,BUY
2020-11-06 13:37:00,13:37,5801525,8243500,2441975,BUY
2020-11-06 13:38:00,13:38,5771225,8260300,2489075,BUY
2020-11-06 13:39:00,13:39,5728900,8240250,2511350,BUY
2020-11-06 13:40:00,13:40,5849425,8247750,2398325,BUY
2020-11-06 13:41:00,13:41,5690475,8285975,2595500,BUY
2020-11-06 13:42:00,13:42,5788875,8261700,2472825,BUY
2020-11-06 13:43:00,13:43,5701650,8323850,2622200,BUY
2020-11-06 13:44:00,13:44,5682825,8261775,2578950,BUY
2020-11-06 13:45:00,13:45,5704675,8296200,2591525,BUY
2020-11-06 13:46:00,13:46,5697500,8306100,2608600,BUY
2020-11-06 13:47:00,13:47,5718450,8330700,2612250,BUY
2020-11-06 13:48:00,13:48,5877000,8378950,2501950,BUY
2020-11-06 13:49:00,13:49,5850425,8402275,2551850,BUY
2020-11-06 13:50:00,13:50,5817050,8370125,2553075,BUY
2020-11-06 13:51:00,13:51,5851575,8358350,2506775,BUY
2020-11-06 13:52:00,13:52,5851575,8413025,2561450,BUY
2020-11-06 13:53:00,13:53,5795125,8386625,2591500,BUY
2020-11-06 13:54:00,13:54,5866850,8397400,2530550,BUY
2020-11-06 13:55:00,13:55,5876650,8372500,2495850,BUY
2020-11-06 13:56:00,13:56,5708550,8347625,2639075,BUY
2020-11-06 13:57:00,13:57,5859175,8360850,2501675,BUY
2020-11-06 13:58:00,13:58,5925175,8415550,2490375,BUY
2020-11-06 13:59:00,13:59,5954700,8438625,2483925,BUY
2020-11-06 14:00:00,14:00,5920975,8371550,2450575,BUY
2020-11-06 14:01:00,14:01,5917425,8389750,2472325,BUY
2020-11-06 14:02:00,14:02,5929175,8392750,2463575,BUY
2020-11-06 14:03:00,14:03,5926975,8393875,2466900,BUY
2020-11-06 14:04:00,14:04,5884050,8424525,2540475,BUY
2020-11-06 14:05:00,14:05,5983800,8486475,2502675,BUY
2020-11-06 14:06:00,14:06,5833100,8414775,2581675,BUY
2020-11-06 14:07:00,14:07,5800600,8462075,2661475,BUY
2020-11-06 14:08:00,14:08,5935700,8409825,2474125,BUY
2020-11-06 14:09:00,14:09,5891275,8476050,2584775,BUY
2020-11-06 14:10:00,14:10,5860250,8463650,2603400,BUY
2020-11-06 14:11:00,14:11,5836925,8476675,2639750,BUY
2020-11-06 14:12:00,14:12,5805925,8490575,2684650,BUY
2020-11-06 14:13:00,14:13,5740600,8438375,2697775,BUY
2020-11-06 14:14:00,14:14,5925550,8519500,2593950,BUY
2020-11-06 14:15:00,14:15,5801525,8560475,2758950,BUY
2020-11-06 14:16:00,14:16,5955925,8550675,2594750,BUY
2020-11-06 14:17:00,14:17,5869175,8585025,2715850,BUY
2020-11-06 14:18:00,14:18,5888400,8589150,2700750,BUY
2020-11-06 14:19:00,14:19,5875775,8572025,2696250,BUY
2020-11-06 14:20:00,14:20,5878225,8560650,2682425,BUY
2020-11-06 14:21:00,14:21,5864875,8601500,2736625,BUY
2020-11-06 14:22:00,14:22,5923225,8611950,2688725,BUY
2020-11-06 14:23:00,14:23,5937575,8566325,2628750,BUY
2020-11-06 14:24:00,14:24,5845050,8570150,2725100,BUY
2020-11-06 14:25:00,14:25,5846900,8649525,2802625,BUY
2020-11-06 14:26:00,14:26,5877200,8590150,2712950,BUY
2020-11-06 14:27:00,14:27,5911225,8636750,2725525,BUY
2020-11-06 14:28:00,14:28,5993500,8678625,2685125,BUY
2020-11-06 14:29:00,14:29,5936900,8685850,2748950,BUY
2020-11-06 14:30:00,14:30,5743100,8535150,2792050,BUY
2020-11-06 14:31:00,14:31,5729350,8496075,2766725,BUY
2020-11-06 14:32:00,14:32,5756900,8521350,2764450,BUY
2020-11-06 14:33:00,14:33,5815550,8447150,2631600,BUY
2020-11-06 14:34:00,14:34,5708225,8461625,2753400,BUY
2020-11-06 14:35:00,14:35,5761150,8431050,2669900,BUY
2020-11-06 14:36:00,14:36,5891700,8478650,2586950,BUY
2020-11-06 14:37:00,14:37,5864800,8507600,2642800,BUY
2020-11-06 14:38:00,14:38,5867075,8434075,2567000,BUY
2020-11-06 14:39:00,14:39,5819275,8331925,2512650,BUY
2020-11-06 14:40:00,14:40,5848700,8337550,2488850,BUY
2020-11-06 14:41:00,14:41,5887700,8304525,2416825,BUY
2020-11-06 14:42:00,14:42,5746300,8171050,2424750,BUY
2020-11-06 14:43:00,14:43,5752125,8179175,2427050,BUY
2020-11-06 14:44:00,14:44,5749225,8172175,2422950,BUY
2020-11-06 14:45:00,14:45,5777225,8179375,2402150,BUY
2020-11-06 14:46:00,14:46,5802225,8191275,2389050,BUY
2020-11-06 14:47:00,14:47,5828075,8201950,2373875,BUY
2020-11-06 14:48:00,14:48,5737650,8161375,2423725,BUY
2020-11-06 14:49:00,14:49,5871650,8139225,2267575,BUY
2020-11-06 14:50:00,14:50,5869850,8160225,2290375,BUY
2020-11-06 14:51:00,14:51,5950725,8173175,2222450,BUY
2020-11-06 14:52:00,14:52,5928025,8107425,2179400,BUY
2020-11-06 14:53:00,14:53,5949700,8135275,2185575,BUY
2020-11-06 14:54:00,14:54,5850325,8155250,2304925,BUY
2020-11-06 14:55:00,14:55,5867700,8127650,2259950,BUY
2020-11-06 14:56:00,14:56,5826050,8142750,2316700,BUY
2020-11-06 14:57:00,14:57,5911575,8134350,2222775,BUY
2020-11-06 14:58:00,14:58,5920450,8161025,2240575,BUY
2020-11-06 14:59:00,14:59,5884150,8150325,2266175,BUY
2020-11-06 15:00:00,15:00,5847750,8171150,2323400,BUY
2020-11-06 15:01:00,15:01,5821925,8176875,2354950,BUY
2020-11-06 15:02:00,15:02,5810175,8166375,2356200,BUY
2020-11-06 15:03:00,15:03,5821025,8112625,2291600,BUY
2020-11-06 15:04:00,15:04,5809700,8111350,2301650,BUY
2020-11-06 15:05:00,15:05,5824125,8089675,2265550,BUY
2020-11-06 15:06:00,15:06,5821600,8078175,2256575,BUY
2020-11-06 15:07:00,15:07,5800475,8139825,2339350,BUY
2020-11-06 15:08:00,15:08,5853350,8146575,2293225,BUY
2020-11-06 15:09:00,15:09,5766325,8146200,2379875,BUY
2020-11-06 15:10:00,15:10,5757100,8115400,2358300,BUY
2020-11-06 15:11:00,15:11,5693500,8168625,2475125,BUY
2020-11-06 15:12:00,15:12,5765225,8045825,2280600,BUY
2020-11-06 15:13:00,15:13,5707975,8084750,2376775,BUY
2020-11-06 15:14:00,15:14,5732050,8065975,2333925,BUY
2020-11-06 15:15:00,15:15,5678850,8076500,2397650,BUY
2020-11-06 15:16:00,15:16,5730375,8058475,2328100,BUY
2020-11-06 15:17:00,15:17,5728175,8062525,2334350,BUY
2020-11-06 15:18:00,15:18,5625025,7946200,2321175,BUY
2020-11-06 15:19:00,15:19,5649475,7982600,2333125,BUY
2020-11-06 15:20:00,15:20,5601350,7974100,2372750,BUY
2020-11-06 15:21:00,15:21,5367625,7766725,2399100,BUY
2020-11-06 15:22:00,15:22,5384450,7771100,2386650,BUY
2020-11-06 15:23:00,15:23,5330875,7758175,2427300,BUY
2020-11-06 15:24:00,15:24,5268200,7711825,2443625,BUY
2020-11-06 15:25:00,15:25,5317775,7725675,2407900,BUY
2020-11-06 15:26:00,15:26,5223725,7676175,2452450,BUY
2020-11-06 15:27:00,15:27,5104650,7538575,2433925,BUY
2020-11-06 15:28:00,15:28,5103925,7554475,2450550,BUY
2020-11-06 15:29:00,15:29,5143875,7556500,2412625,BUY
2020-11-09 09:15:00,09:15,4886250,7272575,2386325,BUY
2020-11-09 09:16:00,09:16,4859675,7297775,2438100,BUY
2020-11-09 09:17:00,09:17,4969650,7303750,2334100,BUY
2020-11-09 09:18:00,09:18,4932150,7303975,2371825,BUY
2020-11-09 09:19:00,09:19,4897700,7291425,2393725,BUY
2020-11-09 09:20:00,09:20,4978850,7373025,2394175,BUY
2020-11-09 09:21:00,09:21,4997075,7361950,2364875,BUY
2020-11-09 09:22:00,09:22,4968000,7363550,2395550,BUY
2020-11-09 09:23:00,09:23,4965025,7309225,2344200,BUY
2020-11-09 09:24:00,09:24,4926625,7309575,2382950,BUY
2020-11-09 09:25:00,09:25,4871700,7216250,2344550,BUY
2020-11-09 09:26:00,09:26,4967725,7461725,2494000,BUY
2020-11-09 09:27:00,09:27,5037925,7453850,2415925,BUY
2020-11-09 09:28:00,09:28,5079050,7435850,2356800,BUY
2020-11-09 09:29:00,09:29,5163150,7647700,2484550,BUY
2020-11-09 09:30:00,09:30,5181225,7654800,2473575,BUY
2020-11-09 09:31:00,09:31,5222925,7581350,2358425,BUY
2020-11-09 09:32:00,09:32,5331750,7823800,2492050,BUY
2020-11-09 09:33:00,09:33,5295800,7804225,2508425,BUY
2020-11-09 09:34:00,09:34,5295375,7721075,2425700,BUY
2020-11-09 09:35:00,09:35,5477025,8051225,2574200,BUY
2020-11-09 09:36:00,09:36,5411450,8106400,2694950,BUY
2020-11-09 09:37:00,09:37,5401125,8112225,2711100,BUY
2020-11-09 09:38:00,09:38,5481025,8252250,2771225,BUY
2020-11-09 09:39:00,09:39,5422400,8265025,2842625,BUY
2020-11-09 09:40:00,09:40,5420975,8262450,2841475,BUY
2020-11-09 09:41:00,09:41,5605725,8456900,2851175,BUY
2020-11-09 09:42:00,09:42,5652000,8432550,2780550,BUY
2020-11-09 09:43:00,09:43,5604125,8437675,2833550,BUY
2020-11-09 09:44:00,09:44,5471325,8211225,2739900,BUY
2020-11-09 09:45:00,09:45,5446375,8275400,2829025,BUY
2020-11-09 09:46:00,09:46,5485375,8263850,2778475,BUY
2020-11-09 09:47:00,09:47,5698650,8499900,2801250,BUY
2020-11-09 09:48:00,09:48,5723175,8518950,2795775,BUY
2020-11-09 09:49:00,09:49,5711950,8396425,2684475,BUY
2020-11-09 09:50:00,09:50,5829050,8503675,2674625,BUY
2020-11-09 09:51:00,09:51,5770975,8512800,2741825,BUY
2020-11-09 09:52:00,09:52,5842425,8478875,2636450,BUY
2020-11-09 09:53:00,09:53,6021825,8571750,2549925,BUY
2020-11-09 09:54:00,09:54,5969225,8641125,2671900,BUY
2020-11-09 09:55:00,09:55,6014950,8655975,2641025,BUY
2020-11-09 09:56:00,09:56,6078550,8704775,2626225,BUY
2020-11-09 09:57:00,09:57,5986350,8674250,2687900,BUY
2020-11-09 09:58:00,09:58,6088475,8731925,2643450,BUY
2020-11-09 09:59:00,09:59,5904125,8897125,2993000,BUY
2020-11-09 10:00:00,10:00,5934650,8897825,2963175,BUY
2020-11-09 10:01:00,10:01,5963175,8936675,2973500,BUY
2020-11-09 10:02:00,10:02,5961275,8960350,2999075,BUY
2020-11-09 10:03:00,10:03,6061000,8904825,2843825,BUY
2020-11-09 10:04:00,10:04,6154050,8955950,2801900,BUY
2020-11-09 10:05:00,10:05,6226200,9125775,2899575,BUY
2020-11-09 10:06:00,10:06,6254200,9180100,2925900,BUY
2020-11-09 10:07:00,10:07,6307875,9135650,2827775,BUY
2020-11-09 10:08:00,10:08,6433175,9197950,2764775,BUY
2020-11-09 10:09:00,10:09,6420050,9267875,2847825,BUY
2020-11-09 10:10:00,10:10,6432775,9191700,2758925,BUY
2020-11-09 10:11:00,10:11,6415650,9205350,2789700,BUY
2020-11-09 10:12:00,10:12,6511050,9258550,2747500,BUY
2020-11-09 10:13:00,10:13,6302650,9170175,2867525,BUY
2020-11-09 10:14:00,10:14,6382150,9250625,2868475,BUY
2020-11-09 10:15:00,10:15,6629675,9330750,2701075,BUY
2020-11-09 10:16:00,10:16,6474200,9291975,2817775,BUY
2020-11-09 10:17:00,10:17,6576375,9306550,2730175,BUY
2020-11-09 10:18:00,10:18,6736625,9279875,2543250,BUY
2020-11-09 10:19:00,10:19,6678825,9334400,2655575,BUY
2020-11-09 10:20:00,10:20,6601100,9340750,2739650,BUY
2020-11-09 10:21:00,10:21,6631175,9350225,2719050,BUY
2020-11-09 10:22:00,10:22,6441425,9338250,2896825,BUY
2020-11-09 10:23:00,10:23,6769350,9400175,2630825,BUY
2020-11-09 10:24:00,10:24,6889075,9423850,2534775,BUY
2020-11-09 10:25:00,10:25,6708950,9313125,2604175,BUY
2020-11-09 10:26:00,10:26,6809150,9311950,2502800,BUY
2020-11-09 10:27:00,10:27,6773075,9164425,2391350,BUY
2020-11-09 10:28:00,10:28,6836300,9334775,2498475,BUY
2020-11-09 10:29:00,10:29,6889650,9380475,2490825,BUY
2020-11-09 10:30:00,10:30,7037275,9369575,2332300,BUY
2020-11-09 10:31:00,10:31,7057825,9421900,2364075,BUY
2020-11-09 10:32:00,10:32,7002600,9419325,2416725,BUY
2020-11-09 10:33:00,10:33,7111300,9395375,2284075,BUY
2020-11-09 10:34:00,10:34,7072325,9423550,2351225,BUY
2020-11-09 10:35:00,10:35,6837200,9449725,2612525,BUY
2020-11-09 10:36:00,10:36,7081200,9415775,2334575,BUY
2020-11-09 10:37:00,10:37,7058500,9465450,2406950,BUY
2020-11-09 10:38:00,10:38,7117650,9403625,2285975,BUY
2020-11-09 10:39:00,10:39,7206300,9369775,2163475,BUY
2020-11-09 10:40:00,10:40,7169025,9357775,2188750,BUY
2020-11-09 10:41:00,10:41,7085100,9339700,2254600,BUY
2020-11-09 10:42:00,10:42,7267375,9356175,2088800,BUY
2020-11-09 10:43:00,10:43,7099125,9328250,2229125,BUY
2020-11-09 10:44:00,10:44,7195850,9107250,1911400,BUY
2020-11-09 10:45:00,10:45,7339300,9140125,1800825,BUY
2020-11-09 10:46:00,10:46,7122150,9156050,2033900,BUY
2020-11-09 10:47:00,10:47,7160550,9053125,1892575,BUY
2020-11-09 10:48:00,10:48,7279500,9044150,1764650,BUY
2020-11-09 10:49:00,10:49,7419600,8984525,1564925,BUY
2020-11-09 10:50:00,10:50,7504025,8961775,1457750,BUY
2020-11-09 10:51:00,10:51,7370625,8913050,1542425,BUY
2020-11-09 10:52:00,10:52,7338950,8887325,1548375,BUY
2020-11-09 10:53:00,10:53,7347325,8787975,1440650,BUY
2020-11-09 10:54:00,10:54,7305725,8865450,1559725,BUY
2020-11-09 10:55:00,10:55,7411575,8682650,1271075,BUY
2020-11-09 10:56:00,10:56,7488825,8900125,1411300,BUY
2020-11-09 10:57:00,10:57,7529850,8787600,1257750,BUY
2020-11-09 10:58:00,10:58,7468200,8860050,1391850,BUY
2020-11-09 10:59:00,10:59,7422800,8721825,1299025,BUY
2020-11-09 11:00:00,11:00,7445000,8786250,1341250,BUY
2020-11-09 11:01:00,11:01,7317700,8804650,1486950,BUY
2020-11-09 11:02:00,11:02,7495700,8898500,1402800,BUY
2020-11-09 11:03:00,11:03,7589675,8886825,1297150,BUY
2020-11-09 11:04:00,11:04,7560800,8905700,1344900,BUY
2020-11-09 11:05:00,11:05,7719650,8890900,1171250,BUY
2020-11-09 11:06:00,11:06,7464050,8868325,1404275,BUY
2020-11-09 11:07:00,11:07,7666150,8852250,1186100,BUY
2020-11-09 11:08:00,11:08,7639425,8884925,1245500,BUY
2020-11-09 11:09:00,11:09,7699075,8925850,1226775,BUY
2020-11-09 11:10:00,11:10,7496250,8912375,1416125,BUY
2020-11-09 11:11:00,11:11,7737325,8927275,1189950,BUY
2020-11-09 11:12:00,11:12,7696525,8875200,1178675,BUY
2020-11-09 11:13:00,11:13,7784675,8940225,1155550,BUY
2020-11-09 11:14:00,11:14,7550925,9033575,1482650,BUY
2020-11-09 11:15:00,11:15,7628525,8941575,1313050,BUY
2020-11-09 11:16:00,11:16,7795750,8548900,753150,BUY
2020-11-09 11:17:00,11:17,7850600,9007050,1156450,BUY
2020-11-09 11:18:00,11:18,7733775,8757825,1024050,BUY
2020-11-09 11:19:00,11:19,7459025,8700725,1241700,BUY
2020-11-09 11:20:00,11:20,7908500,8968250,1059750,BUY
2020-11-09 11:21:00,11:21,7851925,9021375,1169450,BUY
2020-11-09 11:22:00,11:22,7958225,9054000,1095775,BUY
2020-11-09 11:23:00,11:23,7896325,8863325,967000,BUY
2020-11-09 11:24:00,11:24,7739325,8807450,1068125,BUY
2020-11-09 11:25:00,11:25,7857925,8832900,974975,BUY
2020-11-09 11:26:00,11:26,7949275,8815400,866125,BUY
2020-11-09 11:27:00,11:27,7931700,8829925,898225,BUY
2020-11-09 11:28:00,11:28,8048925,8817300,768375,BUY
2020-11-09 11:29:00,11:29,8043725,8885400,841675,BUY
2020-11-09 11:30:00,11:30,8002450,8886475,884025,BUY
2020-11-09 11:31:00,11:31,7829725,8785175,955450,BUY
2020-11-09 11:32:00,11:32,7951650,8835100,883450,BUY
2020-11-09 11:33:00,11:33,7994150,8861175,867025,BUY
2020-11-09 11:34:00,11:34,7835200,8782600,947400,BUY
2020-11-09 11:35:00,11:35,8002300,8812225,809925,BUY
2020-11-09 11:36:00,11:36,8040825,8821100,780275,BUY
2020-11-09 11:37:00,11:37,7846625,8870550,1023925,BUY
2020-11-09 11:38:00,11:38,8205675,8870800,665125,BUY
2020-11-09 11:39:00,11:39,8127475,8617000,489525,BUY
2020-11-09 11:40:00,11:40,8143800,8829400,685600,BUY
2020-11-09 11:41:00,11:41,7993050,8787900,794850,BUY
2020-11-09 11:42:00,11:42,8160025,8398800,238775,BUY
2020-11-09 11:43:00,11:43,8056600,8857625,801025,BUY
2020-11-09 11:44:00,11:44,8105050,8681600,576550,BUY
2020-11-09 11:45:00,11:45,7955125,8833600,878475,BUY
2020-11-09 11:46:00,11:46,8187925,8652500,464575,BUY
2020-11-09 11:47:00,11:47,8194525,8911275,716750,BUY
2020-11-09 11:48:00,11:48,8185775,8674500,488725,BUY
2020-11-09 11:49:00,11:49,8075825,8875025,799200,BUY
2020-11-09 11:50:00,11:50,8103275,8900050,796775,BUY
2020-11-09 11:51:00,11:51,7993950,8722775,728825,BUY
2020-11-09 11:52:00,11:52,8150950,8959400,808450,BUY
2020-11-09 11:53:00,11:53,8182475,8924750,742275,BUY
2020-11-09 11:54:00,11:54,8012225,8846225,834000,BUY
2020-11-09 11:55:00,11:55,8298575,8950600,652025,BUY
2020-11-09 11:56:00,11:56,7980750,8714450,733700,BUY
2020-11-09 11:57:00,11:57,8137525,8914750,777225,BUY
2020-11-09 11:58:00,11:58,7925775,8894700,968925,BUY
2020-11-09 11:59:00,11:59,8124450,8936050,811600,BUY
2020-11-09 12:00:00,12:00,8231625,8845475,613850,BUY
2020-11-09 12:01:00,12:01,8221800,8890900,669100,BUY
2020-11-09 12:02:00,12:02,8127900,8791250,663350,BUY
2020-11-09 12:03:00,12:03,7889825,9061650,1171825,BUY
2020-11-09 12:04:00,12:04,8051175,8838775,787600,BUY
2020-11-09 12:05:00,12:05,8095625,9080850,985225,BUY
2020-11-09 12:06:00,12:06,8430300,8907600,477300,BUY
2020-11-09 12:07:00,12:07,8155000,8516250,361250,BUY
2020-11-09 12:08:00,12:08,8181975,8635675,453700,BUY
2020-11-09 12:09:00,12:09,8055800,8883150,827350,BUY
2020-11-09 12:10:00,12:10,8301175,8895500,594325,BUY
2020-11-09 12:11:00,12:11,8264125,8875400,611275,BUY
2020-11-09 12:12:00,12:12,8237150,8849175,612025,BUY
2020-11-09 12:13:00,12:13,8256375,8895650,639275,BUY
2020-11-09 12:14:00,12:14,8501050,8872475,371425,BUY
2020-11-09 12:15:00,12:15,8285800,8978975,693175,BUY
2020-11-09 12:16:00,12:16,8363425,9047725,684300,BUY
2020-11-09 12:17:00,12:17,8271225,9102200,830975,BUY
2020-11-09 12:18:00,12:18,8297175,8975025,677850,BUY
2020-11-09 12:19:00,12:19,8073700,8598500,524800,BUY
2020-11-09 12:20:00,12:20,8578400,8829075,250675,BUY
2020-11-09 12:21:00,12:21,8485675,9190650,704975,BUY
2020-11-09 12:22:00,12:22,8054300,8974525,920225,BUY
2020-11-09 12:23:00,12:23,7938275,9149900,1211625,BUY
2020-11-09 12:24:00,12:24,8288625,9184900,896275,BUY
2020-11-09 12:25:00,12:25,8110550,9060050,949500,BUY
2020-11-09 12:26:00,12:26,8400025,9116350,716325,BUY
2020-11-09 12:27:00,12:27,8163600,9183200,1019600,BUY
2020-11-09 12:28:00,12:28,8426125,9193625,767500,BUY
2020-11-09 12:29:00,12:29,8551125,9172650,621525,BUY
2020-11-09 12:30:00,12:30,8675250,8795225,119975,BUY
2020-11-09 12:31:00,12:31,8522025,9219600,697575,BUY
2020-11-09 12:32:00,12:32,8689500,8966550,277050,BUY
2020-11-09 12:33:00,12:33,8451525,8731625,280100,BUY
2020-11-09 12:34:00,12:34,8307450,9096300,788850,BUY
2020-11-09 12:35:00,12:35,8542850,9074825,531975,BUY
2020-11-09 12:36:00,12:36,8439775,8699350,259575,BUY
2020-11-09 12:37:00,12:37,8277225,8657000,379775,BUY
2020-11-09 12:38:00,12:38,8289600,8882025,592425,BUY
2020-11-09 12:39:00,12:39,8482775,8500225,17450,BUY
2020-11-09 12:40:00,12:40,8569400,8790350,220950,BUY
2020-11-09 12:41:00,12:41,8368225,9091850,723625,BUY
2020-11-09 12:42:00,12:42,8750425,9112200,361775,BUY
2020-11-09 12:43:00,12:43,8821150,9251350,430200,BUY
2020-11-09 12:44:00,12:44,8398275,9191200,792925,BUY
2020-11-09 12:45:00,12:45,8767250,9273900,506650,BUY
2020-11-09 12:46:00,12:46,8431725,9074875,643150,BUY
2020-11-09 12:47:00,12:47,8548300,9208675,660375,BUY
2020-11-09 12:48:00,12:48,8377450,9244750,867300,BUY
2020-11-09 12:49:00,12:49,8527575,9212925,685350,BUY
2020-11-09 12:50:00,12:50,8668775,9267400,598625,BUY
2020-11-09 12:51:00,12:51,8433050,9231400,798350,BUY
2020-11-09 12:52:00,12:52,8527225,9229725,702500,BUY
2020-11-09 12:53:00,12:53,8402700,9281700,879000,BUY
2020-11-09 12:54:00,12:54,8529075,9229175,700100,BUY
2020-11-09 12:55:00,12:55,8434575,9028125,593550,BUY
2020-11-09 12:56:00,12:56,8454225,9256800,802575,BUY
2020-11-09 12:57:00,12:57,8158675,9242425,1083750,BUY
2020-11-09 12:58:00,12:58,8456100,9053725,597625,BUY
2020-11-09 12:59:00,12:59,8409175,9246275,837100,BUY
2020-11-09 13:00:00,13:00,8534325,9288200,753875,BUY
2020-11-09 13:01:00,13:01,8420700,9334525,913825,BUY
2020-11-09 13:02:00,13:02,7973450,9316700,1343250,BUY
2020-11-09 13:03:00,13:03,8245375,9239650,994275,BUY
2020-11-09 13:04:00,13:04,8284875,9322250,1037375,BUY
2020-11-09 13:05:00,13:05,8358200,9336875,978675,BUY
2020-11-09 13:06:00,13:06,8278775,9315200,1036425,BUY
2020-11-09 13:07:00,13:07,8179125,9343725,1164600,BUY
2020-11-09 13:08:00,13:08,8459300,9100800,641500,BUY
2020-11-09 13:09:00,13:09,8127200,9293600,1166400,BUY
2020-11-09 13:10:00,13:10,8229325,9338275,1108950,BUY
2020-11-09 13:11:00,13:11,8379750,9374075,994325,BUY
2020-11-09 13:12:00,13:12,8289600,9329500,1039900,BUY
2020-11-09 13:13:00,13:13,8323550,9394600,1071050,BUY
2020-11-09 13:14:00,13:14,8358425,9113300,754875,BUY
2020-11-09 13:15:00,13:15,8306475,9369925,1063450,BUY
2020-11-09 13:16:00,13:16,8439200,9408750,969550,BUY
2020-11-09 13:17:00,13:17,8246325,9383525,1137200,BUY
2020-11-09 13:18:00,13:18,8116975,9300275,1183300,BUY
2020-11-09 13:19:00,13:19,8250350,9373825,1123475,BUY
2020-11-09 13:20:00,13:20,8208050,9252900,1044850,BUY
2020-11-09 13:21:00,13:21,8264725,9245125,980400,BUY
2020-11-09 13:22:00,13:22,8273450,9412575,1139125,BUY
2020-11-09 13:23:00,13:23,8065875,9400150,1334275,BUY
2020-11-09 13:24:00,13:24,8082825,9338500,1255675,BUY
2020-11-09 13:25:00,13:25,8286225,9431075,1144850,BUY
2020-11-09 13:26:00,13:26,8159425,9449950,1290525,BUY
2020-11-09 13:27:00,13:27,8428300,9530800,1102500,BUY
2020-11-09 13:28:00,13:28,8131850,9468325,1336475,BUY
2020-11-09 13:29:00,13:29,8564700,9476550,911850,BUY
2020-11-09 13:30:00,13:30,8354600,9471475,1116875,BUY
2020-11-09 13:31:00,13:31,8190850,9292750,1101900,BUY
2020-11-09 13:32:00,13:32,8480500,9521550,1041050,BUY
2020-11-09 13:33:00,13:33,8249525,9486875,1237350,BUY
2020-11-09 13:34:00,13:34,8338400,8935625,597225,BUY
2020-11-09 13:35:00,13:35,8157625,9507350,1349725,BUY
2020-11-09 13:36:00,13:36,8138950,9504250,1365300,BUY
2020-11-09 13:37:00,13:37,8550625,9508200,957575,BUY
2020-11-09 13:38:00,13:38,8617825,9525875,908050,BUY
2020-11-09 13:39:00,13:39,8357675,9472450,1114775,BUY
2020-11-09 13:40:00,13:40,8221100,9486050,1264950,BUY
2020-11-09 13:41:00,13:41,8306775,9546875,1240100,BUY
2020-11-09 13:42:00,13:42,8357850,9365350,1007500,BUY
2020-11-09 13:43:00,13:43,8455900,9320000,864100,BUY
2020-11-09 13:44:00,13:44,8313825,9493050,1179225,BUY
2020-11-09 13:45:00,13:45,8293050,9548300,1255250,BUY
2020-11-09 13:46:00,13:46,8369675,9574950,1205275,BUY
2020-11-09 13:47:00,13:47,8291350,9291750,1000400,BUY
2020-11-09 13:48:00,13:48,8390650,9572725,1182075,BUY
2020-11-09 13:49:00,13:49,8402550,9531250,1128700,BUY
2020-11-09 13:50:00,13:50,8413100,9618475,1205375,BUY
2020-11-09 13:51:00,13:51,8345375,9570350,1224975,BUY
2020-11-09 13:52:00,13:52,8230850,9221150,990300,BUY
2020-11-09 13:53:00,13:53,8180650,9316850,1136200,BUY
2020-11-09 13:54:00,13:54,8242125,9387600,1145475,BUY
2020-11-09 13:55:00,13:55,8475375,9670475,1195100,BUY
2020-11-09 13:56:00,13:56,8179450,9559225,1379775,BUY
2020-11-09 13:57:00,13:57,8237400,9650475,1413075,BUY
2020-11-09 13:58:00,13:58,8224225,9449200,1224975,BUY
2020-11-09 13:59:00,13:59,8318100,9455325,1137225,BUY
2020-11-09 14:00:00,14:00,8301775,9596625,1294850,BUY
2020-11-09 14:01:00,14:01,8312600,9618425,1305825,BUY
2020-11-09 14:02:00,14:02,8290350,9663175,1372825,BUY
2020-11-09 14:03:00,14:03,8240850,9752300,1511450,BUY
2020-11-09 14:04:00,14:04,8461050,9686450,1225400,BUY
2020-11-09 14:05:00,14:05,8323475,9765900,1442425,BUY
2020-11-09 14:06:00,14:06,8290500,9796875,1506375,BUY
2020-11-09 14:07:00,14:07,8283000,9774025,1491025,BUY
2020-11-09 14:08:00,14:08,8321525,9823900,1502375,BUY
2020-11-09 14:09:00,14:09,8127225,9884725,1757500,BUY
2020-11-09 14:10:00,14:10,8513375,9815525,1302150,BUY
2020-11-09 14:11:00,14:11,8380375,9898025,1517650,BUY
2020-11-09 14:12:00,14:12,8284425,9892050,1607625,BUY
2020-11-09 14:13:00,14:13,8276950,9985675,1708725,BUY
2020-11-09 14:14:00,14:14,8402675,9930550,1527875,BUY
2020-11-09 14:15:00,14:15,8416450,10004500,1588050,BUY
2020-11-09 14:16:00,14:16,8451550,10009200,1557650,BUY
2020-11-09 14:17:00,14:17,8276825,10017950,1741125,BUY
2020-11-09 14:18:00,14:18,8268025,9974600,1706575,BUY
2020-11-09 14:19:00,14:19,8201675,9947125,1745450,BUY
2020-11-09 14:20:00,14:20,8001250,9921325,1920075,BUY
2020-11-09 14:21:00,14:21,8384700,9938150,1553450,BUY
2020-11-09 14:22:00,14:22,8542100,9970025,1427925,BUY
2020-11-09 14:23:00,14:23,8433000,9994325,1561325,BUY
2020-11-09 14:24:00,14:24,8374475,9935525,1561050,BUY
2020-11-09 14:25:00,14:25,8418025,9876050,1458025,BUY
2020-11-09 14:26:00,14:26,8247500,9932400,1684900,BUY
2020-11-09 14:27:00,14:27,8423500,10016850,1593350,BUY
2020-11-09 14:28:00,14:28,8223050,10016850,1793800,BUY
2020-11-09 14:29:00,14:29,8286675,10024900,1738225,BUY
2020-11-09 14:30:00,14:30,8596275,10060250,1463975,BUY
2020-11-09 14:31:00,14:31,8424350,9985025,1560675,BUY
2020-11-09 14:32:00,14:32,8129900,9929975,1800075,BUY
2020-11-09 14:33:00,14:33,8443925,10049025,1605100,BUY
2020-11-09 14:34:00,14:34,8406525,9972950,1566425,BUY
2020-11-09 14:35:00,14:35,8221225,10043675,1822450,BUY
2020-11-09 14:36:00,14:36,8290025,10050875,1760850,BUY
2020-11-09 14:37:00,14:37,8138125,10014975,1876850,BUY
2020-11-09 14:38:00,14:38,8240875,9941200,1700325,BUY
2020-11-09 14:39:00,14:39,8303900,10003250,1699350,BUY
2020-11-09 14:40:00,14:40,8408625,9989475,1580850,BUY
2020-11-09 14:41:00,14:41,8368575,9986050,1617475,BUY
2020-11-09 14:42:00,14:42,7840925,9918425,2077500,BUY
2020-11-09 14:43:00,14:43,7776625,9927500,2150875,BUY
2020-11-09 14:44:00,14:44,7862150,9984625,2122475,BUY
2020-11-09 14:45:00,14:45,7991300,9932775,1941475,BUY
2020-11-09 14:46:00,14:46,7818125,9860375,2042250,BUY
2020-11-09 14:47:00,14:47,7942775,9933975,1991200,BUY
2020-11-09 14:48:00,14:48,7796350,9858975,2062625,BUY
2020-11-09 14:49:00,14:49,8005525,9799525,1794000,BUY
2020-11-09 14:50:00,14:50,7845925,9688350,1842425,BUY
2020-11-09 14:51:00,14:51,7762575,9655775,1893200,BUY
2020-11-09 14:52:00,14:52,7813100,9890775,2077675,BUY
2020-11-09 14:53:00,14:53,7829675,9890275,2060600,BUY
2020-11-09 14:54:00,14:54,7907350,9734900,1827550,BUY
2020-11-09 14:55:00,14:55,7894575,9792025,1897450,BUY
2020-11-09 14:56:00,14:56,7700000,9880525,2180525,BUY
2020-11-09 14:57:00,14:57,7555725,9906525,2350800,BUY
2020-11-09 14:58:00,14:58,7746175,9922925,2176750,BUY
2020-11-09 14:59:00,14:59,7728325,9899200,2170875,BUY
2020-11-09 15:00:00,15:00,7955175,9982725,2027550,BUY
2020-11-09 15:01:00,15:01,7850550,9991525,2140975,BUY
2020-11-09 15:02:00,15:02,7886350,10007700,2121350,BUY
2020-11-09 15:03:00,15:03,7747250,9908775,2161525,BUY
2020-11-09 15:04:00,15:04,7694150,9899575,2205425,BUY
2020-11-09 15:05:00,15:05,7795075,9984575,2189500,BUY
2020-11-09 15:07:00,15:07,7615100,9786900,2171800,BUY
2020-11-09 15:08:00,15:08,7534875,9823850,2288975,BUY
2020-11-09 15:09:00,15:09,7660425,9841800,2181375,BUY
2020-11-09 15:10:00,15:10,7517425,9822325,2304900,BUY
2020-11-09 15:11:00,15:11,7594150,9795125,2200975,BUY
2020-11-09 15:12:00,15:12,7433675,9837750,2404075,BUY
2020-11-09 15:13:00,15:13,7575700,9848800,2273100,BUY
2020-11-09 15:14:00,15:14,7615925,9855700,2239775,BUY
2020-11-09 15:15:00,15:15,7583450,9840600,2257150,BUY
2020-11-09 15:16:00,15:16,7603675,9871350,2267675,BUY
2020-11-09 15:17:00,15:17,7601850,9938825,2336975,BUY
2020-11-09 15:18:00,15:18,7355500,9788175,2432675,BUY
2020-11-09 15:19:00,15:19,7371800,9779100,2407300,BUY
2020-11-09 15:20:00,15:20,7360050,9757600,2397550,BUY
2020-11-09 15:21:00,15:21,7240775,9598850,2358075,BUY
2020-11-09 15:22:00,15:22,7229325,9653550,2424225,BUY
2020-11-09 15:23:00,15:23,7194825,9606500,2411675,BUY
2020-11-09 15:24:00,15:24,6984275,9457175,2472900,BUY
2020-11-09 15:25:00,15:25,7219850,9425525,2205675,BUY
2020-11-09 15:26:00,15:26,7167575,9460800,2293225,BUY
2020-11-09 15:27:00,15:27,6883550,9348200,2464650,BUY
2020-11-09 15:28:00,15:28,6949750,9351475,2401725,BUY
2020-11-09 15:29:00,15:29,6955675,9381950,2426275,BUY
2020-11-10 09:15:00,09:15,6240550,9176925,2936375,BUY
2020-11-10 09:16:00,09:16,6208600,9126075,2917475,BUY
2020-11-10 09:17:00,09:17,6679800,9220725,2540925,BUY
2020-11-10 09:18:00,09:18,6688400,9237300,2548900,BUY
2020-11-10 09:19:00,09:19,6724025,9196750,2472725,BUY
2020-11-10 09:20:00,09:20,6593775,9286450,2692675,BUY
2020-11-10 09:21:00,09:21,6560625,9248975,2688350,BUY
2020-11-10 09:22:00,09:22,6619150,9288900,2669750,BUY
2020-11-10 09:23:00,09:23,6521950,9541550,3019600,BUY
2020-11-10 09:24:00,09:24,6702475,9569150,2866675,BUY
2020-11-10 09:25:00,09:25,6768875,9514775,2745900,BUY
2020-11-10 09:26:00,09:26,6688150,9680275,2992125,BUY
2020-11-10 09:27:00,09:27,6666025,9657875,2991850,BUY
2020-11-10 09:28:00,09:28,6622775,9718400,3095625,BUY
2020-11-10 09:29:00,09:29,6628750,9698675,3069925,BUY
2020-11-10 09:30:00,09:30,6587950,9714150,3126200,BUY
2020-11-10 09:31:00,09:31,6627525,9664275,3036750,BUY
2020-11-10 09:32:00,09:32,6523500,9766200,3242700,BUY
2020-11-10 09:33:00,09:33,6643950,9772925,3128975,BUY
2020-11-10 09:34:00,09:34,6566325,9727750,3161425,BUY
2020-11-10 09:35:00,09:35,6528775,9886500,3357725,BUY
2020-11-10 09:36:00,09:36,6354300,9892025,3537725,BUY
2020-11-10 09:37:00,09:37,6471975,9932275,3460300,BUY
2020-11-10 09:38:00,09:38,6517100,10010025,3492925,BUY
2020-11-10 09:39:00,09:39,6535950,10043300,3507350,BUY
2020-11-10 09:40:00,09:40,6734900,10010700,3275800,BUY
2020-11-10 09:41:00,09:41,6827425,10078725,3251300,BUY
2020-11-10 09:42:00,09:42,6994000,10096600,3102600,BUY
2020-11-10 09:43:00,09:43,6579275,10107100,3527825,BUY
2020-11-10 09:44:00,09:44,6759300,10181950,3422650,BUY
2020-11-10 09:45:00,09:45,6888450,10155500,3267050,BUY
2020-11-10 09:46:00,09:46,6976450,10124725,3148275,BUY
2020-11-10 09:47:00,09:47,6809750,10232950,3423200,BUY
2020-11-10 09:48:00,09:48,6803925,10191700,3387775,BUY
2020-11-10 09:49:00,09:49,6754600,10148800,3394200,BUY
2020-11-10 09:50:00,09:50,6796425,10312850,3516425,BUY
2020-11-10 09:51:00,09:51,7011325,10059025,3047700,BUY
2020-11-10 09:52:00,09:52,6912150,10275625,3363475,BUY
2020-11-10 09:53:00,09:53,6994675,10050175,3055500,BUY
2020-11-10 09:54:00,09:54,6948850,10216275,3267425,BUY
2020-11-10 09:55:00,09:55,6869875,9820000,2950125,BUY
2020-11-10 09:56:00,09:56,7322975,10046200,2723225,BUY
2020-11-10 09:57:00,09:57,7191850,10285950,3094100,BUY
2020-11-10 09:58:00,09:58,6949175,10184675,3235500,BUY
2020-11-10 09:59:00,09:59,7147500,10369750,3222250,BUY
2020-11-10 10:00:00,10:00,6962525,10278700,3316175,BUY
2020-11-10 10:01:00,10:01,6788325,10428250,3639925,BUY
2020-11-10 10:02:00,10:02,6983200,10036025,3052825,BUY
2020-11-10 10:03:00,10:03,7192625,10345025,3152400,BUY
2020-11-10 10:04:00,10:04,7164150,10271175,3107025,BUY
2020-11-10 10:05:00,10:05,7031725,10453725,3422000,BUY
2020-11-10 10:06:00,10:06,7079625,10370375,3290750,BUY
2020-11-10 10:07:00,10:07,7174625,10449900,3275275,BUY
2020-11-10 10:08:00,10:08,7164750,10473775,3309025,BUY
2020-11-10 10:09:00,10:09,7238425,10588550,3350125,BUY
2020-11-10 10:10:00,10:10,7539625,10757500,3217875,BUY
2020-11-10 10:11:00,10:11,7388375,10701575,3313200,BUY
2020-11-10 10:12:00,10:12,7272650,10909600,3636950,BUY
2020-11-10 10:13:00,10:13,7335275,10779900,3444625,BUY
2020-11-10 10:14:00,10:14,7329925,10868975,3539050,BUY
2020-11-10 10:15:00,10:15,7234600,10782900,3548300,BUY
2020-11-10 10:16:00,10:16,7576150,10923500,3347350,BUY
2020-11-10 10:17:00,10:17,7287725,11155400,3867675,BUY
2020-11-10 10:18:00,10:18,7331425,11304225,3972800,BUY
2020-11-10 10:19:00,10:19,7201100,11230325,4029225,BUY
2020-11-10 10:20:00,10:20,7117350,11405775,4288425,BUY
2020-11-10 10:21:00,10:21,6995375,11533475,4538100,BUY
2020-11-10 10:22:00,10:22,7107850,11483250,4375400,BUY
2020-11-10 10:23:00,10:23,7041650,11703275,4661625,BUY
2020-11-10 10:24:00,10:24,7143900,11394775,4250875,BUY
2020-11-10 10:25:00,10:25,6945900,11574500,4628600,BUY
2020-11-10 10:26:00,10:26,7451800,11801125,4349325,BUY
2020-11-10 10:27:00,10:27,7394650,11696000,4301350,BUY
2020-11-10 10:28:00,10:28,7075850,11514325,4438475,BUY
2020-11-10 10:29:00,10:29,7637175,11785425,4148250,BUY
2020-11-10 10:30:00,10:30,7489350,12011300,4521950,BUY
2020-11-10 10:31:00,10:31,7366325,11987800,4621475,BUY
2020-11-10 10:32:00,10:32,7707875,11749325,4041450,BUY
2020-11-10 10:33:00,10:33,7241425,11907000,4665575,BUY
2020-11-10 10:34:00,10:34,7688175,12072450,4384275,BUY
2020-11-10 10:35:00,10:35,7557575,12199500,4641925,BUY
2020-11-10 10:36:00,10:36,7725200,12019825,4294625,BUY
2020-11-10 10:37:00,10:37,7152000,11686350,4534350,BUY
2020-11-10 10:38:00,10:38,7878225,12037375,4159150,BUY
2020-11-10 10:39:00,10:39,7886300,12222525,4336225,BUY
2020-11-10 10:40:00,10:40,7654000,12374000,4720000,BUY
2020-11-10 10:41:00,10:41,7922075,12408350,4486275,BUY
2020-11-10 10:42:00,10:42,7727550,12150700,4423150,BUY
2020-11-10 10:43:00,10:43,7869300,12249000,4379700,BUY
2020-11-10 10:44:00,10:44,7796850,12673150,4876300,BUY
2020-11-10 10:45:00,10:45,7810925,12454200,4643275,BUY
2020-11-10 10:46:00,10:46,7748650,12730625,4981975,BUY
2020-11-10 10:47:00,10:47,7776325,12666675,4890350,BUY
2020-11-10 10:48:00,10:48,7947350,12583200,4635850,BUY
2020-11-10 10:49:00,10:49,8167725,12834975,4667250,BUY
2020-11-10 10:50:00,10:50,7746275,12677475,4931200,BUY
2020-11-10 10:51:00,10:51,8034925,12579725,4544800,BUY
2020-11-10 10:52:00,10:52,7954850,12439050,4484200,BUY
2020-11-10 10:53:00,10:53,7458475,12676050,5217575,BUY
2020-11-10 10:54:00,10:54,7650950,12739400,5088450,BUY
2020-11-10 10:55:00,10:55,7815825,12961250,5145425,BUY
2020-11-10 10:56:00,10:56,7893300,12735575,4842275,BUY
2020-11-10 10:57:00,10:57,7805425,12843500,5038075,BUY
2020-11-10 10:58:00,10:58,7806900,12922325,5115425,BUY
2020-11-10 10:59:00,10:59,7715200,13083650,5368450,BUY
2020-11-10 11:00:00,11:00,7619225,13037200,5417975,BUY
2020-11-10 11:01:00,11:01,7515700,12922700,5407000,BUY
2020-11-10 11:02:00,11:02,7802750,13096850,5294100,BUY
2020-11-10 11:03:00,11:03,7768975,13015425,5246450,BUY
2020-11-10 11:04:00,11:04,7692400,12885400,5193000,BUY
2020-11-10 11:05:00,11:05,7611775,12976625,5364850,BUY
2020-11-10 11:06:00,11:06,7563500,13021175,5457675,BUY
2020-11-10 11:07:00,11:07,7756450,13023000,5266550,BUY
2020-11-10 11:08:00,11:08,7196475,13212825,6016350,BUY
2020-11-10 11:09:00,11:09,7498925,13129800,5630875,BUY
2020-11-10 11:10:00,11:10,7304925,13008700,5703775,BUY
2020-11-10 11:11:00,11:11,7610750,13126875,5516125,BUY
2020-11-10 11:12:00,11:12,7538775,13083800,5545025,BUY
2020-11-10 11:13:00,11:13,7334925,13174200,5839275,BUY
2020-11-10 11:14:00,11:14,7620250,12916075,5295825,BUY
2020-11-10 11:15:00,11:15,7635725,12836450,5200725,BUY
2020-11-10 11:16:00,11:16,7618800,13147600,5528800,BUY
2020-11-10 11:17:00,11:17,7490925,12910575,5419650,BUY
2020-11-10 11:18:00,11:18,7400150,12985200,5585050,BUY
2020-11-10 11:19:00,11:19,7537575,13233900,5696325,BUY
2020-11-10 11:20:00,11:20,7495350,13273500,5778150,BUY
2020-11-10 11:21:00,11:21,7757300,13232525,5475225,BUY
2020-11-10 11:22:00,11:22,7712475,13206150,5493675,BUY
2020-11-10 11:23:00,11:23,7773875,13231000,5457125,BUY
2020-11-10 11:24:00,11:24,7855050,13338200,5483150,BUY
2020-11-10 11:25:00,11:25,7910550,13255975,5345425,BUY
2020-11-10 11:26:00,11:26,7676425,13259975,5583550,BUY
2020-11-10 11:27:00,11:27,7517500,13277025,5759525,BUY
2020-11-10 11:28:00,11:28,7827300,13234850,5407550,BUY
2020-11-10 11:29:00,11:29,7503100,12959325,5456225,BUY
2020-11-10 11:30:00,11:30,7751050,13023975,5272925,BUY
2020-11-10 11:31:00,11:31,7801625,12735800,4934175,BUY
2020-11-10 11:32:00,11:32,7445875,12723200,5277325,BUY
2020-11-10 11:33:00,11:33,7454375,12760975,5306600,BUY
2020-11-10 11:34:00,11:34,7608700,12963600,5354900,BUY
2020-11-10 11:35:00,11:35,7733050,13020675,5287625,BUY
2020-11-10 11:36:00,11:36,7629675,13066175,5436500,BUY
2020-11-10 11:37:00,11:37,7719150,13160250,5441100,BUY
2020-11-10 11:38:00,11:38,7618600,13035600,5417000,BUY
2020-11-10 11:39:00,11:39,7572675,12914725,5342050,BUY
2020-11-10 11:40:00,11:40,7886950,13004650,5117700,BUY
2020-11-10 11:41:00,11:41,7430500,13135450,5704950,BUY
2020-11-10 11:42:00,11:42,8049125,13090150,5041025,BUY
2020-11-10 11:43:00,11:43,7632200,13007200,5375000,BUY
2020-11-10 11:44:00,11:44,7540350,12795225,5254875,BUY
2020-11-10 11:45:00,11:45,7632800,13074875,5442075,BUY
2020-11-10 11:46:00,11:46,7796825,12901025,5104200,BUY
2020-11-10 11:47:00,11:47,7644925,13162325,5517400,BUY
2020-11-10 11:48:00,11:48,7695175,13062725,5367550,BUY
2020-11-10 11:49:00,11:49,8050025,13216325,5166300,BUY
2020-11-10 11:50:00,11:50,7967125,13242625,5275500,BUY
2020-11-10 11:51:00,11:51,7786700,13285900,5499200,BUY
2020-11-10 11:52:00,11:52,7521375,13133100,5611725,BUY
2020-11-10 11:53:00,11:53,7918025,12971850,5053825,BUY
2020-11-10 11:54:00,11:54,7727850,12940050,5212200,BUY
2020-11-10 11:55:00,11:55,8311725,13193325,4881600,BUY
2020-11-10 11:56:00,11:56,7906475,13097050,5190575,BUY
2020-11-10 11:57:00,11:57,7468825,13090975,5622150,BUY
2020-11-10 11:58:00,11:58,7863125,13176850,5313725,BUY
2020-11-10 11:59:00,11:59,7733175,13210100,5476925,BUY
2020-11-10 12:00:00,12:00,7997225,13214375,5217150,BUY
2020-11-10 12:01:00,12:01,8031225,13357150,5325925,BUY
2020-11-10 12:02:00,12:02,7942425,13225000,5282575,BUY
2020-11-10 12:03:00,12:03,8018875,13014900,4996025,BUY
2020-11-10 12:04:00,12:04,7719850,12845375,5125525,BUY
2020-11-10 12:05:00,12:05,7922100,12846750,4924650,BUY
2020-11-10 12:06:00,12:06,8085900,13025100,4939200,BUY
2020-11-10 12:07:00,12:07,7838850,13151775,5312925,BUY
2020-11-10 12:08:00,12:08,7913775,13218125,5304350,BUY
2020-11-10 12:09:00,12:09,8361775,13198075,4836300,BUY
2020-11-10 12:10:00,12:10,7991700,12984800,4993100,BUY
2020-11-10 12:11:00,12:11,8138075,13221775,5083700,BUY
2020-11-10 12:12:00,12:12,7755850,13080750,5324900,BUY
2020-11-10 12:13:00,12:13,7950525,13109675,5159150,BUY
2020-11-10 12:14:00,12:14,7850500,13261525,5411025,BUY
2020-11-10 12:15:00,12:15,7814800,13438275,5623475,BUY
2020-11-10 12:16:00,12:16,7993050,13171750,5178700,BUY
2020-11-10 12:17:00,12:17,7763650,13150750,5387100,BUY
2020-11-10 12:18:00,12:18,8047425,13090975,5043550,BUY
2020-11-10 12:19:00,12:19,7664575,12997875,5333300,BUY
2020-11-10 12:20:00,12:20,7895775,13287150,5391375,BUY
2020-11-10 12:21:00,12:21,7943750,13071800,5128050,BUY
2020-11-10 12:22:00,12:22,8089325,13228550,5139225,BUY
2020-11-10 12:23:00,12:23,7377500,13192950,5815450,BUY
2020-11-10 12:24:00,12:24,8016850,13011625,4994775,BUY
2020-11-10 12:25:00,12:25,7850900,13148000,5297100,BUY
2020-11-10 12:26:00,12:26,8005600,13358175,5352575,BUY
2020-11-10 12:27:00,12:27,8248025,13186400,4938375,BUY
2020-11-10 12:28:00,12:28,7953400,13136325,5182925,BUY
2020-11-10 12:29:00,12:29,8279275,13253825,4974550,BUY
2020-11-10 12:30:00,12:30,8466025,13359325,4893300,BUY
2020-11-10 12:31:00,12:31,8120975,13317800,5196825,BUY
2020-11-10 12:32:00,12:32,8103800,13268050,5164250,BUY
2020-11-10 12:33:00,12:33,8180200,13111750,4931550,BUY
2020-11-10 12:34:00,12:34,8186950,13217175,5030225,BUY
2020-11-10 12:35:00,12:35,8085125,13215325,5130200,BUY
2020-11-10 12:36:00,12:36,7458850,13322975,5864125,BUY
2020-11-10 12:37:00,12:37,8038375,13213875,5175500,BUY
2020-11-10 12:38:00,12:38,8169000,13203050,5034050,BUY
2020-11-10 12:39:00,12:39,7810375,13214300,5403925,BUY
2020-11-10 12:40:00,12:40,8025750,13170625,5144875,BUY
2020-11-10 12:41:00,12:41,8160350,13277525,5117175,BUY
2020-11-10 12:42:00,12:42,7799750,12904650,5104900,BUY
2020-11-10 12:43:00,12:43,7964000,13004925,5040925,BUY
2020-11-10 12:44:00,12:44,8111525,13314825,5203300,BUY
2020-11-10 12:45:00,12:45,8166900,13238550,5071650,BUY
2020-11-10 12:46:00,12:46,8198350,13182875,4984525,BUY
2020-11-10 12:47:00,12:47,7820425,13504675,5684250,BUY
2020-11-10 12:48:00,12:48,7851075,13224100,5373025,BUY
2020-11-10 12:49:00,12:49,8073350,13474400,5401050,BUY
2020-11-10 12:50:00,12:50,8275100,13508675,5233575,BUY
2020-11-10 12:51:00,12:51,7649650,13203650,5554000,BUY
2020-11-10 12:52:00,12:52,7794975,13481400,5686425,BUY
2020-11-10 12:53:00,12:53,8148225,13543850,5395625,BUY
2020-11-10 12:54:00,12:54,8288175,13372700,5084525,BUY
2020-11-10 12:55:00,12:55,8188725,12958275,4769550,BUY
2020-11-10 12:56:00,12:56,7984900,12996700,5011800,BUY
2020-11-10 12:57:00,12:57,8025800,13505975,5480175,BUY
2020-11-10 12:58:00,12:58,8091425,13641325,5549900,BUY
2020-11-10 12:59:00,12:59,7974200,13333800,5359600,BUY
2020-11-10 13:00:00,13:00,7952400,13588925,5636525,BUY
2020-11-10 13:01:00,13:01,7679800,13545225,5865425,BUY
2020-11-10 13:02:00,13:02,7689975,13763175,6073200,BUY
2020-11-10 13:03:00,13:03,7459200,13707950,6248750,BUY
2020-11-10 13:04:00,13:04,7627450,13620275,5992825,BUY
2020-11-10 13:05:00,13:05,7431625,13712775,6281150,BUY
2020-11-10 13:06:00,13:06,7411275,13855000,6443725,BUY
2020-11-10 13:07:00,13:07,7326925,13901950,6575025,BUY
2020-11-10 13:08:00,13:08,7193225,13909500,6716275,BUY
2020-11-10 13:09:00,13:09,7590050,13653825,6063775,BUY
2020-11-10 13:10:00,13:10,7642525,13894500,6251975,BUY
2020-11-10 13:11:00,13:11,7531350,13852900,6321550,BUY
2020-11-10 13:12:00,13:12,7467125,13663075,6195950,BUY
2020-11-10 13:13:00,13:13,7179625,13877225,6697600,BUY
2020-11-10 13:14:00,13:14,7564175,13236850,5672675,BUY
2020-11-10 13:15:00,13:15,7345350,13433175,6087825,BUY
2020-11-10 13:16:00,13:16,7326500,13372725,6046225,BUY
2020-11-10 13:17:00,13:17,7552575,13590550,6037975,BUY
2020-11-10 13:18:00,13:18,7499250,13816825,6317575,BUY
2020-11-10 13:19:00,13:19,7416050,13733950,6317900,BUY
2020-11-10 13:20:00,13:20,7442775,13755375,6312600,BUY
2020-11-10 13:21:00,13:21,7659925,13803050,6143125,BUY
2020-11-10 13:22:00,13:22,7392500,13582100,6189600,BUY
2020-11-10 13:23:00,13:23,7544000,13693700,6149700,BUY
2020-11-10 13:24:00,13:24,7296275,13348225,6051950,BUY
2020-11-10 13:25:00,13:25,7309400,13762600,6453200,BUY
2020-11-10 13:26:00,13:26,7764175,13714025,5949850,BUY
2020-11-10 13:27:00,13:27,7726250,13519200,5792950,BUY
2020-11-10 13:28:00,13:28,7648250,13440450,5792200,BUY
2020-11-10 13:29:00,13:29,7693650,13704300,6010650,BUY
2020-11-10 13:30:00,13:30,7630600,13644100,6013500,BUY
2020-11-10 13:31:00,13:31,7616425,13674600,6058175,BUY
2020-11-10 13:32:00,13:32,7423550,13411700,5988150,BUY
2020-11-10 13:33:00,13:33,7467150,13795850,6328700,BUY
2020-11-10 13:34:00,13:34,7446750,13594175,6147425,BUY
2020-11-10 13:35:00,13:35,7110125,13579050,6468925,BUY
2020-11-10 13:36:00,13:36,7644175,13711675,6067500,BUY
2020-11-10 13:37:00,13:37,7531050,13789450,6258400,BUY
2020-11-10 13:38:00,13:38,7638725,13640275,6001550,BUY
2020-11-10 13:39:00,13:39,7232650,13403950,6171300,BUY
2020-11-10 13:40:00,13:40,7100925,13760925,6660000,BUY
2020-11-10 13:41:00,13:41,7571175,13802150,6230975,BUY
2020-11-10 13:42:00,13:42,7411575,13482200,6070625,BUY
2020-11-10 13:43:00,13:43,7475250,13578075,6102825,BUY
2020-11-10 13:44:00,13:44,7664150,13842925,6178775,BUY
2020-11-10 13:45:00,13:45,7813975,13830400,6016425,BUY
2020-11-10 13:46:00,13:46,7705000,13727325,6022325,BUY
2020-11-10 13:47:00,13:47,7744100,13761625,6017525,BUY
2020-11-10 13:48:00,13:48,7575975,13444375,5868400,BUY
2020-11-10 13:49:00,13:49,7602550,13599625,5997075,BUY
2020-11-10 13:50:00,13:50,7569925,13449575,5879650,BUY
2020-11-10 13:51:00,13:51,7384175,13630925,6246750,BUY
2020-11-10 13:52:00,13:52,7420075,13686200,6266125,BUY
2020-11-10 13:53:00,13:53,7390175,13815100,6424925,BUY
2020-11-10 13:54:00,13:54,7537450,13645750,6108300,BUY
2020-11-10 13:55:00,13:55,7365550,13618100,6252550,BUY
2020-11-10 13:56:00,13:56,7352475,13410625,6058150,BUY
2020-11-10 13:57:00,13:57,7313275,13307300,5994025,BUY
2020-11-10 13:58:00,13:58,7351825,13275450,5923625,BUY
2020-11-10 13:59:00,13:59,7380750,13508875,6128125,BUY
2020-11-10 14:00:00,14:00,7694725,13517675,5822950,BUY
2020-11-10 14:01:00,14:01,7553300,13609925,6056625,BUY
2020-11-10 14:02:00,14:02,7318575,13422275,6103700,BUY
2020-11-10 14:03:00,14:03,7546800,13697775,6150975,BUY
2020-11-10 14:04:00,14:04,7710650,13483650,5773000,BUY
2020-11-10 14:05:00,14:05,7756325,13780400,6024075,BUY
2020-11-10 14:06:00,14:06,7662900,13532600,5869700,BUY
2020-11-10 14:07:00,14:07,7773450,13712200,5938750,BUY
2020-11-10 14:08:00,14:08,7881875,13474200,5592325,BUY
2020-11-10 14:09:00,14:09,7705875,13572875,5867000,BUY
2020-11-10 14:10:00,14:10,7885075,13388650,5503575,BUY
2020-11-10 14:11:00,14:11,7785700,13598875,5813175,BUY
2020-11-10 14:12:00,14:12,7699875,13529675,5829800,BUY
2020-11-10 14:13:00,14:13,7514400,13598600,6084200,BUY
2020-11-10 14:14:00,14:14,7509525,13559775,6050250,BUY
2020-11-10 14:15:00,14:15,7789150,13375225,5586075,BUY
2020-11-10 14:16:00,14:16,7541425,13674950,6133525,BUY
2020-11-10 14:17:00,14:17,7549350,13614500,6065150,BUY
2020-11-10 14:18:00,14:18,7525275,13610925,6085650,BUY
2020-11-10 14:19:00,14:19,7281725,13335025,6053300,BUY
2020-11-10 14:20:00,14:20,7175150,13558275,6383125,BUY
2020-11-10 14:21:00,14:21,7568950,13581900,6012950,BUY
2020-11-10 14:22:00,14:22,7544100,13325125,5781025,BUY
2020-11-10 14:23:00,14:23,7254800,13352175,6097375,BUY
2020-11-10 14:24:00,14:24,7460050,13351325,5891275,BUY
2020-11-10 14:25:00,14:25,7787100,13300750,5513650,BUY
2020-11-10 14:26:00,14:26,7468900,13455975,5987075,BUY
2020-11-10 14:27:00,14:27,7360725,13452425,6091700,BUY
2020-11-10 14:28:00,14:28,7525800,13479350,5953550,BUY
2020-11-10 14:29:00,14:29,7434825,13502675,6067850,BUY
2020-11-10 14:30:00,14:30,7648275,13554925,5906650,BUY
2020-11-10 14:31:00,14:31,7594650,13298325,5703675,BUY
2020-11-10 14:32:00,14:32,7355850,13412775,6056925,BUY
2020-11-10 14:33:00,14:33,7364850,13413000,6048150,BUY
2020-11-10 14:34:00,14:34,7660300,13336825,5676525,BUY
2020-11-10 14:35:00,14:35,7563550,13239900,5676350,BUY
2020-11-10 14:36:00,14:36,7331250,13364350,6033100,BUY
2020-11-10 14:37:00,14:37,7289450,13109825,5820375,BUY
2020-11-10 14:38:00,14:38,7541900,13257875,5715975,BUY
2020-11-10 14:39:00,14:39,7477675,13478800,6001125,BUY
2020-11-10 14:40:00,14:40,7685325,13359850,5674525,BUY
2020-11-10 14:41:00,14:41,7220425,13214525,5994100,BUY
2020-11-10 14:42:00,14:42,7810900,13164700,5353800,BUY
2020-11-10 14:43:00,14:43,7701300,13432025,5730725,BUY
2020-11-10 14:44:00,14:44,7188650,13498950,6310300,BUY
2020-11-10 14:45:00,14:45,7459950,13412975,5953025,BUY
2020-11-10 14:46:00,14:46,7457425,13399900,5942475,BUY
2020-11-10 14:47:00,14:47,7582725,13370750,5788025,BUY
2020-11-10 14:48:00,14:48,7715525,13219275,5503750,BUY
2020-11-10 14:49:00,14:49,7789150,12993875,5204725,BUY
2020-11-10 14:50:00,14:50,7871525,13032150,5160625,BUY
2020-11-10 14:51:00,14:51,7708625,13371700,5663075,BUY
2020-11-10 14:52:00,14:52,7603850,13132025,5528175,BUY
2020-11-10 14:53:00,14:53,7764775,13393725,5628950,BUY
2020-11-10 14:54:00,14:54,7972550,13356725,5384175,BUY
2020-11-10 14:55:00,14:55,7646275,13330250,5683975,BUY
2020-11-10 14:56:00,14:56,7747825,13294825,5547000,BUY
2020-11-10 14:57:00,14:57,7831750,13321275,5489525,BUY
2020-11-10 14:58:00,14:58,8022700,13338350,5315650,BUY
2020-11-10 14:59:00,14:59,7850875,13271775,5420900,BUY
2020-11-10 15:00:00,15:00,7966975,13245450,5278475,BUY
2020-11-10 15:01:00,15:01,7909300,13214350,5305050,BUY
2020-11-10 15:02:00,15:02,8087900,13165625,5077725,BUY
2020-11-10 15:03:00,15:03,8108225,12864275,4756050,BUY
2020-11-10 15:04:00,15:04,7809125,12777150,4968025,BUY
2020-11-10 15:05:00,15:05,7786325,12754600,4968275,BUY
2020-11-10 15:06:00,15:06,7726075,12671300,4945225,BUY
2020-11-10 15:07:00,15:07,7790775,12751325,4960550,BUY
2020-11-10 15:08:00,15:08,7719350,12841225,5121875,BUY
2020-11-10 15:09:00,15:09,7580425,12662250,5081825,BUY
2020-11-10 15:10:00,15:10,7583125,12661950,5078825,BUY
2020-11-10 15:11:00,15:11,7856775,12445650,4588875,BUY
2020-11-10 15:12:00,15:12,7665675,12161225,4495550,BUY
2020-11-10 15:13:00,15:13,7762125,12602175,4840050,BUY
2020-11-10 15:14:00,15:14,7591050,12565925,4974875,BUY
2020-11-10 15:15:00,15:15,7735275,12457575,4722300,BUY
2020-11-10 15:16:00,15:16,7832500,12436250,4603750,BUY
2020-11-10 15:17:00,15:17,7643575,12455600,4812025,BUY
2020-11-10 15:18:00,15:18,7524075,12323700,4799625,BUY
2020-11-10 15:19:00,15:19,7484950,12318550,4833600,BUY
2020-11-10 15:20:00,15:20,7671775,12440500,4768725,BUY
2020-11-10 15:21:00,15:21,7671750,12449325,4777575,BUY
2020-11-10 15:22:00,15:22,7759850,12422850,4663000,BUY
2020-11-10 15:23:00,15:23,7577625,12355025,4777400,BUY
2020-11-10 15:24:00,15:24,7536375,12288700,4752325,BUY
2020-11-10 15:25:00,15:25,7842300,12234000,4391700,BUY
2020-11-10 15:26:00,15:26,7894075,12344625,4450550,BUY
2020-11-10 15:27:00,15:27,7445975,11969125,4523150,BUY
2020-11-10 15:28:00,15:28,7445175,11917775,4472600,BUY
2020-11-10 15:29:00,15:29,7423900,11939625,4515725,BUY
2020-11-11 09:15:00,09:15,6871400,11105225,4233825,BUY
2020-11-11 09:16:00,09:16,6629825,11134850,4505025,BUY
2020-11-11 09:17:00,09:17,6945425,11154150,4208725,BUY
2020-11-11 09:18:00,09:18,6698900,11089900,4391000,BUY
2020-11-11 09:19:00,09:19,6859350,11209450,4350100,BUY
2020-11-11 09:20:00,09:20,7026200,11253100,4226900,BUY
2020-11-11 09:21:00,09:21,6866825,11300200,4433375,BUY
2020-11-11 09:22:00,09:22,6765125,11257150,4492025,BUY
2020-11-11 09:23:00,09:23,6947125,11325100,4377975,BUY
2020-11-11 09:24:00,09:24,6939900,11293025,4353125,BUY
2020-11-11 09:25:00,09:25,6709325,10947375,4238050,BUY
2020-11-11 09:26:00,09:26,6795900,11456225,4660325,BUY
2020-11-11 09:27:00,09:27,6893650,11505850,4612200,BUY
2020-11-11 09:28:00,09:28,7086550,11469500,4382950,BUY
2020-11-11 09:29:00,09:29,6918700,11548925,4630225,BUY
2020-11-11 09:30:00,09:30,7003325,11611350,4608025,BUY
2020-11-11 09:31:00,09:31,6928450,11582450,4654000,BUY
2020-11-11 09:32:00,09:32,7235525,11778325,4542800,BUY
2020-11-11 09:33:00,09:33,7074425,11745150,4670725,BUY
2020-11-11 09:34:00,09:34,7090500,11781575,4691075,BUY
2020-11-11 09:35:00,09:35,7091525,11854375,4762850,BUY
2020-11-11 09:36:00,09:36,7218550,11732200,4513650,BUY
2020-11-11 09:37:00,09:37,6741750,11765350,5023600,BUY
2020-11-11 09:38:00,09:38,7124450,11817250,4692800,BUY
2020-11-11 09:39:00,09:39,6975925,11811525,4835600,BUY
2020-11-11 09:40:00,09:40,6977900,11857475,4879575,BUY
2020-11-11 09:41:00,09:41,7271100,11861550,4590450,BUY
2020-11-11 09:42:00,09:42,7241900,11784550,4542650,BUY
2020-11-11 09:43:00,09:43,7183000,11917425,4734425,BUY
2020-11-11 09:44:00,09:44,7365950,11967125,4601175,BUY
2020-11-11 09:45:00,09:45,7688925,12095825,4406900,BUY
2020-11-11 09:46:00,09:46,7420650,12095175,4674525,BUY
2020-11-11 09:47:00,09:47,7547525,12291325,4743800,BUY
2020-11-11 09:48:00,09:48,7502050,12203875,4701825,BUY
2020-11-11 09:49:00,09:49,7751300,12121350,4370050,BUY
2020-11-11 09:50:00,09:50,7615200,12244650,4629450,BUY
2020-11-11 09:51:00,09:51,7575400,12358575,4783175,BUY
2020-11-11 09:52:00,09:52,7449800,12332025,4882225,BUY
2020-11-11 09:53:00,09:53,7807600,12349950,4542350,BUY
2020-11-11 09:54:00,09:54,7824675,12207600,4382925,BUY
2020-11-11 09:55:00,09:55,7182050,12286225,5104175,BUY
2020-11-11 09:56:00,09:56,7752700,12229325,4476625,BUY
2020-11-11 09:57:00,09:57,8023800,12543025,4519225,BUY
2020-11-11 09:58:00,09:58,8236600,12527425,4290825,BUY
2020-11-11 09:59:00,09:59,8009825,12226875,4217050,BUY
2020-11-11 10:00:00,10:00,8122500,12376800,4254300,BUY
2020-11-11 10:01:00,10:01,8071150,12478950,4407800,BUY
2020-11-11 10:02:00,10:02,7695700,12560200,4864500,BUY
2020-11-11 10:03:00,10:03,7673900,12232875,4558975,BUY
2020-11-11 10:04:00,10:04,7615600,12554475,4938875,BUY
2020-11-11 10:05:00,10:05,7778525,12638125,4859600,BUY
2020-11-11 10:06:00,10:06,7788425,12862925,5074500,BUY
2020-11-11 10:07:00,10:07,7823000,12170450,4347450,BUY
2020-11-11 10:08:00,10:08,7672350,12599800,4927450,BUY
2020-11-11 10:09:00,10:09,7799600,12511325,4711725,BUY
2020-11-11 10:10:00,10:10,7925500,12694200,4768700,BUY
2020-11-11 10:11:00,10:11,7646400,12772875,5126475,BUY
2020-11-11 10:12:00,10:12,7701450,12574975,4873525,BUY
2020-11-11 10:13:00,10:13,7524550,12368650,4844100,BUY
2020-11-11 10:14:00,10:14,8007750,12675575,4667825,BUY
2020-11-11 10:15:00,10:15,7736300,12668350,4932050,BUY
2020-11-11 10:16:00,10:16,7782150,12599575,4817425,BUY
2020-11-11 10:17:00,10:17,7991325,12519875,4528550,BUY
2020-11-11 10:18:00,10:18,8051150,12927475,4876325,BUY
2020-11-11 10:19:00,10:19,7944125,12866850,4922725,BUY
2020-11-11 10:20:00,10:20,8556100,13149325,4593225,BUY
2020-11-11 10:21:00,10:21,8340675,13025650,4684975,BUY
2020-11-11 10:22:00,10:22,7981600,12660575,4678975,BUY
2020-11-11 10:23:00,10:23,8150275,13286125,5135850,BUY
2020-11-11 10:24:00,10:24,8055550,12909750,4854200,BUY
2020-11-11 10:25:00,10:25,7933325,12734275,4800950,BUY
2020-11-11 10:26:00,10:26,8340650,13412200,5071550,BUY
2020-11-11 10:27:00,10:27,8605725,13416925,4811200,BUY
2020-11-11 10:28:00,10:28,8388650,13118975,4730325,BUY
2020-11-11 10:29:00,10:29,8675725,13422450,4746725,BUY
2020-11-11 10:30:00,10:30,8979575,13735825,4756250,BUY
2020-11-11 10:31:00,10:31,8751400,13480100,4728700,BUY
2020-11-11 10:32:00,10:32,8520150,13401075,4880925,BUY
2020-11-11 10:33:00,10:33,8559525,13063350,4503825,BUY
2020-11-11 10:34:00,10:34,8533075,13575675,5042600,BUY
2020-11-11 10:35:00,10:35,8909875,13576775,4666900,BUY
2020-11-11 10:36:00,10:36,9205000,13664550,4459550,BUY
2020-11-11 10:37:00,10:37,9039775,13513650,4473875,BUY
2020-11-11 10:38:00,10:38,9035500,13541625,4506125,BUY
2020-11-11 10:39:00,10:39,9184875,13694200,4509325,BUY
2020-11-11 10:40:00,10:40,8959475,13695275,4735800,BUY
2020-11-11 10:41:00,10:41,9274050,13742775,4468725,BUY
2020-11-11 10:42:00,10:42,9233400,13664925,4431525,BUY
2020-11-11 10:43:00,10:43,9101425,13358725,4257300,BUY
2020-11-11 10:44:00,10:44,9263475,13778550,4515075,BUY
2020-11-11 10:45:00,10:45,9574275,13742000,4167725,BUY
2020-11-11 10:46:00,10:46,8932850,13482450,4549600,BUY
2020-11-11 10:47:00,10:47,9168475,13803550,4635075,BUY
2020-11-11 10:48:00,10:48,8977775,13362725,4384950,BUY
2020-11-11 10:49:00,10:49,9491100,13832225,4341125,BUY
2020-11-11 10:50:00,10:50,9322400,13637100,4314700,BUY
2020-11-11 10:51:00,10:51,8721675,13204400,4482725,BUY
2020-11-11 10:52:00,10:52,9206950,13272600,4065650,BUY
2020-11-11 10:53:00,10:53,8915200,13666800,4751600,BUY
2020-11-11 10:54:00,10:54,9252300,13748975,4496675,BUY
2020-11-11 10:55:00,10:55,8698275,13691075,4992800,BUY
2020-11-11 10:56:00,10:56,8809700,14286175,5476475,BUY
2020-11-11 10:57:00,10:57,8801250,13958600,5157350,BUY
2020-11-11 10:58:00,10:58,8828675,14013200,5184525,BUY
2020-11-11 10:59:00,10:59,8930100,14357875,5427775,BUY
2020-11-11 11:00:00,11:00,8541900,14375825,5833925,BUY
2020-11-11 11:01:00,11:01,8676325,13746075,5069750,BUY
2020-11-11 11:02:00,11:02,8487700,14197325,5709625,BUY
2020-11-11 11:03:00,11:03,8807800,13832125,5024325,BUY
2020-11-11 11:04:00,11:04,8882350,13857600,4975250,BUY
2020-11-11 11:05:00,11:05,8821675,14572325,5750650,BUY
2020-11-11 11:06:00,11:06,8660125,14356700,5696575,BUY
2020-11-11 11:07:00,11:07,8433450,13560100,5126650,BUY
2020-11-11 11:08:00,11:08,8673375,14334350,5660975,BUY
2020-11-11 11:09:00,11:09,8664200,14483100,5818900,BUY
2020-11-11 11:10:00,11:10,8706025,14434875,5728850,BUY
2020-11-11 11:11:00,11:11,8665000,13965950,5300950,BUY
2020-11-11 11:12:00,11:12,8724550,14462900,5738350,BUY
2020-11-11 11:13:00,11:13,8671875,14625600,5953725,BUY
2020-11-11 11:14:00,11:14,9335525,14865175,5529650,BUY
2020-11-11 11:15:00,11:15,9191850,14910025,5718175,BUY
2020-11-11 11:16:00,11:16,8774325,14804100,6029775,BUY
2020-11-11 11:17:00,11:17,8891425,14701825,5810400,BUY
2020-11-11 11:18:00,11:18,9076350,14881850,5805500,BUY
2020-11-11 11:19:00,11:19,8814150,14843375,6029225,BUY
2020-11-11 11:20:00,11:20,8801300,14790525,5989225,BUY
2020-11-11 11:21:00,11:21,9094700,14777325,5682625,BUY
2020-11-11 11:22:00,11:22,9111900,14684950,5573050,BUY
2020-11-11 11:23:00,11:23,8589525,14696525,6107000,BUY
2020-11-11 11:24:00,11:24,9127175,14886025,5758850,BUY
2020-11-11 11:25:00,11:25,8806375,14642450,5836075,BUY
2020-11-11 11:26:00,11:26,8716575,14650925,5934350,BUY
2020-11-11 11:27:00,11:27,9070300,14657825,5587525,BUY
2020-11-11 11:28:00,11:28,8969950,14554000,5584050,BUY
2020-11-11 11:29:00,11:29,8807950,14716450,5908500,BUY
2020-11-11 11:30:00,11:30,8724600,14620900,5896300,BUY
2020-11-11 11:31:00,11:31,8542775,14756850,6214075,BUY
2020-11-11 11:32:00,11:32,8952075,14745175,5793100,BUY
2020-11-11 11:33:00,11:33,8582275,14753125,6170850,BUY
2020-11-11 11:34:00,11:34,8364475,14472875,6108400,BUY
2020-11-11 11:35:00,11:35,9126725,14521875,5395150,BUY
2020-11-11 11:36:00,11:36,8653350,14659000,6005650,BUY
2020-11-11 11:37:00,11:37,8978600,14493475,5514875,BUY
2020-11-11 11:38:00,11:38,8469150,14579825,6110675,BUY
2020-11-11 11:39:00,11:39,8602275,14822375,6220100,BUY
2020-11-11 11:40:00,11:40,9060500,14775200,5714700,BUY
2020-11-11 11:41:00,11:41,9334625,14778300,5443675,BUY
2020-11-11 11:42:00,11:42,8720875,14772750,6051875,BUY
2020-11-11 11:43:00,11:43,8928675,14754850,5826175,BUY
2020-11-11 11:44:00,11:44,8595600,14847125,6251525,BUY
2020-11-11 11:45:00,11:45,8626625,14696300,6069675,BUY
2020-11-11 11:46:00,11:46,8764000,14827650,6063650,BUY
2020-11-11 11:47:00,11:47,8831025,14158750,5327725,BUY
2020-11-11 11:48:00,11:48,8913025,14541975,5628950,BUY
2020-11-11 11:49:00,11:49,8844200,14306625,5462425,BUY
2020-11-11 11:50:00,11:50,8707675,14502975,5795300,BUY
2020-11-11 11:51:00,11:51,8713950,14258025,5544075,BUY
2020-11-11 11:52:00,11:52,8637700,14128475,5490775,BUY
2020-11-11 11:53:00,11:53,8474975,14352475,5877500,BUY
2020-11-11 11:54:00,11:54,9167025,14479300,5312275,BUY
2020-11-11 11:55:00,11:55,9158250,14561550,5403300,BUY
2020-11-11 11:56:00,11:56,9135750,14321000,5185250,BUY
2020-11-11 11:57:00,11:57,8971925,14254625,5282700,BUY
2020-11-11 11:58:00,11:58,8983225,14523875,5540650,BUY
2020-11-11 11:59:00,11:59,8799150,14297225,5498075,BUY
2020-11-11 12:00:00,12:00,9005800,14377800,5372000,BUY
2020-11-11 12:01:00,12:01,9051850,14275450,5223600,BUY
2020-11-11 12:02:00,12:02,8504575,13946025,5441450,BUY
2020-11-11 12:03:00,12:03,8627325,13656675,5029350,BUY
2020-11-11 12:04:00,12:04,8663925,13713175,5049250,BUY
2020-11-11 12:05:00,12:05,8842675,13990475,5147800,BUY
2020-11-11 12:06:00,12:06,8951225,13678500,4727275,BUY
2020-11-11 12:07:00,12:07,8770725,14113275,5342550,BUY
2020-11-11 12:08:00,12:08,9046725,13752900,4706175,BUY
2020-11-11 12:09:00,12:09,8861350,13690775,4829425,BUY
2020-11-11 12:10:00,12:10,8796900,13740075,4943175,BUY
2020-11-11 12:11:00,12:11,8911275,13838550,4927275,BUY
2020-11-11 12:12:00,12:12,9124950,13921150,4796200,BUY
2020-11-11 12:13:00,12:13,8731325,13988825,5257500,BUY
2020-11-11 12:14:00,12:14,8928275,13833750,4905475,BUY
2020-11-11 12:15:00,12:15,9320750,13875675,4554925,BUY
2020-11-11 12:16:00,12:16,8921825,13752175,4830350,BUY
2020-11-11 12:17:00,12:17,9221475,13741075,4519600,BUY
2020-11-11 12:18:00,12:18,9188825,13554400,4365575,BUY
2020-11-11 12:19:00,12:19,9055175,13027025,3971850,BUY
2020-11-11 12:20:00,12:20,9001675,13462525,4460850,BUY
2020-11-11 12:21:00,12:21,8975275,13857350,4882075,BUY
2020-11-11 12:22:00,12:22,9098500,13636450,4537950,BUY
2020-11-11 12:23:00,12:23,9261100,14110725,4849625,BUY
2020-11-11 12:24:00,12:24,9343225,13989525,4646300,BUY
2020-11-11 12:25:00,12:25,8847950,13667475,4819525,BUY
2020-11-11 12:26:00,12:26,8987525,14099850,5112325,BUY
2020-11-11 12:27:00,12:27,8816150,14006200,5190050,BUY
2020-11-11 12:28:00,12:28,9079100,14105525,5026425,BUY
2020-11-11 12:29:00,12:29,9476850,14018075,4541225,BUY
2020-11-11 12:30:00,12:30,9165725,14198550,5032825,BUY
2020-11-11 12:31:00,12:31,9196750,13652600,4455850,BUY
2020-11-11 12:32:00,12:32,9221225,13708850,4487625,BUY
2020-11-11 12:33:00,12:33,9193850,14054125,4860275,BUY
2020-11-11 12:34:00,12:34,9186325,14162500,4976175,BUY
2020-11-11 12:35:00,12:35,9255675,13768700,4513025,BUY
2020-11-11 12:36:00,12:36,9353700,13838675,4484975,BUY
2020-11-11 12:37:00,12:37,9441925,13989100,4547175,BUY
2020-11-11 12:38:00,12:38,9254025,13943925,4689900,BUY
2020-11-11 12:39:00,12:39,9331850,13930650,4598800,BUY
2020-11-11 12:40:00,12:40,9236325,13674150,4437825,BUY
2020-11-11 12:41:00,12:41,8920450,13891550,4971100,BUY
2020-11-11 12:42:00,12:42,9285525,13779075,4493550,BUY
2020-11-11 12:43:00,12:43,9202725,13914075,4711350,BUY
2020-11-11 12:44:00,12:44,9145800,13628350,4482550,BUY
2020-11-11 12:45:00,12:45,9288300,13556725,4268425,BUY
2020-11-11 12:46:00,12:46,8709600,13654125,4944525,BUY
2020-11-11 12:47:00,12:47,9330525,13556275,4225750,BUY
2020-11-11 12:48:00,12:48,9099200,13672100,4572900,BUY
2020-11-11 12:49:00,12:49,9216500,13629750,4413250,BUY
2020-11-11 12:50:00,12:50,9263450,13468375,4204925,BUY
2020-11-11 12:51:00,12:51,9363700,13680250,4316550,BUY
2020-11-11 12:52:00,12:52,9074850,13450950,4376100,BUY
2020-11-11 12:53:00,12:53,8764750,13159000,4394250,BUY
2020-11-11 12:54:00,12:54,9113525,13805500,4691975,BUY
2020-11-11 12:55:00,12:55,9264350,13048250,3783900,BUY
2020-11-11 12:56:00,12:56,8806525,14070050,5263525,BUY
2020-11-11 12:57:00,12:57,9685400,13901975,4216575,BUY
2020-11-11 12:58:00,12:58,9744500,14103675,4359175,BUY
2020-11-11 12:59:00,12:59,9434600,14082750,4648150,BUY
2020-11-11 13:00:00,13:00,9305400,14180275,4874875,BUY
2020-11-11 13:01:00,13:01,9363550,13853925,4490375,BUY
2020-11-11 13:02:00,13:02,9061500,13565275,4503775,BUY
2020-11-11 13:03:00,13:03,8986725,13763300,4776575,BUY
2020-11-11 13:04:00,13:04,8607425,13572925,4965500,BUY
2020-11-11 13:05:00,13:05,9106450,14067025,4960575,BUY
2020-11-11 13:06:00,13:06,9629250,14139750,4510500,BUY
2020-11-11 13:07:00,13:07,9295500,14172375,4876875,BUY
2020-11-11 13:08:00,13:08,9233025,13828275,4595250,BUY
2020-11-11 13:09:00,13:09,9176450,13931650,4755200,BUY
2020-11-11 13:10:00,13:10,9229825,14214900,4985075,BUY
2020-11-11 13:11:00,13:11,9308900,13776975,4468075,BUY
2020-11-11 13:12:00,13:12,9651175,14058325,4407150,BUY
2020-11-11 13:13:00,13:13,9684950,13745900,4060950,BUY
2020-11-11 13:14:00,13:14,9717450,14079075,4361625,BUY
2020-11-11 13:15:00,13:15,9671950,14109550,4437600,BUY
2020-11-11 13:16:00,13:16,9856325,13745600,3889275,BUY
2020-11-11 13:17:00,13:17,9726350,14033250,4306900,BUY
2020-11-11 13:18:00,13:18,9974350,13969925,3995575,BUY
2020-11-11 13:19:00,13:19,9792175,14156900,4364725,BUY
2020-11-11 13:20:00,13:20,9659950,13600075,3940125,BUY
2020-11-11 13:21:00,13:21,9642500,14040125,4397625,BUY
2020-11-11 13:22:00,13:22,9540750,13940725,4399975,BUY
2020-11-11 13:23:00,13:23,9582225,14211250,4629025,BUY
2020-11-11 13:24:00,13:24,9507150,13720975,4213825,BUY
2020-11-11 13:25:00,13:25,9356200,14199450,4843250,BUY
2020-11-11 13:26:00,13:26,9609700,14218500,4608800,BUY
2020-11-11 13:27:00,13:27,9519550,14138100,4618550,BUY
2020-11-11 13:28:00,13:28,9573800,14071000,4497200,BUY
2020-11-11 13:29:00,13:29,9701400,13398200,3696800,BUY
2020-11-11 13:30:00,13:30,9495050,14144625,4649575,BUY
2020-11-11 13:31:00,13:31,9931825,14111500,4179675,BUY
2020-11-11 13:32:00,13:32,9916275,14213700,4297425,BUY
2020-11-11 13:33:00,13:33,10056800,14132650,4075850,BUY
2020-11-11 13:34:00,13:34,9943950,13971675,4027725,BUY
2020-11-11 13:35:00,13:35,10054625,14164750,4110125,BUY
2020-11-11 13:36:00,13:36,9686900,14089675,4402775,BUY
2020-11-11 13:37:00,13:37,9573550,13782025,4208475,BUY
2020-11-11 13:38:00,13:38,9720225,14069225,4349000,BUY
2020-11-11 13:39:00,13:39,9919450,13905525,3986075,BUY
2020-11-11 13:40:00,13:40,9721950,14190650,4468700,BUY
2020-11-11 13:41:00,13:41,9615375,13882600,4267225,BUY
2020-11-11 13:42:00,13:42,9837925,14004900,4166975,BUY
2020-11-11 13:43:00,13:43,9428700,14047925,4619225,BUY
2020-11-11 13:44:00,13:44,9547325,14240525,4693200,BUY
2020-11-11 13:45:00,13:45,9619625,14172775,4553150,BUY
2020-11-11 13:46:00,13:46,9873650,14299500,4425850,BUY
2020-11-11 13:47:00,13:47,9221025,14031925,4810900,BUY
2020-11-11 13:48:00,13:48,9664350,14044500,4380150,BUY
2020-11-11 13:49:00,13:49,9245650,14128550,4882900,BUY
2020-11-11 13:50:00,13:50,9629975,14171675,4541700,BUY
2020-11-11 13:51:00,13:51,10143825,14280950,4137125,BUY
2020-11-11 13:52:00,13:52,9993675,14026800,4033125,BUY
2020-11-11 13:53:00,13:53,9760800,14371325,4610525,BUY
2020-11-11 13:54:00,13:54,9598575,13955975,4357400,BUY
2020-11-11 13:55:00,13:55,9905150,14167275,4262125,BUY
2020-11-11 13:56:00,13:56,9563400,14027800,4464400,BUY
2020-11-11 13:57:00,13:57,9995975,12978500,2982525,BUY
2020-11-11 13:58:00,13:58,9727225,13707200,3979975,BUY
2020-11-11 13:59:00,13:59,9240775,13799300,4558525,BUY
2020-11-11 14:00:00,14:00,9783550,13917925,4134375,BUY
2020-11-11 14:01:00,14:01,9792650,14103450,4310800,BUY
2020-11-11 14:02:00,14:02,10192325,14177775,3985450,BUY
2020-11-11 14:03:00,14:03,10179575,13931675,3752100,BUY
2020-11-11 14:04:00,14:04,10071250,14090000,4018750,BUY
2020-11-11 14:05:00,14:05,9939600,14053900,4114300,BUY
2020-11-11 14:06:00,14:06,10344800,13454275,3109475,BUY
2020-11-11 14:07:00,14:07,10118925,12907150,2788225,BUY
2020-11-11 14:08:00,14:08,10113825,13621425,3507600,BUY
2020-11-11 14:09:00,14:09,10494250,13694025,3199775,BUY
2020-11-11 14:10:00,14:10,10635725,13778425,3142700,BUY
2020-11-11 14:11:00,14:11,10126100,13604975,3478875,BUY
2020-11-11 14:12:00,14:12,10256300,13436550,3180250,BUY
2020-11-11 14:13:00,14:13,9978225,12838750,2860525,BUY
2020-11-11 14:14:00,14:14,10258275,13233050,2974775,BUY
2020-11-11 14:15:00,14:15,10678900,13096050,2417150,BUY
2020-11-11 14:16:00,14:16,10292875,13075075,2782200,BUY
2020-11-11 14:17:00,14:17,10296750,13255700,2958950,BUY
2020-11-11 14:18:00,14:18,10412875,13506850,3093975,BUY
2020-11-11 14:19:00,14:19,10554625,13485725,2931100,BUY
2020-11-11 14:20:00,14:20,10477050,13261875,2784825,BUY
2020-11-11 14:21:00,14:21,10463900,13171550,2707650,BUY
2020-11-11 14:22:00,14:22,10649875,13224950,2575075,BUY
2020-11-11 14:23:00,14:23,10330900,13445850,3114950,BUY
2020-11-11 14:24:00,14:24,10689025,13255975,2566950,BUY
2020-11-11 14:25:00,14:25,10360500,13635625,3275125,BUY
2020-11-11 14:26:00,14:26,10586300,13345325,2759025,BUY
2020-11-11 14:27:00,14:27,10439950,13846825,3406875,BUY
2020-11-11 14:28:00,14:28,10996075,13882000,2885925,BUY
2020-11-11 14:29:00,14:29,10471175,13829625,3358450,BUY
2020-11-11 14:30:00,14:30,10485825,13627175,3141350,BUY
2020-11-11 14:31:00,14:31,10506675,13666650,3159975,BUY
2020-11-11 14:32:00,14:32,10320275,13526775,3206500,BUY
2020-11-11 14:33:00,14:33,10251525,13698225,3446700,BUY
2020-11-11 14:34:00,14:34,10288925,13851300,3562375,BUY
2020-11-11 14:35:00,14:35,10485700,13691575,3205875,BUY
2020-11-11 14:36:00,14:36,9923075,13807400,3884325,BUY
2020-11-11 14:37:00,14:37,10008600,14105100,4096500,BUY
2020-11-11 14:38:00,14:38,10537075,14063300,3526225,BUY
2020-11-11 14:39:00,14:39,10342200,13785575,3443375,BUY
2020-11-11 14:40:00,14:40,10382750,13796875,3414125,BUY
2020-11-11 14:41:00,14:41,10232125,14080450,3848325,BUY
2020-11-11 14:42:00,14:42,9848500,13643750,3795250,BUY
2020-11-11 14:43:00,14:43,9847400,14031925,4184525,BUY
2020-11-11 14:44:00,14:44,9971850,13969175,3997325,BUY
2020-11-11 14:45:00,14:45,10195950,14028050,3832100,BUY
2020-11-11 14:46:00,14:46,9991075,13929850,3938775,BUY
2020-11-11 14:47:00,14:47,10032200,13935525,3903325,BUY
2020-11-11 14:48:00,14:48,9769200,13798600,4029400,BUY
2020-11-11 14:49:00,14:49,9973700,13924125,3950425,BUY
2020-11-11 14:50:00,14:50,9887400,13853675,3966275,BUY
2020-11-11 14:51:00,14:51,9645125,13970725,4325600,BUY
2020-11-11 14:52:00,14:52,10000775,13857425,3856650,BUY
2020-11-11 14:53:00,14:53,9634100,13980525,4346425,BUY
2020-11-11 14:54:00,14:54,9797300,13506775,3709475,BUY
2020-11-11 14:55:00,14:55,10198625,13633300,3434675,BUY
2020-11-11 14:56:00,14:56,10070250,13798300,3728050,BUY
2020-11-11 14:57:00,14:57,9937350,13943725,4006375,BUY
2020-11-11 14:58:00,14:58,9811250,13754200,3942950,BUY
2020-11-11 14:59:00,14:59,9877450,13699125,3821675,BUY
2020-11-11 15:00:00,15:00,9947950,13916825,3968875,BUY
2020-11-11 15:01:00,15:01,10082925,13995050,3912125,BUY
2020-11-11 15:02:00,15:02,9629125,13480500,3851375,BUY
2020-11-11 15:03:00,15:03,9147625,13489100,4341475,BUY
2020-11-11 15:04:00,15:04,9511700,13899525,4387825,BUY
2020-11-11 15:05:00,15:05,9539050,13903600,4364550,BUY
2020-11-11 15:06:00,15:06,9348450,13847200,4498750,BUY
2020-11-11 15:07:00,15:07,9379225,13936000,4556775,BUY
2020-11-11 15:08:00,15:08,9521800,13886250,4364450,BUY
2020-11-11 15:09:00,15:09,9371750,13953175,4581425,BUY
2020-11-11 15:10:00,15:10,9494400,14006350,4511950,BUY
2020-11-11 15:11:00,15:11,9374525,13980425,4605900,BUY
2020-11-11 15:12:00,15:12,9182325,13961150,4778825,BUY
2020-11-11 15:13:00,15:13,9762550,13965625,4203075,BUY
2020-11-11 15:14:00,15:14,9298675,13966975,4668300,BUY
2020-11-11 15:15:00,15:15,9632100,14087850,4455750,BUY
2020-11-11 15:16:00,15:16,9780375,14017900,4237525,BUY
2020-11-11 15:17:00,15:17,9803525,13998800,4195275,BUY
2020-11-11 15:18:00,15:18,9486300,14170400,4684100,BUY
2020-11-11 15:19:00,15:19,9349500,14113275,4763775,BUY
2020-11-11 15:20:00,15:20,9502950,14113125,4610175,BUY
2020-11-11 15:21:00,15:21,9304175,14010825,4706650,BUY
2020-11-11 15:22:00,15:22,9413400,14019700,4606300,BUY
2020-11-11 15:23:00,15:23,9301600,13951325,4649725,BUY
2020-11-11 15:24:00,15:24,9085100,13603000,4517900,BUY
2020-11-11 15:25:00,15:25,9501625,13646150,4144525,BUY
2020-11-11 15:26:00,15:26,9207275,13744375,4537100,BUY
2020-11-11 15:27:00,15:27,9497025,13831300,4334275,BUY
2020-11-11 15:28:00,15:28,9379125,13780250,4401125,BUY
2020-11-11 15:29:00,15:29,9462550,13852350,4389800,BUY
2020-11-12 09:15:00,09:15,6646200,12027975,5381775,BUY
2020-11-12 09:16:00,09:16,7523675,12316825,4793150,BUY
2020-11-12 09:17:00,09:17,7786775,12207375,4420600,BUY
2020-11-12 09:18:00,09:18,7728925,12376775,4647850,BUY
2020-11-12 09:19:00,09:19,7732225,12344600,4612375,BUY
2020-11-12 09:20:00,09:20,8058950,12453275,4394325,BUY
2020-11-12 09:21:00,09:21,7965500,12296575,4331075,BUY
2020-11-12 09:22:00,09:22,7891975,12454400,4562425,BUY
2020-11-12 09:23:00,09:23,7791075,12338825,4547750,BUY
2020-11-12 09:24:00,09:24,7951375,12407825,4456450,BUY
2020-11-12 09:25:00,09:25,8082650,12450075,4367425,BUY
2020-11-12 09:26:00,09:26,7798300,12434475,4636175,BUY
2020-11-12 09:27:00,09:27,7826925,12442575,4615650,BUY
2020-11-12 09:28:00,09:28,7809275,12239450,4430175,BUY
2020-11-12 09:29:00,09:29,8045525,12348525,4303000,BUY
2020-11-12 09:30:00,09:30,8039625,12428950,4389325,BUY
2020-11-12 09:31:00,09:31,7925200,12475025,4549825,BUY
2020-11-12 09:32:00,09:32,7972850,12502025,4529175,BUY
2020-11-12 09:33:00,09:33,8043700,12508175,4464475,BUY
2020-11-12 09:34:00,09:34,8308875,12303150,3994275,BUY
2020-11-12 09:35:00,09:35,8053200,12080075,4026875,BUY
2020-11-12 09:36:00,09:36,8421625,12308625,3887000,BUY
2020-11-12 09:37:00,09:37,8497575,12279450,3781875,BUY
2020-11-12 09:38:00,09:38,8198250,12558600,4360350,BUY
2020-11-12 09:39:00,09:39,8157850,12564725,4406875,BUY
2020-11-12 09:40:00,09:40,8555575,12610375,4054800,BUY
2020-11-12 09:41:00,09:41,8138400,12410950,4272550,BUY
2020-11-12 09:42:00,09:42,8515600,12512925,3997325,BUY
2020-11-12 09:43:00,09:43,8356450,12663575,4307125,BUY
2020-11-12 09:44:00,09:44,8688400,12817350,4128950,BUY
2020-11-12 09:45:00,09:45,8901775,12877125,3975350,BUY
2020-11-12 09:46:00,09:46,8659925,12853650,4193725,BUY
2020-11-12 09:47:00,09:47,8870950,12941625,4070675,BUY
2020-11-12 09:48:00,09:48,8649575,12885425,4235850,BUY
2020-11-12 09:49:00,09:49,8915100,12928175,4013075,BUY
2020-11-12 09:50:00,09:50,9212000,13008750,3796750,BUY
2020-11-12 09:51:00,09:51,9242550,12924350,3681800,BUY
2020-11-12 09:52:00,09:52,9112075,13248125,4136050,BUY
2020-11-12 09:53:00,09:53,9680400,13351200,3670800,BUY
2020-11-12 09:54:00,09:54,9445375,12993500,3548125,BUY
2020-11-12 09:55:00,09:55,9269350,12952925,3683575,BUY
2020-11-12 09:56:00,09:56,9825425,13333575,3508150,BUY
2020-11-12 09:57:00,09:57,9847025,13697000,3849975,BUY
2020-11-12 09:58:00,09:58,9717500,12919050,3201550,BUY
2020-11-12 09:59:00,09:59,10366675,13493100,3126425,BUY
2020-11-12 10:00:00,10:00,10412475,13781975,3369500,BUY
2020-11-12 10:01:00,10:01,10311875,13546625,3234750,BUY
2020-11-12 10:02:00,10:02,10390450,13276550,2886100,BUY
2020-11-12 10:03:00,10:03,10824650,13749950,2925300,BUY
2020-11-12 10:04:00,10:04,10993975,13499350,2505375,BUY
2020-11-12 10:05:00,10:05,10727875,14018850,3290975,BUY
2020-11-12 10:06:00,10:06,11192525,14130250,2937725,BUY
2020-11-12 10:07:00,10:07,11427000,14187700,2760700,BUY
2020-11-12 10:08:00,10:08,11721075,13589400,1868325,BUY
2020-11-12 10:09:00,10:09,11856325,14036550,2180225,BUY
2020-11-12 10:10:00,10:10,11978900,14102650,2123750,BUY
2020-11-12 10:11:00,10:11,12587600,14689575,2101975,BUY
2020-11-12 10:12:00,10:12,12305325,14811100,2505775,BUY
2020-11-12 10:13:00,10:13,12300625,14733050,2432425,BUY
2020-11-12 10:14:00,10:14,13278950,14993225,1714275,BUY
2020-11-12 10:15:00,10:15,13376950,14958800,1581850,BUY
2020-11-12 10:16:00,10:16,13205050,14508875,1303825,BUY
2020-11-12 10:17:00,10:17,13920350,14575800,655450,BUY
2020-11-12 10:18:00,10:18,13917250,15351875,1434625,BUY
2020-11-12 10:19:00,10:19,13765825,15650650,1884825,BUY
2020-11-12 10:20:00,10:20,14605375,14874000,268625,BUY
2020-11-12 10:21:00,10:21,14628075,14997200,369125,BUY
2020-11-12 10:22:00,10:22,14640975,14772350,131375,BUY
2020-11-12 10:23:00,10:23,14756400,14992050,235650,BUY
2020-11-12 10:24:00,10:24,14835925,15166550,330625,BUY
2020-11-12 10:25:00,10:25,15324200,15005525,-318675,SELL
2020-11-12 10:26:00,10:26,14561825,14248950,-312875,SELL
2020-11-12 10:27:00,10:27,15016025,14315600,-700425,SELL
2020-11-12 10:28:00,10:28,15392250,14714875,-677375,SELL
2020-11-12 10:29:00,10:29,15538775,14146275,-1392500,SELL
2020-11-12 10:30:00,10:30,15307300,14769475,-537825,SELL
2020-11-12 10:31:00,10:31,15824150,14622825,-1201325,SELL
2020-11-12 10:32:00,10:32,15876850,14190725,-1686125,SELL
2020-11-12 10:33:00,10:33,15651850,13403400,-2248450,SELL
2020-11-12 10:34:00,10:34,15205600,14450075,-755525,SELL
2020-11-12 10:35:00,10:35,15699075,15104150,-594925,SELL
2020-11-12 10:36:00,10:36,15897400,15297425,-599975,SELL
2020-11-12 10:37:00,10:37,16055600,14645775,-1409825,SELL
2020-11-12 10:38:00,10:38,16061350,14929150,-1132200,SELL
2020-11-12 10:39:00,10:39,16220250,15318375,-901875,SELL
2020-11-12 10:40:00,10:40,16398250,15018050,-1380200,SELL
2020-11-12 10:41:00,10:41,15775100,15833600,58500,BUY
2020-11-12 10:42:00,10:42,15738000,15386800,-351200,SELL
2020-11-12 10:43:00,10:43,16271125,15470950,-800175,SELL
2020-11-12 10:44:00,10:44,16150800,16123575,-27225,SELL
2020-11-12 10:45:00,10:45,16214575,15929500,-285075,SELL
2020-11-12 10:46:00,10:46,16122550,15532000,-590550,SELL
2020-11-12 10:47:00,10:47,16846125,16241550,-604575,SELL
2020-11-12 10:48:00,10:48,16628825,15311725,-1317100,SELL
2020-11-12 10:49:00,10:49,16517300,15593350,-923950,SELL
2020-11-12 10:50:00,10:50,16688600,15593900,-1094700,SELL
2020-11-12 10:51:00,10:51,17045000,16002975,-1042025,SELL
2020-11-12 10:52:00,10:52,16909325,16117800,-791525,SELL
2020-11-12 10:53:00,10:53,17075300,15957050,-1118250,SELL
2020-11-12 10:54:00,10:54,17140500,16512400,-628100,SELL
2020-11-12 10:55:00,10:55,16734600,15845150,-889450,SELL
2020-11-12 10:56:00,10:56,17035550,16547825,-487725,SELL
2020-11-12 10:57:00,10:57,16754125,15374525,-1379600,SELL
2020-11-12 10:58:00,10:58,16719200,15674900,-1044300,SELL
2020-11-12 10:59:00,10:59,17013000,15746350,-1266650,SELL
2020-11-12 11:00:00,11:00,17115025,16127475,-987550,SELL
2020-11-12 11:01:00,11:01,16919000,16218325,-700675,SELL
2020-11-12 11:02:00,11:02,16916200,16102600,-813600,SELL
2020-11-12 11:03:00,11:03,16894225,16791350,-102875,SELL
2020-11-12 11:04:00,11:04,16935400,15800525,-1134875,SELL
2020-11-12 11:05:00,11:05,16876825,16362550,-514275,SELL
2020-11-12 11:06:00,11:06,16989175,16214600,-774575,SELL
2020-11-12 11:07:00,11:07,16951150,16143225,-807925,SELL
2020-11-12 11:08:00,11:08,17720850,16409375,-1311475,SELL
2020-11-12 11:09:00,11:09,17446100,14749975,-2696125,SELL
2020-11-12 11:10:00,11:10,17584075,16144800,-1439275,SELL
2020-11-12 11:11:00,11:11,17798125,16503600,-1294525,SELL
2020-11-12 11:12:00,11:12,17537225,16091400,-1445825,SELL
2020-11-12 11:13:00,11:13,17698200,16315025,-1383175,SELL
2020-11-12 11:14:00,11:14,17918050,16744200,-1173850,SELL
2020-11-12 11:15:00,11:15,17375575,16442425,-933150,SELL
2020-11-12 11:16:00,11:16,17400600,16124925,-1275675,SELL
2020-11-12 11:17:00,11:17,18048200,15739050,-2309150,SELL
2020-11-12 11:18:00,11:18,18031375,17045775,-985600,SELL
2020-11-12 11:19:00,11:19,17909850,16882525,-1027325,SELL
2020-11-12 11:20:00,11:20,17834950,16261550,-1573400,SELL
2020-11-12 11:21:00,11:21,17916075,16182825,-1733250,SELL
2020-11-12 11:22:00,11:22,17749650,16936250,-813400,SELL
2020-11-12 11:23:00,11:23,17835525,16137050,-1698475,SELL
2020-11-12 11:24:00,11:24,17943575,16924650,-1018925,SELL
2020-11-12 11:25:00,11:25,17947225,16295175,-1652050,SELL
2020-11-12 11:26:00,11:26,18350050,17056900,-1293150,SELL
2020-11-12 11:27:00,11:27,18236500,16394275,-1842225,SELL
2020-11-12 11:28:00,11:28,17727825,15893875,-1833950,SELL
2020-11-12 11:29:00,11:29,18620400,16138025,-2482375,SELL
2020-11-12 11:30:00,11:30,18617025,16551875,-2065150,SELL
2020-11-12 11:31:00,11:31,18510875,16290250,-2220625,SELL
2020-11-12 11:32:00,11:32,18646125,16653000,-1993125,SELL
2020-11-12 11:33:00,11:33,18468550,17006025,-1462525,SELL
2020-11-12 11:34:00,11:34,18547925,16541725,-2006200,SELL
2020-11-12 11:35:00,11:35,18718450,17186850,-1531600,SELL
2020-11-12 11:36:00,11:36,18254625,16570775,-1683850,SELL
2020-11-12 11:37:00,11:37,18267225,16733025,-1534200,SELL
2020-11-12 11:38:00,11:38,18519375,16851400,-1667975,SELL
2020-11-12 11:39:00,11:39,18385550,17420675,-964875,SELL
2020-11-12 11:40:00,11:40,18256700,16412525,-1844175,SELL
2020-11-12 11:41:00,11:41,18089300,17039925,-1049375,SELL
2020-11-12 11:42:00,11:42,18281000,15868275,-2412725,SELL
2020-11-12 11:43:00,11:43,18430925,17200700,-1230225,SELL
2020-11-12 11:44:00,11:44,18432350,17186050,-1246300,SELL
2020-11-12 11:45:00,11:45,18703325,17289700,-1413625,SELL
2020-11-12 11:46:00,11:46,18514475,16474300,-2040175,SELL
2020-11-12 11:47:00,11:47,18496325,15985025,-2511300,SELL
2020-11-12 11:48:00,11:48,18829550,16523725,-2305825,SELL
2020-11-12 11:49:00,11:49,18824600,16314575,-2510025,SELL
2020-11-12 11:50:00,11:50,18589175,16952375,-1636800,SELL
2020-11-12 11:51:00,11:51,18792700,16600025,-2192675,SELL
2020-11-12 11:52:00,11:52,18692725,15637400,-3055325,SELL
2020-11-12 11:53:00,11:53,19529875,17475025,-2054850,SELL
2020-11-12 11:54:00,11:54,18653600,16365700,-2287900,SELL
2020-11-12 11:55:00,11:55,19086425,16624025,-2462400,SELL
2020-11-12 11:56:00,11:56,19607450,17138175,-2469275,SELL
2020-11-12 11:57:00,11:57,19164400,15776225,-3388175,SELL
2020-11-12 11:58:00,11:58,18937375,15930350,-3007025,SELL
2020-11-12 11:59:00,11:59,18555700,16218850,-2336850,SELL
2020-11-12 12:00:00,12:00,18900150,16111075,-2789075,SELL
2020-11-12 12:01:00,12:01,18830000,16363100,-2466900,SELL
2020-11-12 12:02:00,12:02,18984250,16411675,-2572575,SELL
2020-11-12 12:03:00,12:03,19243650,16835075,-2408575,SELL
2020-11-12 12:04:00,12:04,19201950,16505800,-2696150,SELL
2020-11-12 12:05:00,12:05,19391475,16777150,-2614325,SELL
2020-11-12 12:06:00,12:06,19057950,16786700,-2271250,SELL
2020-11-12 12:07:00,12:07,19202250,17074800,-2127450,SELL
2020-11-12 12:08:00,12:08,19279075,16717550,-2561525,SELL
2020-11-12 12:09:00,12:09,19341775,16145450,-3196325,SELL
2020-11-12 12:10:00,12:10,19401725,16786450,-2615275,SELL
2020-11-12 12:11:00,12:11,19333000,16833475,-2499525,SELL
2020-11-12 12:12:00,12:12,19433600,16717375,-2716225,SELL
2020-11-12 12:13:00,12:13,19211700,16476400,-2735300,SELL
2020-11-12 12:14:00,12:14,19371575,16348275,-3023300,SELL
2020-11-12 12:15:00,12:15,19679200,16973650,-2705550,SELL
2020-11-12 12:16:00,12:16,20315950,17457350,-2858600,SELL
2020-11-12 12:17:00,12:17,20026850,16362550,-3664300,SELL
2020-11-12 12:18:00,12:18,20166275,16182525,-3983750,SELL
2020-11-12 12:19:00,12:19,19900125,16575175,-3324950,SELL
2020-11-12 12:20:00,12:20,20173675,16423275,-3750400,SELL
2020-11-12 12:21:00,12:21,20015850,16165625,-3850225,SELL
2020-11-12 12:22:00,12:22,19813225,16190950,-3622275,SELL
2020-11-12 12:23:00,12:23,19772550,16135200,-3637350,SELL
2020-11-12 12:24:00,12:24,19893050,16691175,-3201875,SELL
2020-11-12 12:25:00,12:25,20148875,16319750,-3829125,SELL
2020-11-12 12:26:00,12:26,20084375,16367900,-3716475,SELL
2020-11-12 12:27:00,12:27,20085625,16579850,-3505775,SELL
2020-11-12 12:28:00,12:28,20296450,16243775,-4052675,SELL
2020-11-12 12:29:00,12:29,20250025,15550475,-4699550,SELL
2020-11-12 12:30:00,12:30,20374375,16126475,-4247900,SELL
2020-11-12 12:31:00,12:31,20386200,16719950,-3666250,SELL
2020-11-12 12:32:00,12:32,19065175,16464825,-2600350,SELL
2020-11-12 12:33:00,12:33,19260450,16514850,-2745600,SELL
2020-11-12 12:34:00,12:34,19088875,16048175,-3040700,SELL
2020-11-12 12:35:00,12:35,19454525,16283050,-3171475,SELL
2020-11-12 12:36:00,12:36,19217250,15832175,-3385075,SELL
2020-11-12 12:37:00,12:37,19369850,16193500,-3176350,SELL
2020-11-12 12:38:00,12:38,19320225,15525800,-3794425,SELL
2020-11-12 12:39:00,12:39,19448650,16153575,-3295075,SELL
2020-11-12 12:40:00,12:40,19671925,16186450,-3485475,SELL
2020-11-12 12:41:00,12:41,19769550,16255200,-3514350,SELL
2020-11-12 12:42:00,12:42,19642550,16304900,-3337650,SELL
2020-11-12 12:43:00,12:43,19522500,16335275,-3187225,SELL
2020-11-12 12:44:00,12:44,19538875,16628525,-2910350,SELL
2020-11-12 12:45:00,12:45,19506375,16170175,-3336200,SELL
2020-11-12 12:46:00,12:46,20030425,16427000,-3603425,SELL
2020-11-12 12:47:00,12:47,19838950,16056700,-3782250,SELL
2020-11-12 12:48:00,12:48,19569900,15974600,-3595300,SELL
2020-11-12 12:49:00,12:49,19571425,16107175,-3464250,SELL
2020-11-12 12:50:00,12:50,19792225,15988125,-3804100,SELL
2020-11-12 12:51:00,12:51,19605800,15616125,-3989675,SELL
2020-11-12 12:52:00,12:52,19632200,15734325,-3897875,SELL
2020-11-12 12:53:00,12:53,19837100,15266750,-4570350,SELL
2020-11-12 12:54:00,12:54,19559275,15124650,-4434625,SELL
2020-11-12 12:55:00,12:55,19663450,14773000,-4890450,SELL
2020-11-12 12:56:00,12:56,19838700,16517975,-3320725,SELL
2020-11-12 12:57:00,12:57,19931050,16177425,-3753625,SELL
2020-11-12 12:58:00,12:58,19534425,15541375,-3993050,SELL
2020-11-12 12:59:00,12:59,19489550,16126475,-3363075,SELL
2020-11-12 13:00:00,13:00,19819275,16307850,-3511425,SELL
2020-11-12 13:01:00,13:01,19996925,16384675,-3612250,SELL
2020-11-12 13:02:00,13:02,19652550,15971000,-3681550,SELL
2020-11-12 13:03:00,13:03,19695350,16537625,-3157725,SELL
2020-11-12 13:04:00,13:04,20074900,16556675,-3518225,SELL
2020-11-12 13:05:00,13:05,19768200,16063900,-3704300,SELL
2020-11-12 13:06:00,13:06,19722950,15904725,-3818225,SELL
2020-11-12 13:07:00,13:07,19829275,16309550,-3519725,SELL
2020-11-12 13:08:00,13:08,19522375,16630125,-2892250,SELL
2020-11-12 13:13:00,13:13,19977025,15941200,-4035825,SELL
2020-11-12 13:14:00,13:14,20213475,16175425,-4038050,SELL
2020-11-12 13:15:00,13:15,20265325,16571675,-3693650,SELL
2020-11-12 13:16:00,13:16,20774675,16848875,-3925800,SELL
2020-11-12 13:17:00,13:17,20374075,16531625,-3842450,SELL
2020-11-12 13:18:00,13:18,20926975,17201575,-3725400,SELL
2020-11-12 13:19:00,13:19,20716475,16907525,-3808950,SELL
2020-11-12 13:20:00,13:20,20509725,16734100,-3775625,SELL
2020-11-12 13:21:00,13:21,20887050,16975250,-3911800,SELL
2020-11-12 13:22:00,13:22,20638975,16199050,-4439925,SELL
2020-11-12 13:27:00,13:27,21207750,17219100,-3988650,SELL
2020-11-12 13:28:00,13:28,21160500,17263925,-3896575,SELL
2020-11-12 13:29:00,13:29,21050075,17262500,-3787575,SELL
2020-11-12 13:30:00,13:30,20975625,16897925,-4077700,SELL
2020-11-12 13:31:00,13:31,20801975,16853125,-3948850,SELL
2020-11-12 13:32:00,13:32,21007850,16068150,-4939700,SELL
2020-11-12 13:33:00,13:33,20875150,16532450,-4342700,SELL
2020-11-12 13:34:00,13:34,21044425,15944100,-5100325,SELL
2020-11-12 13:35:00,13:35,21166125,15972825,-5193300,SELL
2020-11-12 13:36:00,13:36,21167825,16338050,-4829775,SELL
2020-11-12 13:37:00,13:37,21453150,16125975,-5327175,SELL
2020-11-12 13:38:00,13:38,20763975,16645550,-4118425,SELL
2020-11-12 13:39:00,13:39,21620625,16551750,-5068875,SELL
2020-11-12 13:40:00,13:40,21431675,16203175,-5228500,SELL
2020-11-12 13:41:00,13:41,21739225,16834600,-4904625,SELL
2020-11-12 13:42:00,13:42,21604175,16390075,-5214100,SELL
2020-11-12 13:43:00,13:43,21984125,16427300,-5556825,SELL
2020-11-12 13:44:00,13:44,21777925,16267425,-5510500,SELL
2020-11-12 13:45:00,13:45,21517300,16902675,-4614625,SELL
2020-11-12 13:46:00,13:46,21832200,16229200,-5603000,SELL
2020-11-12 13:47:00,13:47,21548850,16481650,-5067200,SELL
2020-11-12 13:48:00,13:48,21451725,15909375,-5542350,SELL
2020-11-12 13:49:00,13:49,21567300,16634375,-4932925,SELL
2020-11-12 13:50:00,13:50,21862050,16602250,-5259800,SELL
2020-11-12 13:51:00,13:51,22020100,16138400,-5881700,SELL
2020-11-12 13:52:00,13:52,21974000,16229900,-5744100,SELL
2020-11-12 13:53:00,13:53,21908725,16137900,-5770825,SELL
2020-11-12 13:54:00,13:54,22028575,16111550,-5917025,SELL
2020-11-12 13:55:00,13:55,21897600,17065300,-4832300,SELL
2020-11-12 13:56:00,13:56,22089575,16951600,-5137975,SELL
2020-11-12 13:57:00,13:57,22286950,16806150,-5480800,SELL
2020-11-12 13:58:00,13:58,22313375,16824725,-5488650,SELL
2020-11-12 13:59:00,13:59,22292225,16506050,-5786175,SELL
2020-11-12 14:00:00,14:00,22674875,16732600,-5942275,SELL
2020-11-12 14:01:00,14:01,22608325,16858150,-5750175,SELL
2020-11-12 14:02:00,14:02,22388450,16636475,-5751975,SELL
2020-11-12 14:03:00,14:03,22422075,16744900,-5677175,SELL
2020-11-12 14:04:00,14:04,22525150,16236400,-6288750,SELL
2020-11-12 14:05:00,14:05,22601175,16719600,-5881575,SELL
2020-11-12 14:06:00,14:06,22594325,16632000,-5962325,SELL
2020-11-12 14:07:00,14:07,22753900,16624050,-6129850,SELL
2020-11-12 14:08:00,14:08,22575425,16479675,-6095750,SELL
2020-11-12 14:09:00,14:09,22430125,16649300,-5780825,SELL
2020-11-12 14:10:00,14:10,22629625,15550800,-7078825,SELL
2020-11-12 14:11:00,14:11,22467175,15923825,-6543350,SELL
2020-11-12 14:12:00,14:12,22239000,16427300,-5811700,SELL
2020-11-12 14:13:00,14:13,22432625,16931250,-5501375,SELL
2020-11-12 14:14:00,14:14,22440050,16536000,-5904050,SELL
2020-11-12 14:15:00,14:15,21896925,17220650,-4676275,SELL
2020-11-12 14:16:00,14:16,22508575,16038525,-6470050,SELL
2020-11-12 14:17:00,14:17,22350725,16898925,-5451800,SELL
2020-11-12 14:18:00,14:18,22029600,16082975,-5946625,SELL
2020-11-12 14:19:00,14:19,22021325,16631175,-5390150,SELL
2020-11-12 14:20:00,14:20,21966575,17059600,-4906975,SELL
2020-11-12 14:21:00,14:21,22090175,17094575,-4995600,SELL
2020-11-12 14:22:00,14:22,22049950,16886025,-5163925,SELL
2020-11-12 14:23:00,14:23,22098700,16430975,-5667725,SELL
2020-11-12 14:24:00,14:24,22189375,16505950,-5683425,SELL
2020-11-12 14:25:00,14:25,22198200,16569000,-5629200,SELL
2020-11-12 14:26:00,14:26,22221950,16715575,-5506375,SELL
2020-11-12 14:27:00,14:27,22284925,16993325,-5291600,SELL
2020-11-12 14:28:00,14:28,22072300,16929200,-5143100,SELL
2020-11-12 14:29:00,14:29,22142200,16660550,-5481650,SELL
2020-11-12 14:30:00,14:30,22672525,16747000,-5925525,SELL
2020-11-12 14:31:00,14:31,22489150,16593925,-5895225,SELL
2020-11-12 14:32:00,14:32,22710500,16859750,-5850750,SELL
2020-11-12 14:33:00,14:33,22455550,16806925,-5648625,SELL
2020-11-12 14:34:00,14:34,22384175,16851250,-5532925,SELL
2020-11-12 14:35:00,14:35,22553525,16915650,-5637875,SELL
2020-11-12 14:36:00,14:36,22780025,16980925,-5799100,SELL
2020-11-12 14:37:00,14:37,22495800,16635075,-5860725,SELL
2020-11-12 14:38:00,14:38,22516975,17126325,-5390650,SELL
2020-11-12 14:39:00,14:39,22246675,16761775,-5484900,SELL
2020-11-12 14:40:00,14:40,22295550,16404025,-5891525,SELL
2020-11-12 14:41:00,14:41,22286950,16505875,-5781075,SELL
2020-11-12 14:42:00,14:42,22329750,16678825,-5650925,SELL
2020-11-12 14:43:00,14:43,22481625,16199425,-6282200,SELL
2020-11-12 14:44:00,14:44,22520675,16657475,-5863200,SELL
2020-11-12 14:45:00,14:45,22360150,16588600,-5771550,SELL
2020-11-12 14:46:00,14:46,22373175,16043175,-6330000,SELL
2020-11-12 14:47:00,14:47,22262025,16527800,-5734225,SELL
2020-11-12 14:48:00,14:48,22707650,16870875,-5836775,SELL
2020-11-12 14:49:00,14:49,22712875,16534650,-6178225,SELL
2020-11-12 14:50:00,14:50,22561825,16303125,-6258700,SELL
2020-11-12 14:51:00,14:51,22472975,16485325,-5987650,SELL
2020-11-12 14:52:00,14:52,22319675,16623000,-5696675,SELL
2020-11-12 14:53:00,14:53,22354600,16431750,-5922850,SELL
2020-11-12 14:54:00,14:54,22634300,16595075,-6039225,SELL
2020-11-12 14:55:00,14:55,22494300,16035250,-6459050,SELL
2020-11-12 14:56:00,14:56,22643450,16179600,-6463850,SELL
2020-11-12 14:57:00,14:57,22488300,16059075,-6429225,SELL
2020-11-12 14:58:00,14:58,22492025,16166900,-6325125,SELL
2020-11-12 14:59:00,14:59,22384775,16188300,-6196475,SELL
2020-11-12 15:00:00,15:00,22162050,15138600,-7023450,SELL
2020-11-12 15:01:00,15:01,22237325,16403975,-5833350,SELL
2020-11-12 15:02:00,15:02,22316075,15892100,-6423975,SELL
2020-11-12 15:03:00,15:03,21722450,16209200,-5513250,SELL
2020-11-12 15:04:00,15:04,21707925,16366125,-5341800,SELL
2020-11-12 15:05:00,15:05,21832900,16281000,-5551900,SELL
2020-11-12 15:06:00,15:06,21334950,16347100,-4987850,SELL
2020-11-12 15:07:00,15:07,21317550,16015250,-5302300,SELL
2020-11-12 15:08:00,15:08,21393975,16465975,-4928000,SELL
2020-11-12 15:09:00,15:09,21353925,16084250,-5269675,SELL
2020-11-12 15:10:00,15:10,21322125,16410050,-4912075,SELL
2020-11-12 15:11:00,15:11,21380825,15848175,-5532650,SELL
2020-11-12 15:12:00,15:12,21164850,16325750,-4839100,SELL
2020-11-12 15:13:00,15:13,20789750,15658425,-5131325,SELL
2020-11-12 15:14:00,15:14,20802625,16176025,-4626600,SELL
2020-11-12 15:15:00,15:15,21008550,16301575,-4706975,SELL
2020-11-12 15:16:00,15:16,20588025,16248350,-4339675,SELL
2020-11-12 15:17:00,15:17,21005175,16241325,-4763850,SELL
2020-11-12 15:18:00,15:18,20838475,15984325,-4854150,SELL
2020-11-12 15:19:00,15:19,20739450,15916900,-4822550,SELL
2020-11-12 15:20:00,15:20,20838600,16317200,-4521400,SELL
2020-11-12 15:21:00,15:21,20379700,15651850,-4727850,SELL
2020-11-12 15:26:00,15:26,19146075,14359850,-4786225,SELL
2020-11-12 15:27:00,15:27,18257575,14197950,-4059625,SELL
2020-11-12 15:28:00,15:28,18295825,13987825,-4308000,SELL
