,timestamp,call,put,diff,sellOrBuy
2020-10-05 09:15:00,09:15,3080725,3706125,625400,BUY
2020-10-05 09:16:00,09:16,3088800,3703000,614200,BUY
2020-10-05 09:17:00,09:17,3470425,3999675,529250,BUY
2020-10-05 09:18:00,09:18,3464675,4002925,538250,BUY
2020-10-05 09:19:00,09:19,3479175,4003100,523925,BUY
2020-10-05 09:20:00,09:20,3971350,4312775,341425,BUY
2020-10-05 09:21:00,09:21,3959325,4317025,357700,BUY
2020-10-05 09:22:00,09:22,3974550,4316075,341525,BUY
2020-10-05 09:23:00,09:23,4127650,4667825,540175,BUY
2020-10-05 09:24:00,09:24,4133800,4675025,541225,BUY
2020-10-05 09:25:00,09:25,4072925,4675975,603050,BUY
2020-10-05 09:26:00,09:26,4311950,4913025,601075,BUY
2020-10-05 09:27:00,09:27,4322750,4917800,595050,BUY
2020-10-05 09:28:00,09:28,4263500,4916775,653275,BUY
2020-10-05 09:29:00,09:29,4490775,5050250,559475,BUY
2020-10-05 09:30:00,09:30,4495775,5055175,559400,BUY
2020-10-05 09:31:00,09:31,4490775,5052350,561575,BUY
2020-10-05 09:32:00,09:32,4620875,5208725,587850,BUY
2020-10-05 09:33:00,09:33,4629425,5208725,579300,BUY
2020-10-05 09:34:00,09:34,4620875,5207850,586975,BUY
2020-10-05 09:35:00,09:35,4643950,5368550,724600,BUY
2020-10-05 09:36:00,09:36,4643950,5367600,723650,BUY
2020-10-05 09:37:00,09:37,4617125,5347450,730325,BUY
2020-10-05 09:38:00,09:38,4716175,5434125,717950,BUY
2020-10-05 09:39:00,09:39,4729825,5429475,699650,BUY
2020-10-05 09:40:00,09:40,4719650,5428525,708875,BUY
2020-10-05 09:41:00,09:41,4735900,5562875,826975,BUY
2020-10-05 09:42:00,09:42,4741950,5565350,823400,BUY
2020-10-05 09:43:00,09:43,4707225,5573525,866300,BUY
2020-10-05 09:44:00,09:44,4790175,5669400,879225,BUY
2020-10-05 09:45:00,09:45,4812200,5670175,857975,BUY
2020-10-05 09:46:00,09:46,4824100,5665150,841050,BUY
2020-10-05 09:47:00,09:47,4856125,5709000,852875,BUY
2020-10-05 09:48:00,09:48,4838025,5685325,847300,BUY
2020-10-05 09:49:00,09:49,4856125,5729725,873600,BUY
2020-10-05 09:50:00,09:50,4974775,5822875,848100,BUY
2020-10-05 09:51:00,09:51,4974500,5866150,891650,BUY
2020-10-05 09:52:00,09:52,4893025,5866150,973125,BUY
2020-10-05 09:53:00,09:53,5002250,5890575,888325,BUY
2020-10-05 09:54:00,09:54,4934525,5884100,949575,BUY
2020-10-05 09:55:00,09:55,4936300,5829775,893475,BUY
2020-10-05 09:56:00,09:56,4947200,5909925,962725,BUY
2020-10-05 09:57:00,09:57,4883550,5900650,1017100,BUY
2020-10-05 09:58:00,09:58,4892750,5901975,1009225,BUY
2020-10-05 09:59:00,09:59,4964525,5954700,990175,BUY
2020-10-05 10:00:00,10:00,4952325,5942150,989825,BUY
2020-10-05 10:01:00,10:01,5052650,5956925,904275,BUY
2020-10-05 10:02:00,10:02,5077200,6033100,955900,BUY
2020-10-05 10:03:00,10:03,5054900,6021450,966550,BUY
2020-10-05 10:04:00,10:04,5086625,6027600,940975,BUY
2020-10-05 10:05:00,10:05,5094550,6121175,1026625,BUY
2020-10-05 10:06:00,10:06,5097550,6096350,998800,BUY
2020-10-05 10:07:00,10:07,5110850,6119450,1008600,BUY
2020-10-05 10:08:00,10:08,5142025,6188625,1046600,BUY
2020-10-05 10:09:00,10:09,5107900,6190100,1082200,BUY
2020-10-05 10:10:00,10:10,5183150,6173250,990100,BUY
2020-10-05 10:11:00,10:11,5198350,6243475,1045125,BUY
2020-10-05 10:12:00,10:12,5197400,6243475,1046075,BUY
2020-10-05 10:13:00,10:13,5210675,6230225,1019550,BUY
2020-10-05 10:14:00,10:14,5251800,6301875,1050075,BUY
2020-10-05 10:15:00,10:15,5228600,6307900,1079300,BUY
2020-10-05 10:16:00,10:16,5320575,6296225,975650,BUY
2020-10-05 10:17:00,10:17,5336650,6380975,1044325,BUY
2020-10-05 10:18:00,10:18,5258025,6385375,1127350,BUY
2020-10-05 10:19:00,10:19,5305275,6382450,1077175,BUY
2020-10-05 10:20:00,10:20,5338425,6401925,1063500,BUY
2020-10-05 10:21:00,10:21,5349175,6392525,1043350,BUY
2020-10-05 10:22:00,10:22,5406850,6433725,1026875,BUY
2020-10-05 10:23:00,10:23,5388375,6397725,1009350,BUY
2020-10-05 10:24:00,10:24,5323250,6402375,1079125,BUY
2020-10-05 10:25:00,10:25,5351325,6395450,1044125,BUY
2020-10-05 10:26:00,10:26,5440675,6460250,1019575,BUY
2020-10-05 10:27:00,10:27,5387375,6481600,1094225,BUY
2020-10-05 10:28:00,10:28,5431050,6459225,1028175,BUY
2020-10-05 10:29:00,10:29,5420050,6432925,1012875,BUY
2020-10-05 10:30:00,10:30,5447075,6527650,1080575,BUY
2020-10-05 10:31:00,10:31,5452975,6531825,1078850,BUY
2020-10-05 10:32:00,10:32,5417025,6532000,1114975,BUY
2020-10-05 10:33:00,10:33,5402700,6499425,1096725,BUY
2020-10-05 10:34:00,10:34,5422850,6532000,1109150,BUY
2020-10-05 10:35:00,10:35,5509050,6535000,1025950,BUY
2020-10-05 10:36:00,10:36,5498800,6520600,1021800,BUY
2020-10-05 10:37:00,10:37,5435800,6528800,1093000,BUY
2020-10-05 10:38:00,10:38,5507425,6548150,1040725,BUY
2020-10-05 10:39:00,10:39,5471625,6541675,1070050,BUY
2020-10-05 10:40:00,10:40,5408900,6541025,1132125,BUY
2020-10-05 10:41:00,10:41,5509025,6612625,1103600,BUY
2020-10-05 10:42:00,10:42,5357850,6609450,1251600,BUY
2020-10-05 10:43:00,10:43,5454825,6594725,1139900,BUY
2020-10-05 10:44:00,10:44,5491175,6589300,1098125,BUY
2020-10-05 10:45:00,10:45,5564500,6665400,1100900,BUY
2020-10-05 10:46:00,10:46,5454375,6606575,1152200,BUY
2020-10-05 10:47:00,10:47,5465250,6630300,1165050,BUY
2020-10-05 10:48:00,10:48,5523000,6669075,1146075,BUY
2020-10-05 10:49:00,10:49,5551500,6628850,1077350,BUY
2020-10-05 10:50:00,10:50,5529000,6709650,1180650,BUY
2020-10-05 10:51:00,10:51,5464350,6712500,1248150,BUY
2020-10-05 10:52:00,10:52,5455225,6700475,1245250,BUY
2020-10-05 10:53:00,10:53,5489550,6736575,1247025,BUY
2020-10-05 10:54:00,10:54,5600650,6743675,1143025,BUY
2020-10-05 10:55:00,10:55,5453300,6699925,1246625,BUY
2020-10-05 10:56:00,10:56,5517650,6736250,1218600,BUY
2020-10-05 10:57:00,10:57,5623350,6757300,1133950,BUY
2020-10-05 10:58:00,10:58,5658000,6732750,1074750,BUY
2020-10-05 10:59:00,10:59,5628525,6815400,1186875,BUY
2020-10-05 11:00:00,11:00,5501775,6804050,1302275,BUY
2020-10-05 11:01:00,11:01,5674850,6813000,1138150,BUY
2020-10-05 11:02:00,11:02,5653000,6855100,1202100,BUY
2020-10-05 11:03:00,11:03,5645650,6864975,1219325,BUY
2020-10-05 11:04:00,11:04,5692725,6847650,1154925,BUY
2020-10-05 11:05:00,11:05,5743525,7008050,1264525,BUY
2020-10-05 11:06:00,11:06,5804700,7013950,1209250,BUY
2020-10-05 11:07:00,11:07,5721825,7006025,1284200,BUY
2020-10-05 11:08:00,11:08,5689750,7096475,1406725,BUY
2020-10-05 11:09:00,11:09,5736975,7094075,1357100,BUY
2020-10-05 11:10:00,11:10,5691425,7097300,1405875,BUY
2020-10-05 11:11:00,11:11,5768050,7127650,1359600,BUY
2020-10-05 11:12:00,11:12,5685300,7128650,1443350,BUY
2020-10-05 11:13:00,11:13,5648375,7128650,1480275,BUY
2020-10-05 11:14:00,11:14,5638400,7142325,1503925,BUY
2020-10-05 11:15:00,11:15,5689525,7160575,1471050,BUY
2020-10-05 11:16:00,11:16,5701025,7180575,1479550,BUY
2020-10-05 11:17:00,11:17,5759900,7230650,1470750,BUY
2020-10-05 11:18:00,11:18,5652050,7229125,1577075,BUY
2020-10-05 11:19:00,11:19,5719425,7222150,1502725,BUY
2020-10-05 11:20:00,11:20,5619125,7284575,1665450,BUY
2020-10-05 11:21:00,11:21,5738075,7290075,1552000,BUY
2020-10-05 11:22:00,11:22,5470625,7287300,1816675,BUY
2020-10-05 11:23:00,11:23,5726525,7301675,1575150,BUY
2020-10-05 11:24:00,11:24,5760250,7332575,1572325,BUY
2020-10-05 11:25:00,11:25,5709875,7330100,1620225,BUY
2020-10-05 11:26:00,11:26,5802575,7356275,1553700,BUY
2020-10-05 11:27:00,11:27,5765725,7330350,1564625,BUY
2020-10-05 11:28:00,11:28,5836625,7384325,1547700,BUY
2020-10-05 11:29:00,11:29,5788300,7327475,1539175,BUY
2020-10-05 11:30:00,11:30,5785500,7333975,1548475,BUY
2020-10-05 11:31:00,11:31,5757900,7324700,1566800,BUY
2020-10-05 11:32:00,11:32,5754450,7353250,1598800,BUY
2020-10-05 11:33:00,11:33,5793925,7383025,1589100,BUY
2020-10-05 11:34:00,11:34,5776575,7375925,1599350,BUY
2020-10-05 11:35:00,11:35,5785925,7384950,1599025,BUY
2020-10-05 11:36:00,11:36,5835175,7387050,1551875,BUY
2020-10-05 11:37:00,11:37,5746525,7382600,1636075,BUY
2020-10-05 11:38:00,11:38,5906350,7417975,1511625,BUY
2020-10-05 11:39:00,11:39,5963875,7431250,1467375,BUY
2020-10-05 11:40:00,11:40,5951925,7436875,1484950,BUY
2020-10-05 11:41:00,11:41,5782125,7092475,1310350,BUY
2020-10-05 11:42:00,11:42,5747800,7092475,1344675,BUY
2020-10-05 11:43:00,11:43,5784675,7083525,1298850,BUY
2020-10-05 11:44:00,11:44,5845375,7154450,1309075,BUY
2020-10-05 11:45:00,11:45,5853600,7137425,1283825,BUY
2020-10-05 11:46:00,11:46,5875575,7153925,1278350,BUY
2020-10-05 11:47:00,11:47,5935925,7169675,1233750,BUY
2020-10-05 11:48:00,11:48,5981025,7190825,1209800,BUY
2020-10-05 11:49:00,11:49,5972250,7187900,1215650,BUY
2020-10-05 11:50:00,11:50,6049675,7210650,1160975,BUY
2020-10-05 11:51:00,11:51,6029725,7214775,1185050,BUY
2020-10-05 11:52:00,11:52,6045200,7173675,1128475,BUY
2020-10-05 11:53:00,11:53,5994050,7151000,1156950,BUY
2020-10-05 11:54:00,11:54,5975825,7197575,1221750,BUY
2020-10-05 11:55:00,11:55,5976450,7202125,1225675,BUY
2020-10-05 11:56:00,11:56,6049800,7225400,1175600,BUY
2020-10-05 11:57:00,11:57,6118650,7222600,1103950,BUY
2020-10-05 11:58:00,11:58,6068075,7211250,1143175,BUY
2020-10-05 11:59:00,11:59,6166175,7173800,1007625,BUY
2020-10-05 12:00:00,12:00,6040550,7117850,1077300,BUY
2020-10-05 12:01:00,12:01,6080525,7156225,1075700,BUY
2020-10-05 12:02:00,12:02,6232175,7165550,933375,BUY
2020-10-05 12:03:00,12:03,6214875,7148325,933450,BUY
2020-10-05 12:04:00,12:04,6232000,7162750,930750,BUY
2020-10-05 12:05:00,12:05,6085350,7152600,1067250,BUY
2020-10-05 12:06:00,12:06,6199550,7171150,971600,BUY
2020-10-05 12:07:00,12:07,6331375,7180650,849275,BUY
2020-10-05 12:08:00,12:08,6269950,7151275,881325,BUY
2020-10-05 12:09:00,12:09,6239450,7158225,918775,BUY
2020-10-05 12:10:00,12:10,6238350,7198425,960075,BUY
2020-10-05 12:11:00,12:11,6165650,7216850,1051200,BUY
2020-10-05 12:12:00,12:12,6297575,7231075,933500,BUY
2020-10-05 12:13:00,12:13,6180825,7209200,1028375,BUY
2020-10-05 12:14:00,12:14,6250075,7229875,979800,BUY
2020-10-05 12:15:00,12:15,6192425,7156675,964250,BUY
2020-10-05 12:16:00,12:16,6314275,7207975,893700,BUY
2020-10-05 12:17:00,12:17,6342700,7246550,903850,BUY
2020-10-05 12:18:00,12:18,6361600,7170275,808675,BUY
2020-10-05 12:19:00,12:19,6179550,7161250,981700,BUY
2020-10-05 12:20:00,12:20,6317625,7182825,865200,BUY
2020-10-05 12:21:00,12:21,6272050,7258300,986250,BUY
2020-10-05 12:22:00,12:22,6191875,6896400,704525,BUY
2020-10-05 12:23:00,12:23,6252025,7260450,1008425,BUY
2020-10-05 12:24:00,12:24,6394325,7264300,869975,BUY
2020-10-05 12:25:00,12:25,6385300,7229525,844225,BUY
2020-10-05 12:26:00,12:26,6396550,7287000,890450,BUY
2020-10-05 12:27:00,12:27,6267975,7263200,995225,BUY
2020-10-05 12:28:00,12:28,6323400,7287250,963850,BUY
2020-10-05 12:29:00,12:29,6298475,7316550,1018075,BUY
2020-10-05 12:30:00,12:30,6435725,7322550,886825,BUY
2020-10-05 12:31:00,12:31,6442475,7316000,873525,BUY
2020-10-05 12:32:00,12:32,6427500,7245950,818450,BUY
2020-10-05 12:33:00,12:33,6336875,7240975,904100,BUY
2020-10-05 12:34:00,12:34,6349525,7210075,860550,BUY
2020-10-05 12:35:00,12:35,6421600,7347675,926075,BUY
2020-10-05 12:36:00,12:36,6437500,7356500,919000,BUY
2020-10-05 12:37:00,12:37,6411350,7359150,947800,BUY
2020-10-05 12:38:00,12:38,6455400,7375350,919950,BUY
2020-10-05 12:39:00,12:39,6438700,7379400,940700,BUY
2020-10-05 12:40:00,12:40,6460775,7359550,898775,BUY
2020-10-05 12:41:00,12:41,6457100,7331775,874675,BUY
2020-10-05 12:42:00,12:42,6571000,7359750,788750,BUY
2020-10-05 12:43:00,12:43,6528275,7364300,836025,BUY
2020-10-05 12:44:00,12:44,6545600,7336200,790600,BUY
2020-10-05 12:45:00,12:45,6494450,7307925,813475,BUY
2020-10-05 12:46:00,12:46,6544700,7322925,778225,BUY
2020-10-05 12:47:00,12:47,6518750,7213225,694475,BUY
2020-10-05 12:48:00,12:48,6492400,7249175,756775,BUY
2020-10-05 12:49:00,12:49,6458975,7330550,871575,BUY
2020-10-05 12:50:00,12:50,6547675,7369025,821350,BUY
2020-10-05 12:51:00,12:51,6608925,7376500,767575,BUY
2020-10-05 12:52:00,12:52,6549675,7248675,699000,BUY
2020-10-05 12:53:00,12:53,6563975,7376675,812700,BUY
2020-10-05 12:54:00,12:54,6385525,7301425,915900,BUY
2020-10-05 12:55:00,12:55,6568500,7372175,803675,BUY
2020-10-05 12:56:00,12:56,6622525,7278900,656375,BUY
2020-10-05 12:57:00,12:57,6605500,7368625,763125,BUY
2020-10-05 12:58:00,12:58,6656100,7413875,757775,BUY
2020-10-05 12:59:00,12:59,6688000,7295575,607575,BUY
2020-10-05 13:00:00,13:00,6674850,7295000,620150,BUY
2020-10-05 13:01:00,13:01,6666950,7284225,617275,BUY
2020-10-05 13:02:00,13:02,6589675,7208825,619150,BUY
2020-10-05 13:03:00,13:03,6646600,7208875,562275,BUY
2020-10-05 13:04:00,13:04,6571700,7119425,547725,BUY
2020-10-05 13:05:00,13:05,6719575,7233300,513725,BUY
2020-10-05 13:06:00,13:06,6589875,7220625,630750,BUY
2020-10-05 13:07:00,13:07,6715250,7234525,519275,BUY
2020-10-05 13:08:00,13:08,6730100,7206050,475950,BUY
2020-10-05 13:09:00,13:09,6694150,7196600,502450,BUY
2020-10-05 13:10:00,13:10,6614825,7190450,575625,BUY
2020-10-05 13:11:00,13:11,6638300,7141225,502925,BUY
2020-10-05 13:12:00,13:12,6833300,7228875,395575,BUY
2020-10-05 13:13:00,13:13,6789750,7226450,436700,BUY
2020-10-05 13:14:00,13:14,6735925,7186325,450400,BUY
2020-10-05 13:15:00,13:15,6732225,7006075,273850,BUY
2020-10-05 13:16:00,13:16,6692175,6990925,298750,BUY
2020-10-05 13:17:00,13:17,6713725,7005800,292075,BUY
2020-10-05 13:18:00,13:18,6681750,7033825,352075,BUY
2020-10-05 13:19:00,13:19,6764875,7019225,254350,BUY
2020-10-05 13:20:00,13:20,6779550,7044975,265425,BUY
2020-10-05 13:21:00,13:21,6747200,6865125,117925,BUY
2020-10-05 13:22:00,13:22,6725975,6865125,139150,BUY
2020-10-05 13:23:00,13:23,6772500,6874900,102400,BUY
2020-10-05 13:24:00,13:24,6804375,6835550,31175,BUY
2020-10-05 13:25:00,13:25,6750125,6828200,78075,BUY
2020-10-05 13:26:00,13:26,6812175,6828200,16025,BUY
2020-10-05 13:27:00,13:27,6839300,6740275,-99025,SELL
2020-10-05 13:28:00,13:28,6821025,6728325,-92700,SELL
2020-10-05 13:29:00,13:29,6792550,6742700,-49850,SELL
2020-10-05 13:30:00,13:30,6845900,6674275,-171625,SELL
2020-10-05 13:31:00,13:31,6860375,6671550,-188825,SELL
2020-10-05 13:32:00,13:32,6839075,6695600,-143475,SELL
2020-10-05 13:33:00,13:33,7022425,6739725,-282700,SELL
2020-10-05 13:34:00,13:34,7025975,6735000,-290975,SELL
2020-10-05 13:35:00,13:35,6989725,6739725,-250000,SELL
2020-10-05 13:36:00,13:36,7069500,6775175,-294325,SELL
2020-10-05 13:37:00,13:37,7061275,6762800,-298475,SELL
2020-10-05 13:38:00,13:38,7070600,6757475,-313125,SELL
2020-10-05 13:39:00,13:39,7121050,6690200,-430850,SELL
2020-10-05 13:40:00,13:40,7174950,6789100,-385850,SELL
2020-10-05 13:41:00,13:41,7188550,6783625,-404925,SELL
2020-10-05 13:42:00,13:42,7144750,6768100,-376650,SELL
2020-10-05 13:43:00,13:43,7134750,6765675,-369075,SELL
2020-10-05 13:44:00,13:44,7197575,6768125,-429450,SELL
2020-10-05 13:45:00,13:45,7258325,6810925,-447400,SELL
2020-10-05 13:46:00,13:46,7217150,6801300,-415850,SELL
2020-10-05 13:47:00,13:47,7213200,6778025,-435175,SELL
2020-10-05 13:48:00,13:48,7293575,6822875,-470700,SELL
2020-10-05 13:49:00,13:49,7294125,6842575,-451550,SELL
2020-10-05 13:50:00,13:50,7243100,6847775,-395325,SELL
2020-10-05 13:51:00,13:51,7286600,6822500,-464100,SELL
2020-10-05 13:52:00,13:52,7286600,6798625,-487975,SELL
2020-10-05 13:53:00,13:53,7254775,6828125,-426650,SELL
2020-10-05 13:54:00,13:54,7305975,6838450,-467525,SELL
2020-10-05 13:55:00,13:55,7304525,6864950,-439575,SELL
2020-10-05 13:56:00,13:56,7323100,6864950,-458150,SELL
2020-10-05 13:57:00,13:57,7115600,6899675,-215925,SELL
2020-10-05 13:58:00,13:58,7253225,6890300,-362925,SELL
2020-10-05 13:59:00,13:59,7218850,6898825,-320025,SELL
2020-10-05 14:00:00,14:00,7323775,6915200,-408575,SELL
2020-10-05 14:01:00,14:01,7284825,6912800,-372025,SELL
2020-10-05 14:02:00,14:02,7311675,6898550,-413125,SELL
2020-10-05 14:03:00,14:03,7374475,6939925,-434550,SELL
2020-10-05 14:04:00,14:04,7344400,6925675,-418725,SELL
2020-10-05 14:05:00,14:05,7337850,6892225,-445625,SELL
2020-10-05 14:06:00,14:06,7358225,6991525,-366700,SELL
2020-10-05 14:07:00,14:07,7404725,6993950,-410775,SELL
2020-10-05 14:08:00,14:08,7332075,6994200,-337875,SELL
2020-10-05 14:09:00,14:09,7292625,6945675,-346950,SELL
2020-10-05 14:10:00,14:10,7226100,6870075,-356025,SELL
2020-10-05 14:11:00,14:11,7292625,6920150,-372475,SELL
2020-10-05 14:12:00,14:12,7357475,6949225,-408250,SELL
2020-10-05 14:13:00,14:13,7300975,6949425,-351550,SELL
2020-10-05 14:14:00,14:14,7202475,6945850,-256625,SELL
2020-10-05 14:15:00,14:15,7381850,6995350,-386500,SELL
2020-10-05 14:16:00,14:16,7355175,6991000,-364175,SELL
2020-10-05 14:17:00,14:17,7298825,6979950,-318875,SELL
2020-10-05 14:18:00,14:18,7314900,6973700,-341200,SELL
2020-10-05 14:19:00,14:19,7331300,6964300,-367000,SELL
2020-10-05 14:20:00,14:20,7375600,6976225,-399375,SELL
2020-10-05 14:21:00,14:21,7321050,6915350,-405700,SELL
2020-10-05 14:22:00,14:22,7296125,6911475,-384650,SELL
2020-10-05 14:23:00,14:23,7340150,6913525,-426625,SELL
2020-10-05 14:24:00,14:24,7345675,6973150,-372525,SELL
2020-10-05 14:25:00,14:25,7368625,6979550,-389075,SELL
2020-10-05 14:26:00,14:26,7344175,6957275,-386900,SELL
2020-10-05 14:27:00,14:27,7464450,6973775,-490675,SELL
2020-10-05 14:28:00,14:28,7472400,6985675,-486725,SELL
2020-10-05 14:29:00,14:29,7455425,6977425,-478000,SELL
2020-10-05 14:30:00,14:30,7487250,6867525,-619725,SELL
2020-10-05 14:31:00,14:31,7426675,6882400,-544275,SELL
2020-10-05 14:32:00,14:32,7288250,6872475,-415775,SELL
2020-10-05 14:33:00,14:33,7519150,6927300,-591850,SELL
2020-10-05 14:34:00,14:34,7464975,6921425,-543550,SELL
2020-10-05 14:35:00,14:35,7471950,6889650,-582300,SELL
2020-10-05 14:36:00,14:36,7419075,6875525,-543550,SELL
2020-10-05 14:37:00,14:37,7505525,6925425,-580100,SELL
2020-10-05 14:38:00,14:38,7483450,6910950,-572500,SELL
2020-10-05 14:39:00,14:39,7459575,6910525,-549050,SELL
2020-10-05 14:40:00,14:40,7544750,6910525,-634225,SELL
2020-10-05 14:41:00,14:41,7465725,6910525,-555200,SELL
2020-10-05 14:42:00,14:42,7491325,6886400,-604925,SELL
2020-10-05 14:43:00,14:43,7348875,6821500,-527375,SELL
2020-10-05 14:44:00,14:44,7444550,6869250,-575300,SELL
2020-10-05 14:45:00,14:45,7564575,6875800,-688775,SELL
2020-10-05 14:46:00,14:46,7592175,6886375,-705800,SELL
2020-10-05 14:47:00,14:47,7560650,6854950,-705700,SELL
2020-10-05 14:48:00,14:48,7394375,6783475,-610900,SELL
2020-10-05 14:49:00,14:49,7428400,6858975,-569425,SELL
2020-10-05 14:50:00,14:50,7476025,6864625,-611400,SELL
2020-10-05 14:51:00,14:51,7370625,6864225,-506400,SELL
2020-10-05 14:52:00,14:52,7473450,6875225,-598225,SELL
2020-10-05 14:53:00,14:53,7439100,6873125,-565975,SELL
2020-10-05 14:54:00,14:54,7426350,6780750,-645600,SELL
2020-10-05 14:55:00,14:55,7424875,6728475,-696400,SELL
2020-10-05 14:56:00,14:56,7339875,6764000,-575875,SELL
2020-10-05 14:57:00,14:57,7378350,6771400,-606950,SELL
2020-10-05 14:58:00,14:58,7411525,6780350,-631175,SELL
2020-10-05 14:59:00,14:59,7426100,6768225,-657875,SELL
2020-10-05 15:00:00,15:00,7378350,6698075,-680275,SELL
2020-10-05 15:01:00,15:01,7404300,6717850,-686450,SELL
2020-10-05 15:02:00,15:02,7341800,6730875,-610925,SELL
2020-10-05 15:03:00,15:03,7337175,6732850,-604325,SELL
2020-10-05 15:04:00,15:04,7327650,6723450,-604200,SELL
2020-10-05 15:05:00,15:05,7352250,6729475,-622775,SELL
2020-10-05 15:06:00,15:06,7142325,6625625,-516700,SELL
2020-10-05 15:07:00,15:07,7174100,6567775,-606325,SELL
2020-10-05 15:08:00,15:08,7203925,6608500,-595425,SELL
2020-10-05 15:09:00,15:09,7206150,6619375,-586775,SELL
2020-10-05 15:10:00,15:10,7238625,6609000,-629625,SELL
2020-10-05 15:11:00,15:11,7216800,6622850,-593950,SELL
2020-10-05 15:12:00,15:12,7186325,6520825,-665500,SELL
2020-10-05 15:13:00,15:13,7170900,6535325,-635575,SELL
2020-10-05 15:14:00,15:14,7196950,6551975,-644975,SELL
2020-10-05 15:15:00,15:15,7117950,6499075,-618875,SELL
2020-10-05 15:16:00,15:16,6987875,6480475,-507400,SELL
2020-10-05 15:17:00,15:17,7132375,6488850,-643525,SELL
2020-10-05 15:18:00,15:18,7003225,6379725,-623500,SELL
2020-10-05 15:19:00,15:19,7073550,6384300,-689250,SELL
2020-10-05 15:20:00,15:20,7081175,6409350,-671825,SELL
2020-10-05 15:21:00,15:21,6881075,6261850,-619225,SELL
2020-10-05 15:22:00,15:22,6872875,6249425,-623450,SELL
2020-10-05 15:23:00,15:23,6872875,6258225,-614650,SELL
2020-10-05 15:24:00,15:24,6751875,6147025,-604850,SELL
2020-10-05 15:25:00,15:25,6797825,6176900,-620925,SELL
2020-10-05 15:26:00,15:26,6771100,6144675,-626425,SELL
2020-10-05 15:27:00,15:27,6579800,6048075,-531725,SELL
2020-10-05 15:28:00,15:28,6560625,6026725,-533900,SELL
2020-10-05 15:29:00,15:29,6597750,6048075,-549675,SELL
2020-10-06 09:15:00,09:15,6314400,5740175,-574225,SELL
2020-10-06 09:16:00,09:16,6268750,5740000,-528750,SELL
2020-10-06 09:17:00,09:17,6473925,5902900,-571025,SELL
2020-10-06 09:18:00,09:18,6450625,5902425,-548200,SELL
2020-10-06 09:19:00,09:19,6455200,5908400,-546800,SELL
2020-10-06 09:20:00,09:20,6905000,6628300,-276700,SELL
2020-10-06 09:21:00,09:21,6902300,6628300,-274000,SELL
2020-10-06 09:22:00,09:22,6894550,6632225,-262325,SELL
2020-10-06 09:23:00,09:23,7187100,7119625,-67475,SELL
2020-10-06 09:24:00,09:24,7172425,7125850,-46575,SELL
2020-10-06 09:25:00,09:25,7171800,7122875,-48925,SELL
2020-10-06 09:26:00,09:26,7393250,6998400,-394850,SELL
2020-10-06 09:27:00,09:27,7344125,7022075,-322050,SELL
2020-10-06 09:28:00,09:28,7423250,7024525,-398725,SELL
2020-10-06 09:29:00,09:29,7527875,7155200,-372675,SELL
2020-10-06 09:30:00,09:30,7556275,7185250,-371025,SELL
2020-10-06 09:31:00,09:31,7526575,7155200,-371375,SELL
2020-10-06 09:32:00,09:32,7608375,7314150,-294225,SELL
2020-10-06 09:33:00,09:33,7622675,7320775,-301900,SELL
2020-10-06 09:34:00,09:34,7617600,7324475,-293125,SELL
2020-10-06 09:35:00,09:35,7752075,7376225,-375850,SELL
2020-10-06 09:36:00,09:36,7752125,7389150,-362975,SELL
2020-10-06 09:37:00,09:37,7722950,7357825,-365125,SELL
2020-10-06 09:38:00,09:38,7840675,7459200,-381475,SELL
2020-10-06 09:39:00,09:39,7797150,7360750,-436400,SELL
2020-10-06 09:40:00,09:40,7824250,7440775,-383475,SELL
2020-10-06 09:41:00,09:41,7921300,7447175,-474125,SELL
2020-10-06 09:42:00,09:42,7920050,7456250,-463800,SELL
2020-10-06 09:43:00,09:43,7937250,7449075,-488175,SELL
2020-10-06 09:44:00,09:44,7904075,7529675,-374400,SELL
2020-10-06 09:45:00,09:45,7911775,7516700,-395075,SELL
2020-10-06 09:46:00,09:46,8027000,7518325,-508675,SELL
2020-10-06 09:47:00,09:47,8024900,7613125,-411775,SELL
2020-10-06 09:48:00,09:48,8079075,7629875,-449200,SELL
2020-10-06 09:49:00,09:49,8031100,7552000,-479100,SELL
2020-10-06 09:50:00,09:50,8094750,7550425,-544325,SELL
2020-10-06 09:51:00,09:51,8081900,7566125,-515775,SELL
2020-10-06 09:52:00,09:52,8002250,7496750,-505500,SELL
2020-10-06 09:53:00,09:53,8136200,7709150,-427050,SELL
2020-10-06 09:54:00,09:54,8088700,7688475,-400225,SELL
2020-10-06 09:55:00,09:55,8145100,7721775,-423325,SELL
2020-10-06 09:56:00,09:56,8275725,7811325,-464400,SELL
2020-10-06 09:57:00,09:57,8301800,7824400,-477400,SELL
2020-10-06 09:58:00,09:58,8275725,7839375,-436350,SELL
2020-10-06 09:59:00,09:59,8352900,7892750,-460150,SELL
2020-10-06 10:00:00,10:00,8353825,7912675,-441150,SELL
2020-10-06 10:01:00,10:01,8279850,7902750,-377100,SELL
2020-10-06 10:02:00,10:02,8328550,7970725,-357825,SELL
2020-10-06 10:03:00,10:03,8329800,7953825,-375975,SELL
2020-10-06 10:04:00,10:04,8336250,7962650,-373600,SELL
2020-10-06 10:05:00,10:05,8265150,7931600,-333550,SELL
2020-10-06 10:06:00,10:06,8272450,7906825,-365625,SELL
2020-10-06 10:07:00,10:07,8297200,7858350,-438850,SELL
2020-10-06 10:08:00,10:08,8321000,7989625,-331375,SELL
2020-10-06 10:09:00,10:09,8321000,7970325,-350675,SELL
2020-10-06 10:10:00,10:10,8384725,8001575,-383150,SELL
2020-10-06 10:11:00,10:11,8362075,7996000,-366075,SELL
2020-10-06 10:12:00,10:12,8341200,7993175,-348025,SELL
2020-10-06 10:13:00,10:13,8275250,7947350,-327900,SELL
2020-10-06 10:14:00,10:14,8368250,8030300,-337950,SELL
2020-10-06 10:15:00,10:15,8385375,8055075,-330300,SELL
2020-10-06 10:16:00,10:16,8338150,8051000,-287150,SELL
2020-10-06 10:17:00,10:17,8318600,8016300,-302300,SELL
2020-10-06 10:18:00,10:18,8343575,8054775,-288800,SELL
2020-10-06 10:19:00,10:19,8380650,8070075,-310575,SELL
2020-10-06 10:20:00,10:20,8411425,8116375,-295050,SELL
2020-10-06 10:21:00,10:21,8442975,8074850,-368125,SELL
2020-10-06 10:22:00,10:22,8344500,8067400,-277100,SELL
2020-10-06 10:23:00,10:23,8386225,8083700,-302525,SELL
2020-10-06 10:24:00,10:24,8477225,8108800,-368425,SELL
2020-10-06 10:25:00,10:25,8431375,8105100,-326275,SELL
2020-10-06 10:26:00,10:26,8330100,8133150,-196950,SELL
2020-10-06 10:27:00,10:27,8396125,8107500,-288625,SELL
2020-10-06 10:28:00,10:28,8264950,8059200,-205750,SELL
2020-10-06 10:29:00,10:29,8334800,8118625,-216175,SELL
2020-10-06 10:30:00,10:30,8473500,8186525,-286975,SELL
2020-10-06 10:31:00,10:31,8428150,8171350,-256800,SELL
2020-10-06 10:32:00,10:32,8458825,8160075,-298750,SELL
2020-10-06 10:33:00,10:33,8458675,8214875,-243800,SELL
2020-10-06 10:34:00,10:34,8429575,8163875,-265700,SELL
2020-10-06 10:35:00,10:35,8358525,8202000,-156525,SELL
2020-10-06 10:36:00,10:36,8378225,8195700,-182525,SELL
2020-10-06 10:37:00,10:37,8378225,8054425,-323800,SELL
2020-10-06 10:38:00,10:38,8405325,8115025,-290300,SELL
2020-10-06 10:39:00,10:39,8343700,8208600,-135100,SELL
2020-10-06 10:40:00,10:40,8467750,8099525,-368225,SELL
2020-10-06 10:41:00,10:41,8413075,8261600,-151475,SELL
2020-10-06 10:42:00,10:42,8470050,8240175,-229875,SELL
2020-10-06 10:43:00,10:43,8494150,8250900,-243250,SELL
2020-10-06 10:44:00,10:44,8520525,8305050,-215475,SELL
2020-10-06 10:45:00,10:45,8535300,8324700,-210600,SELL
2020-10-06 10:46:00,10:46,8514975,8305075,-209900,SELL
2020-10-06 10:47:00,10:47,8381900,8339175,-42725,SELL
2020-10-06 10:48:00,10:48,8427725,8385350,-42375,SELL
2020-10-06 10:49:00,10:49,8344400,8352725,8325,BUY
2020-10-06 10:50:00,10:50,8445850,8418125,-27725,SELL
2020-10-06 10:51:00,10:51,8429650,8419875,-9775,SELL
2020-10-06 10:52:00,10:52,8307975,8419475,111500,BUY
2020-10-06 10:53:00,10:53,8471675,8388125,-83550,SELL
2020-10-06 10:54:00,10:54,8381900,8353650,-28250,SELL
2020-10-06 10:55:00,10:55,8411875,8350850,-61025,SELL
2020-10-06 10:56:00,10:56,8538900,8387050,-151850,SELL
2020-10-06 10:57:00,10:57,8506075,8086100,-419975,SELL
2020-10-06 10:58:00,10:58,8382100,8406050,23950,BUY
2020-10-06 10:59:00,10:59,8495375,8400300,-95075,SELL
2020-10-06 11:00:00,11:00,8473175,8435250,-37925,SELL
2020-10-06 11:01:00,11:01,8481400,8443150,-38250,SELL
2020-10-06 11:02:00,11:02,8527825,8489525,-38300,SELL
2020-10-06 11:03:00,11:03,8394450,8379400,-15050,SELL
2020-10-06 11:04:00,11:04,8357300,8305650,-51650,SELL
2020-10-06 11:05:00,11:05,8540150,8529650,-10500,SELL
2020-10-06 11:06:00,11:06,8463875,8506800,42925,BUY
2020-10-06 11:07:00,11:07,8498500,8516800,18300,BUY
2020-10-06 11:08:00,11:08,8466050,8472925,6875,BUY
2020-10-06 11:09:00,11:09,8477250,8528150,50900,BUY
2020-10-06 11:10:00,11:10,8437200,8528425,91225,BUY
2020-10-06 11:11:00,11:11,8366675,8520600,153925,BUY
2020-10-06 11:12:00,11:12,8271775,8448825,177050,BUY
2020-10-06 11:13:00,11:13,8478900,8565025,86125,BUY
2020-10-06 11:14:00,11:14,8399400,8573375,173975,BUY
2020-10-06 11:15:00,11:15,8380400,8587075,206675,BUY
2020-10-06 11:16:00,11:16,8327200,8587075,259875,BUY
2020-10-06 11:17:00,11:17,8465725,8595200,129475,BUY
2020-10-06 11:18:00,11:18,8415975,8595000,179025,BUY
2020-10-06 11:19:00,11:19,8392300,8397750,5450,BUY
2020-10-06 11:20:00,11:20,8507375,8728200,220825,BUY
2020-10-06 11:21:00,11:21,8370850,8668300,297450,BUY
2020-10-06 11:22:00,11:22,8396375,8674525,278150,BUY
2020-10-06 11:23:00,11:23,8589450,8717950,128500,BUY
2020-10-06 11:24:00,11:24,8557100,8743600,186500,BUY
2020-10-06 11:25:00,11:25,8463075,8708850,245775,BUY
2020-10-06 11:26:00,11:26,8490025,8423375,-66650,SELL
2020-10-06 11:27:00,11:27,8592525,8774150,181625,BUY
2020-10-06 11:28:00,11:28,8470325,8456450,-13875,SELL
2020-10-06 11:29:00,11:29,8471550,8745525,273975,BUY
2020-10-06 11:30:00,11:30,8513100,8814500,301400,BUY
2020-10-06 11:31:00,11:31,8513100,8713650,200550,BUY
2020-10-06 11:32:00,11:32,8439350,8727775,288425,BUY
2020-10-06 11:33:00,11:33,8621950,8819900,197950,BUY
2020-10-06 11:34:00,11:34,8518325,8774600,256275,BUY
2020-10-06 11:35:00,11:35,8533425,8904325,370900,BUY
2020-10-06 11:36:00,11:36,8449225,8572625,123400,BUY
2020-10-06 11:37:00,11:37,8396300,8878550,482250,BUY
2020-10-06 11:38:00,11:38,8564000,9001300,437300,BUY
2020-10-06 11:39:00,11:39,8523900,8975600,451700,BUY
2020-10-06 11:40:00,11:40,8489725,8991225,501500,BUY
2020-10-06 11:41:00,11:41,8534675,8993950,459275,BUY
2020-10-06 11:42:00,11:42,8536325,9012400,476075,BUY
2020-10-06 11:43:00,11:43,8503375,8955550,452175,BUY
2020-10-06 11:44:00,11:44,8569175,9024650,455475,BUY
2020-10-06 11:45:00,11:45,8525575,9001750,476175,BUY
2020-10-06 11:46:00,11:46,8414525,8956225,541700,BUY
2020-10-06 11:47:00,11:47,8446475,9026275,579800,BUY
2020-10-06 11:48:00,11:48,8480900,9033875,552975,BUY
2020-10-06 11:49:00,11:49,8409600,8974250,564650,BUY
2020-10-06 11:50:00,11:50,8450050,9003700,553650,BUY
2020-10-06 11:51:00,11:51,8448925,8839725,390800,BUY
2020-10-06 11:52:00,11:52,8525625,9008875,483250,BUY
2020-10-06 11:53:00,11:53,8418825,8979075,560250,BUY
2020-10-06 11:54:00,11:54,8577500,9012525,435025,BUY
2020-10-06 11:55:00,11:55,8523925,8967750,443825,BUY
2020-10-06 11:56:00,11:56,8486525,9091325,604800,BUY
2020-10-06 11:57:00,11:57,8493525,8994175,500650,BUY
2020-10-06 11:58:00,11:58,8490825,9025175,534350,BUY
2020-10-06 11:59:00,11:59,8521950,9156875,634925,BUY
2020-10-06 12:00:00,12:00,8598100,9191875,593775,BUY
2020-10-06 12:01:00,12:01,8510350,9078950,568600,BUY
2020-10-06 12:02:00,12:02,8594725,9192475,597750,BUY
2020-10-06 12:03:00,12:03,8521000,9151650,630650,BUY
2020-10-06 12:04:00,12:04,8470800,9205700,734900,BUY
2020-10-06 12:05:00,12:05,8544175,9126225,582050,BUY
2020-10-06 12:06:00,12:06,8674650,9126825,452175,BUY
2020-10-06 12:07:00,12:07,8532425,9130375,597950,BUY
2020-10-06 12:08:00,12:08,8501100,9130475,629375,BUY
2020-10-06 12:09:00,12:09,8544650,9143425,598775,BUY
2020-10-06 12:10:00,12:10,8630825,9182650,551825,BUY
2020-10-06 12:11:00,12:11,8488600,9156125,667525,BUY
2020-10-06 12:12:00,12:12,8669325,9175025,505700,BUY
2020-10-06 12:13:00,12:13,8622600,9215075,592475,BUY
2020-10-06 12:14:00,12:14,8523700,9207975,684275,BUY
2020-10-06 12:15:00,12:15,8601325,9145300,543975,BUY
2020-10-06 12:16:00,12:16,8570925,9147850,576925,BUY
2020-10-06 12:17:00,12:17,8557500,9176025,618525,BUY
2020-10-06 12:18:00,12:18,8476825,9212575,735750,BUY
2020-10-06 12:19:00,12:19,8414075,9225425,811350,BUY
2020-10-06 12:20:00,12:20,8493675,8856575,362900,BUY
2020-10-06 12:21:00,12:21,8666825,9247525,580700,BUY
2020-10-06 12:22:00,12:22,8620525,9241750,621225,BUY
2020-10-06 12:23:00,12:23,8535575,9303775,768200,BUY
2020-10-06 12:24:00,12:24,8383700,9285800,902100,BUY
2020-10-06 12:25:00,12:25,8340000,9284800,944800,BUY
2020-10-06 12:26:00,12:26,8437150,9303725,866575,BUY
2020-10-06 12:27:00,12:27,8431750,9121825,690075,BUY
2020-10-06 12:28:00,12:28,8446650,9297350,850700,BUY
2020-10-06 12:29:00,12:29,8552725,9176025,623300,BUY
2020-10-06 12:30:00,12:30,8484825,9253375,768550,BUY
2020-10-06 12:31:00,12:31,8443700,9268025,824325,BUY
2020-10-06 12:32:00,12:32,8504100,9295675,791575,BUY
2020-10-06 12:33:00,12:33,8537950,9170850,632900,BUY
2020-10-06 12:34:00,12:34,8518975,9263900,744925,BUY
2020-10-06 12:35:00,12:35,8526325,9259875,733550,BUY
2020-10-06 12:36:00,12:36,8559175,9067225,508050,BUY
2020-10-06 12:37:00,12:37,8401425,9159175,757750,BUY
2020-10-06 12:38:00,12:38,8454025,9235850,781825,BUY
2020-10-06 12:39:00,12:39,8484125,8874650,390525,BUY
2020-10-06 12:40:00,12:40,8425650,9208375,782725,BUY
2020-10-06 12:41:00,12:41,8592200,9199300,607100,BUY
2020-10-06 12:42:00,12:42,8503700,9198675,694975,BUY
2020-10-06 12:43:00,12:43,8628975,9206275,577300,BUY
2020-10-06 12:44:00,12:44,8522075,9135550,613475,BUY
2020-10-06 12:45:00,12:45,8605200,9191825,586625,BUY
2020-10-06 12:46:00,12:46,8569325,9174525,605200,BUY
2020-10-06 12:47:00,12:47,8518325,9200350,682025,BUY
2020-10-06 12:48:00,12:48,8594125,9196325,602200,BUY
2020-10-06 12:49:00,12:49,8540350,9099575,559225,BUY
2020-10-06 12:50:00,12:50,8594300,9133125,538825,BUY
2020-10-06 12:51:00,12:51,8516900,9201625,684725,BUY
2020-10-06 12:52:00,12:52,8503075,9066475,563400,BUY
2020-10-06 12:53:00,12:53,8584100,9091350,507250,BUY
2020-10-06 12:54:00,12:54,8544300,9079475,535175,BUY
2020-10-06 12:55:00,12:55,8552400,9090800,538400,BUY
2020-10-06 12:56:00,12:56,8688725,9178525,489800,BUY
2020-10-06 12:57:00,12:57,8575000,9050275,475275,BUY
2020-10-06 12:58:00,12:58,8643950,9130000,486050,BUY
2020-10-06 12:59:00,12:59,8648825,9122525,473700,BUY
2020-10-06 13:00:00,13:00,8587250,9158975,571725,BUY
2020-10-06 13:01:00,13:01,8707575,9203875,496300,BUY
2020-10-06 13:02:00,13:02,8643325,9243000,599675,BUY
2020-10-06 13:03:00,13:03,8663350,9227075,563725,BUY
2020-10-06 13:04:00,13:04,8775750,9252000,476250,BUY
2020-10-06 13:05:00,13:05,8691700,9158800,467100,BUY
2020-10-06 13:06:00,13:06,8612250,9054800,442550,BUY
2020-10-06 13:07:00,13:07,8599075,9109450,510375,BUY
2020-10-06 13:08:00,13:08,8622600,9060825,438225,BUY
2020-10-06 13:09:00,13:09,8600625,8833250,232625,BUY
2020-10-06 13:10:00,13:10,8636325,9133075,496750,BUY
2020-10-06 13:11:00,13:11,8606525,9189750,583225,BUY
2020-10-06 13:12:00,13:12,8634175,9144225,510050,BUY
2020-10-06 13:13:00,13:13,8657325,9175550,518225,BUY
2020-10-06 13:14:00,13:14,8620075,9065000,444925,BUY
2020-10-06 13:15:00,13:15,8588800,9152875,564075,BUY
2020-10-06 13:16:00,13:16,8620450,9165375,544925,BUY
2020-10-06 13:17:00,13:17,8581575,9139600,558025,BUY
2020-10-06 13:18:00,13:18,8619950,9093000,473050,BUY
2020-10-06 13:19:00,13:19,8684725,9187725,503000,BUY
2020-10-06 13:20:00,13:20,8819700,9157750,338050,BUY
2020-10-06 13:21:00,13:21,8751275,9215250,463975,BUY
2020-10-06 13:22:00,13:22,8794925,9133350,338425,BUY
2020-10-06 13:23:00,13:23,8640750,9188325,547575,BUY
2020-10-06 13:24:00,13:24,8663400,8672825,9425,BUY
2020-10-06 13:25:00,13:25,8774975,9167900,392925,BUY
2020-10-06 13:26:00,13:26,8701350,9220150,518800,BUY
2020-10-06 13:27:00,13:27,8610775,9243700,632925,BUY
2020-10-06 13:28:00,13:28,8643950,9218400,574450,BUY
2020-10-06 13:29:00,13:29,8678450,9150550,472100,BUY
2020-10-06 13:30:00,13:30,8689200,9191275,502075,BUY
2020-10-06 13:31:00,13:31,8749925,9161875,411950,BUY
2020-10-06 13:32:00,13:32,8789425,9162650,373225,BUY
2020-10-06 13:33:00,13:33,8914625,9233275,318650,BUY
2020-10-06 13:34:00,13:34,8818200,9226875,408675,BUY
2020-10-06 13:35:00,13:35,8793500,9182375,388875,BUY
2020-10-06 13:36:00,13:36,8765925,9063200,297275,BUY
2020-10-06 13:37:00,13:37,8775675,9164775,389100,BUY
2020-10-06 13:38:00,13:38,8736425,9105050,368625,BUY
2020-10-06 13:39:00,13:39,8696825,9159950,463125,BUY
2020-10-06 13:40:00,13:40,8769800,9184975,415175,BUY
2020-10-06 13:41:00,13:41,8752825,9170350,417525,BUY
2020-10-06 13:42:00,13:42,8846075,9206375,360300,BUY
2020-10-06 13:43:00,13:43,8845650,9249125,403475,BUY
2020-10-06 13:44:00,13:44,8778300,9071275,292975,BUY
2020-10-06 13:45:00,13:45,8847850,9276250,428400,BUY
2020-10-06 13:46:00,13:46,8816450,9300425,483975,BUY
2020-10-06 13:47:00,13:47,8947850,9340725,392875,BUY
2020-10-06 13:48:00,13:48,8734200,9223250,489050,BUY
2020-10-06 13:49:00,13:49,8814700,8982575,167875,BUY
2020-10-06 13:50:00,13:50,8783275,9254600,471325,BUY
2020-10-06 13:51:00,13:51,8864450,9198075,333625,BUY
2020-10-06 13:52:00,13:52,8710425,9246550,536125,BUY
2020-10-06 13:53:00,13:53,8801425,9295725,494300,BUY
2020-10-06 13:54:00,13:54,8791775,9259600,467825,BUY
2020-10-06 13:55:00,13:55,8669575,9245575,576000,BUY
2020-10-06 13:56:00,13:56,8813475,9211000,397525,BUY
2020-10-06 13:57:00,13:57,8699325,9192325,493000,BUY
2020-10-06 13:58:00,13:58,8864450,9292725,428275,BUY
2020-10-06 13:59:00,13:59,8761025,9234850,473825,BUY
2020-10-06 14:00:00,14:00,8911450,9274150,362700,BUY
2020-10-06 14:01:00,14:01,8910625,9252675,342050,BUY
2020-10-06 14:02:00,14:02,8959975,9321200,361225,BUY
2020-10-06 14:03:00,14:03,8812325,9355675,543350,BUY
2020-10-06 14:04:00,14:04,8812325,9315275,502950,BUY
2020-10-06 14:05:00,14:05,8851975,9340250,488275,BUY
2020-10-06 14:06:00,14:06,8811650,9353275,541625,BUY
2020-10-06 14:07:00,14:07,8792225,9308100,515875,BUY
2020-10-06 14:08:00,14:08,8777825,9400100,622275,BUY
2020-10-06 14:09:00,14:09,8785750,9287200,501450,BUY
2020-10-06 14:10:00,14:10,8821500,9064375,242875,BUY
2020-10-06 14:11:00,14:11,8831150,9322725,491575,BUY
2020-10-06 14:12:00,14:12,8763775,9283750,519975,BUY
2020-10-06 14:13:00,14:13,8845425,9367575,522150,BUY
2020-10-06 14:14:00,14:14,8876900,9387700,510800,BUY
2020-10-06 14:15:00,14:15,8698125,9317075,618950,BUY
2020-10-06 14:16:00,14:16,8698125,9341975,643850,BUY
2020-10-06 14:17:00,14:17,8844500,9381725,537225,BUY
2020-10-06 14:18:00,14:18,8921150,9353400,432250,BUY
2020-10-06 14:19:00,14:19,8810500,9329450,518950,BUY
2020-10-06 14:20:00,14:20,8874600,9348600,474000,BUY
2020-10-06 14:21:00,14:21,8872475,9308150,435675,BUY
2020-10-06 14:22:00,14:22,8843850,9319700,475850,BUY
2020-10-06 14:23:00,14:23,8867875,9297550,429675,BUY
2020-10-06 14:24:00,14:24,8701950,9154800,452850,BUY
2020-10-06 14:25:00,14:25,8898125,9355975,457850,BUY
2020-10-06 14:26:00,14:26,8847675,9204875,357200,BUY
2020-10-06 14:27:00,14:27,8909675,9343325,433650,BUY
2020-10-06 14:28:00,14:28,8906700,9297600,390900,BUY
2020-10-06 14:29:00,14:29,8889025,9347600,458575,BUY
2020-10-06 14:30:00,14:30,8821825,9316575,494750,BUY
2020-10-06 14:31:00,14:31,8803950,9316575,512625,BUY
2020-10-06 14:32:00,14:32,8777050,9290650,513600,BUY
2020-10-06 14:33:00,14:33,8372700,9133200,760500,BUY
2020-10-06 14:34:00,14:34,8485425,9138150,652725,BUY
2020-10-06 14:35:00,14:35,8469075,9123125,654050,BUY
2020-10-06 14:36:00,14:36,7919700,9095725,1176025,BUY
2020-10-06 14:37:00,14:37,7939125,9060875,1121750,BUY
2020-10-06 14:38:00,14:38,7913800,9092500,1178700,BUY
2020-10-06 14:39:00,14:39,7949000,9082375,1133375,BUY
2020-10-06 14:40:00,14:40,7917950,9113550,1195600,BUY
2020-10-06 14:41:00,14:41,7916025,9094250,1178225,BUY
2020-10-06 14:42:00,14:42,7737525,9020575,1283050,BUY
2020-10-06 14:43:00,14:43,7719100,8977200,1258100,BUY
2020-10-06 14:44:00,14:44,7674100,9021625,1347525,BUY
2020-10-06 14:45:00,14:45,7630025,9116050,1486025,BUY
2020-10-06 14:46:00,14:46,7607875,9062800,1454925,BUY
2020-10-06 14:47:00,14:47,7685150,9133800,1448650,BUY
2020-10-06 14:48:00,14:48,7620050,9090450,1470400,BUY
2020-10-06 14:49:00,14:49,7629700,9153925,1524225,BUY
2020-10-06 14:50:00,14:50,7499900,9156675,1656775,BUY
2020-10-06 14:51:00,14:51,7512800,9006875,1494075,BUY
2020-10-06 14:52:00,14:52,7436900,9004350,1567450,BUY
2020-10-06 14:53:00,14:53,7479925,9002000,1522075,BUY
2020-10-06 14:54:00,14:54,7498250,9028775,1530525,BUY
2020-10-06 14:55:00,14:55,7541475,9036225,1494750,BUY
2020-10-06 14:56:00,14:56,7573800,9034500,1460700,BUY
2020-10-06 14:57:00,14:57,7473625,8996500,1522875,BUY
2020-10-06 14:58:00,14:58,7509350,8994325,1484975,BUY
2020-10-06 14:59:00,14:59,7412725,8951850,1539125,BUY
2020-10-06 15:00:00,15:00,7498700,9040675,1541975,BUY
2020-10-06 15:01:00,15:01,7585400,9053900,1468500,BUY
2020-10-06 15:02:00,15:02,7533450,9031900,1498450,BUY
2020-10-06 15:03:00,15:03,7398625,9036100,1637475,BUY
2020-10-06 15:04:00,15:04,7419425,9050250,1630825,BUY
2020-10-06 15:05:00,15:05,7347125,9047975,1700850,BUY
2020-10-06 15:06:00,15:06,7344900,8984250,1639350,BUY
2020-10-06 15:07:00,15:07,7326400,8935850,1609450,BUY
2020-10-06 15:08:00,15:08,7377875,9001225,1623350,BUY
2020-10-06 15:09:00,15:09,7379800,8935375,1555575,BUY
2020-10-06 15:10:00,15:10,7327375,8953575,1626200,BUY
2020-10-06 15:11:00,15:11,7275675,8947025,1671350,BUY
2020-10-06 15:12:00,15:12,7186850,8881600,1694750,BUY
2020-10-06 15:13:00,15:13,7270375,8884350,1613975,BUY
2020-10-06 15:14:00,15:14,7276825,8855100,1578275,BUY
2020-10-06 15:15:00,15:15,7141100,8693725,1552625,BUY
2020-10-06 15:16:00,15:16,7108750,8675025,1566275,BUY
2020-10-06 15:17:00,15:17,7130675,8707200,1576525,BUY
2020-10-06 15:18:00,15:18,7082675,8493725,1411050,BUY
2020-10-06 15:19:00,15:19,6993675,8484825,1491150,BUY
2020-10-06 15:20:00,15:20,7037475,8499275,1461800,BUY
2020-10-06 15:21:00,15:21,6870275,8234925,1364650,BUY
2020-10-06 15:22:00,15:22,6806725,8229475,1422750,BUY
2020-10-06 15:23:00,15:23,6720675,8219200,1498525,BUY
2020-10-06 15:24:00,15:24,6646325,8017250,1370925,BUY
2020-10-06 15:25:00,15:25,6687675,8022650,1334975,BUY
2020-10-06 15:26:00,15:26,6651450,7997800,1346350,BUY
2020-10-06 15:27:00,15:27,6374925,7779500,1404575,BUY
2020-10-06 15:28:00,15:28,6388325,7799875,1411550,BUY
2020-10-06 15:29:00,15:29,6415700,7793000,1377300,BUY
2020-10-07 09:15:00,09:15,6137375,7465375,1328000,BUY
2020-10-07 09:16:00,09:16,6076400,7456950,1380550,BUY
2020-10-07 09:17:00,09:17,6468450,8096525,1628075,BUY
2020-10-07 09:18:00,09:18,6484375,8085000,1600625,BUY
2020-10-07 09:19:00,09:19,6499425,8099200,1599775,BUY
2020-10-07 09:20:00,09:20,6927700,8715000,1787300,BUY
2020-10-07 09:21:00,09:21,6838700,8718100,1879400,BUY
2020-10-07 09:22:00,09:22,6891975,8715975,1824000,BUY
2020-10-07 09:23:00,09:23,7433600,8952750,1519150,BUY
2020-10-07 09:24:00,09:24,7409550,8946775,1537225,BUY
2020-10-07 09:25:00,09:25,7469825,9006125,1536300,BUY
2020-10-07 09:26:00,09:26,7760825,9207825,1447000,BUY
2020-10-07 09:27:00,09:27,7661350,9211225,1549875,BUY
2020-10-07 09:28:00,09:28,7731700,9204700,1473000,BUY
2020-10-07 09:29:00,09:29,7828850,9276400,1447550,BUY
2020-10-07 09:30:00,09:30,7913050,9259350,1346300,BUY
2020-10-07 09:31:00,09:31,7919250,9252800,1333550,BUY
2020-10-07 09:32:00,09:32,8097450,9453550,1356100,BUY
2020-10-07 09:33:00,09:33,8163525,9453550,1290025,BUY
2020-10-07 09:34:00,09:34,8124650,9436250,1311600,BUY
2020-10-07 09:35:00,09:35,8309225,9563375,1254150,BUY
2020-10-07 09:36:00,09:36,8378925,9608350,1229425,BUY
2020-10-07 09:37:00,09:37,8470375,9558775,1088400,BUY
2020-10-07 09:38:00,09:38,8485500,9566500,1081000,BUY
2020-10-07 09:39:00,09:39,8566800,9566950,1000150,BUY
2020-10-07 09:40:00,09:40,8523800,9548625,1024825,BUY
2020-10-07 09:41:00,09:41,8470075,9552825,1082750,BUY
2020-10-07 09:42:00,09:42,8488475,9573925,1085450,BUY
2020-10-07 09:43:00,09:43,8461975,9537200,1075225,BUY
2020-10-07 09:44:00,09:44,8612450,9570325,957875,BUY
2020-10-07 09:45:00,09:45,8598575,9615925,1017350,BUY
2020-10-07 09:46:00,09:46,8507925,9611925,1104000,BUY
2020-10-07 09:47:00,09:47,8550275,9676700,1126425,BUY
2020-10-07 09:48:00,09:48,8567875,9607675,1039800,BUY
2020-10-07 09:49:00,09:49,8593725,9664600,1070875,BUY
2020-10-07 09:50:00,09:50,8644925,9592400,947475,BUY
2020-10-07 09:51:00,09:51,8701175,9678425,977250,BUY
2020-10-07 09:52:00,09:52,8838475,9670850,832375,BUY
2020-10-07 09:53:00,09:53,8317075,9780450,1463375,BUY
2020-10-07 09:54:00,09:54,8263375,9780450,1517075,BUY
2020-10-07 09:55:00,09:55,8282125,9775250,1493125,BUY
2020-10-07 09:56:00,09:56,7828700,9734275,1905575,BUY
2020-10-07 09:57:00,09:57,7779500,9734600,1955100,BUY
2020-10-07 09:58:00,09:58,7805600,9745450,1939850,BUY
2020-10-07 09:59:00,09:59,7614650,9903150,2288500,BUY
2020-10-07 10:00:00,10:00,7697875,9899275,2201400,BUY
2020-10-07 10:01:00,10:01,7698500,9906150,2207650,BUY
2020-10-07 10:02:00,10:02,7728475,10159650,2431175,BUY
2020-10-07 10:03:00,10:03,7781025,10156875,2375850,BUY
2020-10-07 10:04:00,10:04,7745150,10121050,2375900,BUY
2020-10-07 10:05:00,10:05,7953775,10287850,2334075,BUY
2020-10-07 10:06:00,10:06,7937050,10300125,2363075,BUY
2020-10-07 10:07:00,10:07,7937050,10246225,2309175,BUY
2020-10-07 10:08:00,10:08,8043850,10350600,2306750,BUY
2020-10-07 10:09:00,10:09,7994200,10344200,2350000,BUY
2020-10-07 10:10:00,10:10,8034700,10384425,2349725,BUY
2020-10-07 10:11:00,10:11,8187100,10367550,2180450,BUY
2020-10-07 10:12:00,10:12,8158250,10263900,2105650,BUY
2020-10-07 10:13:00,10:13,8250075,10428150,2178075,BUY
2020-10-07 10:14:00,10:14,8153025,10480125,2327100,BUY
2020-10-07 10:15:00,10:15,8201100,10465150,2264050,BUY
2020-10-07 10:16:00,10:16,8239600,10499150,2259550,BUY
2020-10-07 10:17:00,10:17,8314325,10521050,2206725,BUY
2020-10-07 10:18:00,10:18,8344700,10500775,2156075,BUY
2020-10-07 10:19:00,10:19,8361425,10465625,2104200,BUY
2020-10-07 10:20:00,10:20,8452550,10597975,2145425,BUY
2020-10-07 10:21:00,10:21,8478050,10540900,2062850,BUY
2020-10-07 10:22:00,10:22,8419700,10581925,2162225,BUY
2020-10-07 10:23:00,10:23,8419075,10592900,2173825,BUY
2020-10-07 10:24:00,10:24,8450975,10513475,2062500,BUY
2020-10-07 10:25:00,10:25,8409075,10592900,2183825,BUY
2020-10-07 10:26:00,10:26,8420200,10663200,2243000,BUY
2020-10-07 10:27:00,10:27,8414650,10720825,2306175,BUY
2020-10-07 10:28:00,10:28,8397575,10708925,2311350,BUY
2020-10-07 10:29:00,10:29,8256675,10702300,2445625,BUY
2020-10-07 10:30:00,10:30,8420500,10717825,2297325,BUY
2020-10-07 10:31:00,10:31,8493850,10832275,2338425,BUY
2020-10-07 10:32:00,10:32,8135700,10856875,2721175,BUY
2020-10-07 10:33:00,10:33,8338075,10569375,2231300,BUY
2020-10-07 10:34:00,10:34,8439950,10697675,2257725,BUY
2020-10-07 10:35:00,10:35,8530225,10571550,2041325,BUY
2020-10-07 10:36:00,10:36,8440025,10801175,2361150,BUY
2020-10-07 10:37:00,10:37,8452625,10516475,2063850,BUY
2020-10-07 10:38:00,10:38,8545825,10737800,2191975,BUY
2020-10-07 10:39:00,10:39,8665200,10812450,2147250,BUY
2020-10-07 10:40:00,10:40,8648975,10756825,2107850,BUY
2020-10-07 10:41:00,10:41,8491350,10710275,2218925,BUY
2020-10-07 10:42:00,10:42,8543625,10738650,2195025,BUY
2020-10-07 10:43:00,10:43,8564975,10356700,1791725,BUY
2020-10-07 10:44:00,10:44,8824225,10915400,2091175,BUY
2020-10-07 10:45:00,10:45,8742975,10553300,1810325,BUY
2020-10-07 10:46:00,10:46,8696075,10895950,2199875,BUY
2020-10-07 10:47:00,10:47,8711725,10935400,2223675,BUY
2020-10-07 10:48:00,10:48,8721250,10877800,2156550,BUY
2020-10-07 10:49:00,10:49,8491775,10895700,2403925,BUY
2020-10-07 10:50:00,10:50,8801650,10825350,2023700,BUY
2020-10-07 10:51:00,10:51,8714250,10809750,2095500,BUY
2020-10-07 10:52:00,10:52,8793675,10869550,2075875,BUY
2020-10-07 10:53:00,10:53,8878725,10865550,1986825,BUY
2020-10-07 10:54:00,10:54,8886775,10860050,1973275,BUY
2020-10-07 10:55:00,10:55,9001075,10949075,1948000,BUY
2020-10-07 10:56:00,10:56,8979525,10773875,1794350,BUY
2020-10-07 10:57:00,10:57,9003500,10757000,1753500,BUY
2020-10-07 10:58:00,10:58,8857075,10720325,1863250,BUY
2020-10-07 10:59:00,10:59,8966500,10809425,1842925,BUY
2020-10-07 11:00:00,11:00,9075325,10806100,1730775,BUY
2020-10-07 11:01:00,11:01,9071725,10763575,1691850,BUY
2020-10-07 11:02:00,11:02,9281450,10689650,1408200,BUY
2020-10-07 11:03:00,11:03,9140600,10636000,1495400,BUY
2020-10-07 11:04:00,11:04,9140600,10666275,1525675,BUY
2020-10-07 11:05:00,11:05,9129025,10614875,1485850,BUY
2020-10-07 11:06:00,11:06,9113775,10586150,1472375,BUY
2020-10-07 11:07:00,11:07,9096100,10638425,1542325,BUY
2020-10-07 11:08:00,11:08,9200300,10730800,1530500,BUY
2020-10-07 11:09:00,11:09,9215100,10726850,1511750,BUY
2020-10-07 11:10:00,11:10,9241125,10706275,1465150,BUY
2020-10-07 11:11:00,11:11,9103375,10627950,1524575,BUY
2020-10-07 11:12:00,11:12,9137400,10651800,1514400,BUY
2020-10-07 11:13:00,11:13,9200600,10588100,1387500,BUY
2020-10-07 11:14:00,11:14,9275700,10363025,1087325,BUY
2020-10-07 11:15:00,11:15,9239475,10588925,1349450,BUY
2020-10-07 11:16:00,11:16,9278500,10632050,1353550,BUY
2020-10-07 11:17:00,11:17,9310025,10638025,1328000,BUY
2020-10-07 11:18:00,11:18,9288500,10555025,1266525,BUY
2020-10-07 11:19:00,11:19,9388175,10667025,1278850,BUY
2020-10-07 11:20:00,11:20,9374525,10629475,1254950,BUY
2020-10-07 11:21:00,11:21,9390700,10617550,1226850,BUY
2020-10-07 11:22:00,11:22,9161450,10605300,1443850,BUY
2020-10-07 11:23:00,11:23,9163500,10511525,1348025,BUY
2020-10-07 11:24:00,11:24,9363500,10545675,1182175,BUY
2020-10-07 11:25:00,11:25,9422325,10472925,1050600,BUY
2020-10-07 11:26:00,11:26,9456100,10540675,1084575,BUY
2020-10-07 11:27:00,11:27,9276850,10618700,1341850,BUY
2020-10-07 11:28:00,11:28,9407025,10589925,1182900,BUY
2020-10-07 11:29:00,11:29,9508725,10659750,1151025,BUY
2020-10-07 11:30:00,11:30,9611975,10533500,921525,BUY
2020-10-07 11:31:00,11:31,9496200,10631600,1135400,BUY
2020-10-07 11:32:00,11:32,9589750,9944125,354375,BUY
2020-10-07 11:33:00,11:33,9538850,10234650,695800,BUY
2020-10-07 11:34:00,11:34,9538850,10624550,1085700,BUY
2020-10-07 11:35:00,11:35,9717025,10693075,976050,BUY
2020-10-07 11:36:00,11:36,9690450,10671650,981200,BUY
2020-10-07 11:37:00,11:37,9623475,10688300,1064825,BUY
2020-10-07 11:38:00,11:38,9796375,10738675,942300,BUY
2020-10-07 11:39:00,11:39,9556325,9979275,422950,BUY
2020-10-07 11:40:00,11:40,9868425,10733850,865425,BUY
2020-10-07 11:41:00,11:41,9767250,10767650,1000400,BUY
2020-10-07 11:42:00,11:42,9764825,10705725,940900,BUY
2020-10-07 11:43:00,11:43,9641525,10800175,1158650,BUY
2020-10-07 11:44:00,11:44,9751175,10811425,1060250,BUY
2020-10-07 11:45:00,11:45,9792650,10670825,878175,BUY
2020-10-07 11:46:00,11:46,9823950,10739200,915250,BUY
2020-10-07 11:47:00,11:47,9757600,10743725,986125,BUY
2020-10-07 11:48:00,11:48,9755275,10871575,1116300,BUY
2020-10-07 11:49:00,11:49,9590425,10733625,1143200,BUY
2020-10-07 11:50:00,11:50,9559475,10805025,1245550,BUY
2020-10-07 11:51:00,11:51,9484225,10431500,947275,BUY
2020-10-07 11:52:00,11:52,9719425,10222500,503075,BUY
2020-10-07 11:53:00,11:53,9738475,10803475,1065000,BUY
2020-10-07 11:54:00,11:54,9579750,10724425,1144675,BUY
2020-10-07 11:55:00,11:55,9796900,10876725,1079825,BUY
2020-10-07 11:56:00,11:56,9738075,10895050,1156975,BUY
2020-10-07 11:57:00,11:57,9738100,10773225,1035125,BUY
2020-10-07 11:58:00,11:58,9797075,10756450,959375,BUY
2020-10-07 11:59:00,11:59,9758525,10473075,714550,BUY
2020-10-07 12:00:00,12:00,9836050,10915175,1079125,BUY
2020-10-07 12:01:00,12:01,9660025,10883625,1223600,BUY
2020-10-07 12:02:00,12:02,9745250,10909000,1163750,BUY
2020-10-07 12:03:00,12:03,9720925,10987125,1266200,BUY
2020-10-07 12:04:00,12:04,9868300,10914675,1046375,BUY
2020-10-07 12:05:00,12:05,9863850,11000025,1136175,BUY
2020-10-07 12:06:00,12:06,9883175,10621050,737875,BUY
2020-10-07 12:07:00,12:07,9684700,10874350,1189650,BUY
2020-10-07 12:08:00,12:08,9729375,11059375,1330000,BUY
2020-10-07 12:09:00,12:09,9642150,10950125,1307975,BUY
2020-10-07 12:10:00,12:10,9827025,10968250,1141225,BUY
2020-10-07 12:11:00,12:11,9794525,10885775,1091250,BUY
2020-10-07 12:12:00,12:12,9936450,11094925,1158475,BUY
2020-10-07 12:13:00,12:13,9864350,11072450,1208100,BUY
2020-10-07 12:14:00,12:14,9876825,11128275,1251450,BUY
2020-10-07 12:15:00,12:15,9846450,11049525,1203075,BUY
2020-10-07 12:16:00,12:16,9766725,11055575,1288850,BUY
2020-10-07 12:17:00,12:17,9780325,11068650,1288325,BUY
2020-10-07 12:18:00,12:18,10022225,11113750,1091525,BUY
2020-10-07 12:19:00,12:19,9637775,10978400,1340625,BUY
2020-10-07 12:20:00,12:20,9962600,11077275,1114675,BUY
2020-10-07 12:21:00,12:21,9882225,11052575,1170350,BUY
2020-10-07 12:22:00,12:22,9880050,10708225,828175,BUY
2020-10-07 12:23:00,12:23,9763275,10471525,708250,BUY
2020-10-07 12:24:00,12:24,9956750,11182200,1225450,BUY
2020-10-07 12:25:00,12:25,9884925,11124900,1239975,BUY
2020-10-07 12:26:00,12:26,9944550,11195150,1250600,BUY
2020-10-07 12:27:00,12:27,9905050,11179000,1273950,BUY
2020-10-07 12:28:00,12:28,9930500,11089975,1159475,BUY
2020-10-07 12:29:00,12:29,9923075,10885475,962400,BUY
2020-10-07 12:30:00,12:30,9939475,11194275,1254800,BUY
2020-10-07 12:31:00,12:31,10000225,11241375,1241150,BUY
2020-10-07 12:32:00,12:32,9892950,11248600,1355650,BUY
2020-10-07 12:33:00,12:33,9737225,11206850,1469625,BUY
2020-10-07 12:34:00,12:34,9790900,11002900,1212000,BUY
2020-10-07 12:35:00,12:35,9939000,11318200,1379200,BUY
2020-10-07 12:36:00,12:36,9856950,11243875,1386925,BUY
2020-10-07 12:37:00,12:37,9960125,11323900,1363775,BUY
2020-10-07 12:38:00,12:38,9893475,11413350,1519875,BUY
2020-10-07 12:39:00,12:39,9949325,11278525,1329200,BUY
2020-10-07 12:40:00,12:40,9950725,11356550,1405825,BUY
2020-10-07 12:41:00,12:41,9979175,11343400,1364225,BUY
2020-10-07 12:42:00,12:42,9932800,11227125,1294325,BUY
2020-10-07 12:43:00,12:43,9951800,11279350,1327550,BUY
2020-10-07 12:44:00,12:44,9874950,11453700,1578750,BUY
2020-10-07 12:45:00,12:45,9780525,11385250,1604725,BUY
2020-10-07 12:46:00,12:46,9681500,11444175,1762675,BUY
2020-10-07 12:47:00,12:47,9536375,11442375,1906000,BUY
2020-10-07 12:48:00,12:48,9472375,11461375,1989000,BUY
2020-10-07 12:49:00,12:49,9549675,11458100,1908425,BUY
2020-10-07 12:50:00,12:50,9476825,11434475,1957650,BUY
2020-10-07 12:51:00,12:51,9507900,11474950,1967050,BUY
2020-10-07 12:52:00,12:52,9524475,11382725,1858250,BUY
2020-10-07 12:53:00,12:53,9569650,11458800,1889150,BUY
2020-10-07 12:54:00,12:54,9303250,11423900,2120650,BUY
2020-10-07 12:55:00,12:55,9442275,11493250,2050975,BUY
2020-10-07 12:56:00,12:56,9486050,11535025,2048975,BUY
2020-10-07 12:57:00,12:57,9572100,11502025,1929925,BUY
2020-10-07 12:58:00,12:58,9437150,11189100,1751950,BUY
2020-10-07 12:59:00,12:59,9597325,11599100,2001775,BUY
2020-10-07 13:00:00,13:00,9713350,11621925,1908575,BUY
2020-10-07 13:01:00,13:01,9436850,11574550,2137700,BUY
2020-10-07 13:02:00,13:02,9611650,11583175,1971525,BUY
2020-10-07 13:03:00,13:03,9457350,11597400,2140050,BUY
2020-10-07 13:04:00,13:04,9455275,11608900,2153625,BUY
2020-10-07 13:05:00,13:05,9467250,11632150,2164900,BUY
2020-10-07 13:06:00,13:06,9588625,11661750,2073125,BUY
2020-10-07 13:07:00,13:07,9539125,11583800,2044675,BUY
2020-10-07 13:08:00,13:08,9569500,11548700,1979200,BUY
2020-10-07 13:09:00,13:09,9658250,11547225,1888975,BUY
2020-10-07 13:10:00,13:10,9682925,11538925,1856000,BUY
2020-10-07 13:11:00,13:11,9631475,11459575,1828100,BUY
2020-10-07 13:12:00,13:12,9504525,11451850,1947325,BUY
2020-10-07 13:13:00,13:13,9696425,11588750,1892325,BUY
2020-10-07 13:14:00,13:14,9658525,11534600,1876075,BUY
2020-10-07 13:15:00,13:15,9689550,11580050,1890500,BUY
2020-10-07 13:16:00,13:16,9773200,11581050,1807850,BUY
2020-10-07 13:17:00,13:17,9802750,11560675,1757925,BUY
2020-10-07 13:18:00,13:18,9770300,11575375,1805075,BUY
2020-10-07 13:19:00,13:19,9813750,11568000,1754250,BUY
2020-10-07 13:20:00,13:20,9820875,11596050,1775175,BUY
2020-10-07 13:21:00,13:21,9791525,11430600,1639075,BUY
2020-10-07 13:22:00,13:22,9760275,11392050,1631775,BUY
2020-10-07 13:23:00,13:23,9791875,11441800,1649925,BUY
2020-10-07 13:24:00,13:24,9799750,11489425,1689675,BUY
2020-10-07 13:25:00,13:25,9903900,11546450,1642550,BUY
2020-10-07 13:26:00,13:26,9877425,11466450,1589025,BUY
2020-10-07 13:27:00,13:27,9640350,11499450,1859100,BUY
2020-10-07 13:28:00,13:28,9745800,11521650,1775850,BUY
2020-10-07 13:29:00,13:29,9697050,11457525,1760475,BUY
2020-10-07 13:30:00,13:30,9534825,11456375,1921550,BUY
2020-10-07 13:31:00,13:31,9771075,11202850,1431775,BUY
2020-10-07 13:32:00,13:32,9761275,11513975,1752700,BUY
2020-10-07 13:33:00,13:33,9867450,11549925,1682475,BUY
2020-10-07 13:34:00,13:34,9769525,11415900,1646375,BUY
2020-10-07 13:35:00,13:35,9925375,11503875,1578500,BUY
2020-10-07 13:36:00,13:36,9724700,11509850,1785150,BUY
2020-10-07 13:37:00,13:37,9636675,11296575,1659900,BUY
2020-10-07 13:38:00,13:38,9921475,11621575,1700100,BUY
2020-10-07 13:39:00,13:39,9954725,11208075,1253350,BUY
2020-10-07 13:40:00,13:40,9939325,11508175,1568850,BUY
2020-10-07 13:41:00,13:41,9910775,11526775,1616000,BUY
2020-10-07 13:42:00,13:42,10028475,11532275,1503800,BUY
2020-10-07 13:43:00,13:43,9897350,11440750,1543400,BUY
2020-10-07 13:44:00,13:44,9877900,11439150,1561250,BUY
2020-10-07 13:45:00,13:45,10103375,11210225,1106850,BUY
2020-10-07 13:46:00,13:46,9916850,11542725,1625875,BUY
2020-10-07 13:47:00,13:47,10175825,11568400,1392575,BUY
2020-10-07 13:48:00,13:48,10019450,11703475,1684025,BUY
2020-10-07 13:49:00,13:49,9863800,11623025,1759225,BUY
2020-10-07 13:50:00,13:50,10058250,11626025,1567775,BUY
2020-10-07 13:51:00,13:51,9768375,11684350,1915975,BUY
2020-10-07 13:52:00,13:52,9859075,11661075,1802000,BUY
2020-10-07 13:53:00,13:53,9900000,11681150,1781150,BUY
2020-10-07 13:54:00,13:54,9764600,11627100,1862500,BUY
2020-10-07 13:55:00,13:55,10064225,11778900,1714675,BUY
2020-10-07 13:56:00,13:56,10033075,11731325,1698250,BUY
2020-10-07 13:57:00,13:57,9922925,11699900,1776975,BUY
2020-10-07 13:58:00,13:58,9966125,11674425,1708300,BUY
2020-10-07 13:59:00,13:59,10030175,11748600,1718425,BUY
2020-10-07 14:00:00,14:00,10218025,11740925,1522900,BUY
2020-10-07 14:01:00,14:01,10173075,11735900,1562825,BUY
2020-10-07 14:02:00,14:02,10038850,11710975,1672125,BUY
2020-10-07 14:03:00,14:03,10036550,11491025,1454475,BUY
2020-10-07 14:04:00,14:04,9816750,11394375,1577625,BUY
2020-10-07 14:05:00,14:05,9906525,11432200,1525675,BUY
2020-10-07 14:06:00,14:06,10222300,11458025,1235725,BUY
2020-10-07 14:07:00,14:07,10111000,11403500,1292500,BUY
2020-10-07 14:08:00,14:08,10137475,11429750,1292275,BUY
2020-10-07 14:09:00,14:09,10144800,11507550,1362750,BUY
2020-10-07 14:10:00,14:10,10105900,11471300,1365400,BUY
2020-10-07 14:11:00,14:11,10075350,11441950,1366600,BUY
2020-10-07 14:12:00,14:12,10069275,11510125,1440850,BUY
2020-10-07 14:13:00,14:13,10094900,11577525,1482625,BUY
2020-10-07 14:14:00,14:14,9887025,11547675,1660650,BUY
2020-10-07 14:15:00,14:15,10048800,11660975,1612175,BUY
2020-10-07 14:16:00,14:16,10073025,11689075,1616050,BUY
2020-10-07 14:17:00,14:17,10016150,11668275,1652125,BUY
2020-10-07 14:18:00,14:18,9982500,11660525,1678025,BUY
2020-10-07 14:19:00,14:19,9928875,11647675,1718800,BUY
2020-10-07 14:20:00,14:20,10028950,11558250,1529300,BUY
2020-10-07 14:21:00,14:21,9984200,11718725,1734525,BUY
2020-10-07 14:22:00,14:22,9926875,11615200,1688325,BUY
2020-10-07 14:23:00,14:23,9997025,11657350,1660325,BUY
2020-10-07 14:24:00,14:24,10084750,11366625,1281875,BUY
2020-10-07 14:25:00,14:25,9965350,11632075,1666725,BUY
2020-10-07 14:26:00,14:26,10085050,11668375,1583325,BUY
2020-10-07 14:27:00,14:27,10116700,11768850,1652150,BUY
2020-10-07 14:28:00,14:28,10142025,11768000,1625975,BUY
2020-10-07 14:29:00,14:29,10059825,11703250,1643425,BUY
2020-10-07 14:30:00,14:30,10060325,11702025,1641700,BUY
2020-10-07 14:31:00,14:31,10121700,11748375,1626675,BUY
2020-10-07 14:32:00,14:32,10182025,11817925,1635900,BUY
2020-10-07 14:33:00,14:33,9939025,11791225,1852200,BUY
2020-10-07 14:34:00,14:34,9968150,11736525,1768375,BUY
2020-10-07 14:35:00,14:35,9913050,11754275,1841225,BUY
2020-10-07 14:36:00,14:36,9760675,11767125,2006450,BUY
2020-10-07 14:37:00,14:37,9668850,11761750,2092900,BUY
2020-10-07 14:38:00,14:38,9731350,11742850,2011500,BUY
2020-10-07 14:39:00,14:39,9648150,11708325,2060175,BUY
2020-10-07 14:40:00,14:40,9665400,11674300,2008900,BUY
2020-10-07 14:41:00,14:41,9659800,11730825,2071025,BUY
2020-10-07 14:42:00,14:42,9665425,11691050,2025625,BUY
2020-10-07 14:43:00,14:43,9665175,11738600,2073425,BUY
2020-10-07 14:44:00,14:44,9731675,11666900,1935225,BUY
2020-10-07 14:45:00,14:45,9885750,11818150,1932400,BUY
2020-10-07 14:46:00,14:46,9825750,11806800,1981050,BUY
2020-10-07 14:47:00,14:47,9870975,11798625,1927650,BUY
2020-10-07 14:48:00,14:48,9737375,11617300,1879925,BUY
2020-10-07 14:49:00,14:49,9813000,11632125,1819125,BUY
2020-10-07 14:50:00,14:50,9793175,11616825,1823650,BUY
2020-10-07 14:51:00,14:51,9815775,11604250,1788475,BUY
2020-10-07 14:52:00,14:52,9896825,11643975,1747150,BUY
2020-10-07 14:53:00,14:53,9846750,11615650,1768900,BUY
2020-10-07 14:54:00,14:54,9825425,11608775,1783350,BUY
2020-10-07 14:55:00,14:55,9951275,11653175,1701900,BUY
2020-10-07 14:56:00,14:56,9951300,11628575,1677275,BUY
2020-10-07 14:57:00,14:57,10001675,11597450,1595775,BUY
2020-10-07 14:58:00,14:58,10009375,11585675,1576300,BUY
2020-10-07 14:59:00,14:59,10047125,11600450,1553325,BUY
2020-10-07 15:00:00,15:00,9999525,11578975,1579450,BUY
2020-10-07 15:01:00,15:01,9994350,11592000,1597650,BUY
2020-10-07 15:02:00,15:02,9950300,11596425,1646125,BUY
2020-10-07 15:03:00,15:03,9906275,11493775,1587500,BUY
2020-10-07 15:04:00,15:04,9657975,11416075,1758100,BUY
2020-10-07 15:05:00,15:05,9829475,11460200,1630725,BUY
2020-10-07 15:06:00,15:06,9720725,11456425,1735700,BUY
2020-10-07 15:07:00,15:07,9781925,11433550,1651625,BUY
2020-10-07 15:08:00,15:08,9727275,11285400,1558125,BUY
2020-10-07 15:09:00,15:09,9711650,11363350,1651700,BUY
2020-10-07 15:10:00,15:10,9777125,11386625,1609500,BUY
2020-10-07 15:11:00,15:11,9738125,11308775,1570650,BUY
2020-10-07 15:12:00,15:12,9529175,11210700,1681525,BUY
2020-10-07 15:13:00,15:13,9655000,11235125,1580125,BUY
2020-10-07 15:14:00,15:14,9635450,11212225,1576775,BUY
2020-10-07 15:15:00,15:15,9356850,10946250,1589400,BUY
2020-10-07 15:16:00,15:16,9410325,10936525,1526200,BUY
2020-10-07 15:17:00,15:17,9434025,10965200,1531175,BUY
2020-10-07 15:18:00,15:18,9221900,10806000,1584100,BUY
2020-10-07 15:19:00,15:19,9222150,10798000,1575850,BUY
2020-10-07 15:20:00,15:20,9296975,10805900,1508925,BUY
2020-10-07 15:21:00,15:21,8897150,10416975,1519825,BUY
2020-10-07 15:22:00,15:22,8816475,10415500,1599025,BUY
2020-10-07 15:23:00,15:23,8845975,10379775,1533800,BUY
2020-10-07 15:24:00,15:24,8648600,10218100,1569500,BUY
2020-10-07 15:25:00,15:25,8713100,10192950,1479850,BUY
2020-10-07 15:26:00,15:26,8674775,10205700,1530925,BUY
2020-10-07 15:27:00,15:27,8338375,9856425,1518050,BUY
2020-10-07 15:28:00,15:28,8368500,9853975,1485475,BUY
2020-10-07 15:29:00,15:29,8271950,9863225,1591275,BUY
2020-10-08 09:15:00,09:15,7885500,9378725,1493225,BUY
2020-10-08 09:16:00,09:16,7813125,9390675,1577550,BUY
2020-10-08 09:17:00,09:17,8733050,10481575,1748525,BUY
2020-10-08 09:18:00,09:18,8761450,10477575,1716125,BUY
2020-10-08 09:19:00,09:19,8847150,10433600,1586450,BUY
2020-10-08 09:20:00,09:20,9672350,11766250,2093900,BUY
2020-10-08 09:21:00,09:21,9679050,11782425,2103375,BUY
2020-10-08 09:22:00,09:22,9688825,11709250,2020425,BUY
2020-10-08 09:23:00,09:23,10230825,12595775,2364950,BUY
2020-10-08 09:24:00,09:24,10157575,12640900,2483325,BUY
2020-10-08 09:25:00,09:25,10196725,12649150,2452425,BUY
2020-10-08 09:26:00,09:26,10753075,13448900,2695825,BUY
2020-10-08 09:27:00,09:27,10652225,13428600,2776375,BUY
2020-10-08 09:28:00,09:28,10603525,13378300,2774775,BUY
2020-10-08 09:29:00,09:29,11027075,13817525,2790450,BUY
2020-10-08 09:30:00,09:30,11229550,13909575,2680025,BUY
2020-10-08 09:31:00,09:31,11340675,13927825,2587150,BUY
2020-10-08 09:32:00,09:32,11634450,14141875,2507425,BUY
2020-10-08 09:33:00,09:33,11670875,14043600,2372725,BUY
2020-10-08 09:34:00,09:34,11670875,14170825,2499950,BUY
2020-10-08 09:35:00,09:35,11867075,14776750,2909675,BUY
2020-10-08 09:36:00,09:36,11958250,14835125,2876875,BUY
2020-10-08 09:37:00,09:37,11938075,14781050,2842975,BUY
2020-10-08 09:38:00,09:38,11856150,15333750,3477600,BUY
2020-10-08 09:39:00,09:39,11799750,15150350,3350600,BUY
2020-10-08 09:40:00,09:40,11813275,14854750,3041475,BUY
2020-10-08 09:41:00,09:41,11920925,15633675,3712750,BUY
2020-10-08 09:42:00,09:42,11902325,15864725,3962400,BUY
2020-10-08 09:43:00,09:43,11954650,15595025,3640375,BUY
2020-10-08 09:44:00,09:44,11840950,16437550,4596600,BUY
2020-10-08 09:45:00,09:45,11829350,16043275,4213925,BUY
2020-10-08 09:46:00,09:46,11952950,16455400,4502450,BUY
2020-10-08 09:47:00,09:47,11784250,16816700,5032450,BUY
2020-10-08 09:48:00,09:48,11724225,16859150,5134925,BUY
2020-10-08 09:49:00,09:49,11763925,16905425,5141500,BUY
2020-10-08 09:50:00,09:50,11932050,17104775,5172725,BUY
2020-10-08 09:51:00,09:51,11810825,16789850,4979025,BUY
2020-10-08 09:52:00,09:52,11892200,17102675,5210475,BUY
2020-10-08 09:53:00,09:53,11908150,17287325,5379175,BUY
2020-10-08 09:54:00,09:54,11880675,17359250,5478575,BUY
2020-10-08 09:55:00,09:55,12026175,17404050,5377875,BUY
2020-10-08 09:56:00,09:56,12181875,17673600,5491725,BUY
2020-10-08 09:57:00,09:57,12136000,17679750,5543750,BUY
2020-10-08 09:58:00,09:58,12115375,17589925,5474550,BUY
2020-10-08 09:59:00,09:59,12371225,17300250,4929025,BUY
2020-10-08 10:00:00,10:00,12309200,17618175,5308975,BUY
2020-10-08 10:01:00,10:01,12227450,17746675,5519225,BUY
2020-10-08 10:02:00,10:02,12487025,17931400,5444375,BUY
2020-10-08 10:03:00,10:03,12567150,18063250,5496100,BUY
2020-10-08 10:04:00,10:04,12467225,18047125,5579900,BUY
2020-10-08 10:05:00,10:05,12571750,18297575,5725825,BUY
2020-10-08 10:06:00,10:06,12609400,18197800,5588400,BUY
2020-10-08 10:07:00,10:07,12663900,17979075,5315175,BUY
2020-10-08 10:08:00,10:08,12929700,18332225,5402525,BUY
2020-10-08 10:09:00,10:09,12980800,18430150,5449350,BUY
2020-10-08 10:10:00,10:10,12765450,18060000,5294550,BUY
2020-10-08 10:11:00,10:11,12775325,18658075,5882750,BUY
2020-10-08 10:12:00,10:12,12900550,18511900,5611350,BUY
2020-10-08 10:13:00,10:13,12863375,18629450,5766075,BUY
2020-10-08 10:14:00,10:14,13134175,18321400,5187225,BUY
2020-10-08 10:15:00,10:15,13160275,18736000,5575725,BUY
2020-10-08 10:16:00,10:16,13183075,18602550,5419475,BUY
2020-10-08 10:17:00,10:17,12663300,18902025,6238725,BUY
2020-10-08 10:18:00,10:18,12781325,18859000,6077675,BUY
2020-10-08 10:19:00,10:19,12650950,18604950,5954000,BUY
2020-10-08 10:20:00,10:20,12670700,18617500,5946800,BUY
2020-10-08 10:21:00,10:21,12587400,18831900,6244500,BUY
2020-10-08 10:22:00,10:22,12827750,18601650,5773900,BUY
2020-10-08 10:23:00,10:23,12840900,19034225,6193325,BUY
2020-10-08 10:24:00,10:24,12888975,19006875,6117900,BUY
2020-10-08 10:25:00,10:25,12962025,19120100,6158075,BUY
2020-10-08 10:26:00,10:26,12737975,18531500,5793525,BUY
2020-10-08 10:27:00,10:27,12640950,19285900,6644950,BUY
2020-10-08 10:28:00,10:28,12652950,19315075,6662125,BUY
2020-10-08 10:29:00,10:29,12925675,19073325,6147650,BUY
2020-10-08 10:30:00,10:30,12849325,19124050,6274725,BUY
2020-10-08 10:31:00,10:31,12787250,19280175,6492925,BUY
2020-10-08 10:32:00,10:32,12766925,19287975,6521050,BUY
2020-10-08 10:33:00,10:33,12549000,19149750,6600750,BUY
2020-10-08 10:34:00,10:34,12617150,19407825,6790675,BUY
2020-10-08 10:35:00,10:35,12816200,19297100,6480900,BUY
2020-10-08 10:36:00,10:36,12800875,19670750,6869875,BUY
2020-10-08 10:37:00,10:37,12918000,19449850,6531850,BUY
2020-10-08 10:38:00,10:38,12801150,19715925,6914775,BUY
2020-10-08 10:39:00,10:39,12846200,19332150,6485950,BUY
2020-10-08 10:40:00,10:40,12949750,19241350,6291600,BUY
2020-10-08 10:41:00,10:41,12878525,19442100,6563575,BUY
2020-10-08 10:42:00,10:42,12830425,19228000,6397575,BUY
2020-10-08 10:43:00,10:43,12833200,19495975,6662775,BUY
2020-10-08 10:44:00,10:44,13082800,19565225,6482425,BUY
2020-10-08 10:45:00,10:45,13157400,19311850,6154450,BUY
2020-10-08 10:46:00,10:46,13249275,19018200,5768925,BUY
2020-10-08 10:47:00,10:47,13364575,19687800,6323225,BUY
2020-10-08 10:48:00,10:48,12985725,18493625,5507900,BUY
2020-10-08 10:49:00,10:49,13201825,19562325,6360500,BUY
2020-10-08 10:50:00,10:50,13469400,19876075,6406675,BUY
2020-10-08 10:51:00,10:51,13351525,19251350,5899825,BUY
2020-10-08 10:52:00,10:52,13189875,19522025,6332150,BUY
2020-10-08 10:53:00,10:53,13414700,20196175,6781475,BUY
2020-10-08 10:54:00,10:54,13310475,19087400,5776925,BUY
2020-10-08 10:55:00,10:55,13521725,19565575,6043850,BUY
2020-10-08 10:56:00,10:56,13502225,20020525,6518300,BUY
2020-10-08 10:57:00,10:57,13727150,19389975,5662825,BUY
2020-10-08 10:58:00,10:58,13692875,19151825,5458950,BUY
2020-10-08 10:59:00,10:59,13583550,19623475,6039925,BUY
2020-10-08 11:00:00,11:00,13639175,19910750,6271575,BUY
2020-10-08 11:01:00,11:01,13408750,19667850,6259100,BUY
2020-10-08 11:02:00,11:02,13693125,19734675,6041550,BUY
2020-10-08 11:03:00,11:03,13630575,19631925,6001350,BUY
2020-10-08 11:04:00,11:04,13590325,20143850,6553525,BUY
2020-10-08 11:05:00,11:05,13775325,19943225,6167900,BUY
2020-10-08 11:06:00,11:06,13513850,19880250,6366400,BUY
2020-10-08 11:07:00,11:07,13762600,20135775,6373175,BUY
2020-10-08 11:08:00,11:08,13732075,20097625,6365550,BUY
2020-10-08 11:09:00,11:09,13840425,20283300,6442875,BUY
2020-10-08 11:10:00,11:10,13896325,20231200,6334875,BUY
2020-10-08 11:11:00,11:11,13442000,20340150,6898150,BUY
2020-10-08 11:12:00,11:12,13538875,20656300,7117425,BUY
2020-10-08 11:13:00,11:13,13469250,20713500,7244250,BUY
2020-10-08 11:14:00,11:14,13646450,20392925,6746475,BUY
2020-10-08 11:15:00,11:15,13671575,20755525,7083950,BUY
2020-10-08 11:16:00,11:16,13614600,20854100,7239500,BUY
2020-10-08 11:17:00,11:17,13791500,21088075,7296575,BUY
2020-10-08 11:18:00,11:18,13881225,20851100,6969875,BUY
2020-10-08 11:19:00,11:19,13730025,20610550,6880525,BUY
2020-10-08 11:20:00,11:20,13822625,20931100,7108475,BUY
2020-10-08 11:21:00,11:21,13956475,21116725,7160250,BUY
2020-10-08 11:22:00,11:22,13983200,21234700,7251500,BUY
2020-10-08 11:23:00,11:23,13894375,21048175,7153800,BUY
2020-10-08 11:24:00,11:24,13990700,21087325,7096625,BUY
2020-10-08 11:25:00,11:25,14182275,20720050,6537775,BUY
2020-10-08 11:26:00,11:26,14120575,20820750,6700175,BUY
2020-10-08 11:27:00,11:27,14265025,20883650,6618625,BUY
2020-10-08 11:28:00,11:28,14035750,21265650,7229900,BUY
2020-10-08 11:29:00,11:29,13801175,21184175,7383000,BUY
2020-10-08 11:30:00,11:30,14026100,21406250,7380150,BUY
2020-10-08 11:31:00,11:31,14013925,20896450,6882525,BUY
2020-10-08 11:32:00,11:32,13767725,20931400,7163675,BUY
2020-10-08 11:33:00,11:33,14055175,20814450,6759275,BUY
2020-10-08 11:34:00,11:34,13825000,20815900,6990900,BUY
2020-10-08 11:35:00,11:35,13824425,20418050,6593625,BUY
2020-10-08 11:36:00,11:36,13802400,20986300,7183900,BUY
2020-10-08 11:37:00,11:37,13923225,21031725,7108500,BUY
2020-10-08 11:38:00,11:38,13963750,21440350,7476600,BUY
2020-10-08 11:39:00,11:39,13984050,21064900,7080850,BUY
2020-10-08 11:40:00,11:40,14014100,21697750,7683650,BUY
2020-10-08 11:41:00,11:41,13896100,20592250,6696150,BUY
2020-10-08 11:42:00,11:42,13967550,21625375,7657825,BUY
2020-10-08 11:43:00,11:43,13824300,21059925,7235625,BUY
2020-10-08 11:44:00,11:44,13975975,21685100,7709125,BUY
2020-10-08 11:45:00,11:45,13847450,20789800,6942350,BUY
2020-10-08 11:46:00,11:46,13920125,21161050,7240925,BUY
2020-10-08 11:47:00,11:47,13748675,21518400,7769725,BUY
2020-10-08 11:48:00,11:48,14268975,21319600,7050625,BUY
2020-10-08 11:49:00,11:49,13920500,21062375,7141875,BUY
2020-10-08 11:50:00,11:50,13904100,21367425,7463325,BUY
2020-10-08 11:51:00,11:51,14131325,21077525,6946200,BUY
2020-10-08 11:52:00,11:52,14017225,21685150,7667925,BUY
2020-10-08 11:53:00,11:53,14103200,21249850,7146650,BUY
2020-10-08 11:54:00,11:54,13997975,21407925,7409950,BUY
2020-10-08 11:55:00,11:55,14133350,20956725,6823375,BUY
2020-10-08 11:56:00,11:56,13966275,21962150,7995875,BUY
2020-10-08 11:57:00,11:57,14308550,21832325,7523775,BUY
2020-10-08 11:58:00,11:58,14159175,21330275,7171100,BUY
2020-10-08 11:59:00,11:59,14302175,21574250,7272075,BUY
2020-10-08 12:00:00,12:00,14534525,21681175,7146650,BUY
2020-10-08 12:01:00,12:01,14416475,21198575,6782100,BUY
2020-10-08 12:02:00,12:02,14339400,21030575,6691175,BUY
2020-10-08 12:03:00,12:03,14099950,21638375,7538425,BUY
2020-10-08 12:04:00,12:04,14246050,21623125,7377075,BUY
2020-10-08 12:05:00,12:05,14286175,22184000,7897825,BUY
2020-10-08 12:06:00,12:06,14236225,22037825,7801600,BUY
2020-10-08 12:07:00,12:07,14257025,21742325,7485300,BUY
2020-10-08 12:08:00,12:08,14425375,22223400,7798025,BUY
2020-10-08 12:09:00,12:09,14385925,22056425,7670500,BUY
2020-10-08 12:10:00,12:10,13848850,21597275,7748425,BUY
2020-10-08 12:11:00,12:11,14315175,21994875,7679700,BUY
2020-10-08 12:12:00,12:12,14254375,22149650,7895275,BUY
2020-10-08 12:13:00,12:13,14472600,21476925,7004325,BUY
2020-10-08 12:14:00,12:14,14514225,21499525,6985300,BUY
2020-10-08 12:15:00,12:15,14183625,21577225,7393600,BUY
2020-10-08 12:16:00,12:16,14550500,21765750,7215250,BUY
2020-10-08 12:17:00,12:17,14088150,21456900,7368750,BUY
2020-10-08 12:18:00,12:18,14437850,22060500,7622650,BUY
2020-10-08 12:19:00,12:19,14497025,21925525,7428500,BUY
2020-10-08 12:20:00,12:20,14541775,22014275,7472500,BUY
2020-10-08 12:21:00,12:21,14121500,22246250,8124750,BUY
2020-10-08 12:22:00,12:22,14539100,21297875,6758775,BUY
2020-10-08 12:23:00,12:23,14916075,22034075,7118000,BUY
2020-10-08 12:24:00,12:24,14970300,22210350,7240050,BUY
2020-10-08 12:25:00,12:25,14764300,22272950,7508650,BUY
2020-10-08 12:26:00,12:26,14808625,21828625,7020000,BUY
2020-10-08 12:27:00,12:27,15052350,22178025,7125675,BUY
2020-10-08 12:28:00,12:28,14625200,21163075,6537875,BUY
2020-10-08 12:29:00,12:29,14911350,22198350,7287000,BUY
2020-10-08 12:30:00,12:30,14971525,21923800,6952275,BUY
2020-10-08 12:31:00,12:31,14731775,22053675,7321900,BUY
2020-10-08 12:32:00,12:32,14636050,21783975,7147925,BUY
2020-10-08 12:33:00,12:33,14746100,21957575,7211475,BUY
2020-10-08 12:34:00,12:34,14934375,21976050,7041675,BUY
2020-10-08 12:35:00,12:35,14957675,22231275,7273600,BUY
2020-10-08 12:36:00,12:36,14718175,22130175,7412000,BUY
2020-10-08 12:37:00,12:37,14793925,21902825,7108900,BUY
2020-10-08 12:38:00,12:38,15282975,21585950,6302975,BUY
2020-10-08 12:39:00,12:39,15284100,21731275,6447175,BUY
2020-10-08 12:40:00,12:40,15144500,22003575,6859075,BUY
2020-10-08 12:41:00,12:41,15130050,22251850,7121800,BUY
2020-10-08 12:42:00,12:42,14973325,22485550,7512225,BUY
2020-10-08 12:43:00,12:43,14906325,22229025,7322700,BUY
2020-10-08 12:44:00,12:44,15329200,22543425,7214225,BUY
2020-10-08 12:45:00,12:45,15119750,22394950,7275200,BUY
2020-10-08 12:46:00,12:46,15070525,22206125,7135600,BUY
2020-10-08 12:47:00,12:47,15152900,21946225,6793325,BUY
2020-10-08 12:48:00,12:48,15080275,22005575,6925300,BUY
2020-10-08 12:49:00,12:49,15087700,22036000,6948300,BUY
2020-10-08 12:50:00,12:50,14835450,22489775,7654325,BUY
2020-10-08 12:51:00,12:51,15161075,22514750,7353675,BUY
2020-10-08 12:52:00,12:52,15069200,21883475,6814275,BUY
2020-10-08 12:53:00,12:53,15173075,22030850,6857775,BUY
2020-10-08 12:54:00,12:54,15306500,22092450,6785950,BUY
2020-10-08 12:55:00,12:55,15350075,22461550,7111475,BUY
2020-10-08 12:56:00,12:56,14822350,22826350,8004000,BUY
2020-10-08 12:57:00,12:57,15352875,22837225,7484350,BUY
2020-10-08 12:58:00,12:58,15158775,22232425,7073650,BUY
2020-10-08 12:59:00,12:59,15126250,22516750,7390500,BUY
2020-10-08 13:00:00,13:00,15419625,21991175,6571550,BUY
2020-10-08 13:01:00,13:01,15137875,22239275,7101400,BUY
2020-10-08 13:02:00,13:02,15190125,22000375,6810250,BUY
2020-10-08 13:03:00,13:03,15380775,22622225,7241450,BUY
2020-10-08 13:04:00,13:04,15447225,21940375,6493150,BUY
2020-10-08 13:05:00,13:05,15354700,22273950,6919250,BUY
2020-10-08 13:06:00,13:06,15688925,22225150,6536225,BUY
2020-10-08 13:07:00,13:07,15573250,22259450,6686200,BUY
2020-10-08 13:08:00,13:08,15575675,22626400,7050725,BUY
2020-10-08 13:09:00,13:09,15212300,22087500,6875200,BUY
2020-10-08 13:10:00,13:10,15199525,22269375,7069850,BUY
2020-10-08 13:11:00,13:11,15213575,21860575,6647000,BUY
2020-10-08 13:12:00,13:12,15236125,22183500,6947375,BUY
2020-10-08 13:13:00,13:13,15028025,21792975,6764950,BUY
2020-10-08 13:14:00,13:14,15224700,21912625,6687925,BUY
2020-10-08 13:15:00,13:15,15297975,21435325,6137350,BUY
2020-10-08 13:16:00,13:16,15222625,21426225,6203600,BUY
2020-10-08 13:17:00,13:17,15281525,21557175,6275650,BUY
2020-10-08 13:18:00,13:18,15214425,21269275,6054850,BUY
2020-10-08 13:19:00,13:19,15081325,21898900,6817575,BUY
2020-10-08 13:20:00,13:20,15200825,21550850,6350025,BUY
2020-10-08 13:21:00,13:21,15146600,21894075,6747475,BUY
2020-10-08 13:22:00,13:22,15269100,22141475,6872375,BUY
2020-10-08 13:23:00,13:23,15514525,21915300,6400775,BUY
2020-10-08 13:24:00,13:24,15463525,21626425,6162900,BUY
2020-10-08 13:25:00,13:25,15505125,20955000,5449875,BUY
2020-10-08 13:26:00,13:26,15486425,21804275,6317850,BUY
2020-10-08 13:27:00,13:27,15420900,21686800,6265900,BUY
2020-10-08 13:28:00,13:28,15082300,21260100,6177800,BUY
2020-10-08 13:29:00,13:29,15137450,21774375,6636925,BUY
2020-10-08 13:30:00,13:30,14241200,21596200,7355000,BUY
2020-10-08 13:31:00,13:31,14395775,21761250,7365475,BUY
2020-10-08 13:32:00,13:32,14220100,21438875,7218775,BUY
2020-10-08 13:33:00,13:33,14461225,21435675,6974450,BUY
2020-10-08 13:34:00,13:34,14522025,21862800,7340775,BUY
2020-10-08 13:35:00,13:35,14304375,21504875,7200500,BUY
2020-10-08 13:36:00,13:36,14385675,21682400,7296725,BUY
2020-10-08 13:37:00,13:37,14240325,21230425,6990100,BUY
2020-10-08 13:38:00,13:38,14255550,21790850,7535300,BUY
2020-10-08 13:39:00,13:39,14524475,21374575,6850100,BUY
2020-10-08 13:40:00,13:40,14554100,21815900,7261800,BUY
2020-10-08 13:41:00,13:41,14385925,21461300,7075375,BUY
2020-10-08 13:42:00,13:42,14841375,21415200,6573825,BUY
2020-10-08 13:43:00,13:43,14763350,21629775,6866425,BUY
2020-10-08 13:44:00,13:44,14636000,21286000,6650000,BUY
2020-10-08 13:45:00,13:45,14435975,21310475,6874500,BUY
2020-10-08 13:46:00,13:46,14422000,21002700,6580700,BUY
2020-10-08 13:47:00,13:47,14601250,20920225,6318975,BUY
2020-10-08 13:48:00,13:48,14199675,20628050,6428375,BUY
2020-10-08 13:49:00,13:49,14062250,21099225,7036975,BUY
2020-10-08 13:50:00,13:50,14019025,21636225,7617200,BUY
2020-10-08 13:51:00,13:51,13911825,21346875,7435050,BUY
2020-10-08 13:52:00,13:52,13791025,21088175,7297150,BUY
2020-10-08 13:53:00,13:53,13906175,21042025,7135850,BUY
2020-10-08 13:54:00,13:54,14057975,21470325,7412350,BUY
2020-10-08 13:55:00,13:55,14324025,21582375,7258350,BUY
2020-10-08 13:56:00,13:56,14307350,21633050,7325700,BUY
2020-10-08 13:57:00,13:57,14052150,19531125,5478975,BUY
2020-10-08 13:58:00,13:58,14007700,19538125,5530425,BUY
2020-10-08 13:59:00,13:59,14060275,19484875,5424600,BUY
2020-10-08 14:00:00,14:00,13706600,17026325,3319725,BUY
2020-10-08 14:01:00,14:01,13691500,17198850,3507350,BUY
2020-10-08 14:02:00,14:02,13684100,17232650,3548550,BUY
2020-10-08 14:03:00,14:03,13774850,16980975,3206125,BUY
2020-10-08 14:04:00,14:04,13666375,16968050,3301675,BUY
2020-10-08 14:05:00,14:05,13777550,16963000,3185450,BUY
2020-10-08 14:06:00,14:06,13899375,17437125,3537750,BUY
2020-10-08 14:07:00,14:07,13935325,17541800,3606475,BUY
2020-10-08 14:08:00,14:08,13704975,17580250,3875275,BUY
2020-10-08 14:09:00,14:09,13798825,17821350,4022525,BUY
2020-10-08 14:10:00,14:10,13756125,17833850,4077725,BUY
2020-10-08 14:11:00,14:11,13744825,17877375,4132550,BUY
2020-10-08 14:12:00,14:12,13734300,18248400,4514100,BUY
2020-10-08 14:13:00,14:13,13475075,18187725,4712650,BUY
2020-10-08 14:14:00,14:14,13558750,18172275,4613525,BUY
2020-10-08 14:15:00,14:15,13446650,18317225,4870575,BUY
2020-10-08 14:16:00,14:16,13376075,18540725,5164650,BUY
2020-10-08 14:17:00,14:17,13238425,18569325,5330900,BUY
2020-10-08 14:18:00,14:18,13275400,18123025,4847625,BUY
2020-10-08 14:19:00,14:19,13262925,18623950,5361025,BUY
2020-10-08 14:20:00,14:20,13522225,18651950,5129725,BUY
2020-10-08 14:21:00,14:21,13540350,18386475,4846125,BUY
2020-10-08 14:22:00,14:22,13568100,18476200,4908100,BUY
2020-10-08 14:23:00,14:23,13457450,18513925,5056475,BUY
2020-10-08 14:24:00,14:24,13644025,18466675,4822650,BUY
2020-10-08 14:25:00,14:25,13678675,18383225,4704550,BUY
2020-10-08 14:26:00,14:26,13593175,18300425,4707250,BUY
2020-10-08 14:27:00,14:27,14038575,18024800,3986225,BUY
2020-10-08 14:28:00,14:28,14093625,18206575,4112950,BUY
2020-10-08 14:29:00,14:29,13954900,18210200,4255300,BUY
2020-10-08 14:30:00,14:30,14217800,17530525,3312725,BUY
2020-10-08 14:31:00,14:31,14232350,17710075,3477725,BUY
2020-10-08 14:32:00,14:32,14133375,17726050,3592675,BUY
2020-10-08 14:33:00,14:33,14166050,16403825,2237775,BUY
2020-10-08 14:34:00,14:34,14194550,16350850,2156300,BUY
2020-10-08 14:35:00,14:35,14266475,16392725,2126250,BUY
2020-10-08 14:36:00,14:36,14516625,16208325,1691700,BUY
2020-10-08 14:37:00,14:37,14461025,15956350,1495325,BUY
2020-10-08 14:38:00,14:38,14496900,15824550,1327650,BUY
2020-10-08 14:39:00,14:39,14206600,15303450,1096850,BUY
2020-10-08 14:40:00,14:40,14192875,15500475,1307600,BUY
2020-10-08 14:41:00,14:41,14184775,15447325,1262550,BUY
2020-10-08 14:42:00,14:42,14149550,15715800,1566250,BUY
2020-10-08 14:43:00,14:43,14297875,15415500,1117625,BUY
2020-10-08 14:44:00,14:44,14335050,15328625,993575,BUY
2020-10-08 14:45:00,14:45,14788525,15729600,941075,BUY
2020-10-08 14:46:00,14:46,14739550,15574350,834800,BUY
2020-10-08 14:47:00,14:47,14782075,15670000,887925,BUY
2020-10-08 14:48:00,14:48,14917125,14982225,65100,BUY
2020-10-08 14:49:00,14:49,14867575,15147575,280000,BUY
2020-10-08 14:50:00,14:50,14886350,15029750,143400,BUY
2020-10-08 14:51:00,14:51,14534925,15148600,613675,BUY
2020-10-08 14:52:00,14:52,14593725,15143000,549275,BUY
2020-10-08 14:53:00,14:53,14588025,15376875,788850,BUY
2020-10-08 14:54:00,14:54,14655075,15188050,532975,BUY
2020-10-08 14:55:00,14:55,14723375,15301500,578125,BUY
2020-10-08 14:56:00,14:56,14698525,14977650,279125,BUY
2020-10-08 14:57:00,14:57,13913950,15107300,1193350,BUY
2020-10-08 14:58:00,14:58,13914800,15371400,1456600,BUY
2020-10-08 14:59:00,14:59,13900000,15188650,1288650,BUY
2020-10-08 15:00:00,15:00,13723225,14832200,1108975,BUY
2020-10-08 15:01:00,15:01,13744925,15215950,1471025,BUY
2020-10-08 15:02:00,15:02,13790950,15331775,1540825,BUY
2020-10-08 15:03:00,15:03,13648000,15609475,1961475,BUY
2020-10-08 15:04:00,15:04,13704425,15711475,2007050,BUY
2020-10-08 15:05:00,15:05,13690650,15236775,1546125,BUY
2020-10-08 15:06:00,15:06,13645375,15584500,1939125,BUY
2020-10-08 15:07:00,15:07,13604975,15256525,1651550,BUY
2020-10-08 15:08:00,15:08,13702725,15520950,1818225,BUY
2020-10-08 15:09:00,15:09,13213700,15134900,1921200,BUY
2020-10-08 15:10:00,15:10,13236475,15082600,1846125,BUY
2020-10-08 15:11:00,15:11,13151400,15281675,2130275,BUY
2020-10-08 15:12:00,15:12,12918650,14355750,1437100,BUY
2020-10-08 15:13:00,15:13,12853450,14411500,1558050,BUY
2020-10-08 15:14:00,15:14,12859750,14722100,1862350,BUY
2020-10-08 15:15:00,15:15,12419475,14081075,1661600,BUY
2020-10-08 15:16:00,15:16,12462750,14206175,1743425,BUY
2020-10-08 15:17:00,15:17,12462775,13833450,1370675,BUY
2020-10-08 15:18:00,15:18,12028100,13132000,1103900,BUY
2020-10-08 15:19:00,15:19,11916625,13044825,1128200,BUY
2020-10-08 15:20:00,15:20,12040625,13190300,1149675,BUY
2020-10-08 15:21:00,15:21,11321450,12370300,1048850,BUY
2020-10-08 15:22:00,15:22,11308750,12318675,1009925,BUY
2020-10-08 15:23:00,15:23,11322575,12339250,1016675,BUY
2020-10-08 15:24:00,15:24,10805550,11408025,602475,BUY
2020-10-08 15:25:00,15:25,10905825,11970075,1064250,BUY
2020-10-08 15:26:00,15:26,10732025,11253250,521225,BUY
2020-10-08 15:27:00,15:27,9447250,10022700,575450,BUY
2020-10-08 15:28:00,15:28,9448650,10740950,1292300,BUY
2020-10-08 15:29:00,15:29,9349725,10544000,1194275,BUY
