,timestamp,call,put,diff,sellOrBuy
2020-10-16 09:15:00,09:15,3615075,2252250,-1362825,SELL
2020-10-16 09:16:00,09:16,3614175,2271500,-1342675,SELL
2020-10-16 09:17:00,09:17,3856400,2400000,-1456400,SELL
2020-10-16 09:18:00,09:18,3857475,2433375,-1424100,SELL
2020-10-16 09:19:00,09:19,3857475,2431825,-1425650,SELL
2020-10-16 09:20:00,09:20,4337300,2928950,-1408350,SELL
2020-10-16 09:21:00,09:21,4336225,2922100,-1414125,SELL
2020-10-16 09:22:00,09:22,4336925,2912825,-1424100,SELL
2020-10-16 09:23:00,09:23,4563975,3135275,-1428700,SELL
2020-10-16 09:24:00,09:24,4562400,3132875,-1429525,SELL
2020-10-16 09:25:00,09:25,4548850,3144350,-1404500,SELL
2020-10-16 09:26:00,09:26,4739025,3214775,-1524250,SELL
2020-10-16 09:27:00,09:27,4743300,3233275,-1510025,SELL
2020-10-16 09:28:00,09:28,4736825,3230725,-1506100,SELL
2020-10-16 09:29:00,09:29,4915000,3390775,-1524225,SELL
2020-10-16 09:30:00,09:30,4915325,3420825,-1494500,SELL
2020-10-16 09:31:00,09:31,4897900,3414075,-1483825,SELL
2020-10-16 09:32:00,09:32,4991650,3552375,-1439275,SELL
2020-10-16 09:33:00,09:33,4989825,3549400,-1440425,SELL
2020-10-16 09:34:00,09:34,4973650,3526700,-1446950,SELL
2020-10-16 09:35:00,09:35,5109125,3657475,-1451650,SELL
2020-10-16 09:36:00,09:36,5110775,3693325,-1417450,SELL
2020-10-16 09:37:00,09:37,5104875,3673950,-1430925,SELL
2020-10-16 09:38:00,09:38,5190900,3782825,-1408075,SELL
2020-10-16 09:39:00,09:39,5212325,3801025,-1411300,SELL
2020-10-16 09:40:00,09:40,5204750,3762400,-1442350,SELL
2020-10-16 09:41:00,09:41,5272425,3788950,-1483475,SELL
2020-10-16 09:42:00,09:42,5273650,3803175,-1470475,SELL
2020-10-16 09:43:00,09:43,5256700,3788950,-1467750,SELL
2020-10-16 09:44:00,09:44,5306975,3896250,-1410725,SELL
2020-10-16 09:45:00,09:45,5329900,3923075,-1406825,SELL
2020-10-16 09:46:00,09:46,5353800,3930100,-1423700,SELL
2020-10-16 09:47:00,09:47,5407400,3951475,-1455925,SELL
2020-10-16 09:48:00,09:48,5430525,3985375,-1445150,SELL
2020-10-16 09:49:00,09:49,5424775,3958600,-1466175,SELL
2020-10-16 09:50:00,09:50,5462700,3903150,-1559550,SELL
2020-10-16 09:51:00,09:51,5443850,3895675,-1548175,SELL
2020-10-16 09:52:00,09:52,5440900,3869875,-1571025,SELL
2020-10-16 09:53:00,09:53,5511600,3901525,-1610075,SELL
2020-10-16 09:54:00,09:54,5529875,3893575,-1636300,SELL
2020-10-16 09:55:00,09:55,5529875,3905875,-1624000,SELL
2020-10-16 09:56:00,09:56,5609825,3953125,-1656700,SELL
2020-10-16 09:57:00,09:57,5608150,3953125,-1655025,SELL
2020-10-16 09:58:00,09:58,5629825,3949750,-1680075,SELL
2020-10-16 09:59:00,09:59,5724800,4035175,-1689625,SELL
2020-10-16 10:00:00,10:00,5725800,4036050,-1689750,SELL
2020-10-16 10:01:00,10:01,5726075,4027175,-1698900,SELL
2020-10-16 10:02:00,10:02,5880625,4144725,-1735900,SELL
2020-10-16 10:03:00,10:03,5887525,4171825,-1715700,SELL
2020-10-16 10:04:00,10:04,5881650,4152525,-1729125,SELL
2020-10-16 10:05:00,10:05,5987350,4213425,-1773925,SELL
2020-10-16 10:06:00,10:06,5972400,4213425,-1758975,SELL
2020-10-16 10:07:00,10:07,5972400,4249350,-1723050,SELL
2020-10-16 10:08:00,10:08,5970550,4219300,-1751250,SELL
2020-10-16 10:09:00,10:09,5991500,4214325,-1777175,SELL
2020-10-16 10:10:00,10:10,5970550,4196725,-1773825,SELL
2020-10-16 10:11:00,10:11,6015900,4218650,-1797250,SELL
2020-10-16 10:12:00,10:12,6016575,4227425,-1789150,SELL
2020-10-16 10:13:00,10:13,5979350,4213875,-1765475,SELL
2020-10-16 10:14:00,10:14,6083125,4220350,-1862775,SELL
2020-10-16 10:15:00,10:15,6089000,4246600,-1842400,SELL
2020-10-16 10:16:00,10:16,6089000,4246600,-1842400,SELL
2020-10-16 10:17:00,10:17,6051450,4207650,-1843800,SELL
2020-10-16 10:18:00,10:18,6070575,4193125,-1877450,SELL
2020-10-16 10:19:00,10:19,6054700,4243300,-1811400,SELL
2020-10-16 10:20:00,10:20,6064625,4248725,-1815900,SELL
2020-10-16 10:21:00,10:21,6081250,4285700,-1795550,SELL
2020-10-16 10:22:00,10:22,6081550,4316050,-1765500,SELL
2020-10-16 10:23:00,10:23,6133275,4292825,-1840450,SELL
2020-10-16 10:24:00,10:24,6113200,4283875,-1829325,SELL
2020-10-16 10:25:00,10:25,6113200,4292825,-1820375,SELL
2020-10-16 10:26:00,10:26,6134700,4309175,-1825525,SELL
2020-10-16 10:27:00,10:27,6129725,4272000,-1857725,SELL
2020-10-16 10:28:00,10:28,6136200,4272000,-1864200,SELL
2020-10-16 10:29:00,10:29,6167400,4308275,-1859125,SELL
2020-10-16 10:30:00,10:30,6193550,4317250,-1876300,SELL
2020-10-16 10:31:00,10:31,6173175,4313450,-1859725,SELL
2020-10-16 10:32:00,10:32,6214225,4332825,-1881400,SELL
2020-10-16 10:33:00,10:33,6180950,4279875,-1901075,SELL
2020-10-16 10:34:00,10:34,6212850,4325675,-1887175,SELL
2020-10-16 10:35:00,10:35,6164875,4388775,-1776100,SELL
2020-10-16 10:36:00,10:36,6218725,4359850,-1858875,SELL
2020-10-16 10:37:00,10:37,6197550,4342500,-1855050,SELL
2020-10-16 10:38:00,10:38,6229975,4353825,-1876150,SELL
2020-10-16 10:39:00,10:39,6226825,4329750,-1897075,SELL
2020-10-16 10:40:00,10:40,6223500,4364075,-1859425,SELL
2020-10-16 10:41:00,10:41,6220550,4382800,-1837750,SELL
2020-10-16 10:42:00,10:42,6236025,4369925,-1866100,SELL
2020-10-16 10:43:00,10:43,6278000,4383925,-1894075,SELL
2020-10-16 10:44:00,10:44,6256675,4380425,-1876250,SELL
2020-10-16 10:45:00,10:45,6268025,4424150,-1843875,SELL
2020-10-16 10:46:00,10:46,6284225,4413725,-1870500,SELL
2020-10-16 10:47:00,10:47,6277225,4417750,-1859475,SELL
2020-10-16 10:48:00,10:48,6309750,4428925,-1880825,SELL
2020-10-16 10:49:00,10:49,6306875,4398225,-1908650,SELL
2020-10-16 10:50:00,10:50,6210150,4397075,-1813075,SELL
2020-10-16 10:51:00,10:51,6229200,4400150,-1829050,SELL
2020-10-16 10:52:00,10:52,6204325,4409150,-1795175,SELL
2020-10-16 10:53:00,10:53,6260100,4439650,-1820450,SELL
2020-10-16 10:54:00,10:54,6228100,4461800,-1766300,SELL
2020-10-16 10:55:00,10:55,6240725,4468925,-1771800,SELL
2020-10-16 10:56:00,10:56,6212050,4436950,-1775100,SELL
2020-10-16 10:57:00,10:57,6226650,4434225,-1792425,SELL
2020-10-16 10:58:00,10:58,6204900,4456225,-1748675,SELL
2020-10-16 10:59:00,10:59,6216300,4480375,-1735925,SELL
2020-10-16 11:00:00,11:00,6224525,4488625,-1735900,SELL
2020-10-16 11:01:00,11:01,6215350,4457975,-1757375,SELL
2020-10-16 11:02:00,11:02,6238125,4486600,-1751525,SELL
2020-10-16 11:03:00,11:03,6244675,4464025,-1780650,SELL
2020-10-16 11:04:00,11:04,6246200,4481850,-1764350,SELL
2020-10-16 11:05:00,11:05,6246525,4452100,-1794425,SELL
2020-10-16 11:06:00,11:06,6108725,4438000,-1670725,SELL
2020-10-16 11:07:00,11:07,6230100,4438800,-1791300,SELL
2020-10-16 11:08:00,11:08,6224025,4457175,-1766850,SELL
2020-10-16 11:09:00,11:09,6212075,4449275,-1762800,SELL
2020-10-16 11:10:00,11:10,6238900,4458300,-1780600,SELL
2020-10-16 11:11:00,11:11,6244250,4439075,-1805175,SELL
2020-10-16 11:12:00,11:12,6247750,4445950,-1801800,SELL
2020-10-16 11:13:00,11:13,6273650,4426525,-1847125,SELL
2020-10-16 11:14:00,11:14,6286775,4448425,-1838350,SELL
2020-10-16 11:15:00,11:15,6273850,4476000,-1797850,SELL
2020-10-16 11:16:00,11:16,6265025,4452950,-1812075,SELL
2020-10-16 11:17:00,11:17,6295250,4453350,-1841900,SELL
2020-10-16 11:18:00,11:18,6273750,4452475,-1821275,SELL
2020-10-16 11:19:00,11:19,6184850,4453275,-1731575,SELL
2020-10-16 11:20:00,11:20,6296925,4485125,-1811800,SELL
2020-10-16 11:21:00,11:21,6195750,4494225,-1701525,SELL
2020-10-16 11:22:00,11:22,6304925,4507400,-1797525,SELL
2020-10-16 11:23:00,11:23,6343550,4513200,-1830350,SELL
2020-10-16 11:24:00,11:24,6322250,4490200,-1832050,SELL
2020-10-16 11:25:00,11:25,6304450,4512675,-1791775,SELL
2020-10-16 11:26:00,11:26,6317675,4508125,-1809550,SELL
2020-10-16 11:27:00,11:27,6327100,4508475,-1818625,SELL
2020-10-16 11:28:00,11:28,6333000,4494900,-1838100,SELL
2020-10-16 11:29:00,11:29,6353750,4516250,-1837500,SELL
2020-10-16 11:30:00,11:30,6295500,4519000,-1776500,SELL
2020-10-16 11:31:00,11:31,6289375,4516075,-1773300,SELL
2020-10-16 11:32:00,11:32,6329550,4544325,-1785225,SELL
2020-10-16 11:33:00,11:33,6178275,4555525,-1622750,SELL
2020-10-16 11:34:00,11:34,6338125,4566925,-1771200,SELL
2020-10-16 11:35:00,11:35,6268950,4575325,-1693625,SELL
2020-10-16 11:36:00,11:36,6322225,4578200,-1744025,SELL
2020-10-16 11:37:00,11:37,6307125,4575300,-1731825,SELL
2020-10-16 11:38:00,11:38,6315400,4570850,-1744550,SELL
2020-10-16 11:39:00,11:39,6300350,4623500,-1676850,SELL
2020-10-16 11:40:00,11:40,6305425,4635950,-1669475,SELL
2020-10-16 11:41:00,11:41,6292025,4555000,-1737025,SELL
2020-10-16 11:42:00,11:42,6317950,4574425,-1743525,SELL
2020-10-16 11:43:00,11:43,6285325,4540125,-1745200,SELL
2020-10-16 11:44:00,11:44,6261025,4568025,-1693000,SELL
2020-10-16 11:45:00,11:45,6287875,4568050,-1719825,SELL
2020-10-16 11:46:00,11:46,6314775,4598550,-1716225,SELL
2020-10-16 11:47:00,11:47,6262375,4582975,-1679400,SELL
2020-10-16 11:48:00,11:48,6289675,4605275,-1684400,SELL
2020-10-16 11:49:00,11:49,6317950,4596450,-1721500,SELL
2020-10-16 11:50:00,11:50,6313300,4580400,-1732900,SELL
2020-10-16 11:51:00,11:51,6294875,4569000,-1725875,SELL
2020-10-16 11:52:00,11:52,6315850,4574700,-1741150,SELL
2020-10-16 11:53:00,11:53,6203975,4575450,-1628525,SELL
2020-10-16 11:54:00,11:54,6222800,4587850,-1634950,SELL
2020-10-16 11:55:00,11:55,6307975,4632625,-1675350,SELL
2020-10-16 11:56:00,11:56,6277225,4653725,-1623500,SELL
2020-10-16 11:57:00,11:57,6292375,4623175,-1669200,SELL
2020-10-16 11:58:00,11:58,6215425,4645300,-1570125,SELL
2020-10-16 11:59:00,11:59,6255475,4653675,-1601800,SELL
2020-10-16 12:00:00,12:00,6333950,4688600,-1645350,SELL
2020-10-16 12:01:00,12:01,6331875,4683450,-1648425,SELL
2020-10-16 12:02:00,12:02,6109375,4735475,-1373900,SELL
2020-10-16 12:03:00,12:03,6111750,4695500,-1416250,SELL
2020-10-16 12:04:00,12:04,6081450,4709650,-1371800,SELL
2020-10-16 12:05:00,12:05,6051175,4773725,-1277450,SELL
2020-10-16 12:06:00,12:06,6026800,4787325,-1239475,SELL
2020-10-16 12:07:00,12:07,6043075,4764725,-1278350,SELL
2020-10-16 12:08:00,12:08,6092825,4834650,-1258175,SELL
2020-10-16 12:09:00,12:09,6111650,4862500,-1249150,SELL
2020-10-16 12:10:00,12:10,6090675,4835600,-1255075,SELL
2020-10-16 12:11:00,12:11,6120925,4919700,-1201225,SELL
2020-10-16 12:12:00,12:12,6120825,4919700,-1201125,SELL
2020-10-16 12:13:00,12:13,6107400,4933575,-1173825,SELL
2020-10-16 12:14:00,12:14,6133275,4948300,-1184975,SELL
2020-10-16 12:15:00,12:15,6097725,4920325,-1177400,SELL
2020-10-16 12:16:00,12:16,6109475,4927425,-1182050,SELL
2020-10-16 12:17:00,12:17,6118150,4943025,-1175125,SELL
2020-10-16 12:18:00,12:18,6137750,4958825,-1178925,SELL
2020-10-16 12:19:00,12:19,6107775,4934275,-1173500,SELL
2020-10-16 12:20:00,12:20,6123225,4996225,-1127000,SELL
2020-10-16 12:21:00,12:21,6136050,4995950,-1140100,SELL
2020-10-16 12:22:00,12:22,6161850,4982225,-1179625,SELL
2020-10-16 12:23:00,12:23,6190175,5023950,-1166225,SELL
2020-10-16 12:24:00,12:24,6190125,5055300,-1134825,SELL
2020-10-16 12:25:00,12:25,6194925,5024225,-1170700,SELL
2020-10-16 12:26:00,12:26,6183875,4998525,-1185350,SELL
2020-10-16 12:27:00,12:27,6194775,5012300,-1182475,SELL
2020-10-16 12:28:00,12:28,6169975,5007100,-1162875,SELL
2020-10-16 12:29:00,12:29,6162100,5023675,-1138425,SELL
2020-10-16 12:30:00,12:30,6197775,5033900,-1163875,SELL
2020-10-16 12:31:00,12:31,6222575,5054575,-1168000,SELL
2020-10-16 12:32:00,12:32,6122000,5052350,-1069650,SELL
2020-10-16 12:33:00,12:33,6084150,5047500,-1036650,SELL
2020-10-16 12:34:00,12:34,6122150,5032725,-1089425,SELL
2020-10-16 12:35:00,12:35,6189300,5165250,-1024050,SELL
2020-10-16 12:36:00,12:36,6186625,5134650,-1051975,SELL
2020-10-16 12:37:00,12:37,6183850,5173000,-1010850,SELL
2020-10-16 12:38:00,12:38,6228675,5186450,-1042225,SELL
2020-10-16 12:39:00,12:39,6185675,5171350,-1014325,SELL
2020-10-16 12:40:00,12:40,6242300,5177750,-1064550,SELL
2020-10-16 12:41:00,12:41,6259125,5197800,-1061325,SELL
2020-10-16 12:42:00,12:42,6289800,5218525,-1071275,SELL
2020-10-16 12:43:00,12:43,6269425,5215675,-1053750,SELL
2020-10-16 12:44:00,12:44,6194775,5248700,-946075,SELL
2020-10-16 12:45:00,12:45,6219300,5254475,-964825,SELL
2020-10-16 12:46:00,12:46,6215975,5249500,-966475,SELL
2020-10-16 12:47:00,12:47,6206025,5239525,-966500,SELL
2020-10-16 12:48:00,12:48,6201450,5264975,-936475,SELL
2020-10-16 12:49:00,12:49,6187300,5251725,-935575,SELL
2020-10-16 12:50:00,12:50,6283150,5291100,-992050,SELL
2020-10-16 12:51:00,12:51,6284325,5291200,-993125,SELL
2020-10-16 12:52:00,12:52,6267425,5275800,-991625,SELL
2020-10-16 12:53:00,12:53,6190800,5291525,-899275,SELL
2020-10-16 12:54:00,12:54,6193175,5300000,-893175,SELL
2020-10-16 12:55:00,12:55,6192325,5282975,-909350,SELL
2020-10-16 12:56:00,12:56,6231225,5336700,-894525,SELL
2020-10-16 12:57:00,12:57,6229950,5336750,-893200,SELL
2020-10-16 12:58:00,12:58,6237475,5333900,-903575,SELL
2020-10-16 12:59:00,12:59,6272000,5321750,-950250,SELL
2020-10-16 13:00:00,13:00,6233050,5295450,-937600,SELL
2020-10-16 13:01:00,13:01,6232825,5319050,-913775,SELL
2020-10-16 13:02:00,13:02,6278000,5304575,-973425,SELL
2020-10-16 13:03:00,13:03,6269650,5338300,-931350,SELL
2020-10-16 13:04:00,13:04,6280075,5313975,-966100,SELL
2020-10-16 13:05:00,13:05,6299900,5351000,-948900,SELL
2020-10-16 13:06:00,13:06,6266175,5344675,-921500,SELL
2020-10-16 13:07:00,13:07,6335500,5323650,-1011850,SELL
2020-10-16 13:08:00,13:08,6315225,5369425,-945800,SELL
2020-10-16 13:09:00,13:09,6306875,5383025,-923850,SELL
2020-10-16 13:10:00,13:10,6325100,5373400,-951700,SELL
2020-10-16 13:11:00,13:11,6310900,5349600,-961300,SELL
2020-10-16 13:12:00,13:12,6314075,5365650,-948425,SELL
2020-10-16 13:13:00,13:13,6289375,5374975,-914400,SELL
2020-10-16 13:14:00,13:14,6304175,5365675,-938500,SELL
2020-10-16 13:15:00,13:15,6359375,5388800,-970575,SELL
2020-10-16 13:16:00,13:16,6331725,5361575,-970150,SELL
2020-10-16 13:17:00,13:17,6322650,5379150,-943500,SELL
2020-10-16 13:18:00,13:18,6216300,5385325,-830975,SELL
2020-10-16 13:19:00,13:19,6169100,5362375,-806725,SELL
2020-10-16 13:20:00,13:20,6222425,5383650,-838775,SELL
2020-10-16 13:21:00,13:21,6219775,5368500,-851275,SELL
2020-10-16 13:22:00,13:22,6210775,5397275,-813500,SELL
2020-10-16 13:23:00,13:23,6208125,5368500,-839625,SELL
2020-10-16 13:24:00,13:24,6238925,5363575,-875350,SELL
2020-10-16 13:25:00,13:25,6236625,5353800,-882825,SELL
2020-10-16 13:26:00,13:26,6234025,5378975,-855050,SELL
2020-10-16 13:27:00,13:27,6219000,5366100,-852900,SELL
2020-10-16 13:28:00,13:28,6190600,5371925,-818675,SELL
2020-10-16 13:29:00,13:29,6234900,5366100,-868800,SELL
2020-10-16 13:30:00,13:30,6263700,5373375,-890325,SELL
2020-10-16 13:31:00,13:31,6292500,5392725,-899775,SELL
2020-10-16 13:32:00,13:32,6278500,5405925,-872575,SELL
2020-10-16 13:33:00,13:33,6161825,5366250,-795575,SELL
2020-10-16 13:34:00,13:34,6177950,5379125,-798825,SELL
2020-10-16 13:35:00,13:35,6149150,5375575,-773575,SELL
2020-10-16 13:36:00,13:36,6182675,5413350,-769325,SELL
2020-10-16 13:37:00,13:37,6198975,5399600,-799375,SELL
2020-10-16 13:38:00,13:38,6227125,5419550,-807575,SELL
2020-10-16 13:39:00,13:39,6256300,5418100,-838200,SELL
2020-10-16 13:40:00,13:40,6262950,5420750,-842200,SELL
2020-10-16 13:41:00,13:41,6250625,5446850,-803775,SELL
2020-10-16 13:42:00,13:42,6263375,5429625,-833750,SELL
2020-10-16 13:43:00,13:43,6238550,5446900,-791650,SELL
2020-10-16 13:44:00,13:44,6300175,5439925,-860250,SELL
2020-10-16 13:45:00,13:45,6293875,5446175,-847700,SELL
2020-10-16 13:46:00,13:46,6283575,5413500,-870075,SELL
2020-10-16 13:47:00,13:47,6283575,5428900,-854675,SELL
2020-10-16 13:48:00,13:48,6318400,5378800,-939600,SELL
2020-10-16 13:49:00,13:49,6349925,5378800,-971125,SELL
2020-10-16 13:50:00,13:50,6351200,5365025,-986175,SELL
2020-10-16 13:51:00,13:51,6455100,5412850,-1042250,SELL
2020-10-16 13:52:00,13:52,6439325,5403300,-1036025,SELL
2020-10-16 13:53:00,13:53,6467225,5402600,-1064625,SELL
2020-10-16 13:54:00,13:54,6442100,5374675,-1067425,SELL
2020-10-16 13:55:00,13:55,6431675,5345850,-1085825,SELL
2020-10-16 13:56:00,13:56,6432300,5345750,-1086550,SELL
2020-10-16 13:57:00,13:57,6455725,5339725,-1116000,SELL
2020-10-16 13:58:00,13:58,6471000,5368575,-1102425,SELL
2020-10-16 13:59:00,13:59,6467175,5378700,-1088475,SELL
2020-10-16 14:00:00,14:00,6487150,5404525,-1082625,SELL
2020-10-16 14:01:00,14:01,6478050,5389375,-1088675,SELL
2020-10-16 14:02:00,14:02,6492725,5371325,-1121400,SELL
2020-10-16 14:03:00,14:03,6522450,5403175,-1119275,SELL
2020-10-16 14:04:00,14:04,6517700,5403175,-1114525,SELL
2020-10-16 14:05:00,14:05,6497775,5373600,-1124175,SELL
2020-10-16 14:06:00,14:06,6562950,5403150,-1159800,SELL
2020-10-16 14:07:00,14:07,6540750,5393925,-1146825,SELL
2020-10-16 14:08:00,14:08,6577725,5393925,-1183800,SELL
2020-10-16 14:09:00,14:09,6552850,5385300,-1167550,SELL
2020-10-16 14:10:00,14:10,6582575,5419450,-1163125,SELL
2020-10-16 14:11:00,14:11,6591025,5432125,-1158900,SELL
2020-10-16 14:12:00,14:12,6618425,5387900,-1230525,SELL
2020-10-16 14:13:00,14:13,6628925,5401525,-1227400,SELL
2020-10-16 14:14:00,14:14,6652450,5401525,-1250925,SELL
2020-10-16 14:15:00,14:15,6677850,5398525,-1279325,SELL
2020-10-16 14:16:00,14:16,6613550,5388350,-1225200,SELL
2020-10-16 14:17:00,14:17,6611625,5388225,-1223400,SELL
2020-10-16 14:18:00,14:18,6670650,5416400,-1254250,SELL
2020-10-16 14:19:00,14:19,6653800,5432525,-1221275,SELL
2020-10-16 14:20:00,14:20,6707800,5429950,-1277850,SELL
2020-10-16 14:21:00,14:21,6717050,5395975,-1321075,SELL
2020-10-16 14:22:00,14:22,6720650,5428900,-1291750,SELL
2020-10-16 14:23:00,14:23,6686225,5399325,-1286900,SELL
2020-10-16 14:24:00,14:24,6680975,5389300,-1291675,SELL
2020-10-16 14:25:00,14:25,6671925,5389650,-1282275,SELL
2020-10-16 14:26:00,14:26,6654275,5392175,-1262100,SELL
2020-10-16 14:27:00,14:27,6667075,5356450,-1310625,SELL
2020-10-16 14:28:00,14:28,6704700,5370325,-1334375,SELL
2020-10-16 14:29:00,14:29,6708675,5366675,-1342000,SELL
2020-10-16 14:30:00,14:30,6722075,5437525,-1284550,SELL
2020-10-16 14:31:00,14:31,6720725,5411125,-1309600,SELL
2020-10-16 14:32:00,14:32,6667475,5443375,-1224100,SELL
2020-10-16 14:33:00,14:33,6725650,5333875,-1391775,SELL
2020-10-16 14:34:00,14:34,6696800,5362925,-1333875,SELL
2020-10-16 14:35:00,14:35,6728800,5357300,-1371500,SELL
2020-10-16 14:36:00,14:36,6689475,5340425,-1349050,SELL
2020-10-16 14:37:00,14:37,6689675,5367300,-1322375,SELL
2020-10-16 14:38:00,14:38,6653150,5354900,-1298250,SELL
2020-10-16 14:39:00,14:39,6646950,5339725,-1307225,SELL
2020-10-16 14:40:00,14:40,6687950,5359150,-1328800,SELL
2020-10-16 14:41:00,14:41,6659600,5325900,-1333700,SELL
2020-10-16 14:42:00,14:42,6676975,5357875,-1319100,SELL
2020-10-16 14:43:00,14:43,6687050,5334325,-1352725,SELL
2020-10-16 14:44:00,14:44,6712325,5353825,-1358500,SELL
2020-10-16 14:45:00,14:45,6692300,5375800,-1316500,SELL
2020-10-16 14:46:00,14:46,6694775,5378075,-1316700,SELL
2020-10-16 14:47:00,14:47,6686650,5338000,-1348650,SELL
2020-10-16 14:48:00,14:48,6697100,5366350,-1330750,SELL
2020-10-16 14:49:00,14:49,6621200,5332575,-1288625,SELL
2020-10-16 14:50:00,14:50,6645700,5323175,-1322525,SELL
2020-10-16 14:51:00,14:51,6694950,5341325,-1353625,SELL
2020-10-16 14:52:00,14:52,6669025,5321300,-1347725,SELL
2020-10-16 14:53:00,14:53,6669025,5311175,-1357850,SELL
2020-10-16 14:54:00,14:54,6670300,5317600,-1352700,SELL
2020-10-16 14:55:00,14:55,6717200,5298400,-1418800,SELL
2020-10-16 14:56:00,14:56,6694125,5308250,-1385875,SELL
2020-10-16 14:57:00,14:57,6692875,5317700,-1375175,SELL
2020-10-16 14:58:00,14:58,6692875,5314000,-1378875,SELL
2020-10-16 14:59:00,14:59,6702175,5353750,-1348425,SELL
2020-10-16 15:00:00,15:00,6747900,5337175,-1410725,SELL
2020-10-16 15:01:00,15:01,6734925,5313450,-1421475,SELL
2020-10-16 15:02:00,15:02,6739150,5316375,-1422775,SELL
2020-10-16 15:03:00,15:03,6698150,5291775,-1406375,SELL
2020-10-16 15:04:00,15:04,6690125,5284800,-1405325,SELL
2020-10-16 15:05:00,15:05,6635625,5251700,-1383925,SELL
2020-10-16 15:06:00,15:06,6680700,5250575,-1430125,SELL
2020-10-16 15:07:00,15:07,6630500,5226900,-1403600,SELL
2020-10-16 15:08:00,15:08,6671275,5217350,-1453925,SELL
2020-10-16 15:09:00,15:09,6638725,5221100,-1417625,SELL
2020-10-16 15:10:00,15:10,6655750,5245025,-1410725,SELL
2020-10-16 15:11:00,15:11,6666975,5237675,-1429300,SELL
2020-10-16 15:12:00,15:12,6571150,5105475,-1465675,SELL
2020-10-16 15:13:00,15:13,6564400,5102825,-1461575,SELL
2020-10-16 15:14:00,15:14,6593825,5081550,-1512275,SELL
2020-10-16 15:15:00,15:15,6507850,5025850,-1482000,SELL
2020-10-16 15:16:00,15:16,6495525,4992825,-1502700,SELL
2020-10-16 15:17:00,15:17,6524575,5009800,-1514775,SELL
2020-10-16 15:18:00,15:18,6417675,4943750,-1473925,SELL
2020-10-16 15:19:00,15:19,6430550,4951175,-1479375,SELL
2020-10-16 15:20:00,15:20,6442000,4969100,-1472900,SELL
2020-10-16 15:21:00,15:21,6281275,4861450,-1419825,SELL
2020-10-16 15:22:00,15:22,6277125,4855800,-1421325,SELL
2020-10-16 15:23:00,15:23,6263900,4830375,-1433525,SELL
2020-10-16 15:24:00,15:24,6154025,4690750,-1463275,SELL
2020-10-16 15:25:00,15:25,6182250,4695750,-1486500,SELL
2020-10-16 15:26:00,15:26,6160750,4690675,-1470075,SELL
2020-10-16 15:27:00,15:27,6064450,4542675,-1521775,SELL
2020-10-16 15:28:00,15:28,6051125,4564250,-1486875,SELL
2020-10-16 15:29:00,15:29,6080150,4557575,-1522575,SELL
2020-10-19 09:15:00,09:15,5858000,4415400,-1442600,SELL
2020-10-19 09:16:00,09:16,5850400,4414975,-1435425,SELL
2020-10-19 09:17:00,09:17,6129325,4787825,-1341500,SELL
2020-10-19 09:18:00,09:18,6104625,4785500,-1319125,SELL
2020-10-19 09:19:00,09:19,6122625,4799200,-1323425,SELL
2020-10-19 09:20:00,09:20,6355850,5147425,-1208425,SELL
2020-10-19 09:21:00,09:21,6336925,5147675,-1189250,SELL
2020-10-19 09:22:00,09:22,6380800,5146525,-1234275,SELL
2020-10-19 09:23:00,09:23,6609700,5408200,-1201500,SELL
2020-10-19 09:24:00,09:24,6614075,5408400,-1205675,SELL
2020-10-19 09:25:00,09:25,6612325,5408575,-1203750,SELL
2020-10-19 09:26:00,09:26,6791800,5542500,-1249300,SELL
2020-10-19 09:27:00,09:27,6803500,5536175,-1267325,SELL
2020-10-19 09:28:00,09:28,6816900,5535000,-1281900,SELL
2020-10-19 09:29:00,09:29,6884725,5696875,-1187850,SELL
2020-10-19 09:30:00,09:30,6856075,5682275,-1173800,SELL
2020-10-19 09:31:00,09:31,6905850,5689550,-1216300,SELL
2020-10-19 09:32:00,09:32,6875075,5913950,-961125,SELL
2020-10-19 09:33:00,09:33,6875500,5915025,-960475,SELL
2020-10-19 09:34:00,09:34,6854250,5898725,-955525,SELL
2020-10-19 09:35:00,09:35,6902375,6066975,-835400,SELL
2020-10-19 09:36:00,09:36,6878925,6068125,-810800,SELL
2020-10-19 09:37:00,09:37,6889850,6075850,-814000,SELL
2020-10-19 09:38:00,09:38,6921150,6121575,-799575,SELL
2020-10-19 09:39:00,09:39,6938525,6121425,-817100,SELL
2020-10-19 09:40:00,09:40,6960000,6122700,-837300,SELL
2020-10-19 09:41:00,09:41,6750000,6257375,-492625,SELL
2020-10-19 09:42:00,09:42,6776700,6267150,-509550,SELL
2020-10-19 09:43:00,09:43,6787400,6266275,-521125,SELL
2020-10-19 09:44:00,09:44,6674650,6375925,-298725,SELL
2020-10-19 09:45:00,09:45,6641750,6386050,-255700,SELL
2020-10-19 09:46:00,09:46,6674750,6374825,-299925,SELL
2020-10-19 09:47:00,09:47,6744225,6545025,-199200,SELL
2020-10-19 09:48:00,09:48,6744225,6538750,-205475,SELL
2020-10-19 09:49:00,09:49,6759025,6544925,-214100,SELL
2020-10-19 09:50:00,09:50,6851000,6625300,-225700,SELL
2020-10-19 09:51:00,09:51,6834500,6616275,-218225,SELL
2020-10-19 09:52:00,09:52,6790675,6626300,-164375,SELL
2020-10-19 09:53:00,09:53,6631475,6732975,101500,BUY
2020-10-19 09:54:00,09:54,6664275,6743250,78975,BUY
2020-10-19 09:55:00,09:55,6634350,6740800,106450,BUY
2020-10-19 09:56:00,09:56,6682975,6879600,196625,BUY
2020-10-19 09:57:00,09:57,6652350,6881525,229175,BUY
2020-10-19 09:58:00,09:58,6649100,6871925,222825,BUY
2020-10-19 09:59:00,09:59,6743025,7063300,320275,BUY
2020-10-19 10:00:00,10:00,6725350,7062100,336750,BUY
2020-10-19 10:01:00,10:01,6734975,7064200,329225,BUY
2020-10-19 10:02:00,10:02,6703700,7141075,437375,BUY
2020-10-19 10:03:00,10:03,6741725,7142175,400450,BUY
2020-10-19 10:04:00,10:04,6703700,7141075,437375,BUY
2020-10-19 10:05:00,10:05,6493375,7323200,829825,BUY
2020-10-19 10:06:00,10:06,6474175,7321450,847275,BUY
2020-10-19 10:07:00,10:07,6479675,7320200,840525,BUY
2020-10-19 10:08:00,10:08,6529200,7418750,889550,BUY
2020-10-19 10:09:00,10:09,6533600,7423450,889850,BUY
2020-10-19 10:10:00,10:10,6576725,7427825,851100,BUY
2020-10-19 10:11:00,10:11,6559025,7526600,967575,BUY
2020-10-19 10:12:00,10:12,6539750,7526550,986800,BUY
2020-10-19 10:13:00,10:13,6492275,7517475,1025200,BUY
2020-10-19 10:14:00,10:14,6689500,7605325,915825,BUY
2020-10-19 10:15:00,10:15,6657200,7599700,942500,BUY
2020-10-19 10:16:00,10:16,6703850,7608925,905075,BUY
2020-10-19 10:17:00,10:17,6658350,7751650,1093300,BUY
2020-10-19 10:18:00,10:18,6625175,7744250,1119075,BUY
2020-10-19 10:19:00,10:19,6640300,7747475,1107175,BUY
2020-10-19 10:20:00,10:20,6765325,7836300,1070975,BUY
2020-10-19 10:21:00,10:21,6781650,7839375,1057725,BUY
2020-10-19 10:22:00,10:22,6757625,7833250,1075625,BUY
2020-10-19 10:23:00,10:23,6826275,7905200,1078925,BUY
2020-10-19 10:24:00,10:24,6845725,7808800,963075,BUY
2020-10-19 10:25:00,10:25,6856625,7902425,1045800,BUY
2020-10-19 10:26:00,10:26,6933475,7978875,1045400,BUY
2020-10-19 10:27:00,10:27,6919400,7981775,1062375,BUY
2020-10-19 10:28:00,10:28,6929000,7965225,1036225,BUY
2020-10-19 10:29:00,10:29,6936125,8069750,1133625,BUY
2020-10-19 10:30:00,10:30,6964900,8066025,1101125,BUY
2020-10-19 10:31:00,10:31,6942650,8063150,1120500,BUY
2020-10-19 10:32:00,10:32,7001950,8111250,1109300,BUY
2020-10-19 10:33:00,10:33,6958175,8115300,1157125,BUY
2020-10-19 10:34:00,10:34,6983275,8117700,1134425,BUY
2020-10-19 10:35:00,10:35,7000875,8191800,1190925,BUY
2020-10-19 10:36:00,10:36,6996425,8185475,1189050,BUY
2020-10-19 10:37:00,10:37,6976575,8184275,1207700,BUY
2020-10-19 10:38:00,10:38,7045675,8230000,1184325,BUY
2020-10-19 10:39:00,10:39,7086650,8243275,1156625,BUY
2020-10-19 10:40:00,10:40,7032925,8239950,1207025,BUY
2020-10-19 10:41:00,10:41,7046125,8326925,1280800,BUY
2020-10-19 10:42:00,10:42,7021800,8318025,1296225,BUY
2020-10-19 10:43:00,10:43,7018275,8309025,1290750,BUY
2020-10-19 10:44:00,10:44,7042050,8324950,1282900,BUY
2020-10-19 10:45:00,10:45,7055700,8314725,1259025,BUY
2020-10-19 10:46:00,10:46,7060925,8320875,1259950,BUY
2020-10-19 10:47:00,10:47,7095400,8329350,1233950,BUY
2020-10-19 10:48:00,10:48,7113625,8332675,1219050,BUY
2020-10-19 10:49:00,10:49,7063050,8325300,1262250,BUY
2020-10-19 10:50:00,10:50,7137175,8326950,1189775,BUY
2020-10-19 10:51:00,10:51,7151475,8330675,1179200,BUY
2020-10-19 10:52:00,10:52,7057625,8313350,1255725,BUY
2020-10-19 10:53:00,10:53,7181325,8364175,1182850,BUY
2020-10-19 10:54:00,10:54,7151500,8376150,1224650,BUY
2020-10-19 10:55:00,10:55,7187075,8380500,1193425,BUY
2020-10-19 10:56:00,10:56,7137825,8293625,1155800,BUY
2020-10-19 10:57:00,10:57,7137775,8298900,1161125,BUY
2020-10-19 10:58:00,10:58,7084275,8294450,1210175,BUY
2020-10-19 10:59:00,10:59,7145625,8361100,1215475,BUY
2020-10-19 11:00:00,11:00,7065125,8363800,1298675,BUY
2020-10-19 11:01:00,11:01,7188225,8361650,1173425,BUY
2020-10-19 11:02:00,11:02,7210375,8411825,1201450,BUY
2020-10-19 11:03:00,11:03,7159200,8412700,1253500,BUY
2020-10-19 11:04:00,11:04,7191750,8416050,1224300,BUY
2020-10-19 11:05:00,11:05,7218100,8407625,1189525,BUY
2020-10-19 11:06:00,11:06,7197475,8402400,1204925,BUY
2020-10-19 11:07:00,11:07,7261575,8402400,1140825,BUY
2020-10-19 11:08:00,11:08,7259450,8432850,1173400,BUY
2020-10-19 11:09:00,11:09,7269225,8416425,1147200,BUY
2020-10-19 11:10:00,11:10,7288950,8426200,1137250,BUY
2020-10-19 11:11:00,11:11,7193575,8396200,1202625,BUY
2020-10-19 11:12:00,11:12,7244950,8416825,1171875,BUY
2020-10-19 11:13:00,11:13,7281225,8400000,1118775,BUY
2020-10-19 11:14:00,11:14,7244725,8380750,1136025,BUY
2020-10-19 11:15:00,11:15,7255075,8432200,1177125,BUY
2020-10-19 11:16:00,11:16,7238775,8431525,1192750,BUY
2020-10-19 11:17:00,11:17,7222825,8452325,1229500,BUY
2020-10-19 11:18:00,11:18,7243875,8452650,1208775,BUY
2020-10-19 11:19:00,11:19,7262925,8439350,1176425,BUY
2020-10-19 11:20:00,11:20,7286850,8436375,1149525,BUY
2020-10-19 11:21:00,11:21,7307425,8439650,1132225,BUY
2020-10-19 11:22:00,11:22,7257225,8433375,1176150,BUY
2020-10-19 11:23:00,11:23,7315275,8392775,1077500,BUY
2020-10-19 11:24:00,11:24,7335875,8390575,1054700,BUY
2020-10-19 11:25:00,11:25,7302175,8396400,1094225,BUY
2020-10-19 11:26:00,11:26,7368900,8469650,1100750,BUY
2020-10-19 11:27:00,11:27,7402575,8466375,1063800,BUY
2020-10-19 11:28:00,11:28,7408275,8466375,1058100,BUY
2020-10-19 11:29:00,11:29,7487800,8482850,995050,BUY
2020-10-19 11:30:00,11:30,7487025,8488250,1001225,BUY
2020-10-19 11:31:00,11:31,7438150,8498250,1060100,BUY
2020-10-19 11:32:00,11:32,7492075,8494025,1001950,BUY
2020-10-19 11:33:00,11:33,7354150,8494275,1140125,BUY
2020-10-19 11:34:00,11:34,7491950,8489350,997400,BUY
2020-10-19 11:35:00,11:35,7491500,8525675,1034175,BUY
2020-10-19 11:36:00,11:36,7503425,8533850,1030425,BUY
2020-10-19 11:37:00,11:37,7464875,8527650,1062775,BUY
2020-10-19 11:38:00,11:38,7474200,8568775,1094575,BUY
2020-10-19 11:39:00,11:39,7454650,8570325,1115675,BUY
2020-10-19 11:40:00,11:40,7396200,8573225,1177025,BUY
2020-10-19 11:41:00,11:41,7497725,8582025,1084300,BUY
2020-10-19 11:42:00,11:42,7592300,8582950,990650,BUY
2020-10-19 11:43:00,11:43,7570700,8577750,1007050,BUY
2020-10-19 11:44:00,11:44,7391075,8580400,1189325,BUY
2020-10-19 11:45:00,11:45,7478250,8579200,1100950,BUY
2020-10-19 11:46:00,11:46,7446000,8576250,1130250,BUY
2020-10-19 11:47:00,11:47,7429050,8594825,1165775,BUY
2020-10-19 11:48:00,11:48,7543775,8611875,1068100,BUY
2020-10-19 11:49:00,11:49,7340475,8602250,1261775,BUY
2020-10-19 11:50:00,11:50,7368350,8610725,1242375,BUY
2020-10-19 11:51:00,11:51,7545850,8622475,1076625,BUY
2020-10-19 11:52:00,11:52,7535850,8609450,1073600,BUY
2020-10-19 11:53:00,11:53,7596550,8596925,1000375,BUY
2020-10-19 11:54:00,11:54,7605850,8613425,1007575,BUY
2020-10-19 11:55:00,11:55,7549525,8606675,1057150,BUY
2020-10-19 11:56:00,11:56,7449600,8508375,1058775,BUY
2020-10-19 11:57:00,11:57,7446300,8512000,1065700,BUY
2020-10-19 11:58:00,11:58,7511150,8512000,1000850,BUY
2020-10-19 11:59:00,11:59,7515625,8518200,1002575,BUY
2020-10-19 12:00:00,12:00,7374125,8530825,1156700,BUY
2020-10-19 12:01:00,12:01,7236525,8520525,1284000,BUY
2020-10-19 12:02:00,12:02,7582950,8578825,995875,BUY
2020-10-19 12:03:00,12:03,7596475,8579100,982625,BUY
2020-10-19 12:04:00,12:04,7582375,8569525,987150,BUY
2020-10-19 12:05:00,12:05,7450575,8595975,1145400,BUY
2020-10-19 12:06:00,12:06,7503275,8589675,1086400,BUY
2020-10-19 12:07:00,12:07,7406050,8599225,1193175,BUY
2020-10-19 12:08:00,12:08,7529400,8710325,1180925,BUY
2020-10-19 12:09:00,12:09,7521450,8713925,1192475,BUY
2020-10-19 12:10:00,12:10,7528225,8706825,1178600,BUY
2020-10-19 12:11:00,12:11,7517050,8761250,1244200,BUY
2020-10-19 12:12:00,12:12,7387100,8766775,1379675,BUY
2020-10-19 12:13:00,12:13,7391675,8759325,1367650,BUY
2020-10-19 12:14:00,12:14,7518575,8866375,1347800,BUY
2020-10-19 12:15:00,12:15,7543825,8866825,1323000,BUY
2020-10-19 12:16:00,12:16,7524950,8863450,1338500,BUY
2020-10-19 12:17:00,12:17,7586975,8936750,1349775,BUY
2020-10-19 12:18:00,12:18,7555350,8924975,1369625,BUY
2020-10-19 12:19:00,12:19,7420675,8923275,1502600,BUY
2020-10-19 12:20:00,12:20,7631200,8959500,1328300,BUY
2020-10-19 12:21:00,12:21,7513875,8967550,1453675,BUY
2020-10-19 12:22:00,12:22,7548000,8978350,1430350,BUY
2020-10-19 12:23:00,12:23,7628325,8993525,1365200,BUY
2020-10-19 12:24:00,12:24,7632350,8998550,1366200,BUY
2020-10-19 12:25:00,12:25,7518425,8998875,1480450,BUY
2020-10-19 12:26:00,12:26,7629550,9003100,1373550,BUY
2020-10-19 12:27:00,12:27,7527150,8991050,1463900,BUY
2020-10-19 12:28:00,12:28,7551250,9001350,1450100,BUY
2020-10-19 12:29:00,12:29,7638925,9003650,1364725,BUY
2020-10-19 12:30:00,12:30,7665850,9016900,1351050,BUY
2020-10-19 12:31:00,12:31,7620275,9003775,1383500,BUY
2020-10-19 12:32:00,12:32,7583575,9086425,1502850,BUY
2020-10-19 12:33:00,12:33,7614375,9089600,1475225,BUY
2020-10-19 12:34:00,12:34,7561350,9079975,1518625,BUY
2020-10-19 12:35:00,12:35,7534775,9046625,1511850,BUY
2020-10-19 12:36:00,12:36,7513050,9086450,1573400,BUY
2020-10-19 12:37:00,12:37,7536925,9084700,1547775,BUY
2020-10-19 12:38:00,12:38,7486000,9124650,1638650,BUY
2020-10-19 12:39:00,12:39,7507025,9137175,1630150,BUY
2020-10-19 12:40:00,12:40,7452575,9133400,1680825,BUY
2020-10-19 12:41:00,12:41,7455250,9089250,1634000,BUY
2020-10-19 12:42:00,12:42,7533250,9090750,1557500,BUY
2020-10-19 12:43:00,12:43,7413100,9086650,1673550,BUY
2020-10-19 12:44:00,12:44,7519375,9123800,1604425,BUY
2020-10-19 12:45:00,12:45,7522575,9112325,1589750,BUY
2020-10-19 12:46:00,12:46,7505125,9112325,1607200,BUY
2020-10-19 12:47:00,12:47,7408400,9117225,1708825,BUY
2020-10-19 12:48:00,12:48,7371200,9138225,1767025,BUY
2020-10-19 12:49:00,12:49,7388675,9130400,1741725,BUY
2020-10-19 12:50:00,12:50,7428000,9180875,1752875,BUY
2020-10-19 12:51:00,12:51,7417200,9201000,1783800,BUY
2020-10-19 12:52:00,12:52,7413575,9190375,1776800,BUY
2020-10-19 12:53:00,12:53,7458325,9202250,1743925,BUY
2020-10-19 12:54:00,12:54,7336475,9195975,1859500,BUY
2020-10-19 12:55:00,12:55,7353850,9134975,1781125,BUY
2020-10-19 12:56:00,12:56,7382800,9193875,1811075,BUY
2020-10-19 12:57:00,12:57,7374475,9189625,1815150,BUY
2020-10-19 12:58:00,12:58,7374475,9186050,1811575,BUY
2020-10-19 12:59:00,12:59,7359700,9197200,1837500,BUY
2020-10-19 13:00:00,13:00,7361600,9215325,1853725,BUY
2020-10-19 13:01:00,13:01,7188225,9223050,2034825,BUY
2020-10-19 13:02:00,13:02,7350200,9161775,1811575,BUY
2020-10-19 13:03:00,13:03,7342625,9240525,1897900,BUY
2020-10-19 13:04:00,13:04,7378050,9244150,1866100,BUY
2020-10-19 13:05:00,13:05,7417500,9243700,1826200,BUY
2020-10-19 13:06:00,13:06,7322050,9234100,1912050,BUY
2020-10-19 13:07:00,13:07,7404725,9236800,1832075,BUY
2020-10-19 13:08:00,13:08,7327250,9236750,1909500,BUY
2020-10-19 13:09:00,13:09,7312400,9224000,1911600,BUY
2020-10-19 13:10:00,13:10,7380150,9281550,1901400,BUY
2020-10-19 13:11:00,13:11,7183525,9284225,2100700,BUY
2020-10-19 13:12:00,13:12,7350900,9269000,1918100,BUY
2020-10-19 13:13:00,13:13,7396600,9279775,1883175,BUY
2020-10-19 13:14:00,13:14,7386300,9275950,1889650,BUY
2020-10-19 13:15:00,13:15,7502725,9337400,1834675,BUY
2020-10-19 13:16:00,13:16,7499950,9335300,1835350,BUY
2020-10-19 13:17:00,13:17,7447825,9335575,1887750,BUY
2020-10-19 13:18:00,13:18,7206525,9265025,2058500,BUY
2020-10-19 13:19:00,13:19,7200150,9266550,2066400,BUY
2020-10-19 13:20:00,13:20,7152850,9270625,2117775,BUY
2020-10-19 13:21:00,13:21,7207600,9337175,2129575,BUY
2020-10-19 13:22:00,13:22,7215575,9335125,2119550,BUY
2020-10-19 13:23:00,13:23,7213575,9331325,2117750,BUY
2020-10-19 13:24:00,13:24,7247500,9383225,2135725,BUY
2020-10-19 13:25:00,13:25,7248350,9366000,2117650,BUY
2020-10-19 13:26:00,13:26,7265775,9379125,2113350,BUY
2020-10-19 13:27:00,13:27,7228700,9371575,2142875,BUY
2020-10-19 13:28:00,13:28,7098950,9369250,2270300,BUY
2020-10-19 13:29:00,13:29,7239825,9376700,2136875,BUY
2020-10-19 13:30:00,13:30,7240575,9334500,2093925,BUY
2020-10-19 13:31:00,13:31,7191225,9325925,2134700,BUY
2020-10-19 13:32:00,13:32,7188625,9333325,2144700,BUY
2020-10-19 13:33:00,13:33,7086375,9310475,2224100,BUY
2020-10-19 13:34:00,13:34,7100500,9327225,2226725,BUY
2020-10-19 13:35:00,13:35,7232800,9320250,2087450,BUY
2020-10-19 13:36:00,13:36,7267275,9319000,2051725,BUY
2020-10-19 13:37:00,13:37,7297575,9337500,2039925,BUY
2020-10-19 13:38:00,13:38,7297575,9328025,2030450,BUY
2020-10-19 13:39:00,13:39,7194925,9352500,2157575,BUY
2020-10-19 13:40:00,13:40,7200925,9349050,2148125,BUY
2020-10-19 13:41:00,13:41,7251275,9361275,2110000,BUY
2020-10-19 13:42:00,13:42,7254200,9274950,2020750,BUY
2020-10-19 13:43:00,13:43,7177300,9337625,2160325,BUY
2020-10-19 13:44:00,13:44,7146725,9340625,2193900,BUY
2020-10-19 13:45:00,13:45,7198725,9358200,2159475,BUY
2020-10-19 13:46:00,13:46,7312550,9362400,2049850,BUY
2020-10-19 13:47:00,13:47,7217775,9358650,2140875,BUY
2020-10-19 13:48:00,13:48,7302700,9391725,2089025,BUY
2020-10-19 13:49:00,13:49,7227450,9376950,2149500,BUY
2020-10-19 13:50:00,13:50,7175825,9395350,2219525,BUY
2020-10-19 13:51:00,13:51,7299950,9400050,2100100,BUY
2020-10-19 13:52:00,13:52,7281350,9387325,2105975,BUY
2020-10-19 13:53:00,13:53,7246825,9401150,2154325,BUY
2020-10-19 13:54:00,13:54,7223750,9399050,2175300,BUY
2020-10-19 13:55:00,13:55,7296925,9402550,2105625,BUY
2020-10-19 13:56:00,13:56,7292150,9412200,2120050,BUY
2020-10-19 13:57:00,13:57,7283275,9446525,2163250,BUY
2020-10-19 13:58:00,13:58,7351550,9438175,2086625,BUY
2020-10-19 13:59:00,13:59,7359875,9446550,2086675,BUY
2020-10-19 14:00:00,14:00,7347925,9521725,2173800,BUY
2020-10-19 14:01:00,14:01,7250600,9510550,2259950,BUY
2020-10-19 14:02:00,14:02,7301425,9500000,2198575,BUY
2020-10-19 14:03:00,14:03,7455850,9532825,2076975,BUY
2020-10-19 14:04:00,14:04,7510875,9547875,2037000,BUY
2020-10-19 14:05:00,14:05,7492250,9552525,2060275,BUY
2020-10-19 14:06:00,14:06,7419225,9577850,2158625,BUY
2020-10-19 14:07:00,14:07,7389500,9572400,2182900,BUY
2020-10-19 14:08:00,14:08,7349425,9576750,2227325,BUY
2020-10-19 14:09:00,14:09,7411750,9628675,2216925,BUY
2020-10-19 14:10:00,14:10,7463200,9626825,2163625,BUY
2020-10-19 14:11:00,14:11,7472825,9604050,2131225,BUY
2020-10-19 14:12:00,14:12,7341375,9625200,2283825,BUY
2020-10-19 14:13:00,14:13,7466950,9627550,2160600,BUY
2020-10-19 14:14:00,14:14,7477950,9614925,2136975,BUY
2020-10-19 14:15:00,14:15,7493425,9666825,2173400,BUY
2020-10-19 14:16:00,14:16,7483225,9656425,2173200,BUY
2020-10-19 14:17:00,14:17,7493425,9656450,2163025,BUY
2020-10-19 14:18:00,14:18,7537725,9640750,2103025,BUY
2020-10-19 14:19:00,14:19,7527875,9640950,2113075,BUY
2020-10-19 14:20:00,14:20,7472875,9630350,2157475,BUY
2020-10-19 14:21:00,14:21,7462925,9605525,2142600,BUY
2020-10-19 14:22:00,14:22,7431175,9606075,2174900,BUY
2020-10-19 14:23:00,14:23,7452750,9611425,2158675,BUY
2020-10-19 14:24:00,14:24,7472025,9591475,2119450,BUY
2020-10-19 14:25:00,14:25,7472850,9608625,2135775,BUY
2020-10-19 14:26:00,14:26,7438800,9598600,2159800,BUY
2020-10-19 14:27:00,14:27,7489175,9612300,2123125,BUY
2020-10-19 14:28:00,14:28,7455175,9612300,2157125,BUY
2020-10-19 14:29:00,14:29,7431600,9614125,2182525,BUY
2020-10-19 14:30:00,14:30,7494850,9650825,2155975,BUY
2020-10-19 14:31:00,14:31,7512475,9656550,2144075,BUY
2020-10-19 14:32:00,14:32,7512450,9650925,2138475,BUY
2020-10-19 14:33:00,14:33,7534775,9646275,2111500,BUY
2020-10-19 14:34:00,14:34,7556175,9653725,2097550,BUY
2020-10-19 14:35:00,14:35,7560675,9655075,2094400,BUY
2020-10-19 14:36:00,14:36,7331275,9582875,2251600,BUY
2020-10-19 14:37:00,14:37,7281175,9583625,2302450,BUY
2020-10-19 14:38:00,14:38,7262400,9573800,2311400,BUY
2020-10-19 14:39:00,14:39,7343250,9649900,2306650,BUY
2020-10-19 14:40:00,14:40,7261800,9651725,2389925,BUY
2020-10-19 14:41:00,14:41,7314475,9651725,2337250,BUY
2020-10-19 14:42:00,14:42,7332925,9662000,2329075,BUY
2020-10-19 14:43:00,14:43,7323350,9662000,2338650,BUY
2020-10-19 14:44:00,14:44,7256550,9656650,2400100,BUY
2020-10-19 14:45:00,14:45,7361700,9695825,2334125,BUY
2020-10-19 14:46:00,14:46,7328675,9695650,2366975,BUY
2020-10-19 14:47:00,14:47,7361700,9701375,2339675,BUY
2020-10-19 14:48:00,14:48,7294175,9708900,2414725,BUY
2020-10-19 14:49:00,14:49,7284325,9710850,2426525,BUY
2020-10-19 14:50:00,14:50,7341500,9712850,2371350,BUY
2020-10-19 14:51:00,14:51,7321600,9725125,2403525,BUY
2020-10-19 14:52:00,14:52,7352250,9718975,2366725,BUY
2020-10-19 14:53:00,14:53,7383850,9723700,2339850,BUY
2020-10-19 14:54:00,14:54,7286475,9644300,2357825,BUY
2020-10-19 14:55:00,14:55,7317800,9634300,2316500,BUY
2020-10-19 14:56:00,14:56,7309225,9640400,2331175,BUY
2020-10-19 14:57:00,14:57,7268850,9616525,2347675,BUY
2020-10-19 14:58:00,14:58,7253050,9622050,2369000,BUY
2020-10-19 14:59:00,14:59,7251575,9617025,2365450,BUY
2020-10-19 15:00:00,15:00,7256625,9570675,2314050,BUY
2020-10-19 15:01:00,15:01,7150425,9570675,2420250,BUY
2020-10-19 15:02:00,15:02,7262875,9571325,2308450,BUY
2020-10-19 15:03:00,15:03,7224050,9501650,2277600,BUY
2020-10-19 15:04:00,15:04,7259275,9496050,2236775,BUY
2020-10-19 15:05:00,15:05,7211250,9500775,2289525,BUY
2020-10-19 15:06:00,15:06,7143725,9437950,2294225,BUY
2020-10-19 15:07:00,15:07,7143750,9439350,2295600,BUY
2020-10-19 15:08:00,15:08,7153850,9438775,2284925,BUY
2020-10-19 15:09:00,15:09,7146000,9423000,2277000,BUY
2020-10-19 15:10:00,15:10,7151775,9418150,2266375,BUY
2020-10-19 15:11:00,15:11,7103075,9416600,2313525,BUY
2020-10-19 15:12:00,15:12,7035850,9349250,2313400,BUY
2020-10-19 15:13:00,15:13,7111150,9359025,2247875,BUY
2020-10-19 15:14:00,15:14,7125300,9359150,2233850,BUY
2020-10-19 15:15:00,15:15,7082375,9283775,2201400,BUY
2020-10-19 15:16:00,15:16,7052975,9281275,2228300,BUY
2020-10-19 15:17:00,15:17,7060375,9280225,2219850,BUY
2020-10-19 15:18:00,15:18,6952500,9145500,2193000,BUY
2020-10-19 15:19:00,15:19,6925175,9149225,2224050,BUY
2020-10-19 15:20:00,15:20,6925800,9154150,2228350,BUY
2020-10-19 15:21:00,15:21,6716375,8940200,2223825,BUY
2020-10-19 15:22:00,15:22,6709150,8934850,2225700,BUY
2020-10-19 15:23:00,15:23,6681650,8936900,2255250,BUY
2020-10-19 15:24:00,15:24,6613125,8778675,2165550,BUY
2020-10-19 15:25:00,15:25,6626475,8781925,2155450,BUY
2020-10-19 15:26:00,15:26,6577650,8778600,2200950,BUY
2020-10-19 15:27:00,15:27,6437425,8574025,2136600,BUY
2020-10-19 15:28:00,15:28,6460775,8571850,2111075,BUY
2020-10-19 15:29:00,15:29,6462325,8574575,2112250,BUY
2020-10-20 09:15:00,09:15,6208750,8331400,2122650,BUY
2020-10-20 09:16:00,09:16,6211475,8326300,2114825,BUY
2020-10-20 09:17:00,09:17,6640525,8868250,2227725,BUY
2020-10-20 09:18:00,09:18,6607350,8870925,2263575,BUY
2020-10-20 09:19:00,09:19,6623100,8848700,2225600,BUY
2020-10-20 09:20:00,09:20,7071525,9379275,2307750,BUY
2020-10-20 09:21:00,09:21,7100625,9381800,2281175,BUY
2020-10-20 09:22:00,09:22,7116350,9385100,2268750,BUY
2020-10-20 09:23:00,09:23,7458025,9602525,2144500,BUY
2020-10-20 09:24:00,09:24,7492250,9612325,2120075,BUY
2020-10-20 09:25:00,09:25,7475225,9609025,2133800,BUY
2020-10-20 09:26:00,09:26,7629050,9663825,2034775,BUY
2020-10-20 09:27:00,09:27,7641850,9614425,1972575,BUY
2020-10-20 09:28:00,09:28,7590500,9660500,2070000,BUY
2020-10-20 09:29:00,09:29,7930600,9857300,1926700,BUY
2020-10-20 09:30:00,09:30,7937425,9868475,1931050,BUY
2020-10-20 09:31:00,09:31,7897825,9863975,1966150,BUY
2020-10-20 09:32:00,09:32,8097300,9935825,1838525,BUY
2020-10-20 09:33:00,09:33,8139275,9937725,1798450,BUY
2020-10-20 09:34:00,09:34,8141475,9941650,1800175,BUY
2020-10-20 09:35:00,09:35,8153750,10091025,1937275,BUY
2020-10-20 09:36:00,09:36,8168825,10013850,1845025,BUY
2020-10-20 09:37:00,09:37,8201975,10094625,1892650,BUY
2020-10-20 09:38:00,09:38,8234200,10110025,1875825,BUY
2020-10-20 09:39:00,09:39,8351425,10146175,1794750,BUY
2020-10-20 09:40:00,09:40,8333825,10152775,1818950,BUY
2020-10-20 09:41:00,09:41,8438075,10239375,1801300,BUY
2020-10-20 09:42:00,09:42,8385175,10232500,1847325,BUY
2020-10-20 09:43:00,09:43,8447650,10231350,1783700,BUY
2020-10-20 09:44:00,09:44,8463975,10301300,1837325,BUY
2020-10-20 09:45:00,09:45,8472025,10323200,1851175,BUY
2020-10-20 09:46:00,09:46,8500250,10315425,1815175,BUY
2020-10-20 09:47:00,09:47,8602575,10364250,1761675,BUY
2020-10-20 09:48:00,09:48,8643675,10379150,1735475,BUY
2020-10-20 09:49:00,09:49,8602575,10356000,1753425,BUY
2020-10-20 09:50:00,09:50,8700975,10492450,1791475,BUY
2020-10-20 09:51:00,09:51,8654825,10478025,1823200,BUY
2020-10-20 09:52:00,09:52,8698700,10485750,1787050,BUY
2020-10-20 09:53:00,09:53,8621250,10504900,1883650,BUY
2020-10-20 09:54:00,09:54,8557750,10495200,1937450,BUY
2020-10-20 09:55:00,09:55,8645575,10526050,1880475,BUY
2020-10-20 09:56:00,09:56,8677725,10440350,1762625,BUY
2020-10-20 09:57:00,09:57,8772525,10433125,1660600,BUY
2020-10-20 09:58:00,09:58,8698375,10388800,1690425,BUY
2020-10-20 09:59:00,09:59,8808775,10512275,1703500,BUY
2020-10-20 10:00:00,10:00,8838950,10517550,1678600,BUY
2020-10-20 10:01:00,10:01,8793825,10512275,1718450,BUY
2020-10-20 10:02:00,10:02,8884875,10535050,1650175,BUY
2020-10-20 10:03:00,10:03,8913025,10522050,1609025,BUY
2020-10-20 10:04:00,10:04,8832500,10534450,1701950,BUY
2020-10-20 10:05:00,10:05,8936950,10606600,1669650,BUY
2020-10-20 10:06:00,10:06,8939550,10606000,1666450,BUY
2020-10-20 10:07:00,10:07,8946375,10613950,1667575,BUY
2020-10-20 10:08:00,10:08,8935000,10616375,1681375,BUY
2020-10-20 10:09:00,10:09,9015050,10642175,1627125,BUY
2020-10-20 10:10:00,10:10,9029875,10641475,1611600,BUY
2020-10-20 10:11:00,10:11,9028200,10642850,1614650,BUY
2020-10-20 10:12:00,10:12,8835625,10654050,1818425,BUY
2020-10-20 10:13:00,10:13,8885225,10617175,1731950,BUY
2020-10-20 10:14:00,10:14,9054675,10740825,1686150,BUY
2020-10-20 10:15:00,10:15,9019475,10746200,1726725,BUY
2020-10-20 10:16:00,10:16,8946275,10748875,1802600,BUY
2020-10-20 10:17:00,10:17,8995550,10777400,1781850,BUY
2020-10-20 10:18:00,10:18,9034525,10747225,1712700,BUY
2020-10-20 10:19:00,10:19,9103950,10747225,1643275,BUY
2020-10-20 10:20:00,10:20,9142150,10828700,1686550,BUY
2020-10-20 10:21:00,10:21,8921300,10820575,1899275,BUY
2020-10-20 10:22:00,10:22,9023350,10820575,1797225,BUY
2020-10-20 10:23:00,10:23,8951300,10866975,1915675,BUY
2020-10-20 10:24:00,10:24,8951300,10686950,1735650,BUY
2020-10-20 10:25:00,10:25,8924425,10832900,1908475,BUY
2020-10-20 10:26:00,10:26,9125375,10887875,1762500,BUY
2020-10-20 10:27:00,10:27,9138050,10880975,1742925,BUY
2020-10-20 10:28:00,10:28,9153350,10773900,1620550,BUY
2020-10-20 10:29:00,10:29,9191125,10948625,1757500,BUY
2020-10-20 10:30:00,10:30,9004275,10931300,1927025,BUY
2020-10-20 10:31:00,10:31,9059625,10774200,1714575,BUY
2020-10-20 10:32:00,10:32,9157875,11001150,1843275,BUY
2020-10-20 10:33:00,10:33,9081275,11001750,1920475,BUY
2020-10-20 10:34:00,10:34,9029650,11001750,1972100,BUY
2020-10-20 10:35:00,10:35,9157025,11077825,1920800,BUY
2020-10-20 10:36:00,10:36,9157200,11076225,1919025,BUY
2020-10-20 10:37:00,10:37,9205100,11062900,1857800,BUY
2020-10-20 10:38:00,10:38,9095700,11138550,2042850,BUY
2020-10-20 10:39:00,10:39,9169325,11148700,1979375,BUY
2020-10-20 10:40:00,10:40,9119950,11150275,2030325,BUY
2020-10-20 10:41:00,10:41,9199075,11113300,1914225,BUY
2020-10-20 10:42:00,10:42,9123000,11048575,1925575,BUY
2020-10-20 10:43:00,10:43,9217075,11149450,1932375,BUY
2020-10-20 10:44:00,10:44,9184350,11114875,1930525,BUY
2020-10-20 10:45:00,10:45,9185425,11108550,1923125,BUY
2020-10-20 10:46:00,10:46,9100150,11098800,1998650,BUY
2020-10-20 10:47:00,10:47,8846025,11012125,2166100,BUY
2020-10-20 10:48:00,10:48,8821950,11017750,2195800,BUY
2020-10-20 10:49:00,10:49,8890725,11017750,2127025,BUY
2020-10-20 10:50:00,10:50,8862325,11077050,2214725,BUY
2020-10-20 10:51:00,10:51,8789450,11077050,2287600,BUY
2020-10-20 10:52:00,10:52,8867000,11066650,2199650,BUY
2020-10-20 10:53:00,10:53,8798450,11093425,2294975,BUY
2020-10-20 10:54:00,10:54,8844475,11101725,2257250,BUY
2020-10-20 10:55:00,10:55,8739900,11101725,2361825,BUY
2020-10-20 10:56:00,10:56,8822650,11113575,2290925,BUY
2020-10-20 10:57:00,10:57,8688625,11115575,2426950,BUY
2020-10-20 10:58:00,10:58,8859000,11094375,2235375,BUY
2020-10-20 10:59:00,10:59,8864275,11165300,2301025,BUY
2020-10-20 11:00:00,11:00,8852600,11124300,2271700,BUY
2020-10-20 11:01:00,11:01,8843850,11164575,2320725,BUY
2020-10-20 11:02:00,11:02,8787650,11232825,2445175,BUY
2020-10-20 11:03:00,11:03,8806550,11225100,2418550,BUY
2020-10-20 11:04:00,11:04,8857900,11196275,2338375,BUY
2020-10-20 11:05:00,11:05,8731950,11251800,2519850,BUY
2020-10-20 11:06:00,11:06,8904800,11170125,2265325,BUY
2020-10-20 11:07:00,11:07,8738300,11092750,2354450,BUY
2020-10-20 11:08:00,11:08,8823475,11217250,2393775,BUY
2020-10-20 11:09:00,11:09,8920950,11309600,2388650,BUY
2020-10-20 11:10:00,11:10,8980150,11317100,2336950,BUY
2020-10-20 11:11:00,11:11,8714700,11326100,2611400,BUY
2020-10-20 11:12:00,11:12,8701625,11330175,2628550,BUY
2020-10-20 11:13:00,11:13,8724100,11330175,2606075,BUY
2020-10-20 11:14:00,11:14,8493375,11241825,2748450,BUY
2020-10-20 11:15:00,11:15,8419350,11240900,2821550,BUY
2020-10-20 11:16:00,11:16,8386850,11240075,2853225,BUY
2020-10-20 11:17:00,11:17,8455725,11286775,2831050,BUY
2020-10-20 11:18:00,11:18,8451925,11294000,2842075,BUY
2020-10-20 11:19:00,11:19,8497925,11297400,2799475,BUY
2020-10-20 11:20:00,11:20,8495550,11301500,2805950,BUY
2020-10-20 11:21:00,11:21,8468050,11300700,2832650,BUY
2020-10-20 11:22:00,11:22,8354975,11301800,2946825,BUY
2020-10-20 11:23:00,11:23,8379600,11335875,2956275,BUY
2020-10-20 11:24:00,11:24,8435075,11335825,2900750,BUY
2020-10-20 11:25:00,11:25,8326000,11329175,3003175,BUY
2020-10-20 11:26:00,11:26,8360075,11292325,2932250,BUY
2020-10-20 11:27:00,11:27,8366525,11309150,2942625,BUY
2020-10-20 11:28:00,11:28,8438225,11306450,2868225,BUY
2020-10-20 11:29:00,11:29,8407150,11316400,2909250,BUY
2020-10-20 11:30:00,11:30,8343400,11310375,2966975,BUY
2020-10-20 11:31:00,11:31,8191625,11263850,3072225,BUY
2020-10-20 11:32:00,11:32,8478500,11284400,2805900,BUY
2020-10-20 11:33:00,11:33,8291325,11276350,2985025,BUY
2020-10-20 11:34:00,11:34,8459975,11150250,2690275,BUY
2020-10-20 11:35:00,11:35,8346675,11285050,2938375,BUY
2020-10-20 11:36:00,11:36,8360425,11291725,2931300,BUY
2020-10-20 11:37:00,11:37,8242575,11164725,2922150,BUY
2020-10-20 11:38:00,11:38,8434575,11303225,2868650,BUY
2020-10-20 11:39:00,11:39,8374975,11291800,2916825,BUY
2020-10-20 11:40:00,11:40,8259525,11303900,3044375,BUY
2020-10-20 11:41:00,11:41,8363550,11326625,2963075,BUY
2020-10-20 11:42:00,11:42,8248625,11300350,3051725,BUY
2020-10-20 11:43:00,11:43,8312875,11310700,2997825,BUY
2020-10-20 11:44:00,11:44,8298000,11332125,3034125,BUY
2020-10-20 11:45:00,11:45,8357375,11340875,2983500,BUY
2020-10-20 11:46:00,11:46,8332875,11332125,2999250,BUY
2020-10-20 11:47:00,11:47,8348625,11370675,3022050,BUY
2020-10-20 11:48:00,11:48,8224650,11282725,3058075,BUY
2020-10-20 11:49:00,11:49,8309450,11376600,3067150,BUY
2020-10-20 11:50:00,11:50,8245475,10851975,2606500,BUY
2020-10-20 11:51:00,11:51,8429300,11400325,2971025,BUY
2020-10-20 11:52:00,11:52,8414275,11392850,2978575,BUY
2020-10-20 11:53:00,11:53,8359975,11415125,3055150,BUY
2020-10-20 11:54:00,11:54,8333700,11411875,3078175,BUY
2020-10-20 11:55:00,11:55,8333700,11413825,3080125,BUY
2020-10-20 11:56:00,11:56,8197425,11471950,3274525,BUY
2020-10-20 11:57:00,11:57,8214750,11471175,3256425,BUY
2020-10-20 11:58:00,11:58,8124425,11424400,3299975,BUY
2020-10-20 11:59:00,11:59,8093350,11500600,3407250,BUY
2020-10-20 12:00:00,12:00,8184100,11483700,3299600,BUY
2020-10-20 12:01:00,12:01,8131200,11507125,3375925,BUY
2020-10-20 12:02:00,12:02,8192375,11537250,3344875,BUY
2020-10-20 12:03:00,12:03,8242150,11464425,3222275,BUY
2020-10-20 12:04:00,12:04,8156850,11548700,3391850,BUY
2020-10-20 12:05:00,12:05,8219000,11557100,3338100,BUY
2020-10-20 12:06:00,12:06,8199125,11559175,3360050,BUY
2020-10-20 12:07:00,12:07,8207950,11563600,3355650,BUY
2020-10-20 12:08:00,12:08,8289200,11497250,3208050,BUY
2020-10-20 12:09:00,12:09,8194650,11547025,3352375,BUY
2020-10-20 12:10:00,12:10,8262525,11500600,3238075,BUY
2020-10-20 12:11:00,12:11,8144575,11507000,3362425,BUY
2020-10-20 12:12:00,12:12,8232875,11558475,3325600,BUY
2020-10-20 12:13:00,12:13,8025850,11510475,3484625,BUY
2020-10-20 12:14:00,12:14,8114525,11558450,3443925,BUY
2020-10-20 12:15:00,12:15,8213100,11548900,3335800,BUY
2020-10-20 12:16:00,12:16,8230625,11528550,3297925,BUY
2020-10-20 12:17:00,12:17,8293400,11586375,3292975,BUY
2020-10-20 12:18:00,12:18,8178200,11589325,3411125,BUY
2020-10-20 12:19:00,12:19,8159900,11095025,2935125,BUY
2020-10-20 12:20:00,12:20,8368350,11545825,3177475,BUY
2020-10-20 12:21:00,12:21,8178625,11477050,3298425,BUY
2020-10-20 12:22:00,12:22,8108900,11490800,3381900,BUY
2020-10-20 12:23:00,12:23,8384125,11578725,3194600,BUY
2020-10-20 12:24:00,12:24,8400900,11583000,3182100,BUY
2020-10-20 12:25:00,12:25,8394250,11581425,3187175,BUY
2020-10-20 12:26:00,12:26,8115225,11487650,3372425,BUY
2020-10-20 12:27:00,12:27,8241000,11518475,3277475,BUY
2020-10-20 12:28:00,12:28,8151875,11557050,3405175,BUY
2020-10-20 12:29:00,12:29,8203225,11586450,3383225,BUY
2020-10-20 12:30:00,12:30,8288250,11592275,3304025,BUY
2020-10-20 12:31:00,12:31,8199500,11588400,3388900,BUY
2020-10-20 12:32:00,12:32,8205700,11589350,3383650,BUY
2020-10-20 12:33:00,12:33,8205825,11586975,3381150,BUY
2020-10-20 12:34:00,12:34,8251375,11459000,3207625,BUY
2020-10-20 12:35:00,12:35,8055400,11623600,3568200,BUY
2020-10-20 12:36:00,12:36,8286600,11549125,3262525,BUY
2020-10-20 12:37:00,12:37,8151900,11617325,3465425,BUY
2020-10-20 12:38:00,12:38,8126600,11637325,3510725,BUY
2020-10-20 12:39:00,12:39,8233325,11636075,3402750,BUY
2020-10-20 12:40:00,12:40,8266450,11633175,3366725,BUY
2020-10-20 12:41:00,12:41,8206525,11647750,3441225,BUY
2020-10-20 12:42:00,12:42,8222250,11641500,3419250,BUY
2020-10-20 12:43:00,12:43,8321475,11642525,3321050,BUY
2020-10-20 12:44:00,12:44,8295875,11655250,3359375,BUY
2020-10-20 12:45:00,12:45,8192850,11655000,3462150,BUY
2020-10-20 12:46:00,12:46,8228025,11656075,3428050,BUY
2020-10-20 12:47:00,12:47,8248000,11105800,2857800,BUY
2020-10-20 12:48:00,12:48,8073350,11652475,3579125,BUY
2020-10-20 12:49:00,12:49,8073350,11592225,3518875,BUY
2020-10-20 12:50:00,12:50,8152925,11669750,3516825,BUY
2020-10-20 12:51:00,12:51,8339925,11665725,3325800,BUY
2020-10-20 12:52:00,12:52,8092000,11665725,3573725,BUY
2020-10-20 12:53:00,12:53,8260000,11682325,3422325,BUY
2020-10-20 12:54:00,12:54,8207725,11619175,3411450,BUY
2020-10-20 12:55:00,12:55,8182100,11620700,3438600,BUY
2020-10-20 12:56:00,12:56,8334250,11703350,3369100,BUY
2020-10-20 12:57:00,12:57,8420100,11709850,3289750,BUY
2020-10-20 12:58:00,12:58,8391275,11702225,3310950,BUY
2020-10-20 12:59:00,12:59,8245225,11695250,3450025,BUY
2020-10-20 13:00:00,13:00,8502700,11748625,3245925,BUY
2020-10-20 13:01:00,13:01,8483200,11740550,3257350,BUY
2020-10-20 13:02:00,13:02,8407925,11761475,3353550,BUY
2020-10-20 13:03:00,13:03,8426675,11759800,3333125,BUY
2020-10-20 13:04:00,13:04,8453000,11749375,3296375,BUY
2020-10-20 13:05:00,13:05,8453000,11719825,3266825,BUY
2020-10-20 13:06:00,13:06,8378800,11720225,3341425,BUY
2020-10-20 13:07:00,13:07,8224100,11714575,3490475,BUY
2020-10-20 13:08:00,13:08,8343600,11715250,3371650,BUY
2020-10-20 13:09:00,13:09,8233425,11671800,3438375,BUY
2020-10-20 13:10:00,13:10,8282000,11660925,3378925,BUY
2020-10-20 13:11:00,13:11,8329175,11672000,3342825,BUY
2020-10-20 13:12:00,13:12,8356600,11630350,3273750,BUY
2020-10-20 13:13:00,13:13,8239750,11613325,3373575,BUY
2020-10-20 13:14:00,13:14,8262700,11624225,3361525,BUY
2020-10-20 13:15:00,13:15,8209900,11574900,3365000,BUY
2020-10-20 13:16:00,13:16,8340600,11582750,3242150,BUY
2020-10-20 13:17:00,13:17,8373925,11570725,3196800,BUY
2020-10-20 13:18:00,13:18,8173050,11532000,3358950,BUY
2020-10-20 13:19:00,13:19,8170000,11530875,3360875,BUY
2020-10-20 13:20:00,13:20,8366975,11544425,3177450,BUY
2020-10-20 13:21:00,13:21,8359125,11554675,3195550,BUY
2020-10-20 13:22:00,13:22,8356375,11549925,3193550,BUY
2020-10-20 13:23:00,13:23,8366700,11547675,3180975,BUY
2020-10-20 13:24:00,13:24,8262375,11505425,3243050,BUY
2020-10-20 13:25:00,13:25,8217225,11542275,3325050,BUY
2020-10-20 13:26:00,13:26,8328750,11549925,3221175,BUY
2020-10-20 13:27:00,13:27,8374225,11549325,3175100,BUY
2020-10-20 13:28:00,13:28,8216550,11543350,3326800,BUY
2020-10-20 13:29:00,13:29,8214025,11532200,3318175,BUY
2020-10-20 13:30:00,13:30,8272400,11457575,3185175,BUY
2020-10-20 13:31:00,13:31,8245025,11586700,3341675,BUY
2020-10-20 13:32:00,13:32,8189850,11419675,3229825,BUY
2020-10-20 13:33:00,13:33,8319050,11592075,3273025,BUY
2020-10-20 13:34:00,13:34,8128475,11596725,3468250,BUY
2020-10-20 13:35:00,13:35,8258800,11592075,3333275,BUY
2020-10-20 13:36:00,13:36,8196050,11572650,3376600,BUY
2020-10-20 13:37:00,13:37,8148575,11573750,3425175,BUY
2020-10-20 13:38:00,13:38,8287550,11580100,3292550,BUY
2020-10-20 13:39:00,13:39,8063250,11523850,3460600,BUY
2020-10-20 13:40:00,13:40,8147400,11516775,3369375,BUY
2020-10-20 13:41:00,13:41,8081875,11485450,3403575,BUY
2020-10-20 13:42:00,13:42,8114825,11473100,3358275,BUY
2020-10-20 13:43:00,13:43,8076000,11471500,3395500,BUY
2020-10-20 13:44:00,13:44,8221350,11514675,3293325,BUY
2020-10-20 13:45:00,13:45,8164600,11477925,3313325,BUY
2020-10-20 13:46:00,13:46,8154125,11368450,3214325,BUY
2020-10-20 13:47:00,13:47,8154125,11441575,3287450,BUY
2020-10-20 13:48:00,13:48,8026025,11441150,3415125,BUY
2020-10-20 13:49:00,13:49,8068875,11484050,3415175,BUY
2020-10-20 13:50:00,13:50,8184775,11487050,3302275,BUY
2020-10-20 13:51:00,13:51,7875500,11433125,3557625,BUY
2020-10-20 13:52:00,13:52,7940075,11409625,3469550,BUY
2020-10-20 13:53:00,13:53,8031725,11265375,3233650,BUY
2020-10-20 13:54:00,13:54,8113000,11451325,3338325,BUY
2020-10-20 13:55:00,13:55,7992425,11451325,3458900,BUY
2020-10-20 13:56:00,13:56,8044775,11451325,3406550,BUY
2020-10-20 13:57:00,13:57,8176750,11431375,3254625,BUY
2020-10-20 13:58:00,13:58,8129100,11403550,3274450,BUY
2020-10-20 13:59:00,13:59,8030975,11416975,3386000,BUY
2020-10-20 14:00:00,14:00,8149175,11414225,3265050,BUY
2020-10-20 14:01:00,14:01,8155150,11420150,3265000,BUY
2020-10-20 14:02:00,14:02,8042075,11409400,3367325,BUY
2020-10-20 14:03:00,14:03,8128250,11343875,3215625,BUY
2020-10-20 14:04:00,14:04,7975500,11303500,3328000,BUY
2020-10-20 14:05:00,14:05,8138275,11341750,3203475,BUY
2020-10-20 14:06:00,14:06,8095375,11287475,3192100,BUY
2020-10-20 14:07:00,14:07,7959200,11257950,3298750,BUY
2020-10-20 14:08:00,14:08,7924500,11221900,3297400,BUY
2020-10-20 14:09:00,14:09,8075175,11314625,3239450,BUY
2020-10-20 14:10:00,14:10,8095550,11318325,3222775,BUY
2020-10-20 14:11:00,14:11,8221000,11317250,3096250,BUY
2020-10-20 14:12:00,14:12,8073400,11225675,3152275,BUY
2020-10-20 14:13:00,14:13,7958975,11261000,3302025,BUY
2020-10-20 14:14:00,14:14,8037925,11227375,3189450,BUY
2020-10-20 14:15:00,14:15,8096150,11183775,3087625,BUY
2020-10-20 14:16:00,14:16,8003025,11182675,3179650,BUY
2020-10-20 14:17:00,14:17,8018200,11173375,3155175,BUY
2020-10-20 14:18:00,14:18,7909150,11092900,3183750,BUY
2020-10-20 14:19:00,14:19,7913800,11091000,3177200,BUY
2020-10-20 14:20:00,14:20,7930450,11066000,3135550,BUY
2020-10-20 14:21:00,14:21,7727375,11047125,3319750,BUY
2020-10-20 14:22:00,14:22,7908150,11056450,3148300,BUY
2020-10-20 14:23:00,14:23,7791900,11052250,3260350,BUY
2020-10-20 14:24:00,14:24,7877775,11018650,3140875,BUY
2020-10-20 14:25:00,14:25,7869350,10941025,3071675,BUY
2020-10-20 14:26:00,14:26,7725725,10989300,3263575,BUY
2020-10-20 14:27:00,14:27,7656575,10949450,3292875,BUY
2020-10-20 14:28:00,14:28,7728400,10962075,3233675,BUY
2020-10-20 14:29:00,14:29,7800150,10804250,3004100,BUY
2020-10-20 14:30:00,14:30,7757400,10978350,3220950,BUY
2020-10-20 14:31:00,14:31,7658200,10940825,3282625,BUY
2020-10-20 14:32:00,14:32,7889350,10968025,3078675,BUY
2020-10-20 14:33:00,14:33,7831650,10914700,3083050,BUY
2020-10-20 14:34:00,14:34,7751925,10934025,3182100,BUY
2020-10-20 14:35:00,14:35,7699850,10934300,3234450,BUY
2020-10-20 14:36:00,14:36,7814650,10960775,3146125,BUY
2020-10-20 14:37:00,14:37,7905025,10968350,3063325,BUY
2020-10-20 14:38:00,14:38,7797550,10967325,3169775,BUY
2020-10-20 14:39:00,14:39,7824975,10860425,3035450,BUY
2020-10-20 14:40:00,14:40,7781800,10859275,3077475,BUY
2020-10-20 14:41:00,14:41,7578025,10780125,3202100,BUY
2020-10-20 14:42:00,14:42,7811450,10793225,2981775,BUY
2020-10-20 14:43:00,14:43,7715900,10792175,3076275,BUY
2020-10-20 14:44:00,14:44,7718150,10827975,3109825,BUY
2020-10-20 14:45:00,14:45,7764950,10787725,3022775,BUY
2020-10-20 14:46:00,14:46,7752325,10822475,3070150,BUY
2020-10-20 14:47:00,14:47,7845575,10824450,2978875,BUY
2020-10-20 14:48:00,14:48,7634675,10814700,3180025,BUY
2020-10-20 14:49:00,14:49,7696550,10813450,3116900,BUY
2020-10-20 14:50:00,14:50,7675050,10814650,3139600,BUY
2020-10-20 14:51:00,14:51,7716425,10805050,3088625,BUY
2020-10-20 14:52:00,14:52,7717850,10803025,3085175,BUY
2020-10-20 14:53:00,14:53,7670975,10803025,3132050,BUY
2020-10-20 14:54:00,14:54,7606125,10735575,3129450,BUY
2020-10-20 14:55:00,14:55,7810525,10747250,2936725,BUY
2020-10-20 14:56:00,14:56,7698800,10736625,3037825,BUY
2020-10-20 14:57:00,14:57,7493300,10692225,3198925,BUY
2020-10-20 14:58:00,14:58,7672050,10582500,2910450,BUY
2020-10-20 14:59:00,14:59,7729000,10647550,2918550,BUY
2020-10-20 15:00:00,15:00,7542275,10624175,3081900,BUY
2020-10-20 15:01:00,15:01,7560600,10626325,3065725,BUY
2020-10-20 15:02:00,15:02,7693525,10626600,2933075,BUY
2020-10-20 15:03:00,15:03,7585325,10525950,2940625,BUY
2020-10-20 15:04:00,15:04,7504975,10517275,3012300,BUY
2020-10-20 15:05:00,15:05,7514425,10517275,3002850,BUY
2020-10-20 15:06:00,15:06,7345000,10398925,3053925,BUY
2020-10-20 15:07:00,15:07,7403200,10413625,3010425,BUY
2020-10-20 15:08:00,15:08,7496225,10428750,2932525,BUY
2020-10-20 15:09:00,15:09,7429350,10354650,2925300,BUY
2020-10-20 15:10:00,15:10,7502725,10352400,2849675,BUY
2020-10-20 15:11:00,15:11,7433300,10350075,2916775,BUY
2020-10-20 15:12:00,15:12,7179775,10190325,3010550,BUY
2020-10-20 15:13:00,15:13,7335950,10188300,2852350,BUY
2020-10-20 15:14:00,15:14,7358075,10185850,2827775,BUY
2020-10-20 15:15:00,15:15,7231000,9987900,2756900,BUY
2020-10-20 15:16:00,15:16,7230875,9986925,2756050,BUY
2020-10-20 15:17:00,15:17,7277100,9986925,2709825,BUY
2020-10-20 15:18:00,15:18,7072850,9731875,2659025,BUY
2020-10-20 15:19:00,15:19,7074550,9733250,2658700,BUY
2020-10-20 15:20:00,15:20,7074950,9742275,2667325,BUY
2020-10-20 15:21:00,15:21,6790725,9520400,2729675,BUY
2020-10-20 15:22:00,15:22,6863950,9522600,2658650,BUY
2020-10-20 15:23:00,15:23,6715275,9515875,2800600,BUY
2020-10-20 15:24:00,15:24,6679150,9328400,2649250,BUY
2020-10-20 15:25:00,15:25,6735500,9330625,2595125,BUY
2020-10-20 15:26:00,15:26,6706150,9330625,2624475,BUY
2020-10-20 15:27:00,15:27,6507175,9109225,2602050,BUY
2020-10-20 15:28:00,15:28,6396550,9097650,2701100,BUY
2020-10-20 15:29:00,15:29,6516250,9109300,2593050,BUY
2020-10-21 09:15:00,09:15,5403650,8735400,3331750,BUY
2020-10-21 09:16:00,09:16,5384500,8765825,3381325,BUY
2020-10-21 09:17:00,09:17,6727000,9423900,2696900,BUY
2020-10-21 09:18:00,09:18,6621825,9390425,2768600,BUY
2020-10-21 09:19:00,09:19,6753350,9392775,2639425,BUY
2020-10-21 09:20:00,09:20,7217250,10049275,2832025,BUY
2020-10-21 09:21:00,09:21,7201425,10079725,2878300,BUY
2020-10-21 09:22:00,09:22,7184300,10079725,2895425,BUY
2020-10-21 09:23:00,09:23,7422175,10468875,3046700,BUY
2020-10-21 09:24:00,09:24,7420850,10469475,3048625,BUY
2020-10-21 09:25:00,09:25,7359775,10469475,3109700,BUY
2020-10-21 09:26:00,09:26,7461250,10846550,3385300,BUY
2020-10-21 09:27:00,09:27,7487225,10848100,3360875,BUY
2020-10-21 09:28:00,09:28,7487225,10845825,3358600,BUY
2020-10-21 09:29:00,09:29,7655275,11192550,3537275,BUY
2020-10-21 09:30:00,09:30,7625975,11198675,3572700,BUY
2020-10-21 09:31:00,09:31,7588825,11198675,3609850,BUY
2020-10-21 09:32:00,09:32,7814025,11518600,3704575,BUY
2020-10-21 09:33:00,09:33,7734975,11552125,3817150,BUY
2020-10-21 09:34:00,09:34,7809100,11547950,3738850,BUY
2020-10-21 09:35:00,09:35,7890550,11732300,3841750,BUY
2020-10-21 09:36:00,09:36,7896600,11725275,3828675,BUY
2020-10-21 09:37:00,09:37,7921000,11732300,3811300,BUY
2020-10-21 09:38:00,09:38,8035550,11900000,3864450,BUY
2020-10-21 09:39:00,09:39,7924400,11785050,3860650,BUY
2020-10-21 09:40:00,09:40,8082200,11866875,3784675,BUY
2020-10-21 09:41:00,09:41,8205550,11915725,3710175,BUY
2020-10-21 09:42:00,09:42,8151225,11943075,3791850,BUY
2020-10-21 09:43:00,09:43,8205525,11881525,3676000,BUY
2020-10-21 09:44:00,09:44,8170950,12109125,3938175,BUY
2020-10-21 09:45:00,09:45,8188200,12069125,3880925,BUY
2020-10-21 09:46:00,09:46,8133325,12042625,3909300,BUY
2020-10-21 09:47:00,09:47,8111775,12071200,3959425,BUY
2020-10-21 09:48:00,09:48,8038300,12104525,4066225,BUY
2020-10-21 09:49:00,09:49,8120250,12075725,3955475,BUY
2020-10-21 09:50:00,09:50,8293925,12179600,3885675,BUY
2020-10-21 09:51:00,09:51,8080650,12111150,4030500,BUY
2020-10-21 09:52:00,09:52,8155725,12143275,3987550,BUY
2020-10-21 09:53:00,09:53,8205275,12206775,4001500,BUY
2020-10-21 09:54:00,09:54,8205200,12228350,4023150,BUY
2020-10-21 09:55:00,09:55,8306400,12263300,3956900,BUY
2020-10-21 09:56:00,09:56,8223325,12333300,4109975,BUY
2020-10-21 09:57:00,09:57,8347650,12368575,4020925,BUY
2020-10-21 09:58:00,09:58,8289200,12303525,4014325,BUY
2020-10-21 09:59:00,09:59,8247475,12495150,4247675,BUY
2020-10-21 10:00:00,10:00,8265950,12406075,4140125,BUY
2020-10-21 10:01:00,10:01,8198000,12428475,4230475,BUY
2020-10-21 10:02:00,10:02,8436450,12582150,4145700,BUY
2020-10-21 10:03:00,10:03,8281700,12554875,4273175,BUY
2020-10-21 10:04:00,10:04,8372800,12515200,4142400,BUY
2020-10-21 10:05:00,10:05,8451500,12626475,4174975,BUY
2020-10-21 10:06:00,10:06,8595100,12658150,4063050,BUY
2020-10-21 10:07:00,10:07,8335450,12583525,4248075,BUY
2020-10-21 10:08:00,10:08,8451550,12767525,4315975,BUY
2020-10-21 10:09:00,10:09,8573300,12846000,4272700,BUY
2020-10-21 10:10:00,10:10,8516975,12814850,4297875,BUY
2020-10-21 10:11:00,10:11,8281625,12851100,4569475,BUY
2020-10-21 10:12:00,10:12,8416850,12958625,4541775,BUY
2020-10-21 10:13:00,10:13,8383350,12913825,4530475,BUY
2020-10-21 10:14:00,10:14,8526575,13120975,4594400,BUY
2020-10-21 10:15:00,10:15,8532850,13090575,4557725,BUY
2020-10-21 10:16:00,10:16,8468675,13088125,4619450,BUY
2020-10-21 10:17:00,10:17,8432125,13203025,4770900,BUY
2020-10-21 10:18:00,10:18,8431700,13203000,4771300,BUY
2020-10-21 10:19:00,10:19,8409125,13172575,4763450,BUY
2020-10-21 10:20:00,10:20,8435625,13113150,4677525,BUY
2020-10-21 10:21:00,10:21,8393850,13164825,4770975,BUY
2020-10-21 10:22:00,10:22,8441125,13221725,4780600,BUY
2020-10-21 10:23:00,10:23,8374325,13138200,4763875,BUY
2020-10-21 10:24:00,10:24,8391125,13174500,4783375,BUY
2020-10-21 10:25:00,10:25,8288925,13104125,4815200,BUY
2020-10-21 10:26:00,10:26,8179225,13218500,5039275,BUY
2020-10-21 10:27:00,10:27,8329375,13080450,4751075,BUY
2020-10-21 10:28:00,10:28,7955600,13100550,5144950,BUY
2020-10-21 10:29:00,10:29,8230225,13110000,4879775,BUY
2020-10-21 10:30:00,10:30,8108025,13056500,4948475,BUY
2020-10-21 10:31:00,10:31,8229750,13007075,4777325,BUY
2020-10-21 10:32:00,10:32,8201075,13166550,4965475,BUY
2020-10-21 10:33:00,10:33,8153125,13234700,5081575,BUY
2020-10-21 10:34:00,10:34,8383700,13138450,4754750,BUY
2020-10-21 10:35:00,10:35,8262225,13099300,4837075,BUY
2020-10-21 10:36:00,10:36,8310675,13133800,4823125,BUY
2020-10-21 10:37:00,10:37,8201375,13137000,4935625,BUY
2020-10-21 10:38:00,10:38,8385200,12986550,4601350,BUY
2020-10-21 10:39:00,10:39,8318300,13242150,4923850,BUY
2020-10-21 10:40:00,10:40,8296375,13284475,4988100,BUY
2020-10-21 10:41:00,10:41,8408125,13220350,4812225,BUY
2020-10-21 10:42:00,10:42,8181000,12938150,4757150,BUY
2020-10-21 10:43:00,10:43,8266550,13252400,4985850,BUY
2020-10-21 10:44:00,10:44,8370850,13067800,4696950,BUY
2020-10-21 10:45:00,10:45,8248075,13286575,5038500,BUY
2020-10-21 10:46:00,10:46,8102700,12967250,4864550,BUY
2020-10-21 10:47:00,10:47,8235025,13409800,5174775,BUY
2020-10-21 10:48:00,10:48,8151325,13394600,5243275,BUY
2020-10-21 10:49:00,10:49,8361475,13394550,5033075,BUY
2020-10-21 10:50:00,10:50,8411000,13439325,5028325,BUY
2020-10-21 10:51:00,10:51,8356650,13421400,5064750,BUY
2020-10-21 10:52:00,10:52,8358575,13425600,5067025,BUY
2020-10-21 10:53:00,10:53,7994375,12981550,4987175,BUY
2020-10-21 10:54:00,10:54,8373375,13360450,4987075,BUY
2020-10-21 10:55:00,10:55,8314900,13215500,4900600,BUY
2020-10-21 10:56:00,10:56,7993250,13409250,5416000,BUY
2020-10-21 10:57:00,10:57,7935000,13366275,5431275,BUY
2020-10-21 10:58:00,10:58,8268975,13414550,5145575,BUY
2020-10-21 10:59:00,10:59,7997650,13097250,5099600,BUY
2020-10-21 11:00:00,11:00,8161175,13381500,5220325,BUY
2020-10-21 11:01:00,11:01,8393475,13452050,5058575,BUY
2020-10-21 11:02:00,11:02,8387650,13501875,5114225,BUY
2020-10-21 11:03:00,11:03,8527850,13577225,5049375,BUY
2020-10-21 11:04:00,11:04,8327675,13216875,4889200,BUY
2020-10-21 11:05:00,11:05,8192075,13641500,5449425,BUY
2020-10-21 11:06:00,11:06,8179225,13531225,5352000,BUY
2020-10-21 11:07:00,11:07,8334925,13525150,5190225,BUY
2020-10-21 11:08:00,11:08,8110700,13643375,5532675,BUY
2020-10-21 11:09:00,11:09,8097675,13543525,5445850,BUY
2020-10-21 11:10:00,11:10,8196225,13655400,5459175,BUY
2020-10-21 11:11:00,11:11,8235225,13793650,5558425,BUY
2020-10-21 11:12:00,11:12,8091050,13720275,5629225,BUY
2020-10-21 11:13:00,11:13,8346925,13588100,5241175,BUY
2020-10-21 11:14:00,11:14,8096800,13641475,5544675,BUY
2020-10-21 11:15:00,11:15,8352750,13751075,5398325,BUY
2020-10-21 11:16:00,11:16,8084350,13703800,5619450,BUY
2020-10-21 11:17:00,11:17,8182950,13735975,5553025,BUY
2020-10-21 11:18:00,11:18,8456325,13768150,5311825,BUY
2020-10-21 11:19:00,11:19,8316925,13721675,5404750,BUY
2020-10-21 11:20:00,11:20,8203200,13568650,5365450,BUY
2020-10-21 11:21:00,11:21,8224150,13628950,5404800,BUY
2020-10-21 11:22:00,11:22,8047775,13599325,5551550,BUY
2020-10-21 11:23:00,11:23,8125500,13531475,5405975,BUY
2020-10-21 11:24:00,11:24,8245625,13568375,5322750,BUY
2020-10-21 11:25:00,11:25,8045675,13348275,5302600,BUY
2020-10-21 11:26:00,11:26,8544300,13538175,4993875,BUY
2020-10-21 11:27:00,11:27,8443925,13358500,4914575,BUY
2020-10-21 11:28:00,11:28,8522075,13442275,4920200,BUY
2020-10-21 11:29:00,11:29,8522075,13679600,5157525,BUY
2020-10-21 11:30:00,11:30,8389625,13564175,5174550,BUY
2020-10-21 11:31:00,11:31,8276125,13526300,5250175,BUY
2020-10-21 11:32:00,11:32,8532450,13741550,5209100,BUY
2020-10-21 11:33:00,11:33,8081700,13685625,5603925,BUY
2020-10-21 11:34:00,11:34,8112275,13359650,5247375,BUY
2020-10-21 11:35:00,11:35,8407150,13392525,4985375,BUY
2020-10-21 11:36:00,11:36,8215625,13772650,5557025,BUY
2020-10-21 11:37:00,11:37,8417700,13863025,5445325,BUY
2020-10-21 11:38:00,11:38,8704750,13692900,4988150,BUY
2020-10-21 11:39:00,11:39,8558500,13719400,5160900,BUY
2020-10-21 11:40:00,11:40,8699725,13836500,5136775,BUY
2020-10-21 11:41:00,11:41,8761950,13847050,5085100,BUY
2020-10-21 11:42:00,11:42,8592625,13742825,5150200,BUY
2020-10-21 11:43:00,11:43,8583550,13858725,5275175,BUY
2020-10-21 11:44:00,11:44,8525850,13829600,5303750,BUY
2020-10-21 11:45:00,11:45,8722975,13790475,5067500,BUY
2020-10-21 11:46:00,11:46,8644150,13826600,5182450,BUY
2020-10-21 11:47:00,11:47,8429500,13844225,5414725,BUY
2020-10-21 11:48:00,11:48,8500575,13886200,5385625,BUY
2020-10-21 11:49:00,11:49,8095400,13785400,5690000,BUY
2020-10-21 11:50:00,11:50,8608100,13967050,5358950,BUY
2020-10-21 11:51:00,11:51,8560150,13960975,5400825,BUY
2020-10-21 11:52:00,11:52,8480250,13924550,5444300,BUY
2020-10-21 11:53:00,11:53,8429300,13984125,5554825,BUY
2020-10-21 11:54:00,11:54,8438250,13950875,5512625,BUY
2020-10-21 11:55:00,11:55,8581325,13773375,5192050,BUY
2020-10-21 11:56:00,11:56,8513700,14022150,5508450,BUY
2020-10-21 11:57:00,11:57,8389475,13986650,5597175,BUY
2020-10-21 11:58:00,11:58,8404775,13928200,5523425,BUY
2020-10-21 11:59:00,11:59,8606750,13749800,5143050,BUY
2020-10-21 12:00:00,12:00,8600975,13628575,5027600,BUY
2020-10-21 12:01:00,12:01,8537550,13639900,5102350,BUY
2020-10-21 12:02:00,12:02,8144200,13559025,5414825,BUY
2020-10-21 12:03:00,12:03,8503550,14056475,5552925,BUY
2020-10-21 12:04:00,12:04,8354400,14012775,5658375,BUY
2020-10-21 12:05:00,12:05,8301050,13526450,5225400,BUY
2020-10-21 12:06:00,12:06,8325375,12805525,4480150,BUY
2020-10-21 12:07:00,12:07,8118975,13777300,5658325,BUY
2020-10-21 12:08:00,12:08,8710900,14067325,5356425,BUY
2020-10-21 12:09:00,12:09,8422425,14054850,5632425,BUY
2020-10-21 12:10:00,12:10,8381050,14036575,5655525,BUY
2020-10-21 12:11:00,12:11,8343150,14050250,5707100,BUY
2020-10-21 12:12:00,12:12,8471800,14052200,5580400,BUY
2020-10-21 12:13:00,12:13,8483375,14049400,5566025,BUY
2020-10-21 12:14:00,12:14,8418125,13899575,5481450,BUY
2020-10-21 12:15:00,12:15,8426200,14184550,5758350,BUY
2020-10-21 12:16:00,12:16,8409725,14133525,5723800,BUY
2020-10-21 12:17:00,12:17,8091925,13807725,5715800,BUY
2020-10-21 12:18:00,12:18,8174525,14028350,5853825,BUY
2020-10-21 12:19:00,12:19,8348575,14021300,5672725,BUY
2020-10-21 12:20:00,12:20,8332225,14075025,5742800,BUY
2020-10-21 12:21:00,12:21,8260775,13852400,5591625,BUY
2020-10-21 12:22:00,12:22,8102350,14057750,5955400,BUY
2020-10-21 12:23:00,12:23,8494500,14189075,5694575,BUY
2020-10-21 12:24:00,12:24,8705725,14215200,5509475,BUY
2020-10-21 12:25:00,12:25,8617675,14248025,5630350,BUY
2020-10-21 12:26:00,12:26,8330850,14178675,5847825,BUY
2020-10-21 12:27:00,12:27,8119350,14095825,5976475,BUY
2020-10-21 12:28:00,12:28,8505775,14288550,5782775,BUY
2020-10-21 12:29:00,12:29,8346750,14255575,5908825,BUY
2020-10-21 12:30:00,12:30,8222525,14227675,6005150,BUY
2020-10-21 12:31:00,12:31,8118000,14201800,6083800,BUY
2020-10-21 12:32:00,12:32,8269325,14331925,6062600,BUY
2020-10-21 12:33:00,12:33,8388000,14250625,5862625,BUY
2020-10-21 12:34:00,12:34,8386975,13707100,5320125,BUY
2020-10-21 12:35:00,12:35,8228600,14286475,6057875,BUY
2020-10-21 12:36:00,12:36,8319250,14271025,5951775,BUY
2020-10-21 12:37:00,12:37,8352575,14259100,5906525,BUY
2020-10-21 12:38:00,12:38,8255875,14249525,5993650,BUY
2020-10-21 12:39:00,12:39,8073625,13733050,5659425,BUY
2020-10-21 12:40:00,12:40,8452475,14242175,5789700,BUY
2020-10-21 12:41:00,12:41,8495450,14022925,5527475,BUY
2020-10-21 12:42:00,12:42,8533850,14254950,5721100,BUY
2020-10-21 12:43:00,12:43,8484200,14264150,5779950,BUY
2020-10-21 12:44:00,12:44,8595275,14013850,5418575,BUY
2020-10-21 12:45:00,12:45,8779825,14318625,5538800,BUY
2020-10-21 12:46:00,12:46,8620300,14233650,5613350,BUY
2020-10-21 12:47:00,12:47,8647650,13968375,5320725,BUY
2020-10-21 12:48:00,12:48,8534125,14197975,5663850,BUY
2020-10-21 12:49:00,12:49,8586475,14207700,5621225,BUY
2020-10-21 12:50:00,12:50,8734375,14211175,5476800,BUY
2020-10-21 12:51:00,12:51,8631475,13980200,5348725,BUY
2020-10-21 12:52:00,12:52,8630825,13975550,5344725,BUY
2020-10-21 12:53:00,12:53,8554300,13858125,5303825,BUY
2020-10-21 12:54:00,12:54,8591125,14119825,5528700,BUY
2020-10-21 12:55:00,12:55,8606475,14241250,5634775,BUY
2020-10-21 12:56:00,12:56,8591125,13585800,4994675,BUY
2020-10-21 12:57:00,12:57,8408550,14391125,5982575,BUY
2020-10-21 12:58:00,12:58,8572000,14029175,5457175,BUY
2020-10-21 12:59:00,12:59,8736000,13904175,5168175,BUY
2020-10-21 13:00:00,13:00,8753300,14267975,5514675,BUY
2020-10-21 13:01:00,13:01,8645125,14267975,5622850,BUY
2020-10-21 13:02:00,13:02,8753300,14254050,5500750,BUY
2020-10-21 13:03:00,13:03,8673650,14081700,5408050,BUY
2020-10-21 13:04:00,13:04,8652950,14353800,5700850,BUY
2020-10-21 13:05:00,13:05,8739325,14253650,5514325,BUY
2020-10-21 13:06:00,13:06,8521450,14111250,5589800,BUY
2020-10-21 13:07:00,13:07,8319250,13950650,5631400,BUY
2020-10-21 13:08:00,13:08,8397725,14039400,5641675,BUY
2020-10-21 13:09:00,13:09,8483650,13784800,5301150,BUY
2020-10-21 13:10:00,13:10,8342825,13965375,5622550,BUY
2020-10-21 13:11:00,13:11,8626875,13986000,5359125,BUY
2020-10-21 13:12:00,13:12,8467975,14419900,5951925,BUY
2020-10-21 13:13:00,13:13,8632750,14444350,5811600,BUY
2020-10-21 13:14:00,13:14,8683125,13784925,5101800,BUY
2020-10-21 13:15:00,13:15,8944150,14464600,5520450,BUY
2020-10-21 13:16:00,13:16,8919500,14464600,5545100,BUY
2020-10-21 13:17:00,13:17,8876575,14460775,5584200,BUY
2020-10-21 13:18:00,13:18,8608225,13774700,5166475,BUY
2020-10-21 13:19:00,13:19,8667725,13739000,5071275,BUY
2020-10-21 13:20:00,13:20,8711650,13779225,5067575,BUY
2020-10-21 13:21:00,13:21,8682250,13514500,4832250,BUY
2020-10-21 13:22:00,13:22,8578750,13535525,4956775,BUY
2020-10-21 13:23:00,13:23,8685350,13539200,4853850,BUY
2020-10-21 13:24:00,13:24,8754525,12888675,4134150,BUY
2020-10-21 13:25:00,13:25,8785725,12920975,4135250,BUY
2020-10-21 13:26:00,13:26,8681150,12917375,4236225,BUY
2020-10-21 13:27:00,13:27,8617425,12633700,4016275,BUY
2020-10-21 13:28:00,13:28,8601025,12596800,3995775,BUY
2020-10-21 13:29:00,13:29,8622900,12612925,3990025,BUY
2020-10-21 13:30:00,13:30,8657700,12222075,3564375,BUY
2020-10-21 13:31:00,13:31,8668350,12195225,3526875,BUY
2020-10-21 13:32:00,13:32,8591900,12195225,3603325,BUY
2020-10-21 13:33:00,13:33,8650275,12178575,3528300,BUY
2020-10-21 13:34:00,13:34,8597150,12182100,3584950,BUY
2020-10-21 13:35:00,13:35,8662850,12137750,3474900,BUY
2020-10-21 13:36:00,13:36,8729800,12113050,3383250,BUY
2020-10-21 13:37:00,13:37,8761525,12113050,3351525,BUY
2020-10-21 13:38:00,13:38,8749600,12113050,3363450,BUY
2020-10-21 13:39:00,13:39,8688800,11897600,3208800,BUY
2020-10-21 13:40:00,13:40,8774250,11897600,3123350,BUY
2020-10-21 13:41:00,13:41,8702150,11897600,3195450,BUY
2020-10-21 13:42:00,13:42,8881075,11954150,3073075,BUY
2020-10-21 13:43:00,13:43,8820350,11922450,3102100,BUY
2020-10-21 13:44:00,13:44,8783550,11922450,3138900,BUY
2020-10-21 13:45:00,13:45,8932775,11557675,2624900,BUY
2020-10-21 13:46:00,13:46,8770925,11531675,2760750,BUY
2020-10-21 13:47:00,13:47,8865375,11537325,2671950,BUY
2020-10-21 13:48:00,13:48,8932250,11489375,2557125,BUY
2020-10-21 13:49:00,13:49,8847725,11483950,2636225,BUY
2020-10-21 13:50:00,13:50,8786875,11489375,2702500,BUY
2020-10-21 13:51:00,13:51,8982300,11499300,2517000,BUY
2020-10-21 13:52:00,13:52,8890850,11491050,2600200,BUY
2020-10-21 13:53:00,13:53,8854375,11468525,2614150,BUY
2020-10-21 13:54:00,13:54,8904650,11337125,2432475,BUY
2020-10-21 13:55:00,13:55,8868025,11250675,2382650,BUY
2020-10-21 13:56:00,13:56,8761950,11337125,2575175,BUY
2020-10-21 13:57:00,13:57,8867675,11331750,2464075,BUY
2020-10-21 13:58:00,13:58,8870225,11357650,2487425,BUY
2020-10-21 13:59:00,13:59,9012650,11336925,2324275,BUY
2020-10-21 14:00:00,14:00,8880075,11393475,2513400,BUY
2020-10-21 14:01:00,14:01,8962700,11401800,2439100,BUY
2020-10-21 14:02:00,14:02,9022825,11401800,2378975,BUY
2020-10-21 14:03:00,14:03,9185075,11376850,2191775,BUY
2020-10-21 14:04:00,14:04,9157950,11376850,2218900,BUY
2020-10-21 14:05:00,14:05,9147250,11376850,2229600,BUY
2020-10-21 14:06:00,14:06,9232575,11383825,2151250,BUY
2020-10-21 14:07:00,14:07,9278775,11387750,2108975,BUY
2020-10-21 14:08:00,14:08,9267125,11331925,2064800,BUY
2020-10-21 14:09:00,14:09,9337100,11416050,2078950,BUY
2020-10-21 14:10:00,14:10,9285200,11424450,2139250,BUY
2020-10-21 14:11:00,14:11,9337125,11390950,2053825,BUY
2020-10-21 14:12:00,14:12,9156650,10858900,1702250,BUY
2020-10-21 14:13:00,14:13,9285075,10834075,1549000,BUY
2020-10-21 14:14:00,14:14,9188800,10859450,1670650,BUY
2020-10-21 14:15:00,14:15,9386650,10757225,1370575,BUY
2020-10-21 14:16:00,14:16,9394550,10773450,1378900,BUY
2020-10-21 14:17:00,14:17,9352175,10764850,1412675,BUY
2020-10-21 14:18:00,14:18,9338500,10845475,1506975,BUY
2020-10-21 14:19:00,14:19,9428800,10807750,1378950,BUY
2020-10-21 14:20:00,14:20,9413975,10812150,1398175,BUY
2020-10-21 14:21:00,14:21,9427125,10788625,1361500,BUY
2020-10-21 14:22:00,14:22,9370225,10830625,1460400,BUY
2020-10-21 14:23:00,14:23,9345750,10834725,1488975,BUY
2020-10-21 14:24:00,14:24,9413100,10710825,1297725,BUY
2020-10-21 14:25:00,14:25,9559500,10732850,1173350,BUY
2020-10-21 14:26:00,14:26,9467350,10753200,1285850,BUY
2020-10-21 14:27:00,14:27,9454875,10491800,1036925,BUY
2020-10-21 14:28:00,14:28,9448725,10477650,1028925,BUY
2020-10-21 14:29:00,14:29,9332475,10462825,1130350,BUY
2020-10-21 14:30:00,14:30,9424100,10492275,1068175,BUY
2020-10-21 14:31:00,14:31,9418100,10495950,1077850,BUY
2020-10-21 14:32:00,14:32,9420475,10483750,1063275,BUY
2020-10-21 14:33:00,14:33,9467400,10665400,1198000,BUY
2020-10-21 14:34:00,14:34,9427150,10641100,1213950,BUY
2020-10-21 14:35:00,14:35,9452425,10656900,1204475,BUY
2020-10-21 14:36:00,14:36,9490500,10636125,1145625,BUY
2020-10-21 14:37:00,14:37,9409225,10652050,1242825,BUY
2020-10-21 14:38:00,14:38,9409425,10712800,1303375,BUY
2020-10-21 14:39:00,14:39,9548275,10806500,1258225,BUY
2020-10-21 14:40:00,14:40,9524950,10806500,1281550,BUY
2020-10-21 14:41:00,14:41,9519025,10767300,1248275,BUY
2020-10-21 14:42:00,14:42,9188850,10786425,1597575,BUY
2020-10-21 14:43:00,14:43,8976025,10778100,1802075,BUY
2020-10-21 14:44:00,14:44,9098800,10727425,1628625,BUY
2020-10-21 14:45:00,14:45,9196050,10864700,1668650,BUY
2020-10-21 14:46:00,14:46,9198300,10870875,1672575,BUY
2020-10-21 14:47:00,14:47,9179200,10809800,1630600,BUY
2020-10-21 14:48:00,14:48,9202000,10963050,1761050,BUY
2020-10-21 14:49:00,14:49,9183800,10978250,1794450,BUY
2020-10-21 14:50:00,14:50,9198725,10975200,1776475,BUY
2020-10-21 14:51:00,14:51,9179875,11062450,1882575,BUY
2020-10-21 14:52:00,14:52,9158275,11065500,1907225,BUY
2020-10-21 14:53:00,14:53,9181900,11065500,1883600,BUY
2020-10-21 14:54:00,14:54,9239475,11156350,1916875,BUY
2020-10-21 14:55:00,14:55,9230800,11114775,1883975,BUY
2020-10-21 14:56:00,14:56,9124300,11077025,1952725,BUY
2020-10-21 14:57:00,14:57,9199200,11073600,1874400,BUY
2020-10-21 14:58:00,14:58,9069000,11131275,2062275,BUY
2020-10-21 14:59:00,14:59,9058650,11077800,2019150,BUY
2020-10-21 15:00:00,15:00,8334650,10879525,2544875,BUY
2020-10-21 15:01:00,15:01,8279625,10898875,2619250,BUY
2020-10-21 15:02:00,15:02,8304875,10843675,2538800,BUY
2020-10-21 15:03:00,15:03,7939000,10544575,2605575,BUY
2020-10-21 15:04:00,15:04,8014575,10585975,2571400,BUY
2020-10-21 15:05:00,15:05,7912925,10585975,2673050,BUY
2020-10-21 15:06:00,15:06,8027125,10675650,2648525,BUY
2020-10-21 15:07:00,15:07,8025900,10626575,2600675,BUY
2020-10-21 15:08:00,15:08,8022175,10626575,2604400,BUY
2020-10-21 15:09:00,15:09,7922150,10642025,2719875,BUY
2020-10-21 15:10:00,15:10,8019475,10682075,2662600,BUY
2020-10-21 15:11:00,15:11,8018300,10712350,2694050,BUY
2020-10-21 15:12:00,15:12,7710575,10738800,3028225,BUY
2020-10-21 15:13:00,15:13,7725250,10728450,3003200,BUY
2020-10-21 15:14:00,15:14,7659675,10681550,3021875,BUY
2020-10-21 15:15:00,15:15,7377775,10746650,3368875,BUY
2020-10-21 15:16:00,15:16,7428425,10746400,3317975,BUY
2020-10-21 15:17:00,15:17,7261875,10746400,3484525,BUY
2020-10-21 15:18:00,15:18,6993825,10743275,3749450,BUY
2020-10-21 15:19:00,15:19,6930500,10748500,3818000,BUY
2020-10-21 15:20:00,15:20,7008100,10754775,3746675,BUY
2020-10-21 15:21:00,15:21,6704100,10639400,3935300,BUY
2020-10-21 15:22:00,15:22,6708200,10600250,3892050,BUY
2020-10-21 15:23:00,15:23,6638750,10636425,3997675,BUY
2020-10-21 15:24:00,15:24,6406000,10546625,4140625,BUY
2020-10-21 15:25:00,15:25,6434875,10550500,4115625,BUY
2020-10-21 15:26:00,15:26,6364375,10487100,4122725,BUY
2020-10-21 15:27:00,15:27,6297125,10365400,4068275,BUY
2020-10-21 15:28:00,15:28,6270400,10365175,4094775,BUY
2020-10-21 15:29:00,15:29,6334500,10365175,4030675,BUY
2020-10-22 09:15:00,09:15,6062300,8362100,2299800,BUY
2020-10-22 09:16:00,09:16,6071525,10020100,3948575,BUY
2020-10-22 09:17:00,09:17,6270700,10383000,4112300,BUY
2020-10-22 09:18:00,09:18,6279425,10360975,4081550,BUY
2020-10-22 09:19:00,09:19,6185600,10381000,4195400,BUY
2020-10-22 09:20:00,09:20,7033775,11167775,4134000,BUY
2020-10-22 09:21:00,09:21,7108650,11144100,4035450,BUY
2020-10-22 09:22:00,09:22,7128975,11167350,4038375,BUY
2020-10-22 09:23:00,09:23,8540175,12749225,4209050,BUY
2020-10-22 09:24:00,09:24,8485250,12753825,4268575,BUY
2020-10-22 09:25:00,09:25,8519750,12751775,4232025,BUY
2020-10-22 09:26:00,09:26,9554225,13581800,4027575,BUY
2020-10-22 09:27:00,09:27,9464675,13556800,4092125,BUY
2020-10-22 09:28:00,09:28,9544725,13569900,4025175,BUY
2020-10-22 09:29:00,09:29,10250275,14010050,3759775,BUY
2020-10-22 09:30:00,09:30,10257100,13963775,3706675,BUY
2020-10-22 09:31:00,09:31,10216225,14014575,3798350,BUY
2020-10-22 09:32:00,09:32,10720750,14171025,3450275,BUY
2020-10-22 09:33:00,09:33,10600875,14174100,3573225,BUY
2020-10-22 09:34:00,09:34,10768375,14174100,3405725,BUY
2020-10-22 09:35:00,09:35,11047025,14354850,3307825,BUY
2020-10-22 09:36:00,09:36,11044750,14354850,3310100,BUY
2020-10-22 09:37:00,09:37,10942750,14348725,3405975,BUY
2020-10-22 09:38:00,09:38,11405750,14571550,3165800,BUY
2020-10-22 09:39:00,09:39,11379825,14575250,3195425,BUY
2020-10-22 09:40:00,09:40,11226150,14502550,3276400,BUY
2020-10-22 09:41:00,09:41,11798925,14774625,2975700,BUY
2020-10-22 09:42:00,09:42,11800175,14719100,2918925,BUY
2020-10-22 09:43:00,09:43,11678100,14698775,3020675,BUY
2020-10-22 09:44:00,09:44,11889400,14895825,3006425,BUY
2020-10-22 09:45:00,09:45,11994200,14938150,2943950,BUY
2020-10-22 09:46:00,09:46,12001050,14932100,2931050,BUY
2020-10-22 09:47:00,09:47,11974900,15037200,3062300,BUY
2020-10-22 09:48:00,09:48,11964000,15011900,3047900,BUY
2020-10-22 09:49:00,09:49,11934600,15023525,3088925,BUY
2020-10-22 09:50:00,09:50,12275850,15141525,2865675,BUY
2020-10-22 09:51:00,09:51,12255075,15196725,2941650,BUY
2020-10-22 09:52:00,09:52,12194900,15212875,3017975,BUY
2020-10-22 09:53:00,09:53,12336750,15353700,3016950,BUY
2020-10-22 09:54:00,09:54,12297200,15370600,3073400,BUY
2020-10-22 09:55:00,09:55,12323900,15344125,3020225,BUY
2020-10-22 09:56:00,09:56,12119400,15511175,3391775,BUY
2020-10-22 09:57:00,09:57,12055625,15497050,3441425,BUY
2020-10-22 09:58:00,09:58,12063250,15497050,3433800,BUY
2020-10-22 09:59:00,09:59,12345675,15792700,3447025,BUY
2020-10-22 10:00:00,10:00,12303550,15838775,3535225,BUY
2020-10-22 10:01:00,10:01,12266650,15823100,3556450,BUY
2020-10-22 10:02:00,10:02,12553575,15840425,3286850,BUY
2020-10-22 10:03:00,10:03,12579250,16083050,3503800,BUY
2020-10-22 10:04:00,10:04,12429025,16154875,3725850,BUY
2020-10-22 10:05:00,10:05,12894225,16387875,3493650,BUY
2020-10-22 10:06:00,10:06,12692950,16145000,3452050,BUY
2020-10-22 10:07:00,10:07,12816800,16365275,3548475,BUY
2020-10-22 10:08:00,10:08,13068400,16740900,3672500,BUY
2020-10-22 10:09:00,10:09,13056450,16723425,3666975,BUY
2020-10-22 10:10:00,10:10,13174325,16754475,3580150,BUY
2020-10-22 10:11:00,10:11,13145675,16930450,3784775,BUY
2020-10-22 10:12:00,10:12,13182300,16850550,3668250,BUY
2020-10-22 10:13:00,10:13,13160575,16918000,3757425,BUY
2020-10-22 10:14:00,10:14,13188550,16802900,3614350,BUY
2020-10-22 10:15:00,10:15,13307450,16620250,3312800,BUY
2020-10-22 10:16:00,10:16,13243650,16956600,3712950,BUY
2020-10-22 10:17:00,10:17,13427875,17027600,3599725,BUY
2020-10-22 10:18:00,10:18,13312000,16648475,3336475,BUY
2020-10-22 10:19:00,10:19,13330425,16999825,3669400,BUY
2020-10-22 10:20:00,10:20,13731300,17218650,3487350,BUY
2020-10-22 10:21:00,10:21,13867575,17283400,3415825,BUY
2020-10-22 10:22:00,10:22,13790925,17269400,3478475,BUY
2020-10-22 10:23:00,10:23,14054250,17370350,3316100,BUY
2020-10-22 10:24:00,10:24,13825350,17266300,3440950,BUY
2020-10-22 10:25:00,10:25,13940725,17063250,3122525,BUY
2020-10-22 10:26:00,10:26,13830575,17323900,3493325,BUY
2020-10-22 10:27:00,10:27,14046750,17329450,3282700,BUY
2020-10-22 10:28:00,10:28,14090900,17310900,3220000,BUY
2020-10-22 10:29:00,10:29,14031725,17405300,3373575,BUY
2020-10-22 10:30:00,10:30,14175300,17376125,3200825,BUY
2020-10-22 10:31:00,10:31,14086150,17322950,3236800,BUY
2020-10-22 10:32:00,10:32,14109325,17330200,3220875,BUY
2020-10-22 10:33:00,10:33,14085325,16993800,2908475,BUY
2020-10-22 10:34:00,10:34,14141150,17361825,3220675,BUY
2020-10-22 10:35:00,10:35,14212475,17454525,3242050,BUY
2020-10-22 10:36:00,10:36,14212525,17423675,3211150,BUY
2020-10-22 10:37:00,10:37,14062375,17354350,3291975,BUY
2020-10-22 10:38:00,10:38,14402725,17554825,3152100,BUY
2020-10-22 10:39:00,10:39,14200150,17574150,3374000,BUY
2020-10-22 10:40:00,10:40,14297250,17421425,3124175,BUY
2020-10-22 10:41:00,10:41,14325875,17435850,3109975,BUY
2020-10-22 10:42:00,10:42,14380275,17261725,2881450,BUY
2020-10-22 10:43:00,10:43,14278525,17585600,3307075,BUY
2020-10-22 10:44:00,10:44,14351150,17638775,3287625,BUY
2020-10-22 10:45:00,10:45,14329400,17720350,3390950,BUY
2020-10-22 10:46:00,10:46,14282550,17666050,3383500,BUY
2020-10-22 10:47:00,10:47,14374300,17829475,3455175,BUY
2020-10-22 10:48:00,10:48,14503325,17768200,3264875,BUY
2020-10-22 10:49:00,10:49,14492750,17879725,3386975,BUY
2020-10-22 10:50:00,10:50,14502575,17834050,3331475,BUY
2020-10-22 10:51:00,10:51,14428150,17813150,3385000,BUY
2020-10-22 10:52:00,10:52,14340050,17226125,2886075,BUY
2020-10-22 10:53:00,10:53,14502225,17483500,2981275,BUY
2020-10-22 10:54:00,10:54,14518600,17807275,3288675,BUY
2020-10-22 10:55:00,10:55,14684625,17914575,3229950,BUY
2020-10-22 10:56:00,10:56,14578100,18159600,3581500,BUY
2020-10-22 10:57:00,10:57,14646500,18117300,3470800,BUY
2020-10-22 10:58:00,10:58,14694750,18144375,3449625,BUY
2020-10-22 10:59:00,10:59,14812525,18299750,3487225,BUY
2020-10-22 11:00:00,11:00,14818875,18299950,3481075,BUY
2020-10-22 11:01:00,11:01,14679925,18317100,3637175,BUY
2020-10-22 11:02:00,11:02,14069175,18597275,4528100,BUY
2020-10-22 11:03:00,11:03,14082300,18612475,4530175,BUY
2020-10-22 11:04:00,11:04,13958000,18522975,4564975,BUY
2020-10-22 11:05:00,11:05,13852150,18757100,4904950,BUY
2020-10-22 11:06:00,11:06,13900625,18694375,4793750,BUY
2020-10-22 11:07:00,11:07,13785600,18685100,4899500,BUY
2020-10-22 11:08:00,11:08,13964375,18906150,4941775,BUY
2020-10-22 11:09:00,11:09,13793900,18445625,4651725,BUY
2020-10-22 11:10:00,11:10,13801550,18802425,5000875,BUY
2020-10-22 11:11:00,11:11,13852725,18662525,4809800,BUY
2020-10-22 11:12:00,11:12,13852775,18913150,5060375,BUY
2020-10-22 11:13:00,11:13,14003400,18960675,4957275,BUY
2020-10-22 11:14:00,11:14,13984900,19007225,5022325,BUY
2020-10-22 11:15:00,11:15,13798025,18750975,4952950,BUY
2020-10-22 11:16:00,11:16,13991975,19048375,5056400,BUY
2020-10-22 11:17:00,11:17,13954575,18589700,4635125,BUY
2020-10-22 11:18:00,11:18,14015125,18948425,4933300,BUY
2020-10-22 11:19:00,11:19,14065800,18579150,4513350,BUY
2020-10-22 11:20:00,11:20,14158725,19087950,4929225,BUY
2020-10-22 11:21:00,11:21,13876250,19077150,5200900,BUY
2020-10-22 11:22:00,11:22,14116925,19047925,4931000,BUY
2020-10-22 11:23:00,11:23,14055750,18876000,4820250,BUY
2020-10-22 11:24:00,11:24,14040250,18828350,4788100,BUY
2020-10-22 11:25:00,11:25,14218925,19061875,4842950,BUY
2020-10-22 11:26:00,11:26,14244300,18478200,4233900,BUY
2020-10-22 11:27:00,11:27,14459100,19120875,4661775,BUY
2020-10-22 11:28:00,11:28,14432875,19197200,4764325,BUY
2020-10-22 11:29:00,11:29,14323025,18789175,4466150,BUY
2020-10-22 11:30:00,11:30,14329200,18815275,4486075,BUY
2020-10-22 11:31:00,11:31,14338950,18484675,4145725,BUY
2020-10-22 11:32:00,11:32,14254375,18491125,4236750,BUY
2020-10-22 11:33:00,11:33,14217200,18507525,4290325,BUY
2020-10-22 11:34:00,11:34,14229075,18472950,4243875,BUY
2020-10-22 11:35:00,11:35,14568475,18676200,4107725,BUY
2020-10-22 11:36:00,11:36,14672100,18386025,3713925,BUY
2020-10-22 11:37:00,11:37,14629850,18499425,3869575,BUY
2020-10-22 11:38:00,11:38,14419700,18702300,4282600,BUY
2020-10-22 11:39:00,11:39,14443200,18772100,4328900,BUY
2020-10-22 11:40:00,11:40,14618250,18505325,3887075,BUY
2020-10-22 11:41:00,11:41,14672500,18988250,4315750,BUY
2020-10-22 11:42:00,11:42,14466025,18892650,4426625,BUY
2020-10-22 11:43:00,11:43,14765550,18917200,4151650,BUY
2020-10-22 11:44:00,11:44,14740050,19056625,4316575,BUY
2020-10-22 11:45:00,11:45,14779450,19172000,4392550,BUY
2020-10-22 11:46:00,11:46,14789250,18858500,4069250,BUY
2020-10-22 11:47:00,11:47,14829525,18815350,3985825,BUY
2020-10-22 11:48:00,11:48,14828750,19228000,4399250,BUY
2020-10-22 11:49:00,11:49,14767575,18414000,3646425,BUY
2020-10-22 11:50:00,11:50,14710700,19019675,4308975,BUY
2020-10-22 11:51:00,11:51,14719000,19051725,4332725,BUY
2020-10-22 11:52:00,11:52,14774250,19282175,4507925,BUY
2020-10-22 11:53:00,11:53,14963475,19109975,4146500,BUY
2020-10-22 11:54:00,11:54,15050425,19374075,4323650,BUY
2020-10-22 11:55:00,11:55,15039125,19382950,4343825,BUY
2020-10-22 11:56:00,11:56,14724225,19109350,4385125,BUY
2020-10-22 11:57:00,11:57,14858275,18418850,3560575,BUY
2020-10-22 11:58:00,11:58,14981075,18937300,3956225,BUY
2020-10-22 11:59:00,11:59,15098450,19059400,3960950,BUY
2020-10-22 12:00:00,12:00,15027650,19432275,4404625,BUY
2020-10-22 12:01:00,12:01,15177000,19470525,4293525,BUY
2020-10-22 12:02:00,12:02,15092150,19569900,4477750,BUY
2020-10-22 12:03:00,12:03,15032625,18992850,3960225,BUY
2020-10-22 12:04:00,12:04,14957450,18450425,3492975,BUY
2020-10-22 12:05:00,12:05,15213650,19529025,4315375,BUY
2020-10-22 12:06:00,12:06,15135375,19597000,4461625,BUY
2020-10-22 12:07:00,12:07,15175350,19349025,4173675,BUY
2020-10-22 12:08:00,12:08,15667100,19326375,3659275,BUY
2020-10-22 12:09:00,12:09,15488625,19620075,4131450,BUY
2020-10-22 12:10:00,12:10,15546975,19565525,4018550,BUY
2020-10-22 12:11:00,12:11,15466575,19096925,3630350,BUY
2020-10-22 12:12:00,12:12,15522475,19467375,3944900,BUY
2020-10-22 12:13:00,12:13,15563100,18205750,2642650,BUY
2020-10-22 12:14:00,12:14,15458475,19709200,4250725,BUY
2020-10-22 12:15:00,12:15,15562075,19734625,4172550,BUY
2020-10-22 12:16:00,12:16,15506075,19213825,3707750,BUY
2020-10-22 12:17:00,12:17,15317925,19714225,4396300,BUY
2020-10-22 12:18:00,12:18,15697625,19757000,4059375,BUY
2020-10-22 12:19:00,12:19,15607725,19736900,4129175,BUY
2020-10-22 12:20:00,12:20,15626975,19508150,3881175,BUY
2020-10-22 12:21:00,12:21,15638875,19857825,4218950,BUY
2020-10-22 12:22:00,12:22,15600000,19420125,3820125,BUY
2020-10-22 12:23:00,12:23,15709675,19751325,4041650,BUY
2020-10-22 12:24:00,12:24,15932950,19738200,3805250,BUY
2020-10-22 12:25:00,12:25,16022725,19813825,3791100,BUY
2020-10-22 12:26:00,12:26,15880825,19580200,3699375,BUY
2020-10-22 12:27:00,12:27,15858925,18967700,3108775,BUY
2020-10-22 12:28:00,12:28,15834300,19002050,3167750,BUY
2020-10-22 12:29:00,12:29,15747575,19257200,3509625,BUY
2020-10-22 12:30:00,12:30,15854575,19246600,3392025,BUY
2020-10-22 12:31:00,12:31,15923000,19139300,3216300,BUY
2020-10-22 12:32:00,12:32,16007800,19025700,3017900,BUY
2020-10-22 12:33:00,12:33,16091375,18955950,2864575,BUY
2020-10-22 12:34:00,12:34,16128375,19242325,3113950,BUY
2020-10-22 12:35:00,12:35,16180525,19321125,3140600,BUY
2020-10-22 12:36:00,12:36,16357825,19461775,3103950,BUY
2020-10-22 12:37:00,12:37,16088425,19370675,3282250,BUY
2020-10-22 12:38:00,12:38,16306750,19267900,2961150,BUY
2020-10-22 12:39:00,12:39,16640650,19485725,2845075,BUY
2020-10-22 12:40:00,12:40,16603225,19387625,2784400,BUY
2020-10-22 12:41:00,12:41,16629225,19456750,2827525,BUY
2020-10-22 12:42:00,12:42,16516025,19216650,2700625,BUY
2020-10-22 12:43:00,12:43,16542325,19284675,2742350,BUY
2020-10-22 12:44:00,12:44,16598425,19297125,2698700,BUY
2020-10-22 12:45:00,12:45,16699900,19422700,2722800,BUY
2020-10-22 12:46:00,12:46,16688250,19141000,2452750,BUY
2020-10-22 12:47:00,12:47,16633875,19295975,2662100,BUY
2020-10-22 12:48:00,12:48,16668250,19377575,2709325,BUY
2020-10-22 12:49:00,12:49,16660625,19355550,2694925,BUY
2020-10-22 12:50:00,12:50,16784725,19137750,2353025,BUY
2020-10-22 12:51:00,12:51,17022325,19341425,2319100,BUY
2020-10-22 12:52:00,12:52,16967100,19122950,2155850,BUY
2020-10-22 12:53:00,12:53,16857700,19457900,2600200,BUY
2020-10-22 12:54:00,12:54,16813450,19220575,2407125,BUY
2020-10-22 12:55:00,12:55,16974900,19468525,2493625,BUY
2020-10-22 12:56:00,12:56,16801400,19493500,2692100,BUY
2020-10-22 12:57:00,12:57,17246475,19539750,2293275,BUY
2020-10-22 12:58:00,12:58,17189000,19474500,2285500,BUY
2020-10-22 12:59:00,12:59,17014700,19538050,2523350,BUY
2020-10-22 13:00:00,13:00,16828225,19233350,2405125,BUY
2020-10-22 13:01:00,13:01,16786075,19505800,2719725,BUY
2020-10-22 13:02:00,13:02,16731650,19274150,2542500,BUY
2020-10-22 13:03:00,13:03,16876000,19759675,2883675,BUY
2020-10-22 13:04:00,13:04,16851650,19479450,2627800,BUY
2020-10-22 13:05:00,13:05,16742275,19185200,2442925,BUY
2020-10-22 13:06:00,13:06,17001050,19596350,2595300,BUY
2020-10-22 13:07:00,13:07,17127850,19638175,2510325,BUY
2020-10-22 13:08:00,13:08,17020975,19849300,2828325,BUY
2020-10-22 13:09:00,13:09,16738575,20131225,3392650,BUY
2020-10-22 13:10:00,13:10,16852300,20054100,3201800,BUY
2020-10-22 13:11:00,13:11,16993950,20029825,3035875,BUY
2020-10-22 13:12:00,13:12,16821725,19964700,3142975,BUY
2020-10-22 13:13:00,13:13,16648350,20128700,3480350,BUY
2020-10-22 13:14:00,13:14,16699825,20102150,3402325,BUY
2020-10-22 13:15:00,13:15,16850250,20113925,3263675,BUY
2020-10-22 13:16:00,13:16,16895700,19920600,3024900,BUY
2020-10-22 13:17:00,13:17,16990125,20104775,3114650,BUY
2020-10-22 13:18:00,13:18,17105750,19997775,2892025,BUY
2020-10-22 13:19:00,13:19,17003050,19786975,2783925,BUY
2020-10-22 13:20:00,13:20,17111775,20034900,2923125,BUY
2020-10-22 13:21:00,13:21,17108300,19596775,2488475,BUY
2020-10-22 13:22:00,13:22,17053775,19674975,2621200,BUY
2020-10-22 13:23:00,13:23,16916450,20075900,3159450,BUY
2020-10-22 13:24:00,13:24,17219900,20073100,2853200,BUY
2020-10-22 13:25:00,13:25,17287125,20076975,2789850,BUY
2020-10-22 13:26:00,13:26,17156400,20121975,2965575,BUY
2020-10-22 13:27:00,13:27,17131725,19961700,2829975,BUY
2020-10-22 13:28:00,13:28,17243975,19776475,2532500,BUY
2020-10-22 13:29:00,13:29,17010700,20116125,3105425,BUY
2020-10-22 13:30:00,13:30,16987850,20136800,3148950,BUY
2020-10-22 13:31:00,13:31,17138200,20094250,2956050,BUY
2020-10-22 13:32:00,13:32,16940200,20132050,3191850,BUY
2020-10-22 13:33:00,13:33,17163950,20183475,3019525,BUY
2020-10-22 13:34:00,13:34,16970775,20175225,3204450,BUY
2020-10-22 13:35:00,13:35,17086925,20168275,3081350,BUY
2020-10-22 13:36:00,13:36,17083100,19778325,2695225,BUY
2020-10-22 13:37:00,13:37,17025925,20036150,3010225,BUY
2020-10-22 13:38:00,13:38,16908325,19727625,2819300,BUY
2020-10-22 13:39:00,13:39,17130900,19924950,2794050,BUY
2020-10-22 13:40:00,13:40,17284725,19681800,2397075,BUY
2020-10-22 13:41:00,13:41,17217700,19652050,2434350,BUY
2020-10-22 13:42:00,13:42,17580550,19973875,2393325,BUY
2020-10-22 13:43:00,13:43,17586350,19987450,2401100,BUY
2020-10-22 13:44:00,13:44,17679525,20039225,2359700,BUY
2020-10-22 13:45:00,13:45,17858925,19867800,2008875,BUY
2020-10-22 13:46:00,13:46,17731025,19778400,2047375,BUY
2020-10-22 13:47:00,13:47,17788700,19757700,1969000,BUY
2020-10-22 13:48:00,13:48,17538400,19416700,1878300,BUY
2020-10-22 13:49:00,13:49,17451500,19451200,1999700,BUY
2020-10-22 13:50:00,13:50,17663950,19485575,1821625,BUY
2020-10-22 13:51:00,13:51,17913075,19308100,1395025,BUY
2020-10-22 13:52:00,13:52,17834700,19600650,1765950,BUY
2020-10-22 13:53:00,13:53,17812200,19609550,1797350,BUY
2020-10-22 13:54:00,13:54,17854400,19360675,1506275,BUY
2020-10-22 13:55:00,13:55,17840050,19722475,1882425,BUY
2020-10-22 13:56:00,13:56,17926700,19421625,1494925,BUY
2020-10-22 13:57:00,13:57,17830450,19447750,1617300,BUY
2020-10-22 13:58:00,13:58,17661475,19818450,2156975,BUY
2020-10-22 13:59:00,13:59,17838200,19475150,1636950,BUY
2020-10-22 14:00:00,14:00,17542900,19921725,2378825,BUY
2020-10-22 14:01:00,14:01,17523600,19843650,2320050,BUY
2020-10-22 14:02:00,14:02,17367175,19624800,2257625,BUY
2020-10-22 14:03:00,14:03,17241050,19938800,2697750,BUY
2020-10-22 14:04:00,14:04,17336675,19563925,2227250,BUY
2020-10-22 14:05:00,14:05,17355325,19737250,2381925,BUY
2020-10-22 14:06:00,14:06,17188175,19795050,2606875,BUY
2020-10-22 14:07:00,14:07,17080350,19886550,2806200,BUY
2020-10-22 14:08:00,14:08,17037050,19824250,2787200,BUY
2020-10-22 14:09:00,14:09,17317950,19900750,2582800,BUY
2020-10-22 14:10:00,14:10,17177550,19866975,2689425,BUY
2020-10-22 14:11:00,14:11,17271725,19814675,2542950,BUY
2020-10-22 14:12:00,14:12,17064200,19665575,2601375,BUY
2020-10-22 14:13:00,14:13,17134200,19938325,2804125,BUY
2020-10-22 14:14:00,14:14,17120800,19995525,2874725,BUY
2020-10-22 14:15:00,14:15,17324600,19674825,2350225,BUY
2020-10-22 14:16:00,14:16,17182825,19906275,2723450,BUY
2020-10-22 14:17:00,14:17,17238725,19671775,2433050,BUY
2020-10-22 14:18:00,14:18,17091250,19656775,2565525,BUY
2020-10-22 14:19:00,14:19,17200700,19955925,2755225,BUY
2020-10-22 14:20:00,14:20,17120550,19478350,2357800,BUY
2020-10-22 14:21:00,14:21,17136275,19796900,2660625,BUY
2020-10-22 14:22:00,14:22,17099075,19801900,2702825,BUY
2020-10-22 14:23:00,14:23,17284975,19589425,2304450,BUY
2020-10-22 14:24:00,14:24,17432725,19676025,2243300,BUY
2020-10-22 14:25:00,14:25,17438125,19672000,2233875,BUY
2020-10-22 14:26:00,14:26,17420150,19073925,1653775,BUY
2020-10-22 14:27:00,14:27,17161650,19837525,2675875,BUY
2020-10-22 14:28:00,14:28,17062875,19630275,2567400,BUY
2020-10-22 14:29:00,14:29,16960300,19716550,2756250,BUY
2020-10-22 14:30:00,14:30,17219050,19694100,2475050,BUY
2020-10-22 14:31:00,14:31,17103175,19333900,2230725,BUY
2020-10-22 14:32:00,14:32,17130625,19407700,2277075,BUY
2020-10-22 14:33:00,14:33,17270425,19534575,2264150,BUY
2020-10-22 14:34:00,14:34,17312700,19551550,2238850,BUY
2020-10-22 14:35:00,14:35,17207425,19551550,2344125,BUY
2020-10-22 14:36:00,14:36,17298050,19227250,1929200,BUY
2020-10-22 14:37:00,14:37,17289450,19144150,1854700,BUY
2020-10-22 14:38:00,14:38,17284175,19132125,1847950,BUY
2020-10-22 14:39:00,14:39,17298025,18518125,1220100,BUY
2020-10-22 14:40:00,14:40,17297325,18587950,1290625,BUY
2020-10-22 14:41:00,14:41,17265575,18561800,1296225,BUY
2020-10-22 14:42:00,14:42,17076375,18054900,978525,BUY
2020-10-22 14:43:00,14:43,17064850,18013450,948600,BUY
2020-10-22 14:44:00,14:44,16997700,18262650,1264950,BUY
2020-10-22 14:45:00,14:45,16845575,17649725,804150,BUY
2020-10-22 14:46:00,14:46,16775400,17960750,1185350,BUY
2020-10-22 14:47:00,14:47,16865075,17851125,986050,BUY
2020-10-22 14:48:00,14:48,16597300,17431300,834000,BUY
2020-10-22 14:49:00,14:49,16653925,17602475,948550,BUY
2020-10-22 14:50:00,14:50,16684925,17690800,1005875,BUY
2020-10-22 14:51:00,14:51,16601525,17975475,1373950,BUY
2020-10-22 14:52:00,14:52,16636050,17911850,1275800,BUY
2020-10-22 14:53:00,14:53,16634675,17921425,1286750,BUY
2020-10-22 14:54:00,14:54,16605850,18017625,1411775,BUY
2020-10-22 14:55:00,14:55,16473475,18192700,1719225,BUY
2020-10-22 14:56:00,14:56,16616325,18164125,1547800,BUY
2020-10-22 14:57:00,14:57,15409450,18074325,2664875,BUY
2020-10-22 14:58:00,14:58,15451875,17780450,2328575,BUY
2020-10-22 14:59:00,14:59,15468850,18045075,2576225,BUY
2020-10-22 15:00:00,15:00,15661450,18029975,2368525,BUY
2020-10-22 15:01:00,15:01,15634225,17920950,2286725,BUY
2020-10-22 15:02:00,15:02,15679875,17791850,2111975,BUY
2020-10-22 15:03:00,15:03,15605500,17775750,2170250,BUY
2020-10-22 15:04:00,15:04,15622050,17967425,2345375,BUY
2020-10-22 15:05:00,15:05,15680050,18020425,2340375,BUY
2020-10-22 15:06:00,15:06,15630900,17667475,2036575,BUY
2020-10-22 15:07:00,15:07,15671875,17463875,1792000,BUY
2020-10-22 15:08:00,15:08,15575825,17634800,2058975,BUY
2020-10-22 15:09:00,15:09,15560825,17440325,1879500,BUY
2020-10-22 15:10:00,15:10,15607725,17461525,1853800,BUY
2020-10-22 15:11:00,15:11,15579175,17227975,1648800,BUY
2020-10-22 15:12:00,15:12,15059800,17205075,2145275,BUY
2020-10-22 15:13:00,15:13,14997150,17207500,2210350,BUY
2020-10-22 15:14:00,15:14,15093875,17034275,1940400,BUY
2020-10-22 15:15:00,15:15,14335625,16015350,1679725,BUY
2020-10-22 15:16:00,15:16,14286750,16413450,2126700,BUY
2020-10-22 15:17:00,15:17,14269500,16192475,1922975,BUY
2020-10-22 15:18:00,15:18,13346250,14980600,1634350,BUY
2020-10-22 15:19:00,15:19,13296675,15053050,1756375,BUY
2020-10-22 15:20:00,15:20,13344350,14599125,1254775,BUY
2020-10-22 15:21:00,15:21,12434675,14251875,1817200,BUY
2020-10-22 15:22:00,15:22,12432875,13658800,1225925,BUY
2020-10-22 15:23:00,15:23,12412950,13900500,1487550,BUY
2020-10-22 15:24:00,15:24,11750500,12499925,749425,BUY
2020-10-22 15:25:00,15:25,11826175,12676850,850675,BUY
2020-10-22 15:26:00,15:26,11764525,12624525,860000,BUY
2020-10-22 15:27:00,15:27,10300475,11475875,1175400,BUY
2020-10-22 15:28:00,15:28,10311275,11874325,1563050,BUY
2020-10-22 15:29:00,15:29,10279575,9542150,-737425,SELL
