,timestamp,call,put,diff,sellOrBuy
2020-12-18 09:15:00,09:15,2562625,3714650,1152025,BUY
2020-12-18 09:16:00,09:16,2539850,3714500,1174650,BUY
2020-12-18 09:17:00,09:17,2754275,3896650,1142375,BUY
2020-12-18 09:18:00,09:18,2767550,3894550,1127000,BUY
2020-12-18 09:19:00,09:19,2772875,3904850,1131975,BUY
2020-12-18 09:20:00,09:20,3184675,4318875,1134200,BUY
2020-12-18 09:21:00,09:21,3203800,4326625,1122825,BUY
2020-12-18 09:22:00,09:22,3180925,4316575,1135650,BUY
2020-12-18 09:23:00,09:23,3418000,4507825,1089825,BUY
2020-12-18 09:24:00,09:24,3444450,4505225,1060775,BUY
2020-12-18 09:25:00,09:25,3414475,4508775,1094300,BUY
2020-12-18 09:26:00,09:26,3670300,4666875,996575,BUY
2020-12-18 09:27:00,09:27,3648050,4652700,1004650,BUY
2020-12-18 09:28:00,09:28,3661950,4665125,1003175,BUY
2020-12-18 09:29:00,09:29,3866350,4767650,901300,BUY
2020-12-18 09:30:00,09:30,3861625,4764700,903075,BUY
2020-12-18 09:31:00,09:31,3866225,4770875,904650,BUY
2020-12-18 09:32:00,09:32,4118175,4799100,680925,BUY
2020-12-18 09:33:00,09:33,4110575,4801525,690950,BUY
2020-12-18 09:34:00,09:34,4107550,4789375,681825,BUY
2020-12-18 09:35:00,09:35,4390825,4829000,438175,BUY
2020-12-18 09:36:00,09:36,4386400,4826650,440250,BUY
2020-12-18 09:37:00,09:37,4386150,4805025,418875,BUY
2020-12-18 09:38:00,09:38,4573975,4899300,325325,BUY
2020-12-18 09:39:00,09:39,4591150,4910675,319525,BUY
2020-12-18 09:40:00,09:40,4586625,4909125,322500,BUY
2020-12-18 09:41:00,09:41,4853600,4910175,56575,BUY
2020-12-18 09:42:00,09:42,4857525,4916100,58575,BUY
2020-12-18 09:43:00,09:43,4862500,4910175,47675,BUY
2020-12-18 09:44:00,09:44,4978600,5061750,83150,BUY
2020-12-18 09:45:00,09:45,4984425,5065550,81125,BUY
2020-12-18 09:46:00,09:46,4970650,5051625,80975,BUY
2020-12-18 09:47:00,09:47,5122875,5333475,210600,BUY
2020-12-18 09:48:00,09:48,5091500,5331925,240425,BUY
2020-12-18 09:49:00,09:49,5111850,5313900,202050,BUY
2020-12-18 09:50:00,09:50,5277750,5443500,165750,BUY
2020-12-18 09:51:00,09:51,5266875,5448175,181300,BUY
2020-12-18 09:52:00,09:52,5270775,5462375,191600,BUY
2020-12-18 09:53:00,09:53,5380350,5534600,154250,BUY
2020-12-18 09:54:00,09:54,5382950,5538150,155200,BUY
2020-12-18 09:55:00,09:55,5364350,5531625,167275,BUY
2020-12-18 09:56:00,09:56,5599975,5461400,-138575,SELL
2020-12-18 09:57:00,09:57,5602225,5467500,-134725,SELL
2020-12-18 09:58:00,09:58,5597625,5457150,-140475,SELL
2020-12-18 09:59:00,09:59,5826900,5421875,-405025,SELL
2020-12-18 10:00:00,10:00,5831800,5428875,-402925,SELL
2020-12-18 10:01:00,10:01,5834975,5428875,-406100,SELL
2020-12-18 10:02:00,10:02,5969775,5491575,-478200,SELL
2020-12-18 10:03:00,10:03,5948175,5488550,-459625,SELL
2020-12-18 10:04:00,10:04,5957200,5492825,-464375,SELL
2020-12-18 10:05:00,10:05,6053000,5687000,-366000,SELL
2020-12-18 10:06:00,10:06,6079450,5700400,-379050,SELL
2020-12-18 10:07:00,10:07,6078375,5690775,-387600,SELL
2020-12-18 10:08:00,10:08,6094975,5815725,-279250,SELL
2020-12-18 10:09:00,10:09,6091100,5809200,-281900,SELL
2020-12-18 10:10:00,10:10,6088750,5810375,-278375,SELL
2020-12-18 10:11:00,10:11,6204125,5967275,-236850,SELL
2020-12-18 10:12:00,10:12,6195425,5934275,-261150,SELL
2020-12-18 10:13:00,10:13,6195425,5959700,-235725,SELL
2020-12-18 10:14:00,10:14,6235475,6061575,-173900,SELL
2020-12-18 10:15:00,10:15,6239475,6050025,-189450,SELL
2020-12-18 10:16:00,10:16,6233850,6062675,-171175,SELL
2020-12-18 10:17:00,10:17,6291875,6116900,-174975,SELL
2020-12-18 10:18:00,10:18,6292475,6115025,-177450,SELL
2020-12-18 10:19:00,10:19,6290850,6102100,-188750,SELL
2020-12-18 10:20:00,10:20,6337400,6169750,-167650,SELL
2020-12-18 10:21:00,10:21,6317275,6184775,-132500,SELL
2020-12-18 10:22:00,10:22,6331575,6203750,-127825,SELL
2020-12-18 10:23:00,10:23,6395725,6285800,-109925,SELL
2020-12-18 10:24:00,10:24,6381175,6281525,-99650,SELL
2020-12-18 10:25:00,10:25,6383925,6230225,-153700,SELL
2020-12-18 10:26:00,10:26,6460875,6366425,-94450,SELL
2020-12-18 10:27:00,10:27,6456875,6347150,-109725,SELL
2020-12-18 10:28:00,10:28,6446775,6337200,-109575,SELL
2020-12-18 10:29:00,10:29,6530250,6353800,-176450,SELL
2020-12-18 10:30:00,10:30,6539800,6393600,-146200,SELL
2020-12-18 10:31:00,10:31,6517625,6356650,-160975,SELL
2020-12-18 10:32:00,10:32,6589575,6419425,-170150,SELL
2020-12-18 10:33:00,10:33,6581050,6428900,-152150,SELL
2020-12-18 10:34:00,10:34,6574275,6431100,-143175,SELL
2020-12-18 10:35:00,10:35,6580850,6473450,-107400,SELL
2020-12-18 10:36:00,10:36,6601275,6471700,-129575,SELL
2020-12-18 10:37:00,10:37,6584850,6488075,-96775,SELL
2020-12-18 10:38:00,10:38,6617925,6565425,-52500,SELL
2020-12-18 10:39:00,10:39,6630550,6548975,-81575,SELL
2020-12-18 10:40:00,10:40,6630550,6543575,-86975,SELL
2020-12-18 10:41:00,10:41,6650875,6588900,-61975,SELL
2020-12-18 10:42:00,10:42,6661225,6591875,-69350,SELL
2020-12-18 10:43:00,10:43,6642950,6574075,-68875,SELL
2020-12-18 10:44:00,10:44,6701325,6618250,-83075,SELL
2020-12-18 10:45:00,10:45,6687100,6618425,-68675,SELL
2020-12-18 10:46:00,10:46,6691825,6593750,-98075,SELL
2020-12-18 10:47:00,10:47,6725050,6662900,-62150,SELL
2020-12-18 10:48:00,10:48,6735600,6637250,-98350,SELL
2020-12-18 10:49:00,10:49,6744825,6669400,-75425,SELL
2020-12-18 10:50:00,10:50,6761725,6716475,-45250,SELL
2020-12-18 10:51:00,10:51,6763975,6686900,-77075,SELL
2020-12-18 10:52:00,10:52,6748700,6703375,-45325,SELL
2020-12-18 10:53:00,10:53,6741500,6764250,22750,BUY
2020-12-18 10:54:00,10:54,6736475,6801975,65500,BUY
2020-12-18 10:55:00,10:55,6748725,6780750,32025,BUY
2020-12-18 10:56:00,10:56,6770625,6815350,44725,BUY
2020-12-18 10:57:00,10:57,6749775,6763800,14025,BUY
2020-12-18 10:58:00,10:58,6766325,6784025,17700,BUY
2020-12-18 10:59:00,10:59,6783125,6788625,5500,BUY
2020-12-18 11:00:00,11:00,6768475,6804575,36100,BUY
2020-12-18 11:01:00,11:01,6773175,6790000,16825,BUY
2020-12-18 11:02:00,11:02,6801275,6874925,73650,BUY
2020-12-18 11:03:00,11:03,6805250,6848925,43675,BUY
2020-12-18 11:04:00,11:04,6792100,6868075,75975,BUY
2020-12-18 11:05:00,11:05,6762450,6866150,103700,BUY
2020-12-18 11:06:00,11:06,6758500,6890775,132275,BUY
2020-12-18 11:07:00,11:07,6769275,6919825,150550,BUY
2020-12-18 11:08:00,11:08,6792875,6847900,55025,BUY
2020-12-18 11:09:00,11:09,6797600,6920600,123000,BUY
2020-12-18 11:10:00,11:10,6791125,6928525,137400,BUY
2020-12-18 11:11:00,11:11,6829525,6895625,66100,BUY
2020-12-18 11:12:00,11:12,6819825,6926025,106200,BUY
2020-12-18 11:13:00,11:13,6827525,6895850,68325,BUY
2020-12-18 11:14:00,11:14,6743775,6919250,175475,BUY
2020-12-18 11:15:00,11:15,6813850,6910425,96575,BUY
2020-12-18 11:16:00,11:16,6815850,6938650,122800,BUY
2020-12-18 11:17:00,11:17,6819750,6892075,72325,BUY
2020-12-18 11:18:00,11:18,6820800,6916175,95375,BUY
2020-12-18 11:19:00,11:19,6825275,6936400,111125,BUY
2020-12-18 11:20:00,11:20,6819575,6920375,100800,BUY
2020-12-18 11:21:00,11:21,6829475,6964950,135475,BUY
2020-12-18 11:22:00,11:22,6823900,6896875,72975,BUY
2020-12-18 11:23:00,11:23,6846825,6954775,107950,BUY
2020-12-18 11:24:00,11:24,6834325,6947550,113225,BUY
2020-12-18 11:25:00,11:25,6850925,7010700,159775,BUY
2020-12-18 11:26:00,11:26,6806700,7048700,242000,BUY
2020-12-18 11:27:00,11:27,6797075,7012925,215850,BUY
2020-12-18 11:28:00,11:28,6788025,6974450,186425,BUY
2020-12-18 11:29:00,11:29,6730100,6997975,267875,BUY
2020-12-18 11:30:00,11:30,6722050,7008575,286525,BUY
2020-12-18 11:31:00,11:31,6721050,7008075,287025,BUY
2020-12-18 11:32:00,11:32,6731375,7003125,271750,BUY
2020-12-18 11:33:00,11:33,6732850,7021950,289100,BUY
2020-12-18 11:34:00,11:34,6734975,6972575,237600,BUY
2020-12-18 11:35:00,11:35,6728700,7029975,301275,BUY
2020-12-18 11:36:00,11:36,6725825,6952750,226925,BUY
2020-12-18 11:37:00,11:37,6721675,6937400,215725,BUY
2020-12-18 11:38:00,11:38,6724475,6793475,69000,BUY
2020-12-18 11:39:00,11:39,6722750,6971475,248725,BUY
2020-12-18 11:40:00,11:40,6741875,6989950,248075,BUY
2020-12-18 11:41:00,11:41,6775575,7047525,271950,BUY
2020-12-18 11:42:00,11:42,6757075,6996900,239825,BUY
2020-12-18 11:43:00,11:43,6773500,6947450,173950,BUY
2020-12-18 11:44:00,11:44,6758700,7038400,279700,BUY
2020-12-18 11:45:00,11:45,6748250,6998075,249825,BUY
2020-12-18 11:46:00,11:46,6741450,7008075,266625,BUY
2020-12-18 11:47:00,11:47,6743175,6996900,253725,BUY
2020-12-18 11:48:00,11:48,6759575,6978375,218800,BUY
2020-12-18 11:49:00,11:49,6742775,6977450,234675,BUY
2020-12-18 11:50:00,11:50,6685400,6990925,305525,BUY
2020-12-18 11:51:00,11:51,6762600,7008700,246100,BUY
2020-12-18 11:52:00,11:52,6775050,6999125,224075,BUY
2020-12-18 11:53:00,11:53,6766150,7013200,247050,BUY
2020-12-18 11:54:00,11:54,6798125,7101375,303250,BUY
2020-12-18 11:55:00,11:55,6775825,6801125,25300,BUY
2020-12-18 11:56:00,11:56,6826350,7081925,255575,BUY
2020-12-18 11:57:00,11:57,6809425,7054675,245250,BUY
2020-12-18 11:58:00,11:58,6811275,7014650,203375,BUY
2020-12-18 11:59:00,11:59,6803125,6978425,175300,BUY
2020-12-18 12:00:00,12:00,6821825,7038450,216625,BUY
2020-12-18 12:01:00,12:01,6813200,7027150,213950,BUY
2020-12-18 12:02:00,12:02,6816300,7102575,286275,BUY
2020-12-18 12:03:00,12:03,6816450,7079175,262725,BUY
2020-12-18 12:04:00,12:04,6807625,7020500,212875,BUY
2020-12-18 12:05:00,12:05,6813150,7044650,231500,BUY
2020-12-18 12:06:00,12:06,6772675,6951475,178800,BUY
2020-12-18 12:07:00,12:07,6796200,7090025,293825,BUY
2020-12-18 12:08:00,12:08,6789600,7107450,317850,BUY
2020-12-18 12:09:00,12:09,6785550,7103075,317525,BUY
2020-12-18 12:10:00,12:10,6805425,7081800,276375,BUY
2020-12-18 12:11:00,12:11,6792900,6833550,40650,BUY
2020-12-18 12:12:00,12:12,6824200,7126625,302425,BUY
2020-12-18 12:13:00,12:13,6791650,7097225,305575,BUY
2020-12-18 12:14:00,12:14,6778425,6862500,84075,BUY
2020-12-18 12:15:00,12:15,6788100,7160200,372100,BUY
2020-12-18 12:16:00,12:16,6783750,6856225,72475,BUY
2020-12-18 12:17:00,12:17,6794700,7122100,327400,BUY
2020-12-18 12:18:00,12:18,6801475,7090050,288575,BUY
2020-12-18 12:19:00,12:19,6822700,6833950,11250,BUY
2020-12-18 12:20:00,12:20,6844250,7131200,286950,BUY
2020-12-18 12:21:00,12:21,6861500,7113675,252175,BUY
2020-12-18 12:22:00,12:22,6868500,6899150,30650,BUY
2020-12-18 12:23:00,12:23,6749025,7091100,342075,BUY
2020-12-18 12:24:00,12:24,6849950,7118900,268950,BUY
2020-12-18 12:25:00,12:25,6853750,7135075,281325,BUY
2020-12-18 12:26:00,12:26,6857325,7161275,303950,BUY
2020-12-18 12:27:00,12:27,6879775,7166975,287200,BUY
2020-12-18 12:28:00,12:28,6868825,7157550,288725,BUY
2020-12-18 12:29:00,12:29,6893375,7176350,282975,BUY
2020-12-18 12:30:00,12:30,6862000,7137725,275725,BUY
2020-12-18 12:31:00,12:31,6867700,7177700,310000,BUY
2020-12-18 12:32:00,12:32,6829175,7196525,367350,BUY
2020-12-18 12:33:00,12:33,6889825,7221050,331225,BUY
2020-12-18 12:34:00,12:34,6896250,7222500,326250,BUY
2020-12-18 12:35:00,12:35,6885600,7216925,331325,BUY
2020-12-18 12:36:00,12:36,6927025,7250300,323275,BUY
2020-12-18 12:37:00,12:37,6918775,7237475,318700,BUY
2020-12-18 12:38:00,12:38,6931800,7235550,303750,BUY
2020-12-18 12:39:00,12:39,6942750,7213025,270275,BUY
2020-12-18 12:40:00,12:40,6948775,7192875,244100,BUY
2020-12-18 12:41:00,12:41,6944975,7162700,217725,BUY
2020-12-18 12:42:00,12:42,6971650,7198700,227050,BUY
2020-12-18 12:43:00,12:43,6978975,7198200,219225,BUY
2020-12-18 12:44:00,12:44,6977650,7164800,187150,BUY
2020-12-18 12:45:00,12:45,6990850,7241150,250300,BUY
2020-12-18 12:46:00,12:46,6995675,7238075,242400,BUY
2020-12-18 12:47:00,12:47,6993950,7230350,236400,BUY
2020-12-18 12:48:00,12:48,6985675,7238125,252450,BUY
2020-12-18 12:49:00,12:49,6970075,7191450,221375,BUY
2020-12-18 12:50:00,12:50,6974800,7184875,210075,BUY
2020-12-18 12:51:00,12:51,6985225,7262775,277550,BUY
2020-12-18 12:52:00,12:52,6991250,7195250,204000,BUY
2020-12-18 12:53:00,12:53,6973400,7219825,246425,BUY
2020-12-18 12:54:00,12:54,6999250,7198750,199500,BUY
2020-12-18 12:55:00,12:55,6983625,7196675,213050,BUY
2020-12-18 12:56:00,12:56,6990275,7211450,221175,BUY
2020-12-18 12:57:00,12:57,7012200,7167900,155700,BUY
2020-12-18 12:58:00,12:58,6977750,7177075,199325,BUY
2020-12-18 12:59:00,12:59,6974550,7160850,186300,BUY
2020-12-18 13:00:00,13:00,6993075,7231375,238300,BUY
2020-12-18 13:01:00,13:01,7008175,7274975,266800,BUY
2020-12-18 13:02:00,13:02,6992550,7238950,246400,BUY
2020-12-18 13:03:00,13:03,7015850,7270725,254875,BUY
2020-12-18 13:04:00,13:04,7035650,7280475,244825,BUY
2020-12-18 13:05:00,13:05,7031250,7284375,253125,BUY
2020-12-18 13:06:00,13:06,7035400,7278950,243550,BUY
2020-12-18 13:07:00,13:07,7062250,7282000,219750,BUY
2020-12-18 13:08:00,13:08,7039800,7268175,228375,BUY
2020-12-18 13:09:00,13:09,7045875,7202000,156125,BUY
2020-12-18 13:10:00,13:10,7072075,7255825,183750,BUY
2020-12-18 13:11:00,13:11,7068300,7284850,216550,BUY
2020-12-18 13:12:00,13:12,7026125,7228925,202800,BUY
2020-12-18 13:13:00,13:13,7030575,7176900,146325,BUY
2020-12-18 13:14:00,13:14,7030575,7211250,180675,BUY
2020-12-18 13:15:00,13:15,7041525,7246625,205100,BUY
2020-12-18 13:16:00,13:16,7041225,7256225,215000,BUY
2020-12-18 13:17:00,13:17,7047075,7235575,188500,BUY
2020-12-18 13:18:00,13:18,7059300,7248500,189200,BUY
2020-12-18 13:19:00,13:19,7057800,7222275,164475,BUY
2020-12-18 13:20:00,13:20,7061125,7218300,157175,BUY
2020-12-18 13:21:00,13:21,7039900,6967875,-72025,SELL
2020-12-18 13:22:00,13:22,7063750,7234900,171150,BUY
2020-12-18 13:23:00,13:23,7061325,7215275,153950,BUY
2020-12-18 13:24:00,13:24,7051350,7257125,205775,BUY
2020-12-18 13:25:00,13:25,7071325,7286550,215225,BUY
2020-12-18 13:26:00,13:26,7087125,7329050,241925,BUY
2020-12-18 13:27:00,13:27,7052875,7309575,256700,BUY
2020-12-18 13:28:00,13:28,7023925,7291350,267425,BUY
2020-12-18 13:29:00,13:29,7019125,7298475,279350,BUY
2020-12-18 13:30:00,13:30,6753150,7138925,385775,BUY
2020-12-18 13:31:00,13:31,6745500,7107050,361550,BUY
2020-12-18 13:32:00,13:32,6745500,7120900,375400,BUY
2020-12-18 13:33:00,13:33,6719300,7140475,421175,BUY
2020-12-18 13:34:00,13:34,6704850,7165450,460600,BUY
2020-12-18 13:35:00,13:35,6715800,7163425,447625,BUY
2020-12-18 13:36:00,13:36,6737775,7117725,379950,BUY
2020-12-18 13:37:00,13:37,6712750,7125675,412925,BUY
2020-12-18 13:38:00,13:38,6735700,7155850,420150,BUY
2020-12-18 13:39:00,13:39,6720975,7143600,422625,BUY
2020-12-18 13:40:00,13:40,6723700,7168100,444400,BUY
2020-12-18 13:41:00,13:41,6742400,7154925,412525,BUY
2020-12-18 13:42:00,13:42,6732400,7101800,369400,BUY
2020-12-18 13:43:00,13:43,6738350,7156200,417850,BUY
2020-12-18 13:44:00,13:44,6738350,7166400,428050,BUY
2020-12-18 13:45:00,13:45,6755100,7161875,406775,BUY
2020-12-18 13:46:00,13:46,6755100,7164850,409750,BUY
2020-12-18 13:47:00,13:47,6755100,7128875,373775,BUY
2020-12-18 13:48:00,13:48,6791800,7139000,347200,BUY
2020-12-18 13:49:00,13:49,6791800,7155225,363425,BUY
2020-12-18 13:50:00,13:50,6791800,7162100,370300,BUY
2020-12-18 13:51:00,13:51,6806050,7162250,356200,BUY
2020-12-18 13:52:00,13:52,6803275,6968350,165075,BUY
2020-12-18 13:53:00,13:53,6813625,7178450,364825,BUY
2020-12-18 13:54:00,13:54,6869000,7011725,142725,BUY
2020-12-18 13:55:00,13:55,6865325,7267100,401775,BUY
2020-12-18 13:56:00,13:56,6871775,7241675,369900,BUY
2020-12-18 13:57:00,13:57,6854625,7232800,378175,BUY
2020-12-18 13:58:00,13:58,6840300,7237875,397575,BUY
2020-12-18 13:59:00,13:59,6835100,7225725,390625,BUY
2020-12-18 14:00:00,14:00,6898325,7221975,323650,BUY
2020-12-18 14:01:00,14:01,6901375,7230950,329575,BUY
2020-12-18 14:02:00,14:02,6918050,7206800,288750,BUY
2020-12-18 14:03:00,14:03,6924375,7252625,328250,BUY
2020-12-18 14:04:00,14:04,6951100,7254100,303000,BUY
2020-12-18 14:05:00,14:05,6920575,7249500,328925,BUY
2020-12-18 14:06:00,14:06,6909175,7172800,263625,BUY
2020-12-18 14:07:00,14:07,6909175,7185225,276050,BUY
2020-12-18 14:08:00,14:08,6941925,7263100,321175,BUY
2020-12-18 14:09:00,14:09,6804300,7185600,381300,BUY
2020-12-18 14:10:00,14:10,6823000,7213050,390050,BUY
2020-12-18 14:11:00,14:11,6794250,7180575,386325,BUY
2020-12-18 14:12:00,14:12,6644575,7164050,519475,BUY
2020-12-18 14:13:00,14:13,6652975,7163000,510025,BUY
2020-12-18 14:14:00,14:14,6645100,7152775,507675,BUY
2020-12-18 14:15:00,14:15,6490700,7184125,693425,BUY
2020-12-18 14:16:00,14:16,6481000,7183750,702750,BUY
2020-12-18 14:17:00,14:17,6481000,7146750,665750,BUY
2020-12-18 14:18:00,14:18,6426225,7107775,681550,BUY
2020-12-18 14:19:00,14:19,6426225,7175500,749275,BUY
2020-12-18 14:20:00,14:20,6436500,7163175,726675,BUY
2020-12-18 14:21:00,14:21,6479000,7198300,719300,BUY
2020-12-18 14:22:00,14:22,6472550,7146600,674050,BUY
2020-12-18 14:23:00,14:23,6478075,7168125,690050,BUY
2020-12-18 14:24:00,14:24,6419300,7164675,745375,BUY
2020-12-18 14:25:00,14:25,6405150,7209700,804550,BUY
2020-12-18 14:26:00,14:26,6409475,7223600,814125,BUY
2020-12-18 14:27:00,14:27,6414350,7191525,777175,BUY
2020-12-18 14:28:00,14:28,6426550,7176675,750125,BUY
2020-12-18 14:29:00,14:29,6415275,7181075,765800,BUY
2020-12-18 14:30:00,14:30,6424950,7192725,767775,BUY
2020-12-18 14:31:00,14:31,6430400,7199125,768725,BUY
2020-12-18 14:32:00,14:32,6432950,7192950,760000,BUY
2020-12-18 14:33:00,14:33,6346275,7240125,893850,BUY
2020-12-18 14:34:00,14:34,6356600,7221025,864425,BUY
2020-12-18 14:35:00,14:35,6368325,7250200,881875,BUY
2020-12-18 14:36:00,14:36,6243175,7209675,966500,BUY
2020-12-18 14:37:00,14:37,6230125,7208725,978600,BUY
2020-12-18 14:38:00,14:38,6216350,7204775,988425,BUY
2020-12-18 14:39:00,14:39,6089375,7127025,1037650,BUY
2020-12-18 14:40:00,14:40,6089300,7101525,1012225,BUY
2020-12-18 14:41:00,14:41,6058100,7129600,1071500,BUY
2020-12-18 14:42:00,14:42,6007675,7158000,1150325,BUY
2020-12-18 14:43:00,14:43,6019675,7187025,1167350,BUY
2020-12-18 14:44:00,14:44,5993900,7151225,1157325,BUY
2020-12-18 14:45:00,14:45,5895550,7138125,1242575,BUY
2020-12-18 14:46:00,14:46,5900325,7154225,1253900,BUY
2020-12-18 14:47:00,14:47,5904525,7142725,1238200,BUY
2020-12-18 14:48:00,14:48,5870925,7123000,1252075,BUY
2020-12-18 14:49:00,14:49,5847375,7115750,1268375,BUY
2020-12-18 14:50:00,14:50,5854325,7131500,1277175,BUY
2020-12-18 14:51:00,14:51,5835275,7100275,1265000,BUY
2020-12-18 14:52:00,14:52,5833800,7099400,1265600,BUY
2020-12-18 14:53:00,14:53,5824275,7048375,1224100,BUY
2020-12-18 14:54:00,14:54,5699800,7036125,1336325,BUY
2020-12-18 14:55:00,14:55,5695175,6970525,1275350,BUY
2020-12-18 14:56:00,14:56,5702000,7017100,1315100,BUY
2020-12-18 14:57:00,14:57,5633825,6920725,1286900,BUY
2020-12-18 14:58:00,14:58,5637050,6948000,1310950,BUY
2020-12-18 14:59:00,14:59,5632425,6946150,1313725,BUY
2020-12-18 15:00:00,15:00,5529350,6864500,1335150,BUY
2020-12-18 15:01:00,15:01,5531775,6839125,1307350,BUY
2020-12-18 15:02:00,15:02,5523900,6843725,1319825,BUY
2020-12-18 15:03:00,15:03,5489200,6786750,1297550,BUY
2020-12-18 15:04:00,15:04,5515600,6803625,1288025,BUY
2020-12-18 15:05:00,15:05,5497025,6792300,1295275,BUY
2020-12-18 15:06:00,15:06,5434750,6666375,1231625,BUY
2020-12-18 15:07:00,15:07,5459250,6692050,1232800,BUY
2020-12-18 15:08:00,15:08,5455875,6663725,1207850,BUY
2020-12-18 15:09:00,15:09,5465575,6652550,1186975,BUY
2020-12-18 15:10:00,15:10,5482650,6675400,1192750,BUY
2020-12-18 15:11:00,15:11,5470450,6675400,1204950,BUY
2020-12-18 15:12:00,15:12,5419750,6625625,1205875,BUY
2020-12-18 15:13:00,15:13,5432825,6635100,1202275,BUY
2020-12-18 15:14:00,15:14,5429800,6643525,1213725,BUY
2020-12-18 15:15:00,15:15,5361375,6588350,1226975,BUY
2020-12-18 15:16:00,15:16,5361425,6584075,1222650,BUY
2020-12-18 15:17:00,15:17,5373200,6593650,1220450,BUY
2020-12-18 15:18:00,15:18,5316450,6597400,1280950,BUY
2020-12-18 15:19:00,15:19,5325000,6580050,1255050,BUY
2020-12-18 15:20:00,15:20,5329700,6581900,1252200,BUY
2020-12-18 15:21:00,15:21,5222875,6420825,1197950,BUY
2020-12-18 15:22:00,15:22,5212550,6387575,1175025,BUY
2020-12-18 15:23:00,15:23,5209200,6416650,1207450,BUY
2020-12-18 15:24:00,15:24,5116350,6313125,1196775,BUY
2020-12-18 15:25:00,15:25,5134525,6315325,1180800,BUY
2020-12-18 15:26:00,15:26,5125175,6305325,1180150,BUY
2020-12-18 15:27:00,15:27,5077750,6193750,1116000,BUY
2020-12-18 15:28:00,15:28,5082725,6195775,1113050,BUY
2020-12-18 15:29:00,15:29,5079925,6210050,1130125,BUY
2020-12-21 09:15:00,09:15,5028625,6099675,1071050,BUY
2020-12-21 09:16:00,09:16,5019425,6095275,1075850,BUY
2020-12-21 09:17:00,09:17,5143175,6176100,1032925,BUY
2020-12-21 09:18:00,09:18,5146975,6164600,1017625,BUY
2020-12-21 09:19:00,09:19,5138425,6175675,1037250,BUY
2020-12-21 09:20:00,09:20,5665575,6326525,660950,BUY
2020-12-21 09:21:00,09:21,5659700,6314400,654700,BUY
2020-12-21 09:22:00,09:22,5660400,6321975,661575,BUY
2020-12-21 09:23:00,09:23,6374725,6727225,352500,BUY
2020-12-21 09:24:00,09:24,6379075,6720450,341375,BUY
2020-12-21 09:25:00,09:25,6385025,6722900,337875,BUY
2020-12-21 09:26:00,09:26,6539550,6853175,313625,BUY
2020-12-21 09:27:00,09:27,6547500,6855100,307600,BUY
2020-12-21 09:28:00,09:28,6537625,6842375,304750,BUY
2020-12-21 09:29:00,09:29,6761925,6977600,215675,BUY
2020-12-21 09:30:00,09:30,6762350,6983050,220700,BUY
2020-12-21 09:31:00,09:31,6757525,6968125,210600,BUY
2020-12-21 09:32:00,09:32,6893250,7103850,210600,BUY
2020-12-21 09:33:00,09:33,6886450,7107450,221000,BUY
2020-12-21 09:34:00,09:34,6875400,7105975,230575,BUY
2020-12-21 09:35:00,09:35,6928900,7236425,307525,BUY
2020-12-21 09:36:00,09:36,6928900,7222925,294025,BUY
2020-12-21 09:37:00,09:37,6933925,7214175,280250,BUY
2020-12-21 09:38:00,09:38,6979125,7346475,367350,BUY
2020-12-21 09:39:00,09:39,6973100,7326575,353475,BUY
2020-12-21 09:40:00,09:40,6970950,7305450,334500,BUY
2020-12-21 09:41:00,09:41,7057675,7470525,412850,BUY
2020-12-21 09:42:00,09:42,7062475,7483300,420825,BUY
2020-12-21 09:43:00,09:43,7061100,7483300,422200,BUY
2020-12-21 09:44:00,09:44,7135975,7763200,627225,BUY
2020-12-21 09:45:00,09:45,7133025,7805075,672050,BUY
2020-12-21 09:46:00,09:46,7118850,7759200,640350,BUY
2020-12-21 09:47:00,09:47,7294025,7961000,666975,BUY
2020-12-21 09:48:00,09:48,7294025,7961100,667075,BUY
2020-12-21 09:49:00,09:49,7287975,7939775,651800,BUY
2020-12-21 09:50:00,09:50,7271100,7951250,680150,BUY
2020-12-21 09:51:00,09:51,7264825,7888300,623475,BUY
2020-12-21 09:52:00,09:52,7273725,7933750,660025,BUY
2020-12-21 09:53:00,09:53,7344050,8054825,710775,BUY
2020-12-21 09:54:00,09:54,7355525,8070625,715100,BUY
2020-12-21 09:55:00,09:55,7344050,8042625,698575,BUY
2020-12-21 09:56:00,09:56,7458500,8134375,675875,BUY
2020-12-21 09:57:00,09:57,7458575,8104100,645525,BUY
2020-12-21 09:58:00,09:58,7441825,8089800,647975,BUY
2020-12-21 09:59:00,09:59,7562775,8157400,594625,BUY
2020-12-21 10:00:00,10:00,7565450,8157550,592100,BUY
2020-12-21 10:01:00,10:01,7580350,8155150,574800,BUY
2020-12-21 10:02:00,10:02,7669950,8230350,560400,BUY
2020-12-21 10:03:00,10:03,7700900,8292550,591650,BUY
2020-12-21 10:04:00,10:04,7713050,8283150,570100,BUY
2020-12-21 10:05:00,10:05,7740800,8317700,576900,BUY
2020-12-21 10:06:00,10:06,7741300,8335325,594025,BUY
2020-12-21 10:07:00,10:07,7734350,8323650,589300,BUY
2020-12-21 10:08:00,10:08,7686000,8311600,625600,BUY
2020-12-21 10:09:00,10:09,7723825,8363175,639350,BUY
2020-12-21 10:10:00,10:10,7722150,8371100,648950,BUY
2020-12-21 10:11:00,10:11,7763450,8510825,747375,BUY
2020-12-21 10:12:00,10:12,7730200,8503925,773725,BUY
2020-12-21 10:13:00,10:13,7740625,8476200,735575,BUY
2020-12-21 10:14:00,10:14,7821775,8526100,704325,BUY
2020-12-21 10:15:00,10:15,7850900,8534100,683200,BUY
2020-12-21 10:16:00,10:16,7846050,8523600,677550,BUY
2020-12-21 10:17:00,10:17,7872575,8565300,692725,BUY
2020-12-21 10:18:00,10:18,7872575,8558625,686050,BUY
2020-12-21 10:19:00,10:19,7872575,8509325,636750,BUY
2020-12-21 10:20:00,10:20,7927075,8619050,691975,BUY
2020-12-21 10:21:00,10:21,7927000,8584775,657775,BUY
2020-12-21 10:22:00,10:22,7896675,8624550,727875,BUY
2020-12-21 10:23:00,10:23,7900450,8705400,804950,BUY
2020-12-21 10:24:00,10:24,7930725,8688300,757575,BUY
2020-12-21 10:25:00,10:25,7928975,8680500,751525,BUY
2020-12-21 10:26:00,10:26,7998275,8743150,744875,BUY
2020-12-21 10:27:00,10:27,8009400,8713550,704150,BUY
2020-12-21 10:28:00,10:28,8015750,8755350,739600,BUY
2020-12-21 10:29:00,10:29,7990250,8755800,765550,BUY
2020-12-21 10:30:00,10:30,8008425,8739800,731375,BUY
2020-12-21 10:31:00,10:31,8012550,8744750,732200,BUY
2020-12-21 10:32:00,10:32,8036625,8780850,744225,BUY
2020-12-21 10:33:00,10:33,8036850,8781450,744600,BUY
2020-12-21 10:34:00,10:34,8025950,8795775,769825,BUY
2020-12-21 10:35:00,10:35,8057625,8779925,722300,BUY
2020-12-21 10:36:00,10:36,8057625,8837675,780050,BUY
2020-12-21 10:37:00,10:37,8104850,8893550,788700,BUY
2020-12-21 10:38:00,10:38,7754850,8784500,1029650,BUY
2020-12-21 10:39:00,10:39,7757375,8781200,1023825,BUY
2020-12-21 10:40:00,10:40,7759350,8799525,1040175,BUY
2020-12-21 10:41:00,10:41,7492550,8690325,1197775,BUY
2020-12-21 10:42:00,10:42,7494125,8762775,1268650,BUY
2020-12-21 10:43:00,10:43,7485675,8748700,1263025,BUY
2020-12-21 10:44:00,10:44,7554650,8674575,1119925,BUY
2020-12-21 10:45:00,10:45,7536350,8703350,1167000,BUY
2020-12-21 10:46:00,10:46,7553550,8681075,1127525,BUY
2020-12-21 10:47:00,10:47,7610800,8704450,1093650,BUY
2020-12-21 10:48:00,10:48,7607550,8717475,1109925,BUY
2020-12-21 10:49:00,10:49,7611375,8662675,1051300,BUY
2020-12-21 10:50:00,10:50,7699450,8683375,983925,BUY
2020-12-21 10:51:00,10:51,7686800,8783975,1097175,BUY
2020-12-21 10:52:00,10:52,7709750,8787450,1077700,BUY
2020-12-21 10:53:00,10:53,7738650,8965925,1227275,BUY
2020-12-21 10:54:00,10:54,7761475,8962700,1201225,BUY
2020-12-21 10:55:00,10:55,7761475,8943900,1182425,BUY
2020-12-21 10:56:00,10:56,7805500,9008000,1202500,BUY
2020-12-21 10:57:00,10:57,7764050,8898325,1134275,BUY
2020-12-21 10:58:00,10:58,7764050,8971975,1207925,BUY
2020-12-21 10:59:00,10:59,7871075,9032575,1161500,BUY
2020-12-21 11:00:00,11:00,7873900,9042500,1168600,BUY
2020-12-21 11:01:00,11:01,7858500,8990075,1131575,BUY
2020-12-21 11:02:00,11:02,7893700,8847375,953675,BUY
2020-12-21 11:03:00,11:03,7876600,9053675,1177075,BUY
2020-12-21 11:04:00,11:04,7888075,9056350,1168275,BUY
2020-12-21 11:05:00,11:05,7916250,9046650,1130400,BUY
2020-12-21 11:06:00,11:06,7904125,8902150,998025,BUY
2020-12-21 11:07:00,11:07,7916250,9031250,1115000,BUY
2020-12-21 11:08:00,11:08,7940475,8980725,1040250,BUY
2020-12-21 11:09:00,11:09,7957625,9069150,1111525,BUY
2020-12-21 11:10:00,11:10,7963525,8835750,872225,BUY
2020-12-21 11:11:00,11:11,7989575,9035950,1046375,BUY
2020-12-21 11:12:00,11:12,7976875,9134125,1157250,BUY
2020-12-21 11:13:00,11:13,8008075,9126075,1118000,BUY
2020-12-21 11:14:00,11:14,8102000,9151275,1049275,BUY
2020-12-21 11:15:00,11:15,8103600,9124175,1020575,BUY
2020-12-21 11:16:00,11:16,8091125,9103925,1012800,BUY
2020-12-21 11:17:00,11:17,8119675,9093750,974075,BUY
2020-12-21 11:18:00,11:18,8107550,9086900,979350,BUY
2020-12-21 11:19:00,11:19,8107550,9126525,1018975,BUY
2020-12-21 11:20:00,11:20,8156300,9051125,894825,BUY
2020-12-21 11:21:00,11:21,8197125,9177625,980500,BUY
2020-12-21 11:22:00,11:22,8156925,9117725,960800,BUY
2020-12-21 11:23:00,11:23,8183175,9139375,956200,BUY
2020-12-21 11:24:00,11:24,8172875,9184225,1011350,BUY
2020-12-21 11:25:00,11:25,8183200,9141000,957800,BUY
2020-12-21 11:26:00,11:26,8181700,9168850,987150,BUY
2020-12-21 11:27:00,11:27,8187550,9135075,947525,BUY
2020-12-21 11:28:00,11:28,8165250,9107500,942250,BUY
2020-12-21 11:29:00,11:29,8213525,8987750,774225,BUY
2020-12-21 11:30:00,11:30,8222150,9219125,996975,BUY
2020-12-21 11:31:00,11:31,8232875,9179975,947100,BUY
2020-12-21 11:32:00,11:32,8248275,8981600,733325,BUY
2020-12-21 11:33:00,11:33,8273750,8978800,705050,BUY
2020-12-21 11:34:00,11:34,8267350,8986875,719525,BUY
2020-12-21 11:35:00,11:35,8268625,9244750,976125,BUY
2020-12-21 11:36:00,11:36,8275100,9222225,947125,BUY
2020-12-21 11:37:00,11:37,8275100,9292400,1017300,BUY
2020-12-21 11:38:00,11:38,8278925,9235125,956200,BUY
2020-12-21 11:39:00,11:39,8284200,8909700,625500,BUY
2020-12-21 11:40:00,11:40,8280325,9224150,943825,BUY
2020-12-21 11:41:00,11:41,8321725,9235275,913550,BUY
2020-12-21 11:42:00,11:42,8297600,9200925,903325,BUY
2020-12-21 11:43:00,11:43,8297575,9219850,922275,BUY
2020-12-21 11:44:00,11:44,8348475,9196750,848275,BUY
2020-12-21 11:45:00,11:45,8352075,9223350,871275,BUY
2020-12-21 11:46:00,11:46,8353325,9222350,869025,BUY
2020-12-21 11:47:00,11:47,8346775,9209325,862550,BUY
2020-12-21 11:48:00,11:48,8345725,9226450,880725,BUY
2020-12-21 11:49:00,11:49,8345725,9251500,905775,BUY
2020-12-21 11:50:00,11:50,8405575,9278000,872425,BUY
2020-12-21 11:51:00,11:51,8417325,9284500,867175,BUY
2020-12-21 11:52:00,11:52,8413025,9272725,859700,BUY
2020-12-21 11:53:00,11:53,8386025,9250300,864275,BUY
2020-12-21 11:54:00,11:54,8397325,9245325,848000,BUY
2020-12-21 11:55:00,11:55,8428650,9248550,819900,BUY
2020-12-21 11:56:00,11:56,8512850,9301325,788475,BUY
2020-12-21 11:57:00,11:57,8532475,9275475,743000,BUY
2020-12-21 11:58:00,11:58,8527300,9285400,758100,BUY
2020-12-21 11:59:00,11:59,8596425,9463275,866850,BUY
2020-12-21 12:00:00,12:00,8616975,9442500,825525,BUY
2020-12-21 12:01:00,12:01,8614900,9416975,802075,BUY
2020-12-21 12:02:00,12:02,8608975,9473750,864775,BUY
2020-12-21 12:03:00,12:03,8667900,9517925,850025,BUY
2020-12-21 12:04:00,12:04,8655150,9496975,841825,BUY
2020-12-21 12:05:00,12:05,8658200,9437950,779750,BUY
2020-12-21 12:06:00,12:06,8716900,9429275,712375,BUY
2020-12-21 12:07:00,12:07,8722875,9558475,835600,BUY
2020-12-21 12:08:00,12:08,8749275,9541450,792175,BUY
2020-12-21 12:09:00,12:09,8784250,9560800,776550,BUY
2020-12-21 12:10:00,12:10,8785225,9617425,832200,BUY
2020-12-21 12:11:00,12:11,8764650,9593475,828825,BUY
2020-12-21 12:12:00,12:12,8844950,9572625,727675,BUY
2020-12-21 12:13:00,12:13,8865475,9615100,749625,BUY
2020-12-21 12:14:00,12:14,8862175,9572475,710300,BUY
2020-12-21 12:15:00,12:15,8945050,9532775,587725,BUY
2020-12-21 12:16:00,12:16,8916875,9540275,623400,BUY
2020-12-21 12:17:00,12:17,8926900,9496675,569775,BUY
2020-12-21 12:18:00,12:18,8962775,9496950,534175,BUY
2020-12-21 12:19:00,12:19,8971425,9484375,512950,BUY
2020-12-21 12:20:00,12:20,8971425,9576650,605225,BUY
2020-12-21 12:21:00,12:21,9008575,9514975,506400,BUY
2020-12-21 12:22:00,12:22,8999650,9539075,539425,BUY
2020-12-21 12:23:00,12:23,8993625,9495850,502225,BUY
2020-12-21 12:24:00,12:24,9037600,9488025,450425,BUY
2020-12-21 12:25:00,12:25,9053225,9578375,525150,BUY
2020-12-21 12:26:00,12:26,9026875,9526725,499850,BUY
2020-12-21 12:27:00,12:27,9058500,9564850,506350,BUY
2020-12-21 12:28:00,12:28,9050725,9565000,514275,BUY
2020-12-21 12:29:00,12:29,9067075,9579775,512700,BUY
2020-12-21 12:30:00,12:30,9264600,9689100,424500,BUY
2020-12-21 12:31:00,12:31,9254625,9617000,362375,BUY
2020-12-21 12:32:00,12:32,9254625,9652825,398200,BUY
2020-12-21 12:33:00,12:33,9286300,9557925,271625,BUY
2020-12-21 12:34:00,12:34,9295800,9575075,279275,BUY
2020-12-21 12:35:00,12:35,9300525,9536350,235825,BUY
2020-12-21 12:36:00,12:36,9378050,9618125,240075,BUY
2020-12-21 12:37:00,12:37,9383050,9602500,219450,BUY
2020-12-21 12:38:00,12:38,9393650,9659000,265350,BUY
2020-12-21 12:39:00,12:39,9504800,9627550,122750,BUY
2020-12-21 12:40:00,12:40,9487425,9660750,173325,BUY
2020-12-21 12:41:00,12:41,9492850,9590150,97300,BUY
2020-12-21 12:42:00,12:42,9553550,9530950,-22600,SELL
2020-12-21 12:43:00,12:43,9514025,9535975,21950,BUY
2020-12-21 12:44:00,12:44,9528700,9533725,5025,BUY
2020-12-21 12:45:00,12:45,9569150,9530975,-38175,SELL
2020-12-21 12:46:00,12:46,9550625,9464075,-86550,SELL
2020-12-21 12:47:00,12:47,9569150,9540975,-28175,SELL
2020-12-21 12:48:00,12:48,9583475,9593925,10450,BUY
2020-12-21 12:49:00,12:49,9600925,9594525,-6400,SELL
2020-12-21 12:50:00,12:50,9618225,9623750,5525,BUY
2020-12-21 12:51:00,12:51,9696250,9463950,-232300,SELL
2020-12-21 12:52:00,12:52,9694375,9456250,-238125,SELL
2020-12-21 12:53:00,12:53,9691350,9443300,-248050,SELL
2020-12-21 12:54:00,12:54,9793600,9423025,-370575,SELL
2020-12-21 12:55:00,12:55,9805575,9434175,-371400,SELL
2020-12-21 12:56:00,12:56,9774625,9452850,-321775,SELL
2020-12-21 12:57:00,12:57,9845450,9273450,-572000,SELL
2020-12-21 12:58:00,12:58,9829900,9260675,-569225,SELL
2020-12-21 12:59:00,12:59,9853200,9289400,-563800,SELL
2020-12-21 13:00:00,13:00,9898750,9186300,-712450,SELL
2020-12-21 13:01:00,13:01,9893925,9180300,-713625,SELL
2020-12-21 13:02:00,13:02,9900225,9193225,-707000,SELL
2020-12-21 13:03:00,13:03,9945775,8568825,-1376950,SELL
2020-12-21 13:04:00,13:04,9959550,8552675,-1406875,SELL
2020-12-21 13:05:00,13:05,9956925,8563025,-1393900,SELL
2020-12-21 13:06:00,13:06,9898400,8546675,-1351725,SELL
2020-12-21 13:07:00,13:07,9891175,8550000,-1341175,SELL
2020-12-21 13:08:00,13:08,9900100,8539425,-1360675,SELL
2020-12-21 13:09:00,13:09,9981375,8417450,-1563925,SELL
2020-12-21 13:10:00,13:10,9980700,8409525,-1571175,SELL
2020-12-21 13:11:00,13:11,9980725,8371375,-1609350,SELL
2020-12-21 13:12:00,13:12,10129975,8406850,-1723125,SELL
2020-12-21 13:13:00,13:13,10125250,8422925,-1702325,SELL
2020-12-21 13:14:00,13:14,10122100,8394325,-1727775,SELL
2020-12-21 13:15:00,13:15,10192650,8477375,-1715275,SELL
2020-12-21 13:16:00,13:16,10192650,8447600,-1745050,SELL
2020-12-21 13:17:00,13:17,10184700,8452275,-1732425,SELL
2020-12-21 13:18:00,13:18,10304325,8521250,-1783075,SELL
2020-12-21 13:19:00,13:19,10303525,8516925,-1786600,SELL
2020-12-21 13:20:00,13:20,10303525,8515775,-1787750,SELL
2020-12-21 13:21:00,13:21,10309575,8538125,-1771450,SELL
2020-12-21 13:22:00,13:22,10286350,8538125,-1748225,SELL
2020-12-21 13:23:00,13:23,10306300,8483700,-1822600,SELL
2020-12-21 13:24:00,13:24,10348550,8574100,-1774450,SELL
2020-12-21 13:25:00,13:25,10334050,8598325,-1735725,SELL
2020-12-21 13:26:00,13:26,10342500,8585525,-1756975,SELL
2020-12-21 13:27:00,13:27,10375550,8596225,-1779325,SELL
2020-12-21 13:28:00,13:28,10365550,8543125,-1822425,SELL
2020-12-21 13:29:00,13:29,10386600,8568850,-1817750,SELL
2020-12-21 13:30:00,13:30,10473000,8621325,-1851675,SELL
2020-12-21 13:31:00,13:31,10470075,8603275,-1866800,SELL
2020-12-21 13:32:00,13:32,10456875,8603225,-1853650,SELL
2020-12-21 13:33:00,13:33,10576725,8575250,-2001475,SELL
2020-12-21 13:34:00,13:34,10574125,8629350,-1944775,SELL
2020-12-21 13:35:00,13:35,10586200,8641975,-1944225,SELL
2020-12-21 13:36:00,13:36,10619325,8401575,-2217750,SELL
2020-12-21 13:37:00,13:37,10616725,8416700,-2200025,SELL
2020-12-21 13:38:00,13:38,10619250,8406850,-2212400,SELL
2020-12-21 13:39:00,13:39,10657625,8124225,-2533400,SELL
2020-12-21 13:40:00,13:40,10642575,8142275,-2500300,SELL
2020-12-21 13:41:00,13:41,10651100,8115325,-2535775,SELL
2020-12-21 13:42:00,13:42,10807500,8135850,-2671650,SELL
2020-12-21 13:43:00,13:43,10814600,8128475,-2686125,SELL
2020-12-21 13:44:00,13:44,10812750,8118325,-2694425,SELL
2020-12-21 13:45:00,13:45,10943650,8294175,-2649475,SELL
2020-12-21 13:46:00,13:46,10943900,8318000,-2625900,SELL
2020-12-21 13:47:00,13:47,10950425,8294175,-2656250,SELL
2020-12-21 13:48:00,13:48,11035875,8368050,-2667825,SELL
2020-12-21 13:49:00,13:49,11032975,8372000,-2660975,SELL
2020-12-21 13:50:00,13:50,11035850,8366375,-2669475,SELL
2020-12-21 13:51:00,13:51,11042700,8424875,-2617825,SELL
2020-12-21 13:52:00,13:52,11042875,8408925,-2633950,SELL
2020-12-21 13:53:00,13:53,11042875,8437150,-2605725,SELL
2020-12-21 13:54:00,13:54,11094925,8483875,-2611050,SELL
2020-12-21 13:55:00,13:55,11091975,8492825,-2599150,SELL
2020-12-21 13:56:00,13:56,11094975,8482600,-2612375,SELL
2020-12-21 13:57:00,13:57,11069925,8451525,-2618400,SELL
2020-12-21 13:58:00,13:58,11065675,8441300,-2624375,SELL
2020-12-21 13:59:00,13:59,11076000,8462825,-2613175,SELL
2020-12-21 14:00:00,14:00,11046975,8406500,-2640475,SELL
2020-12-21 14:01:00,14:01,11044050,8383100,-2660950,SELL
2020-12-21 14:02:00,14:02,11044825,8378800,-2666025,SELL
2020-12-21 14:03:00,14:03,11080475,8369575,-2710900,SELL
2020-12-21 14:04:00,14:04,11083800,8369575,-2714225,SELL
2020-12-21 14:05:00,14:05,11077900,8385625,-2692275,SELL
2020-12-21 14:06:00,14:06,11019350,8440025,-2579325,SELL
2020-12-21 14:07:00,14:07,11023225,8424500,-2598725,SELL
2020-12-21 14:08:00,14:08,11013550,8433500,-2580050,SELL
2020-12-21 14:09:00,14:09,11082300,8440500,-2641800,SELL
2020-12-21 14:10:00,14:10,11091200,8436100,-2655100,SELL
2020-12-21 14:11:00,14:11,11077000,8446900,-2630100,SELL
2020-12-21 14:12:00,14:12,11148400,8380425,-2767975,SELL
2020-12-21 14:13:00,14:13,11163600,8383825,-2779775,SELL
2020-12-21 14:14:00,14:14,11161450,8390200,-2771250,SELL
2020-12-21 14:15:00,14:15,11178825,8358225,-2820600,SELL
2020-12-21 14:16:00,14:16,11178875,8336900,-2841975,SELL
2020-12-21 14:17:00,14:17,11178175,8365550,-2812625,SELL
2020-12-21 14:18:00,14:18,11229475,8256125,-2973350,SELL
2020-12-21 14:19:00,14:19,11227050,8268150,-2958900,SELL
2020-12-21 14:20:00,14:20,11229625,8239625,-2990000,SELL
2020-12-21 14:21:00,14:21,11197650,8048475,-3149175,SELL
2020-12-21 14:22:00,14:22,11199350,8045725,-3153625,SELL
2020-12-21 14:23:00,14:23,11200375,8043175,-3157200,SELL
2020-12-21 14:24:00,14:24,11206100,7959900,-3246200,SELL
2020-12-21 14:25:00,14:25,11207700,7946650,-3261050,SELL
2020-12-21 14:26:00,14:26,11203975,7952925,-3251050,SELL
2020-12-21 14:27:00,14:27,11200800,7932950,-3267850,SELL
2020-12-21 14:28:00,14:28,11204350,7949450,-3254900,SELL
2020-12-21 14:29:00,14:29,11204675,7956000,-3248675,SELL
2020-12-21 14:30:00,14:30,11255175,7964375,-3290800,SELL
2020-12-21 14:31:00,14:31,11259325,7954600,-3304725,SELL
2020-12-21 14:32:00,14:32,11258525,7950700,-3307825,SELL
2020-12-21 14:33:00,14:33,11244200,7960400,-3283800,SELL
2020-12-21 14:34:00,14:34,11252900,7999550,-3253350,SELL
2020-12-21 14:35:00,14:35,11246975,7991550,-3255425,SELL
2020-12-21 14:36:00,14:36,11246100,7986875,-3259225,SELL
2020-12-21 14:37:00,14:37,11249325,8007800,-3241525,SELL
2020-12-21 14:38:00,14:38,11246125,7999300,-3246825,SELL
2020-12-21 14:39:00,14:39,11241000,8001250,-3239750,SELL
2020-12-21 14:40:00,14:40,11241625,8012750,-3228875,SELL
2020-12-21 14:41:00,14:41,11240900,8022450,-3218450,SELL
2020-12-21 14:42:00,14:42,11258850,7936375,-3322475,SELL
2020-12-21 14:43:00,14:43,11258925,7930500,-3328425,SELL
2020-12-21 14:44:00,14:44,11259625,7944600,-3315025,SELL
2020-12-21 14:45:00,14:45,11262825,7796275,-3466550,SELL
2020-12-21 14:46:00,14:46,11262425,7804050,-3458375,SELL
2020-12-21 14:47:00,14:47,11265325,7796850,-3468475,SELL
2020-12-21 14:48:00,14:48,11235775,7753050,-3482725,SELL
2020-12-21 14:49:00,14:49,11235450,7736200,-3499250,SELL
2020-12-21 14:50:00,14:50,11235825,7749625,-3486200,SELL
2020-12-21 14:51:00,14:51,11265350,7731375,-3533975,SELL
2020-12-21 14:52:00,14:52,11266100,7707200,-3558900,SELL
2020-12-21 14:53:00,14:53,11266100,7719725,-3546375,SELL
2020-12-21 14:54:00,14:54,11264575,7647325,-3617250,SELL
2020-12-21 14:55:00,14:55,11269675,7640525,-3629150,SELL
2020-12-21 14:56:00,14:56,11264600,7588950,-3675650,SELL
2020-12-21 14:57:00,14:57,11170350,7551825,-3618525,SELL
2020-12-21 14:58:00,14:58,11169500,7560050,-3609450,SELL
2020-12-21 14:59:00,14:59,11170325,7491975,-3678350,SELL
2020-12-21 15:00:00,15:00,11083850,7381625,-3702225,SELL
2020-12-21 15:01:00,15:01,11083850,7334775,-3749075,SELL
2020-12-21 15:02:00,15:02,11088175,7369625,-3718550,SELL
2020-12-21 15:03:00,15:03,10953750,7138025,-3815725,SELL
2020-12-21 15:04:00,15:04,10950525,7133025,-3817500,SELL
2020-12-21 15:05:00,15:05,10958150,7133700,-3824450,SELL
2020-12-21 15:06:00,15:06,10893000,6995150,-3897850,SELL
2020-12-21 15:07:00,15:07,10892900,7010525,-3882375,SELL
2020-12-21 15:08:00,15:08,10892925,7010525,-3882400,SELL
2020-12-21 15:09:00,15:09,10954050,7056250,-3897800,SELL
2020-12-21 15:10:00,15:10,10959100,7086850,-3872250,SELL
2020-12-21 15:11:00,15:11,10953700,7064550,-3889150,SELL
2020-12-21 15:12:00,15:12,10975625,7015675,-3959950,SELL
2020-12-21 15:13:00,15:13,10974600,7010575,-3964025,SELL
2020-12-21 15:14:00,15:14,10975425,7012775,-3962650,SELL
2020-12-21 15:15:00,15:15,10999125,7025750,-3973375,SELL
2020-12-21 15:16:00,15:16,10997600,7015275,-3982325,SELL
2020-12-21 15:17:00,15:17,10997825,7032550,-3965275,SELL
2020-12-21 15:18:00,15:18,11031525,6993500,-4038025,SELL
2020-12-21 15:19:00,15:19,11030600,6992250,-4038350,SELL
2020-12-21 15:20:00,15:20,11038275,6971425,-4066850,SELL
2020-12-21 15:21:00,15:21,11016200,6947375,-4068825,SELL
2020-12-21 15:22:00,15:22,11016675,6948975,-4067700,SELL
2020-12-21 15:23:00,15:23,11010050,6945700,-4064350,SELL
2020-12-21 15:24:00,15:24,10985050,6926075,-4058975,SELL
2020-12-21 15:25:00,15:25,10992675,6926550,-4066125,SELL
2020-12-21 15:26:00,15:26,10987375,6916225,-4071150,SELL
2020-12-21 15:27:00,15:27,11008600,6894700,-4113900,SELL
2020-12-21 15:28:00,15:28,11004450,6888500,-4115950,SELL
2020-12-21 15:29:00,15:29,11007000,6894700,-4112300,SELL
2020-12-22 09:15:00,09:15,10179475,5560125,-4619350,SELL
2020-12-22 09:16:00,09:16,10174975,5568400,-4606575,SELL
2020-12-22 09:17:00,09:17,10276775,5656050,-4620725,SELL
2020-12-22 09:18:00,09:18,10279575,5649100,-4630475,SELL
2020-12-22 09:19:00,09:19,10275700,5649100,-4626600,SELL
2020-12-22 09:20:00,09:20,10340475,5671700,-4668775,SELL
2020-12-22 09:21:00,09:21,10344325,5679975,-4664350,SELL
2020-12-22 09:22:00,09:22,10341275,5632475,-4708800,SELL
2020-12-22 09:23:00,09:23,10362250,5670675,-4691575,SELL
2020-12-22 09:24:00,09:24,10368025,5721700,-4646325,SELL
2020-12-22 09:25:00,09:25,10373525,5714750,-4658775,SELL
2020-12-22 09:26:00,09:26,10418425,5791050,-4627375,SELL
2020-12-22 09:27:00,09:27,10418425,5826475,-4591950,SELL
2020-12-22 09:28:00,09:28,10415325,5838275,-4577050,SELL
2020-12-22 09:29:00,09:29,10497350,5899950,-4597400,SELL
2020-12-22 09:30:00,09:30,10493950,5902900,-4591050,SELL
2020-12-22 09:31:00,09:31,10493625,5791850,-4701775,SELL
2020-12-22 09:32:00,09:32,10607200,5934675,-4672525,SELL
2020-12-22 09:33:00,09:33,10609800,5979100,-4630700,SELL
2020-12-22 09:34:00,09:34,10606450,5965700,-4640750,SELL
2020-12-22 09:35:00,09:35,10747400,5995600,-4751800,SELL
2020-12-22 09:36:00,09:36,10741350,6034800,-4706550,SELL
2020-12-22 09:37:00,09:37,10741350,5897875,-4843475,SELL
2020-12-22 09:38:00,09:38,10836500,6211550,-4624950,SELL
2020-12-22 09:39:00,09:39,10840200,6231525,-4608675,SELL
2020-12-22 09:40:00,09:40,10836500,6172400,-4664100,SELL
2020-12-22 09:41:00,09:41,10847900,6293775,-4554125,SELL
2020-12-22 09:42:00,09:42,10848250,6305575,-4542675,SELL
2020-12-22 09:43:00,09:43,10844900,6253375,-4591525,SELL
2020-12-22 09:44:00,09:44,10924825,6322325,-4602500,SELL
2020-12-22 09:45:00,09:45,10927500,6387825,-4539675,SELL
2020-12-22 09:46:00,09:46,10927325,6364325,-4563000,SELL
2020-12-22 09:47:00,09:47,11099450,6493875,-4605575,SELL
2020-12-22 09:48:00,09:48,11099650,6481750,-4617900,SELL
2020-12-22 09:49:00,09:49,11098950,6486975,-4611975,SELL
2020-12-22 09:50:00,09:50,11104850,6410900,-4693950,SELL
2020-12-22 09:51:00,09:51,11105650,6453375,-4652275,SELL
2020-12-22 09:52:00,09:52,11101700,6424850,-4676850,SELL
2020-12-22 09:53:00,09:53,11149400,6440850,-4708550,SELL
2020-12-22 09:54:00,09:54,11150175,6351125,-4799050,SELL
2020-12-22 09:55:00,09:55,11142650,6434325,-4708325,SELL
2020-12-22 09:56:00,09:56,11093050,6403350,-4689700,SELL
2020-12-22 09:57:00,09:57,11097150,6396000,-4701150,SELL
2020-12-22 09:58:00,09:58,11096725,6349875,-4746850,SELL
2020-12-22 09:59:00,09:59,11086675,6348025,-4738650,SELL
2020-12-22 10:00:00,10:00,11086925,6401525,-4685400,SELL
2020-12-22 10:01:00,10:01,11087450,6291875,-4795575,SELL
2020-12-22 10:02:00,10:02,11087900,6355225,-4732675,SELL
2020-12-22 10:03:00,10:03,11093675,6492250,-4601425,SELL
2020-12-22 10:04:00,10:04,11097900,6286100,-4811800,SELL
2020-12-22 10:05:00,10:05,11134525,6420500,-4714025,SELL
2020-12-22 10:06:00,10:06,11127000,6465075,-4661925,SELL
2020-12-22 10:07:00,10:07,11138625,6455550,-4683075,SELL
2020-12-22 10:08:00,10:08,11208675,6577850,-4630825,SELL
2020-12-22 10:09:00,10:09,11208450,6558675,-4649775,SELL
2020-12-22 10:10:00,10:10,11207600,6538700,-4668900,SELL
2020-12-22 10:11:00,10:11,11174025,6550700,-4623325,SELL
2020-12-22 10:12:00,10:12,11173675,6499850,-4673825,SELL
2020-12-22 10:13:00,10:13,11169675,6539025,-4630650,SELL
2020-12-22 10:14:00,10:14,11174375,6694800,-4479575,SELL
2020-12-22 10:15:00,10:15,11258325,6641400,-4616925,SELL
2020-12-22 10:16:00,10:16,11251300,6546700,-4704600,SELL
2020-12-22 10:17:00,10:17,11313025,6763150,-4549875,SELL
2020-12-22 10:18:00,10:18,11314375,6668500,-4645875,SELL
2020-12-22 10:19:00,10:19,11306725,6763150,-4543575,SELL
2020-12-22 10:20:00,10:20,11347775,6692475,-4655300,SELL
2020-12-22 10:21:00,10:21,11325875,6692200,-4633675,SELL
2020-12-22 10:22:00,10:22,11334225,6572350,-4761875,SELL
2020-12-22 10:23:00,10:23,11282775,6614250,-4668525,SELL
2020-12-22 10:24:00,10:24,11291975,6668675,-4623300,SELL
2020-12-22 10:25:00,10:25,11280250,6579350,-4700900,SELL
2020-12-22 10:26:00,10:26,11294075,6663225,-4630850,SELL
2020-12-22 10:27:00,10:27,11313350,6663100,-4650250,SELL
2020-12-22 10:28:00,10:28,11307500,6705800,-4601700,SELL
2020-12-22 10:29:00,10:29,11394125,6711975,-4682150,SELL
2020-12-22 10:30:00,10:30,11380875,6704250,-4676625,SELL
2020-12-22 10:31:00,10:31,11394075,6704250,-4689825,SELL
2020-12-22 10:32:00,10:32,11400225,6518650,-4881575,SELL
2020-12-22 10:33:00,10:33,11396525,6708775,-4687750,SELL
2020-12-22 10:34:00,10:34,11401750,6708775,-4692975,SELL
2020-12-22 10:35:00,10:35,11465600,6691800,-4773800,SELL
2020-12-22 10:36:00,10:36,11461875,6719425,-4742450,SELL
2020-12-22 10:37:00,10:37,11456000,6714625,-4741375,SELL
2020-12-22 10:38:00,10:38,11461625,6675875,-4785750,SELL
2020-12-22 10:39:00,10:39,11461650,6795525,-4666125,SELL
2020-12-22 10:40:00,10:40,11461650,6640825,-4820825,SELL
2020-12-22 10:41:00,10:41,11438425,6800425,-4638000,SELL
2020-12-22 10:42:00,10:42,11504225,6668850,-4835375,SELL
2020-12-22 10:43:00,10:43,11504225,6911925,-4592300,SELL
2020-12-22 10:44:00,10:44,11507475,6923475,-4584000,SELL
2020-12-22 10:45:00,10:45,11442050,6980675,-4461375,SELL
2020-12-22 10:46:00,10:46,11510825,6987750,-4523075,SELL
2020-12-22 10:47:00,10:47,11570200,6924075,-4646125,SELL
2020-12-22 10:48:00,10:48,11572000,6930900,-4641100,SELL
2020-12-22 10:49:00,10:49,11566150,7016400,-4549750,SELL
2020-12-22 10:50:00,10:50,11620125,6928900,-4691225,SELL
2020-12-22 10:51:00,10:51,11696650,6982050,-4714600,SELL
2020-12-22 10:52:00,10:52,11693800,7128875,-4564925,SELL
2020-12-22 10:53:00,10:53,11609525,6765250,-4844275,SELL
2020-12-22 10:54:00,10:54,11593250,6799475,-4793775,SELL
2020-12-22 10:55:00,10:55,11593250,6988525,-4604725,SELL
2020-12-22 10:56:00,10:56,11696425,6696900,-4999525,SELL
2020-12-22 10:57:00,10:57,11690750,7039550,-4651200,SELL
2020-12-22 10:58:00,10:58,11694350,6723925,-4970425,SELL
2020-12-22 10:59:00,10:59,11759650,6914925,-4844725,SELL
2020-12-22 11:00:00,11:00,11764600,7143725,-4620875,SELL
2020-12-22 11:01:00,11:01,11759975,6914825,-4845150,SELL
2020-12-22 11:02:00,11:02,11817700,6940550,-4877150,SELL
2020-12-22 11:03:00,11:03,11812900,6997700,-4815200,SELL
2020-12-22 11:04:00,11:04,11823150,7052375,-4770775,SELL
2020-12-22 11:05:00,11:05,11816200,6863500,-4952700,SELL
2020-12-22 11:06:00,11:06,11786650,7054450,-4732200,SELL
2020-12-22 11:07:00,11:07,11816500,7045825,-4770675,SELL
2020-12-22 11:08:00,11:08,11792800,7037375,-4755425,SELL
2020-12-22 11:09:00,11:09,11796125,7042125,-4754000,SELL
2020-12-22 11:10:00,11:10,11794250,6942125,-4852125,SELL
2020-12-22 11:11:00,11:11,11815175,7098075,-4717100,SELL
2020-12-22 11:12:00,11:12,11808550,7012575,-4795975,SELL
2020-12-22 11:13:00,11:13,11814475,7039575,-4774900,SELL
2020-12-22 11:14:00,11:14,11760500,7132225,-4628275,SELL
2020-12-22 11:15:00,11:15,11758575,7204675,-4553900,SELL
2020-12-22 11:16:00,11:16,11760525,7204675,-4555850,SELL
2020-12-22 11:17:00,11:17,11762950,7150225,-4612725,SELL
2020-12-22 11:18:00,11:18,11764800,7162025,-4602775,SELL
2020-12-22 11:19:00,11:19,11768225,7213100,-4555125,SELL
2020-12-22 11:20:00,11:20,11742125,7190500,-4551625,SELL
2020-12-22 11:21:00,11:21,11742075,7188250,-4553825,SELL
2020-12-22 11:22:00,11:22,11682125,7188250,-4493875,SELL
2020-12-22 11:23:00,11:23,11790800,7117625,-4673175,SELL
2020-12-22 11:24:00,11:24,11778200,7119625,-4658575,SELL
2020-12-22 11:25:00,11:25,11786600,6983650,-4802950,SELL
2020-12-22 11:26:00,11:26,11775300,7177200,-4598100,SELL
2020-12-22 11:27:00,11:27,11791175,7195100,-4596075,SELL
2020-12-22 11:28:00,11:28,11837025,7127775,-4709250,SELL
2020-12-22 11:29:00,11:29,11946525,7139875,-4806650,SELL
2020-12-22 11:30:00,11:30,11947850,7355375,-4592475,SELL
2020-12-22 11:31:00,11:31,11933700,7352100,-4581600,SELL
2020-12-22 11:32:00,11:32,11931850,7260025,-4671825,SELL
2020-12-22 11:33:00,11:33,12002175,7404625,-4597550,SELL
2020-12-22 11:34:00,11:34,12003175,7305150,-4698025,SELL
2020-12-22 11:35:00,11:35,11980475,7419050,-4561425,SELL
2020-12-22 11:36:00,11:36,11992525,7378900,-4613625,SELL
2020-12-22 11:37:00,11:37,11992225,7417050,-4575175,SELL
2020-12-22 11:38:00,11:38,12096525,7589850,-4506675,SELL
2020-12-22 11:39:00,11:39,12091850,7557125,-4534725,SELL
2020-12-22 11:40:00,11:40,12091475,7554375,-4537100,SELL
2020-12-22 11:41:00,11:41,12133500,7512000,-4621500,SELL
2020-12-22 11:42:00,11:42,12135975,7546650,-4589325,SELL
2020-12-22 11:43:00,11:43,12133000,7415350,-4717650,SELL
2020-12-22 11:44:00,11:44,12145925,7607325,-4538600,SELL
2020-12-22 11:45:00,11:45,12143300,7447975,-4695325,SELL
2020-12-22 11:46:00,11:46,12143475,7576875,-4566600,SELL
2020-12-22 11:47:00,11:47,12148450,7583150,-4565300,SELL
2020-12-22 11:48:00,11:48,12146950,7453475,-4693475,SELL
2020-12-22 11:49:00,11:49,12150075,7469650,-4680425,SELL
2020-12-22 11:50:00,11:50,12172325,7306500,-4865825,SELL
2020-12-22 11:51:00,11:51,12172775,7389825,-4782950,SELL
2020-12-22 11:52:00,11:52,12170725,7234150,-4936575,SELL
2020-12-22 11:53:00,11:53,12183750,7392475,-4791275,SELL
2020-12-22 11:54:00,11:54,12186150,7323225,-4862925,SELL
2020-12-22 11:55:00,11:55,12135050,7482475,-4652575,SELL
2020-12-22 11:56:00,11:56,12177975,7268175,-4909800,SELL
2020-12-22 11:57:00,11:57,12065950,7126125,-4939825,SELL
2020-12-22 11:58:00,11:58,12175250,7309500,-4865750,SELL
2020-12-22 11:59:00,11:59,12134425,7432950,-4701475,SELL
2020-12-22 12:00:00,12:00,12238200,7686825,-4551375,SELL
2020-12-22 12:01:00,12:01,12180200,7374825,-4805375,SELL
2020-12-22 12:02:00,12:02,12128425,7305750,-4822675,SELL
2020-12-22 12:03:00,12:03,12241575,7457575,-4784000,SELL
2020-12-22 12:04:00,12:04,12236225,7404375,-4831850,SELL
2020-12-22 12:05:00,12:05,12239375,7591275,-4648100,SELL
2020-12-22 12:06:00,12:06,12256675,7487850,-4768825,SELL
2020-12-22 12:07:00,12:07,12258100,7617200,-4640900,SELL
2020-12-22 12:08:00,12:08,12257925,7344800,-4913125,SELL
2020-12-22 12:09:00,12:09,12256850,7463150,-4793700,SELL
2020-12-22 12:10:00,12:10,12261700,7555500,-4706200,SELL
2020-12-22 12:11:00,12:11,12261425,7559250,-4702175,SELL
2020-12-22 12:12:00,12:12,12351950,7514775,-4837175,SELL
2020-12-22 12:13:00,12:13,12350425,7598825,-4751600,SELL
2020-12-22 12:14:00,12:14,12351950,7668075,-4683875,SELL
2020-12-22 12:15:00,12:15,12408875,7703625,-4705250,SELL
2020-12-22 12:16:00,12:16,12354825,7771100,-4583725,SELL
2020-12-22 12:17:00,12:17,12356875,7772700,-4584175,SELL
2020-12-22 12:18:00,12:18,12291225,7692375,-4598850,SELL
2020-12-22 12:19:00,12:19,12414600,7705100,-4709500,SELL
2020-12-22 12:20:00,12:20,12412375,7592675,-4819700,SELL
2020-12-22 12:21:00,12:21,12279175,7625250,-4653925,SELL
2020-12-22 12:22:00,12:22,12282450,7634875,-4647575,SELL
2020-12-22 12:23:00,12:23,12319000,7726650,-4592350,SELL
2020-12-22 12:24:00,12:24,12334150,7627375,-4706775,SELL
2020-12-22 12:25:00,12:25,12321900,7480025,-4841875,SELL
2020-12-22 12:26:00,12:26,12163500,7678950,-4484550,SELL
2020-12-22 12:27:00,12:27,12384775,7626275,-4758500,SELL
2020-12-22 12:28:00,12:28,12384775,7023350,-5361425,SELL
2020-12-22 12:29:00,12:29,12386200,7627325,-4758875,SELL
2020-12-22 12:30:00,12:30,12448725,7711425,-4737300,SELL
2020-12-22 12:31:00,12:31,12449300,7710800,-4738500,SELL
2020-12-22 12:32:00,12:32,12449050,7647950,-4801100,SELL
2020-12-22 12:33:00,12:33,12335075,7428925,-4906150,SELL
2020-12-22 12:34:00,12:34,12385150,7618975,-4766175,SELL
2020-12-22 12:35:00,12:35,12383500,7489100,-4894400,SELL
2020-12-22 12:36:00,12:36,12381825,7441475,-4940350,SELL
2020-12-22 12:37:00,12:37,12379775,7409775,-4970000,SELL
2020-12-22 12:38:00,12:38,12382450,7545425,-4837025,SELL
2020-12-22 12:39:00,12:39,12404575,7551125,-4853450,SELL
2020-12-22 12:40:00,12:40,12403475,7460800,-4942675,SELL
2020-12-22 12:41:00,12:41,12402850,7331900,-5070950,SELL
2020-12-22 12:42:00,12:42,12371650,7233175,-5138475,SELL
2020-12-22 12:43:00,12:43,12368275,7384550,-4983725,SELL
2020-12-22 12:44:00,12:44,12370350,7510825,-4859525,SELL
2020-12-22 12:45:00,12:45,12369850,7604050,-4765800,SELL
2020-12-22 12:46:00,12:46,12367950,7566450,-4801500,SELL
2020-12-22 12:47:00,12:47,12368100,7547675,-4820425,SELL
2020-12-22 12:48:00,12:48,12343125,7488550,-4854575,SELL
2020-12-22 12:49:00,12:49,12343125,7429450,-4913675,SELL
2020-12-22 12:50:00,12:50,12336375,7373950,-4962425,SELL
2020-12-22 12:51:00,12:51,12441025,7460975,-4980050,SELL
2020-12-22 12:52:00,12:52,12439225,7679875,-4759350,SELL
2020-12-22 12:53:00,12:53,12442600,7532200,-4910400,SELL
2020-12-22 12:54:00,12:54,12429125,7606700,-4822425,SELL
2020-12-22 12:55:00,12:55,12351050,7415625,-4935425,SELL
2020-12-22 12:56:00,12:56,12433550,7411700,-5021850,SELL
2020-12-22 12:57:00,12:57,12533600,7693300,-4840300,SELL
2020-12-22 12:58:00,12:58,12532100,7641350,-4890750,SELL
2020-12-22 12:59:00,12:59,12531200,7399900,-5131300,SELL
2020-12-22 13:00:00,13:00,12595475,7336425,-5259050,SELL
2020-12-22 13:01:00,13:01,12599675,7607300,-4992375,SELL
2020-12-22 13:02:00,13:02,12599225,7583250,-5015975,SELL
2020-12-22 13:03:00,13:03,12673550,7541700,-5131850,SELL
2020-12-22 13:04:00,13:04,12673650,7429675,-5243975,SELL
2020-12-22 13:05:00,13:05,12689375,7678375,-5011000,SELL
2020-12-22 13:06:00,13:06,12700450,7515300,-5185150,SELL
2020-12-22 13:07:00,13:07,12691525,7342450,-5349075,SELL
2020-12-22 13:08:00,13:08,12496550,7367825,-5128725,SELL
2020-12-22 13:09:00,13:09,12215000,7321475,-4893525,SELL
2020-12-22 13:10:00,13:10,12661225,7640150,-5021075,SELL
2020-12-22 13:11:00,13:11,12627375,7400200,-5227175,SELL
2020-12-22 13:12:00,13:12,12509150,7347575,-5161575,SELL
2020-12-22 13:13:00,13:13,12613325,7372900,-5240425,SELL
2020-12-22 13:14:00,13:14,12651075,7215050,-5436025,SELL
2020-12-22 13:15:00,13:15,12399300,7316425,-5082875,SELL
2020-12-22 13:16:00,13:16,12415650,7510075,-4905575,SELL
2020-12-22 13:17:00,13:17,12418975,7613650,-4805325,SELL
2020-12-22 13:18:00,13:18,12427475,7728975,-4698500,SELL
2020-12-22 13:19:00,13:19,12426975,7784125,-4642850,SELL
2020-12-22 13:20:00,13:20,12426975,7766000,-4660975,SELL
2020-12-22 13:21:00,13:21,12196450,7549100,-4647350,SELL
2020-12-22 13:22:00,13:22,12227200,7555725,-4671475,SELL
2020-12-22 13:23:00,13:23,12242975,7700475,-4542500,SELL
2020-12-22 13:24:00,13:24,12223075,7452000,-4771075,SELL
2020-12-22 13:25:00,13:25,12222925,7460050,-4762875,SELL
2020-12-22 13:26:00,13:26,12218425,7593475,-4624950,SELL
2020-12-22 13:27:00,13:27,12312925,7618975,-4693950,SELL
2020-12-22 13:28:00,13:28,12310850,7886425,-4424425,SELL
2020-12-22 13:29:00,13:29,12305875,7640950,-4664925,SELL
2020-12-22 13:30:00,13:30,12398750,7904725,-4494025,SELL
2020-12-22 13:31:00,13:31,12401750,7779000,-4622750,SELL
2020-12-22 13:32:00,13:32,12399875,7846525,-4553350,SELL
2020-12-22 13:33:00,13:33,12426850,7698725,-4728125,SELL
2020-12-22 13:34:00,13:34,12424550,7800175,-4624375,SELL
2020-12-22 13:35:00,13:35,12432350,7772875,-4659475,SELL
2020-12-22 13:36:00,13:36,12429875,7810250,-4619625,SELL
2020-12-22 13:37:00,13:37,12316750,7995600,-4321150,SELL
2020-12-22 13:38:00,13:38,12429875,7843725,-4586150,SELL
2020-12-22 13:39:00,13:39,12366225,7900450,-4465775,SELL
2020-12-22 13:40:00,13:40,12388225,8063000,-4325225,SELL
2020-12-22 13:41:00,13:41,12388700,8112475,-4276225,SELL
2020-12-22 13:42:00,13:42,12415325,8060925,-4354400,SELL
2020-12-22 13:43:00,13:43,12415325,8068350,-4346975,SELL
2020-12-22 13:44:00,13:44,12415325,7970200,-4445125,SELL
2020-12-22 13:45:00,13:45,12444325,8192075,-4252250,SELL
2020-12-22 13:46:00,13:46,12438800,8149500,-4289300,SELL
2020-12-22 13:47:00,13:47,12439275,8149500,-4289775,SELL
2020-12-22 13:48:00,13:48,12368975,7967025,-4401950,SELL
2020-12-22 13:49:00,13:49,12384450,8231525,-4152925,SELL
2020-12-22 13:50:00,13:50,12383925,8052975,-4330950,SELL
2020-12-22 13:51:00,13:51,12175450,7874350,-4301100,SELL
2020-12-22 13:52:00,13:52,12174700,7838025,-4336675,SELL
2020-12-22 13:53:00,13:53,12179700,7877975,-4301725,SELL
2020-12-22 13:54:00,13:54,12250575,7777450,-4473125,SELL
2020-12-22 13:55:00,13:55,12218000,7797525,-4420475,SELL
2020-12-22 13:56:00,13:56,12246150,7951300,-4294850,SELL
2020-12-22 13:57:00,13:57,12261250,8034525,-4226725,SELL
2020-12-22 13:58:00,13:58,12224925,7938925,-4286000,SELL
2020-12-22 13:59:00,13:59,12257450,7991250,-4266200,SELL
2020-12-22 14:00:00,14:00,12242925,8097000,-4145925,SELL
2020-12-22 14:01:00,14:01,12238525,7977600,-4260925,SELL
2020-12-22 14:02:00,14:02,12247675,7886225,-4361450,SELL
2020-12-22 14:03:00,14:03,12359175,8067950,-4291225,SELL
2020-12-22 14:04:00,14:04,12352375,8027125,-4325250,SELL
2020-12-22 14:05:00,14:05,12359150,7874900,-4484250,SELL
2020-12-22 14:06:00,14:06,12325575,7912875,-4412700,SELL
2020-12-22 14:07:00,14:07,12320650,8053650,-4267000,SELL
2020-12-22 14:08:00,14:08,12308825,7891475,-4417350,SELL
2020-12-22 14:09:00,14:09,12111150,8000100,-4111050,SELL
2020-12-22 14:10:00,14:10,12110025,8087350,-4022675,SELL
2020-12-22 14:11:00,14:11,12114050,7810500,-4303550,SELL
2020-12-22 14:12:00,14:12,12054025,8061725,-3992300,SELL
2020-12-22 14:13:00,14:13,12053500,8056700,-3996800,SELL
2020-12-22 14:14:00,14:14,12051650,8003275,-4048375,SELL
2020-12-22 14:15:00,14:15,12027925,7980375,-4047550,SELL
2020-12-22 14:16:00,14:16,12029650,8081550,-3948100,SELL
2020-12-22 14:17:00,14:17,12034975,8135200,-3899775,SELL
2020-12-22 14:18:00,14:18,12019525,8002875,-4016650,SELL
2020-12-22 14:19:00,14:19,12024050,8059900,-3964150,SELL
2020-12-22 14:20:00,14:20,12024050,7821825,-4202225,SELL
2020-12-22 14:21:00,14:21,12044950,8115500,-3929450,SELL
2020-12-22 14:22:00,14:22,12049900,8125350,-3924550,SELL
2020-12-22 14:23:00,14:23,12045400,7908400,-4137000,SELL
2020-12-22 14:24:00,14:24,12030625,7991875,-4038750,SELL
2020-12-22 14:25:00,14:25,12077650,8082400,-3995250,SELL
2020-12-22 14:26:00,14:26,12073750,8124400,-3949350,SELL
2020-12-22 14:27:00,14:27,12128825,8008825,-4120000,SELL
2020-12-22 14:28:00,14:28,12132725,8156550,-3976175,SELL
2020-12-22 14:29:00,14:29,12101050,7954075,-4146975,SELL
2020-12-22 14:30:00,14:30,12175050,8212000,-3963050,SELL
2020-12-22 14:31:00,14:31,12168325,8045200,-4123125,SELL
2020-12-22 14:32:00,14:32,12168325,8023400,-4144925,SELL
2020-12-22 14:33:00,14:33,12154400,8056175,-4098225,SELL
2020-12-22 14:34:00,14:34,12200250,8096850,-4103400,SELL
2020-12-22 14:35:00,14:35,12180050,8153825,-4026225,SELL
2020-12-22 14:36:00,14:36,12150675,8300025,-3850650,SELL
2020-12-22 14:37:00,14:37,12148850,8290325,-3858525,SELL
2020-12-22 14:38:00,14:38,12150725,8299825,-3850900,SELL
2020-12-22 14:39:00,14:39,12162725,8346550,-3816175,SELL
2020-12-22 14:40:00,14:40,12160000,8303525,-3856475,SELL
2020-12-22 14:41:00,14:41,12130475,8360550,-3769925,SELL
2020-12-22 14:42:00,14:42,12164500,8465025,-3699475,SELL
2020-12-22 14:43:00,14:43,12123650,8337925,-3785725,SELL
2020-12-22 14:44:00,14:44,12150175,8317450,-3832725,SELL
2020-12-22 14:45:00,14:45,12091550,8388975,-3702575,SELL
2020-12-22 14:46:00,14:46,12080175,8476650,-3603525,SELL
2020-12-22 14:47:00,14:47,12091275,8484675,-3606600,SELL
2020-12-22 14:48:00,14:48,12041400,8345950,-3695450,SELL
2020-12-22 14:49:00,14:49,12069325,8410825,-3658500,SELL
2020-12-22 14:50:00,14:50,12067450,8508725,-3558725,SELL
2020-12-22 14:51:00,14:51,11736875,8464200,-3272675,SELL
2020-12-22 14:52:00,14:52,11739525,8395625,-3343900,SELL
2020-12-22 14:53:00,14:53,11741525,8309075,-3432450,SELL
2020-12-22 14:54:00,14:54,11644500,8349900,-3294600,SELL
2020-12-22 14:55:00,14:55,11644750,8168650,-3476100,SELL
2020-12-22 14:56:00,14:56,11644750,8320325,-3324425,SELL
2020-12-22 14:57:00,14:57,11619750,8289375,-3330375,SELL
2020-12-22 14:58:00,14:58,11609850,8333200,-3276650,SELL
2020-12-22 14:59:00,14:59,11586825,8164975,-3421850,SELL
2020-12-22 15:00:00,15:00,11694725,8312000,-3382725,SELL
2020-12-22 15:01:00,15:01,11697775,8183825,-3513950,SELL
2020-12-22 15:02:00,15:02,11665925,7941350,-3724575,SELL
2020-12-22 15:03:00,15:03,11639500,8129625,-3509875,SELL
2020-12-22 15:04:00,15:04,11620550,8082325,-3538225,SELL
2020-12-22 15:05:00,15:05,11604025,8173375,-3430650,SELL
2020-12-22 15:06:00,15:06,11582775,8195350,-3387425,SELL
2020-12-22 15:07:00,15:07,11565400,8150975,-3414425,SELL
2020-12-22 15:08:00,15:08,11562350,8241225,-3321125,SELL
2020-12-22 15:09:00,15:09,11481950,8188675,-3293275,SELL
2020-12-22 15:10:00,15:10,11485925,8291275,-3194650,SELL
2020-12-22 15:11:00,15:11,11483100,8183725,-3299375,SELL
2020-12-22 15:12:00,15:12,11426725,8154975,-3271750,SELL
2020-12-22 15:13:00,15:13,11433150,7888725,-3544425,SELL
2020-12-22 15:14:00,15:14,11372200,8100750,-3271450,SELL
2020-12-22 15:15:00,15:15,11469075,8194050,-3275025,SELL
2020-12-22 15:16:00,15:16,11462575,8259150,-3203425,SELL
2020-12-22 15:17:00,15:17,11448100,8122900,-3325200,SELL
2020-12-22 15:18:00,15:18,11417200,8184925,-3232275,SELL
2020-12-22 15:19:00,15:19,11423275,8262525,-3160750,SELL
2020-12-22 15:20:00,15:20,11435275,8236175,-3199100,SELL
2020-12-22 15:21:00,15:21,11391825,8191975,-3199850,SELL
2020-12-22 15:22:00,15:22,11379025,8283075,-3095950,SELL
2020-12-22 15:23:00,15:23,11366025,8251750,-3114275,SELL
2020-12-22 15:24:00,15:24,11227775,8040975,-3186800,SELL
2020-12-22 15:25:00,15:25,11250950,8141050,-3109900,SELL
2020-12-22 15:26:00,15:26,11253700,8046200,-3207500,SELL
2020-12-22 15:27:00,15:27,11241000,8225250,-3015750,SELL
2020-12-22 15:28:00,15:28,11204575,8072325,-3132250,SELL
2020-12-22 15:29:00,15:29,11240925,8184100,-3056825,SELL
2020-12-23 09:15:00,09:15,9950700,7194250,-2756450,SELL
2020-12-23 09:16:00,09:16,9920175,7172400,-2747775,SELL
2020-12-23 09:17:00,09:17,10072100,7348225,-2723875,SELL
2020-12-23 09:18:00,09:18,10074175,7216400,-2857775,SELL
2020-12-23 09:19:00,09:19,10076300,7334100,-2742200,SELL
2020-12-23 09:20:00,09:20,10271400,7517675,-2753725,SELL
2020-12-23 09:21:00,09:21,10268875,7421850,-2847025,SELL
2020-12-23 09:22:00,09:22,10265350,7510650,-2754700,SELL
2020-12-23 09:23:00,09:23,10451350,7726400,-2724950,SELL
2020-12-23 09:24:00,09:24,10480200,7766475,-2713725,SELL
2020-12-23 09:25:00,09:25,10477675,7677675,-2800000,SELL
2020-12-23 09:26:00,09:26,10647300,7994375,-2652925,SELL
2020-12-23 09:27:00,09:27,10643500,8004525,-2638975,SELL
2020-12-23 09:28:00,09:28,10652250,7806950,-2845300,SELL
2020-12-23 09:29:00,09:29,10765775,8054500,-2711275,SELL
2020-12-23 09:30:00,09:30,10911550,8224300,-2687250,SELL
2020-12-23 09:31:00,09:31,10909250,8159650,-2749600,SELL
2020-12-23 09:32:00,09:32,11173625,8303400,-2870225,SELL
2020-12-23 09:33:00,09:33,11192475,8197675,-2994800,SELL
2020-12-23 09:34:00,09:34,11200100,8355400,-2844700,SELL
2020-12-23 09:35:00,09:35,11484475,8579650,-2904825,SELL
2020-12-23 09:36:00,09:36,11282750,8509300,-2773450,SELL
2020-12-23 09:37:00,09:37,11415775,8516225,-2899550,SELL
2020-12-23 09:38:00,09:38,11586475,8592125,-2994350,SELL
2020-12-23 09:39:00,09:39,11587275,8736125,-2851150,SELL
2020-12-23 09:40:00,09:40,11587275,8680200,-2907075,SELL
2020-12-23 09:41:00,09:41,11592875,8643550,-2949325,SELL
2020-12-23 09:42:00,09:42,11577450,8577675,-2999775,SELL
2020-12-23 09:43:00,09:43,11579450,8544650,-3034800,SELL
2020-12-23 09:44:00,09:44,11812275,8687175,-3125100,SELL
2020-12-23 09:45:00,09:45,11703025,8685825,-3017200,SELL
2020-12-23 09:46:00,09:46,11803825,8681625,-3122200,SELL
2020-12-23 09:47:00,09:47,12025475,9057325,-2968150,SELL
2020-12-23 09:48:00,09:48,12019325,9029525,-2989800,SELL
2020-12-23 09:49:00,09:49,12001075,8931050,-3070025,SELL
2020-12-23 09:50:00,09:50,11849900,9148850,-2701050,SELL
2020-12-23 09:51:00,09:51,12114275,9070550,-3043725,SELL
2020-12-23 09:52:00,09:52,12096250,9129350,-2966900,SELL
2020-12-23 09:53:00,09:53,12243450,9620475,-2622975,SELL
2020-12-23 09:54:00,09:54,12155500,9534975,-2620525,SELL
2020-12-23 09:55:00,09:55,12241525,9538300,-2703225,SELL
2020-12-23 09:56:00,09:56,12164925,9571025,-2593900,SELL
2020-12-23 09:57:00,09:57,12122225,9609750,-2512475,SELL
2020-12-23 09:58:00,09:58,12056600,9614275,-2442325,SELL
2020-12-23 09:59:00,09:59,12024475,9557200,-2467275,SELL
2020-12-23 10:00:00,10:00,12014500,9716300,-2298200,SELL
2020-12-23 10:01:00,10:01,12019200,9819075,-2200125,SELL
2020-12-23 10:02:00,10:02,12255150,9762125,-2493025,SELL
2020-12-23 10:03:00,10:03,12245200,9621700,-2623500,SELL
2020-12-23 10:04:00,10:04,12204400,9761300,-2443100,SELL
2020-12-23 10:05:00,10:05,12356350,9726850,-2629500,SELL
2020-12-23 10:06:00,10:06,12337750,9909225,-2428525,SELL
2020-12-23 10:07:00,10:07,12335750,9697925,-2637825,SELL
2020-12-23 10:08:00,10:08,12421375,10051700,-2369675,SELL
2020-12-23 10:09:00,10:09,12389450,9890350,-2499100,SELL
2020-12-23 10:10:00,10:10,12370550,10012750,-2357800,SELL
2020-12-23 10:11:00,10:11,12491350,9855925,-2635425,SELL
2020-12-23 10:12:00,10:12,12252225,9930100,-2322125,SELL
2020-12-23 10:13:00,10:13,12500125,10154050,-2346075,SELL
2020-12-23 10:14:00,10:14,12490025,10162600,-2327425,SELL
2020-12-23 10:15:00,10:15,12502050,10037750,-2464300,SELL
2020-12-23 10:16:00,10:16,12521050,10036650,-2484400,SELL
2020-12-23 10:17:00,10:17,12469225,10035950,-2433275,SELL
2020-12-23 10:18:00,10:18,12458525,10030975,-2427550,SELL
2020-12-23 10:19:00,10:19,12582700,9843075,-2739625,SELL
2020-12-23 10:20:00,10:20,12534075,10030200,-2503875,SELL
2020-12-23 10:21:00,10:21,12598500,9948625,-2649875,SELL
2020-12-23 10:22:00,10:22,12315450,10074525,-2240925,SELL
2020-12-23 10:23:00,10:23,12602300,10164425,-2437875,SELL
2020-12-23 10:24:00,10:24,12745850,10323700,-2422150,SELL
2020-12-23 10:25:00,10:25,12723075,10217175,-2505900,SELL
2020-12-23 10:26:00,10:26,12758075,10291025,-2467050,SELL
2020-12-23 10:27:00,10:27,12780775,10438400,-2342375,SELL
2020-12-23 10:28:00,10:28,12675325,10292400,-2382925,SELL
2020-12-23 10:29:00,10:29,12735425,10560700,-2174725,SELL
2020-12-23 10:30:00,10:30,12733825,10553650,-2180175,SELL
2020-12-23 10:31:00,10:31,12646600,10425775,-2220825,SELL
2020-12-23 10:32:00,10:32,12482375,10586075,-1896300,SELL
2020-12-23 10:33:00,10:33,12480600,10612300,-1868300,SELL
2020-12-23 10:34:00,10:34,12466250,10512925,-1953325,SELL
2020-12-23 10:35:00,10:35,12232800,10646950,-1585850,SELL
2020-12-23 10:36:00,10:36,12247000,10408875,-1838125,SELL
2020-12-23 10:37:00,10:37,12295450,10556275,-1739175,SELL
2020-12-23 10:38:00,10:38,12250975,10527525,-1723450,SELL
2020-12-23 10:39:00,10:39,12263175,10759325,-1503850,SELL
2020-12-23 10:40:00,10:40,12253175,10706600,-1546575,SELL
2020-12-23 10:41:00,10:41,11604400,10753225,-851175,SELL
2020-12-23 10:42:00,10:42,11592200,10656900,-935300,SELL
2020-12-23 10:43:00,10:43,11419400,10756425,-662975,SELL
2020-12-23 10:44:00,10:44,11846175,10832375,-1013800,SELL
2020-12-23 10:45:00,10:45,11892925,10948275,-944650,SELL
2020-12-23 10:46:00,10:46,11881100,10825750,-1055350,SELL
2020-12-23 10:47:00,10:47,12053325,11064700,-988625,SELL
2020-12-23 10:48:00,10:48,11970450,10971250,-999200,SELL
2020-12-23 10:49:00,10:49,12026075,11060300,-965775,SELL
2020-12-23 10:50:00,10:50,12023250,10986800,-1036450,SELL
2020-12-23 10:51:00,10:51,11982400,10980475,-1001925,SELL
2020-12-23 10:52:00,10:52,11998550,10980475,-1018075,SELL
2020-12-23 10:53:00,10:53,11929500,10927325,-1002175,SELL
2020-12-23 10:54:00,10:54,11977075,10802225,-1174850,SELL
2020-12-23 10:55:00,10:55,11946200,11059750,-886450,SELL
2020-12-23 10:56:00,10:56,11939500,11033475,-906025,SELL
2020-12-23 10:57:00,10:57,11945975,11028675,-917300,SELL
2020-12-23 10:58:00,10:58,11973475,10840425,-1133050,SELL
2020-12-23 10:59:00,10:59,11993925,11005875,-988050,SELL
2020-12-23 11:00:00,11:00,11997975,11095975,-902000,SELL
2020-12-23 11:01:00,11:01,11789325,10832225,-957100,SELL
2020-12-23 11:02:00,11:02,11989800,10927800,-1062000,SELL
2020-12-23 11:03:00,11:03,12024100,11030625,-993475,SELL
2020-12-23 11:04:00,11:04,11993375,10989875,-1003500,SELL
2020-12-23 11:05:00,11:05,11880925,11113850,-767075,SELL
2020-12-23 11:06:00,11:06,12076275,11140750,-935525,SELL
2020-12-23 11:07:00,11:07,11944425,11166200,-778225,SELL
2020-12-23 11:08:00,11:08,11922750,10940625,-982125,SELL
2020-12-23 11:09:00,11:09,12016350,11069650,-946700,SELL
2020-12-23 11:10:00,11:10,12073950,11159550,-914400,SELL
2020-12-23 11:11:00,11:11,11924025,11063425,-860600,SELL
2020-12-23 11:12:00,11:12,12039475,11153075,-886400,SELL
2020-12-23 11:13:00,11:13,12076400,10927325,-1149075,SELL
2020-12-23 11:14:00,11:14,11703075,11041025,-662050,SELL
2020-12-23 11:15:00,11:15,12093225,11135500,-957725,SELL
2020-12-23 11:16:00,11:16,12031525,10917350,-1114175,SELL
2020-12-23 11:17:00,11:17,11930875,11117875,-813000,SELL
2020-12-23 11:18:00,11:18,11766100,10961850,-804250,SELL
2020-12-23 11:19:00,11:19,12023950,10952750,-1071200,SELL
2020-12-23 11:20:00,11:20,11977725,11108600,-869125,SELL
2020-12-23 11:21:00,11:21,12105575,11032850,-1072725,SELL
2020-12-23 11:22:00,11:22,12068200,11075300,-992900,SELL
2020-12-23 11:23:00,11:23,12041400,11000725,-1040675,SELL
2020-12-23 11:24:00,11:24,12084725,11121500,-963225,SELL
2020-12-23 11:25:00,11:25,12074850,10934050,-1140800,SELL
2020-12-23 11:26:00,11:26,12114250,11056125,-1058125,SELL
2020-12-23 11:27:00,11:27,12045300,11109850,-935450,SELL
2020-12-23 11:28:00,11:28,12116325,11141425,-974900,SELL
2020-12-23 11:29:00,11:29,12019900,11284275,-735625,SELL
2020-12-23 11:30:00,11:30,12134400,11161200,-973200,SELL
2020-12-23 11:31:00,11:31,11807600,11226400,-581200,SELL
2020-12-23 11:32:00,11:32,12141575,11257200,-884375,SELL
2020-12-23 11:33:00,11:33,12139525,11101625,-1037900,SELL
2020-12-23 11:34:00,11:34,12097500,11011900,-1085600,SELL
2020-12-23 11:35:00,11:35,12173825,11143375,-1030450,SELL
2020-12-23 11:36:00,11:36,11969475,11244725,-724750,SELL
2020-12-23 11:37:00,11:37,12136775,10928775,-1208000,SELL
2020-12-23 11:38:00,11:38,12213900,11045575,-1168325,SELL
2020-12-23 11:39:00,11:39,12209800,11165900,-1043900,SELL
2020-12-23 11:40:00,11:40,12140275,10726900,-1413375,SELL
2020-12-23 11:41:00,11:41,12144250,10950100,-1194150,SELL
2020-12-23 11:42:00,11:42,12113400,10757100,-1356300,SELL
2020-12-23 11:43:00,11:43,12015350,10951625,-1063725,SELL
2020-12-23 11:44:00,11:44,12124975,10839850,-1285125,SELL
2020-12-23 11:45:00,11:45,11875350,10977800,-897550,SELL
2020-12-23 11:46:00,11:46,11820350,10842675,-977675,SELL
2020-12-23 11:47:00,11:47,12057975,11032650,-1025325,SELL
2020-12-23 11:48:00,11:48,11815900,10666150,-1149750,SELL
2020-12-23 11:49:00,11:49,12119275,11051875,-1067400,SELL
2020-12-23 11:50:00,11:50,12027300,10712825,-1314475,SELL
2020-12-23 11:51:00,11:51,12148250,11228975,-919275,SELL
2020-12-23 11:52:00,11:52,12137975,11143975,-994000,SELL
2020-12-23 11:53:00,11:53,12056750,11240950,-815800,SELL
2020-12-23 11:54:00,11:54,12135575,11117350,-1018225,SELL
2020-12-23 11:55:00,11:55,12080950,11241025,-839925,SELL
2020-12-23 11:56:00,11:56,11950375,11108900,-841475,SELL
2020-12-23 11:57:00,11:57,12130700,11125825,-1004875,SELL
2020-12-23 11:58:00,11:58,11894375,10920525,-973850,SELL
2020-12-23 11:59:00,11:59,12026950,10675025,-1351925,SELL
2020-12-23 12:00:00,12:00,12059275,10919100,-1140175,SELL
2020-12-23 12:01:00,12:01,12159100,10983425,-1175675,SELL
2020-12-23 12:02:00,12:02,12003050,11124625,-878425,SELL
2020-12-23 12:03:00,12:03,12201775,10969775,-1232000,SELL
2020-12-23 12:04:00,12:04,12156200,11146725,-1009475,SELL
2020-12-23 12:05:00,12:05,12161000,11103000,-1058000,SELL
2020-12-23 12:06:00,12:06,12313300,11019925,-1293375,SELL
2020-12-23 12:07:00,12:07,12287275,11054275,-1233000,SELL
2020-12-23 12:08:00,12:08,12341225,10926350,-1414875,SELL
2020-12-23 12:09:00,12:09,12187325,10879650,-1307675,SELL
2020-12-23 12:10:00,12:10,11891425,10644825,-1246600,SELL
2020-12-23 12:11:00,12:11,12367200,10836775,-1530425,SELL
2020-12-23 12:12:00,12:12,12230325,10792225,-1438100,SELL
2020-12-23 12:13:00,12:13,12315675,10746325,-1569350,SELL
2020-12-23 12:14:00,12:14,12299025,10754825,-1544200,SELL
2020-12-23 12:15:00,12:15,12393375,11096875,-1296500,SELL
2020-12-23 12:16:00,12:16,12301925,10961325,-1340600,SELL
2020-12-23 12:17:00,12:17,12391825,10679100,-1712725,SELL
2020-12-23 12:18:00,12:18,12376225,11075275,-1300950,SELL
2020-12-23 12:19:00,12:19,12396225,11137550,-1258675,SELL
2020-12-23 12:20:00,12:20,12402675,11102350,-1300325,SELL
2020-12-23 12:21:00,12:21,12221850,10816275,-1405575,SELL
2020-12-23 12:22:00,12:22,12312625,10965475,-1347150,SELL
2020-12-23 12:23:00,12:23,12301575,10977425,-1324150,SELL
2020-12-23 12:24:00,12:24,12353175,10980400,-1372775,SELL
2020-12-23 12:25:00,12:25,12436500,10910425,-1526075,SELL
2020-12-23 12:26:00,12:26,12227225,10698050,-1529175,SELL
2020-12-23 12:27:00,12:27,12289825,11045825,-1244000,SELL
2020-12-23 12:28:00,12:28,12450500,11194300,-1256200,SELL
2020-12-23 12:29:00,12:29,12407450,11001175,-1406275,SELL
2020-12-23 12:30:00,12:30,12506925,10930375,-1576550,SELL
2020-12-23 12:31:00,12:31,12523725,11119050,-1404675,SELL
2020-12-23 12:32:00,12:32,12420525,11080900,-1339625,SELL
2020-12-23 12:33:00,12:33,12572375,11287400,-1284975,SELL
2020-12-23 12:34:00,12:34,12376700,11136675,-1240025,SELL
2020-12-23 12:35:00,12:35,12574775,11319500,-1255275,SELL
2020-12-23 12:36:00,12:36,12677075,11429675,-1247400,SELL
2020-12-23 12:37:00,12:37,12657850,11255375,-1402475,SELL
2020-12-23 12:38:00,12:38,12418275,11229075,-1189200,SELL
2020-12-23 12:39:00,12:39,12401900,11300850,-1101050,SELL
2020-12-23 12:40:00,12:40,12555825,11280900,-1274925,SELL
2020-12-23 12:41:00,12:41,12600500,11219325,-1381175,SELL
2020-12-23 12:42:00,12:42,12670900,11400550,-1270350,SELL
2020-12-23 12:43:00,12:43,12670900,11461000,-1209900,SELL
2020-12-23 12:44:00,12:44,12651650,11415075,-1236575,SELL
2020-12-23 12:45:00,12:45,12707725,11369150,-1338575,SELL
2020-12-23 12:46:00,12:46,12758525,11290075,-1468450,SELL
2020-12-23 12:47:00,12:47,12719075,11454925,-1264150,SELL
2020-12-23 12:48:00,12:48,12712700,11558900,-1153800,SELL
2020-12-23 12:49:00,12:49,12741725,11707025,-1034700,SELL
2020-12-23 12:50:00,12:50,12729750,11585075,-1144675,SELL
2020-12-23 12:51:00,12:51,12624925,11482025,-1142900,SELL
2020-12-23 12:52:00,12:52,12631825,11533725,-1098100,SELL
2020-12-23 12:53:00,12:53,12624925,11554550,-1070375,SELL
2020-12-23 12:54:00,12:54,12547825,11536450,-1011375,SELL
2020-12-23 12:55:00,12:55,12541200,11718200,-823000,SELL
2020-12-23 12:56:00,12:56,12295375,11528600,-766775,SELL
2020-12-23 12:57:00,12:57,12007800,11505450,-502350,SELL
2020-12-23 12:58:00,12:58,11770525,11505450,-265075,SELL
2020-12-23 12:59:00,12:59,12274900,11723175,-551725,SELL
2020-12-23 13:00:00,13:00,12041600,11860125,-181475,SELL
2020-12-23 13:01:00,13:01,12284700,11780400,-504300,SELL
2020-12-23 13:02:00,13:02,12144325,11903775,-240550,SELL
2020-12-23 13:03:00,13:03,12237775,11865850,-371925,SELL
2020-12-23 13:04:00,13:04,11991000,11786675,-204325,SELL
2020-12-23 13:05:00,13:05,12253225,11877300,-375925,SELL
2020-12-23 13:06:00,13:06,12099350,11903425,-195925,SELL
2020-12-23 13:07:00,13:07,12169100,11776725,-392375,SELL
2020-12-23 13:08:00,13:08,12349150,11955425,-393725,SELL
2020-12-23 13:09:00,13:09,12391475,12018400,-373075,SELL
2020-12-23 13:10:00,13:10,12426700,11953200,-473500,SELL
2020-12-23 13:11:00,13:11,12424700,11918975,-505725,SELL
2020-12-23 13:12:00,13:12,12365950,11647625,-718325,SELL
2020-12-23 13:13:00,13:13,12341825,11622575,-719250,SELL
2020-12-23 13:14:00,13:14,12345225,11659000,-686225,SELL
2020-12-23 13:15:00,13:15,12225500,11797625,-427875,SELL
2020-12-23 13:16:00,13:16,12235325,11711450,-523875,SELL
2020-12-23 13:17:00,13:17,12225500,11622725,-602775,SELL
2020-12-23 13:18:00,13:18,12133050,11875275,-257775,SELL
2020-12-23 13:19:00,13:19,12187400,11693800,-493600,SELL
2020-12-23 13:20:00,13:20,12232900,11591075,-641825,SELL
2020-12-23 13:21:00,13:21,12256350,11538175,-718175,SELL
2020-12-23 13:22:00,13:22,12204825,11857225,-347600,SELL
2020-12-23 13:23:00,13:23,12042100,11770025,-272075,SELL
2020-12-23 13:24:00,13:24,12115000,11851225,-263775,SELL
2020-12-23 13:25:00,13:25,12252700,11819925,-432775,SELL
2020-12-23 13:26:00,13:26,12252700,11765250,-487450,SELL
2020-12-23 13:27:00,13:27,12101675,11788275,-313400,SELL
2020-12-23 13:28:00,13:28,12210550,11872725,-337825,SELL
2020-12-23 13:29:00,13:29,12198250,11812250,-386000,SELL
2020-12-23 13:30:00,13:30,12230675,11950100,-280575,SELL
2020-12-23 13:31:00,13:31,11951050,11951400,350,BUY
2020-12-23 13:32:00,13:32,12169900,12008250,-161650,SELL
2020-12-23 13:33:00,13:33,12034825,11899450,-135375,SELL
2020-12-23 13:34:00,13:34,11964250,11841025,-123225,SELL
2020-12-23 13:35:00,13:35,12137750,12074025,-63725,SELL
2020-12-23 13:36:00,13:36,12142900,12090375,-52525,SELL
2020-12-23 13:37:00,13:37,12130125,11951025,-179100,SELL
2020-12-23 13:38:00,13:38,12184425,11786425,-398000,SELL
2020-12-23 13:39:00,13:39,12178225,11945775,-232450,SELL
2020-12-23 13:40:00,13:40,12233575,12150100,-83475,SELL
2020-12-23 13:41:00,13:41,12058100,12019000,-39100,SELL
2020-12-23 13:42:00,13:42,12145100,11736800,-408300,SELL
2020-12-23 13:43:00,13:43,11998750,11990150,-8600,SELL
2020-12-23 13:44:00,13:44,11911125,11861175,-49950,SELL
2020-12-23 13:45:00,13:45,12117150,11793550,-323600,SELL
2020-12-23 13:46:00,13:46,12172275,12160075,-12200,SELL
2020-12-23 13:47:00,13:47,11825275,12104925,279650,BUY
2020-12-23 13:48:00,13:48,11908475,12016325,107850,BUY
2020-12-23 13:49:00,13:49,12034125,12013175,-20950,SELL
2020-12-23 13:50:00,13:50,12024375,11956975,-67400,SELL
2020-12-23 13:51:00,13:51,12092150,11954050,-138100,SELL
2020-12-23 13:52:00,13:52,12075625,11739650,-335975,SELL
2020-12-23 13:53:00,13:53,12049175,11828325,-220850,SELL
2020-12-23 13:54:00,13:54,12063900,11781275,-282625,SELL
2020-12-23 13:55:00,13:55,12057400,11868300,-189100,SELL
2020-12-23 13:56:00,13:56,11996850,11844675,-152175,SELL
2020-12-23 13:57:00,13:57,11823825,11839825,16000,BUY
2020-12-23 13:58:00,13:58,12037950,11781625,-256325,SELL
2020-12-23 13:59:00,13:59,12112025,11935475,-176550,SELL
2020-12-23 14:00:00,14:00,11933975,11902150,-31825,SELL
2020-12-23 14:01:00,14:01,12010775,11769250,-241525,SELL
2020-12-23 14:02:00,14:02,12089075,11895225,-193850,SELL
2020-12-23 14:03:00,14:03,12115850,11869975,-245875,SELL
2020-12-23 14:04:00,14:04,12115850,11778875,-336975,SELL
2020-12-23 14:05:00,14:05,12092800,12050950,-41850,SELL
2020-12-23 14:06:00,14:06,12067550,11858650,-208900,SELL
2020-12-23 14:07:00,14:07,12107800,11582375,-525425,SELL
2020-12-23 14:08:00,14:08,12116550,11948175,-168375,SELL
2020-12-23 14:09:00,14:09,12103400,11888100,-215300,SELL
2020-12-23 14:10:00,14:10,12163800,11764925,-398875,SELL
2020-12-23 14:11:00,14:11,12135475,11861175,-274300,SELL
2020-12-23 14:12:00,14:12,12155750,11803475,-352275,SELL
2020-12-23 14:13:00,14:13,12146900,11741100,-405800,SELL
2020-12-23 14:14:00,14:14,12178550,11852325,-326225,SELL
2020-12-23 14:15:00,14:15,12096775,12019025,-77750,SELL
2020-12-23 14:16:00,14:16,12125675,11850450,-275225,SELL
2020-12-23 14:17:00,14:17,11967925,11714550,-253375,SELL
2020-12-23 14:18:00,14:18,12176150,11856050,-320100,SELL
2020-12-23 14:19:00,14:19,12163050,11829450,-333600,SELL
2020-12-23 14:20:00,14:20,12029950,11676350,-353600,SELL
2020-12-23 14:21:00,14:21,12078525,11984725,-93800,SELL
2020-12-23 14:22:00,14:22,12143200,11794325,-348875,SELL
2020-12-23 14:23:00,14:23,12159375,11991500,-167875,SELL
2020-12-23 14:24:00,14:24,12091375,11703900,-387475,SELL
2020-12-23 14:25:00,14:25,11949000,11775325,-173675,SELL
2020-12-23 14:26:00,14:26,11995300,11844100,-151200,SELL
2020-12-23 14:27:00,14:27,11950775,11755975,-194800,SELL
2020-12-23 14:28:00,14:28,12081800,11529175,-552625,SELL
2020-12-23 14:29:00,14:29,12081700,11871750,-209950,SELL
2020-12-23 14:30:00,14:30,12085850,11554200,-531650,SELL
2020-12-23 14:31:00,14:31,11956600,11366300,-590300,SELL
2020-12-23 14:32:00,14:32,12062350,11510675,-551675,SELL
2020-12-23 14:33:00,14:33,11954500,11508900,-445600,SELL
2020-12-23 14:34:00,14:34,12091525,11642125,-449400,SELL
2020-12-23 14:35:00,14:35,12082125,11545975,-536150,SELL
2020-12-23 14:36:00,14:36,11938850,11555825,-383025,SELL
2020-12-23 14:37:00,14:37,12090825,11537900,-552925,SELL
2020-12-23 14:38:00,14:38,12104025,11643575,-460450,SELL
2020-12-23 14:39:00,14:39,11970775,11494375,-476400,SELL
2020-12-23 14:40:00,14:40,11965075,11445800,-519275,SELL
2020-12-23 14:41:00,14:41,11844575,11582525,-262050,SELL
2020-12-23 14:42:00,14:42,11852450,11453700,-398750,SELL
2020-12-23 14:43:00,14:43,11915075,11461700,-453375,SELL
2020-12-23 14:44:00,14:44,11739225,11395700,-343525,SELL
2020-12-23 14:45:00,14:45,11852525,11277625,-574900,SELL
2020-12-23 14:46:00,14:46,11652875,11370450,-282425,SELL
2020-12-23 14:47:00,14:47,11725725,11344500,-381225,SELL
2020-12-23 14:48:00,14:48,11764000,11216800,-547200,SELL
2020-12-23 14:49:00,14:49,11747050,10899875,-847175,SELL
2020-12-23 14:50:00,14:50,11794600,11195925,-598675,SELL
2020-12-23 14:51:00,14:51,11718450,10911425,-807025,SELL
2020-12-23 14:52:00,14:52,11707800,10937925,-769875,SELL
2020-12-23 14:53:00,14:53,11670500,11055525,-614975,SELL
2020-12-23 14:54:00,14:54,11653550,10767525,-886025,SELL
2020-12-23 14:55:00,14:55,11653550,10914350,-739200,SELL
2020-12-23 14:56:00,14:56,11663050,10947300,-715750,SELL
2020-12-23 14:57:00,14:57,11626900,10808075,-818825,SELL
2020-12-23 14:58:00,14:58,11617625,10835200,-782425,SELL
2020-12-23 14:59:00,14:59,11589125,10756275,-832850,SELL
2020-12-23 15:00:00,15:00,11483525,10838800,-644725,SELL
2020-12-23 15:01:00,15:01,11472075,10839525,-632550,SELL
2020-12-23 15:02:00,15:02,11497000,10845600,-651400,SELL
2020-12-23 15:03:00,15:03,11366575,10751650,-614925,SELL
2020-12-23 15:04:00,15:04,11353625,10819225,-534400,SELL
2020-12-23 15:05:00,15:05,11409375,10780725,-628650,SELL
2020-12-23 15:06:00,15:06,11212450,10537900,-674550,SELL
2020-12-23 15:07:00,15:07,11241125,10498800,-742325,SELL
2020-12-23 15:08:00,15:08,11269175,10586600,-682575,SELL
2020-12-23 15:09:00,15:09,11003200,10371000,-632200,SELL
2020-12-23 15:10:00,15:10,11022300,10379200,-643100,SELL
2020-12-23 15:11:00,15:11,11014350,10402800,-611550,SELL
2020-12-23 15:12:00,15:12,10943075,10318700,-624375,SELL
2020-12-23 15:13:00,15:13,10933075,10219750,-713325,SELL
2020-12-23 15:14:00,15:14,10948075,10400800,-547275,SELL
2020-12-23 15:15:00,15:15,10807175,10268700,-538475,SELL
2020-12-23 15:16:00,15:16,10780475,10152050,-628425,SELL
2020-12-23 15:17:00,15:17,10760350,10314425,-445925,SELL
2020-12-23 15:18:00,15:18,10632825,10272300,-360525,SELL
2020-12-23 15:19:00,15:19,10623825,10171975,-451850,SELL
2020-12-23 15:20:00,15:20,10633775,10278925,-354850,SELL
2020-12-23 15:21:00,15:21,10211125,10013700,-197425,SELL
2020-12-23 15:22:00,15:22,10202175,9922000,-280175,SELL
2020-12-23 15:23:00,15:23,10210225,9949400,-260825,SELL
2020-12-23 15:24:00,15:24,9893025,9645750,-247275,SELL
2020-12-23 15:25:00,15:25,9911300,9811200,-100100,SELL
2020-12-23 15:26:00,15:26,9920400,9769325,-151075,SELL
2020-12-23 15:27:00,15:27,9564350,9554075,-10275,SELL
2020-12-23 15:28:00,15:28,9553525,9464750,-88775,SELL
2020-12-23 15:29:00,15:29,9559125,9513600,-45525,SELL
2020-12-24 09:15:00,09:15,9277700,8730050,-547650,SELL
2020-12-24 09:16:00,09:16,9278825,9306900,28075,BUY
2020-12-24 09:17:00,09:17,9380525,9485500,104975,BUY
2020-12-24 09:18:00,09:18,9386225,9460050,73825,BUY
2020-12-24 09:19:00,09:19,9365550,9478850,113300,BUY
2020-12-24 09:20:00,09:20,9580525,9908575,328050,BUY
2020-12-24 09:21:00,09:21,9589800,9916525,326725,BUY
2020-12-24 09:22:00,09:22,9570900,9915250,344350,BUY
2020-12-24 09:23:00,09:23,10084100,10691675,607575,BUY
2020-12-24 09:24:00,09:24,10101125,10697850,596725,BUY
2020-12-24 09:25:00,09:25,10044950,10703950,659000,BUY
2020-12-24 09:26:00,09:26,10189950,11786825,1596875,BUY
2020-12-24 09:27:00,09:27,10180325,11817000,1636675,BUY
2020-12-24 09:28:00,09:28,10215225,11816500,1601275,BUY
2020-12-24 09:29:00,09:29,10414425,12598700,2184275,BUY
2020-12-24 09:30:00,09:30,10422275,12610300,2188025,BUY
2020-12-24 09:31:00,09:31,10414725,12591400,2176675,BUY
2020-12-24 09:32:00,09:32,11109550,13632875,2523325,BUY
2020-12-24 09:33:00,09:33,11085675,13628875,2543200,BUY
2020-12-24 09:34:00,09:34,11056000,13628875,2572875,BUY
2020-12-24 09:35:00,09:35,11619800,14478175,2858375,BUY
2020-12-24 09:36:00,09:36,11593075,14441525,2848450,BUY
2020-12-24 09:37:00,09:37,11585450,14441525,2856075,BUY
2020-12-24 09:38:00,09:38,12482650,15125750,2643100,BUY
2020-12-24 09:39:00,09:39,12482325,15130350,2648025,BUY
2020-12-24 09:40:00,09:40,12484725,15156650,2671925,BUY
2020-12-24 09:41:00,09:41,12767050,15911675,3144625,BUY
2020-12-24 09:42:00,09:42,12775625,15957800,3182175,BUY
2020-12-24 09:43:00,09:43,12832875,15970750,3137875,BUY
2020-12-24 09:44:00,09:44,13018925,16393800,3374875,BUY
2020-12-24 09:45:00,09:45,13065400,16362625,3297225,BUY
2020-12-24 09:46:00,09:46,13051700,16361550,3309850,BUY
2020-12-24 09:47:00,09:47,13330825,16916725,3585900,BUY
2020-12-24 09:48:00,09:48,13298775,16921950,3623175,BUY
2020-12-24 09:49:00,09:49,13341225,16899575,3558350,BUY
2020-12-24 09:50:00,09:50,13406150,17030125,3623975,BUY
2020-12-24 09:51:00,09:51,13456700,17074600,3617900,BUY
2020-12-24 09:52:00,09:52,13470350,17080900,3610550,BUY
2020-12-24 09:53:00,09:53,12777325,17077825,4300500,BUY
2020-12-24 09:54:00,09:54,12777375,17117375,4340000,BUY
2020-12-24 09:55:00,09:55,12817375,17017750,4200375,BUY
2020-12-24 09:56:00,09:56,12716475,17153975,4437500,BUY
2020-12-24 09:57:00,09:57,12718750,17154175,4435425,BUY
2020-12-24 09:58:00,09:58,12649550,17171425,4521875,BUY
2020-12-24 09:59:00,09:59,12975275,17369200,4393925,BUY
2020-12-24 10:00:00,10:00,12874025,17362450,4488425,BUY
2020-12-24 10:01:00,10:01,12963625,17366450,4402825,BUY
2020-12-24 10:02:00,10:02,12979625,17475575,4495950,BUY
2020-12-24 10:03:00,10:03,12935350,17475575,4540225,BUY
2020-12-24 10:04:00,10:04,13062950,17427575,4364625,BUY
2020-12-24 10:05:00,10:05,12952975,17723875,4770900,BUY
2020-12-24 10:06:00,10:06,12953075,17711050,4757975,BUY
2020-12-24 10:07:00,10:07,12910200,17709525,4799325,BUY
2020-12-24 10:08:00,10:08,12837875,17768050,4930175,BUY
2020-12-24 10:09:00,10:09,12664350,17828550,5164200,BUY
2020-12-24 10:10:00,10:10,13070675,17862150,4791475,BUY
2020-12-24 10:11:00,10:11,12956450,18110825,5154375,BUY
2020-12-24 10:12:00,10:12,12914025,18097650,5183625,BUY
2020-12-24 10:13:00,10:13,12998800,18105350,5106550,BUY
2020-12-24 10:14:00,10:14,12163550,18359125,6195575,BUY
2020-12-24 10:15:00,10:15,12178100,18363075,6184975,BUY
2020-12-24 10:16:00,10:16,12169200,18366825,6197625,BUY
2020-12-24 10:17:00,10:17,12157275,18499625,6342350,BUY
2020-12-24 10:18:00,10:18,12165050,18530100,6365050,BUY
2020-12-24 10:19:00,10:19,12165050,18585150,6420100,BUY
2020-12-24 10:20:00,10:20,12202975,18783975,6581000,BUY
2020-12-24 10:21:00,10:21,12202750,18777175,6574425,BUY
2020-12-24 10:22:00,10:22,12235250,18718775,6483525,BUY
2020-12-24 10:23:00,10:23,12232400,18817550,6585150,BUY
2020-12-24 10:24:00,10:24,12259875,18845725,6585850,BUY
2020-12-24 10:25:00,10:25,12296100,18774625,6478525,BUY
2020-12-24 10:26:00,10:26,12511975,18901100,6389125,BUY
2020-12-24 10:27:00,10:27,12474800,18899025,6424225,BUY
2020-12-24 10:28:00,10:28,12406300,18894100,6487800,BUY
2020-12-24 10:29:00,10:29,12634600,18927225,6292625,BUY
2020-12-24 10:30:00,10:30,12656650,18980100,6323450,BUY
2020-12-24 10:31:00,10:31,12639675,18980100,6340425,BUY
2020-12-24 10:32:00,10:32,12830400,18972850,6142450,BUY
2020-12-24 10:33:00,10:33,12798000,19037650,6239650,BUY
2020-12-24 10:34:00,10:34,12766075,19038925,6272850,BUY
2020-12-24 10:35:00,10:35,13087425,19105375,6017950,BUY
2020-12-24 10:36:00,10:36,12892325,19065700,6173375,BUY
2020-12-24 10:37:00,10:37,13056600,19083775,6027175,BUY
2020-12-24 10:38:00,10:38,12779900,19115450,6335550,BUY
2020-12-24 10:39:00,10:39,12957200,19073550,6116350,BUY
2020-12-24 10:40:00,10:40,13087075,19113200,6026125,BUY
2020-12-24 10:41:00,10:41,13114150,19223350,6109200,BUY
2020-12-24 10:42:00,10:42,13205550,19226200,6020650,BUY
2020-12-24 10:43:00,10:43,12976675,19261550,6284875,BUY
2020-12-24 10:44:00,10:44,13200850,19354975,6154125,BUY
2020-12-24 10:45:00,10:45,13255825,19280325,6024500,BUY
2020-12-24 10:46:00,10:46,13132375,19251575,6119200,BUY
2020-12-24 10:47:00,10:47,13370050,19378200,6008150,BUY
2020-12-24 10:48:00,10:48,13369975,19444525,6074550,BUY
2020-12-24 10:49:00,10:49,13370250,19319775,5949525,BUY
2020-12-24 10:50:00,10:50,13574375,19422625,5848250,BUY
2020-12-24 10:51:00,10:51,13527800,19536100,6008300,BUY
2020-12-24 10:52:00,10:52,13542725,19530350,5987625,BUY
2020-12-24 10:53:00,10:53,13520800,19596850,6076050,BUY
2020-12-24 10:54:00,10:54,13520550,19510575,5990025,BUY
2020-12-24 10:55:00,10:55,13601175,19602825,6001650,BUY
2020-12-24 10:56:00,10:56,13742300,19446175,5703875,BUY
2020-12-24 10:57:00,10:57,13547950,19675625,6127675,BUY
2020-12-24 10:58:00,10:58,13628175,19668850,6040675,BUY
2020-12-24 10:59:00,10:59,13641125,19776625,6135500,BUY
2020-12-24 11:00:00,11:00,13751750,19765100,6013350,BUY
2020-12-24 11:01:00,11:01,13717700,19743400,6025700,BUY
2020-12-24 11:02:00,11:02,13705625,19785525,6079900,BUY
2020-12-24 11:03:00,11:03,13798500,19796475,5997975,BUY
2020-12-24 11:04:00,11:04,13812375,19790750,5978375,BUY
2020-12-24 11:05:00,11:05,13994975,19755275,5760300,BUY
2020-12-24 11:06:00,11:06,13828075,19644400,5816325,BUY
2020-12-24 11:07:00,11:07,13955750,19632275,5676525,BUY
2020-12-24 11:08:00,11:08,13904675,19913075,6008400,BUY
2020-12-24 11:09:00,11:09,13974525,19877100,5902575,BUY
2020-12-24 11:10:00,11:10,13754350,19834250,6079900,BUY
2020-12-24 11:11:00,11:11,14039200,19941550,5902350,BUY
2020-12-24 11:12:00,11:12,14070300,19982475,5912175,BUY
2020-12-24 11:13:00,11:13,14140125,19999625,5859500,BUY
2020-12-24 11:14:00,11:14,14127725,19923525,5795800,BUY
2020-12-24 11:15:00,11:15,14145775,19917100,5771325,BUY
2020-12-24 11:16:00,11:16,14227100,19921975,5694875,BUY
2020-12-24 11:17:00,11:17,14100875,19795325,5694450,BUY
2020-12-24 11:18:00,11:18,14107050,19778225,5671175,BUY
2020-12-24 11:19:00,11:19,13960225,19784300,5824075,BUY
2020-12-24 11:20:00,11:20,14207050,19604075,5397025,BUY
2020-12-24 11:21:00,11:21,14234925,19633775,5398850,BUY
2020-12-24 11:22:00,11:22,14203800,19586650,5382850,BUY
2020-12-24 11:23:00,11:23,14121500,19286625,5165125,BUY
2020-12-24 11:24:00,11:24,14021500,19369475,5347975,BUY
2020-12-24 11:25:00,11:25,14102175,19317250,5215075,BUY
2020-12-24 11:26:00,11:26,14172025,19353500,5181475,BUY
2020-12-24 11:27:00,11:27,14101225,19318400,5217175,BUY
2020-12-24 11:28:00,11:28,14002275,19366625,5364350,BUY
2020-12-24 11:29:00,11:29,14051225,19367125,5315900,BUY
2020-12-24 11:30:00,11:30,13982650,19426775,5444125,BUY
2020-12-24 11:31:00,11:31,14121100,19426775,5305675,BUY
2020-12-24 11:32:00,11:32,14187225,19313625,5126400,BUY
2020-12-24 11:33:00,11:33,14257675,19275525,5017850,BUY
2020-12-24 11:34:00,11:34,14237525,19216425,4978900,BUY
2020-12-24 11:35:00,11:35,14138375,19089375,4951000,BUY
2020-12-24 11:36:00,11:36,14191350,19035800,4844450,BUY
2020-12-24 11:37:00,11:37,13950300,19099575,5149275,BUY
2020-12-24 11:38:00,11:38,14118975,18995050,4876075,BUY
2020-12-24 11:39:00,11:39,13976450,18976300,4999850,BUY
2020-12-24 11:40:00,11:40,14128500,18981325,4852825,BUY
2020-12-24 11:41:00,11:41,13960875,18937225,4976350,BUY
2020-12-24 11:42:00,11:42,13910575,18955150,5044575,BUY
2020-12-24 11:43:00,11:43,13966150,18961825,4995675,BUY
2020-12-24 11:44:00,11:44,13849075,18960725,5111650,BUY
2020-12-24 11:45:00,11:45,14117775,18960575,4842800,BUY
2020-12-24 11:46:00,11:46,14052225,19024550,4972325,BUY
2020-12-24 11:47:00,11:47,14045325,19008625,4963300,BUY
2020-12-24 11:48:00,11:48,14127450,19098300,4970850,BUY
2020-12-24 11:49:00,11:49,14249050,19123375,4874325,BUY
2020-12-24 11:50:00,11:50,14096750,19017225,4920475,BUY
2020-12-24 11:51:00,11:51,14351725,19109125,4757400,BUY
2020-12-24 11:52:00,11:52,14245750,19121675,4875925,BUY
2020-12-24 11:53:00,11:53,14151300,19129075,4977775,BUY
2020-12-24 11:54:00,11:54,14328175,19084025,4755850,BUY
2020-12-24 11:55:00,11:55,14103325,19040600,4937275,BUY
2020-12-24 11:56:00,11:56,14397225,18554225,4157000,BUY
2020-12-24 11:57:00,11:57,14198600,18808625,4610025,BUY
2020-12-24 11:58:00,11:58,14487875,19148900,4661025,BUY
2020-12-24 11:59:00,11:59,14570050,18991950,4421900,BUY
2020-12-24 12:00:00,12:00,14492250,19287725,4795475,BUY
2020-12-24 12:01:00,12:01,14454950,19134850,4679900,BUY
2020-12-24 12:02:00,12:02,14421850,19093975,4672125,BUY
2020-12-24 12:03:00,12:03,14670675,19269500,4598825,BUY
2020-12-24 12:04:00,12:04,14649150,19307700,4658550,BUY
2020-12-24 12:05:00,12:05,14593975,19266200,4672225,BUY
2020-12-24 12:06:00,12:06,14789975,19467050,4677075,BUY
2020-12-24 12:07:00,12:07,14717925,19414525,4696600,BUY
2020-12-24 12:08:00,12:08,14728150,19408925,4680775,BUY
2020-12-24 12:09:00,12:09,14933650,19502775,4569125,BUY
2020-12-24 12:10:00,12:10,14736550,19598025,4861475,BUY
2020-12-24 12:11:00,12:11,14847625,19564875,4717250,BUY
2020-12-24 12:12:00,12:12,14874075,20066025,5191950,BUY
2020-12-24 12:13:00,12:13,14922800,20092325,5169525,BUY
2020-12-24 12:14:00,12:14,14901025,20097225,5196200,BUY
2020-12-24 12:15:00,12:15,15084400,20212825,5128425,BUY
2020-12-24 12:16:00,12:16,14983050,20238375,5255325,BUY
2020-12-24 12:17:00,12:17,15114925,20093300,4978375,BUY
2020-12-24 12:18:00,12:18,14946675,20212475,5265800,BUY
2020-12-24 12:19:00,12:19,15078275,20186025,5107750,BUY
2020-12-24 12:20:00,12:20,15232850,20274325,5041475,BUY
2020-12-24 12:21:00,12:21,15175800,20428150,5252350,BUY
2020-12-24 12:22:00,12:22,15105300,20352025,5246725,BUY
2020-12-24 12:23:00,12:23,15140250,20384925,5244675,BUY
2020-12-24 12:24:00,12:24,15369450,20402475,5033025,BUY
2020-12-24 12:25:00,12:25,15155125,20384975,5229850,BUY
2020-12-24 12:26:00,12:26,15050475,20506475,5456000,BUY
2020-12-24 12:27:00,12:27,14910775,20399200,5488425,BUY
2020-12-24 12:28:00,12:28,14753650,20206050,5452400,BUY
2020-12-24 12:29:00,12:29,14875350,20543925,5668575,BUY
2020-12-24 12:30:00,12:30,15253150,20595025,5341875,BUY
2020-12-24 12:31:00,12:31,15430600,20535050,5104450,BUY
2020-12-24 12:32:00,12:32,15043675,20620800,5577125,BUY
2020-12-24 12:33:00,12:33,15413175,20394950,4981775,BUY
2020-12-24 12:34:00,12:34,15412875,20666375,5253500,BUY
2020-12-24 12:35:00,12:35,15247575,20564675,5317100,BUY
2020-12-24 12:36:00,12:36,15447575,20629625,5182050,BUY
2020-12-24 12:37:00,12:37,15283625,20629625,5346000,BUY
2020-12-24 12:38:00,12:38,15385325,20526200,5140875,BUY
2020-12-24 12:39:00,12:39,14753025,20680625,5927600,BUY
2020-12-24 12:40:00,12:40,15456600,20687850,5231250,BUY
2020-12-24 12:41:00,12:41,15456600,20733500,5276900,BUY
2020-12-24 12:42:00,12:42,15279550,20859000,5579450,BUY
2020-12-24 12:43:00,12:43,15011450,20799625,5788175,BUY
2020-12-24 12:44:00,12:44,14978375,20904975,5926600,BUY
2020-12-24 12:45:00,12:45,15330275,21006875,5676600,BUY
2020-12-24 12:46:00,12:46,15265450,21006875,5741425,BUY
2020-12-24 12:47:00,12:47,15356050,20973725,5617675,BUY
2020-12-24 12:48:00,12:48,15322450,21253625,5931175,BUY
2020-12-24 12:49:00,12:49,15291375,21200250,5908875,BUY
2020-12-24 12:50:00,12:50,15291375,21176825,5885450,BUY
2020-12-24 12:51:00,12:51,15371150,21201825,5830675,BUY
2020-12-24 12:52:00,12:52,15386025,21243450,5857425,BUY
2020-12-24 12:53:00,12:53,15306175,21154175,5848000,BUY
2020-12-24 12:54:00,12:54,15407850,21087125,5679275,BUY
2020-12-24 12:55:00,12:55,15503750,20907050,5403300,BUY
2020-12-24 12:56:00,12:56,15385900,20876875,5490975,BUY
2020-12-24 12:57:00,12:57,15443600,21041800,5598200,BUY
2020-12-24 12:58:00,12:58,15326650,21098075,5771425,BUY
2020-12-24 12:59:00,12:59,15238025,21040525,5802500,BUY
2020-12-24 13:00:00,13:00,15424100,21137100,5713000,BUY
2020-12-24 13:01:00,13:01,15250625,21161750,5911125,BUY
2020-12-24 13:02:00,13:02,15129650,21011800,5882150,BUY
2020-12-24 13:03:00,13:03,15491650,21236250,5744600,BUY
2020-12-24 13:04:00,13:04,15455075,21225800,5770725,BUY
2020-12-24 13:05:00,13:05,15582925,21359750,5776825,BUY
2020-12-24 13:06:00,13:06,15336100,21067575,5731475,BUY
2020-12-24 13:07:00,13:07,15563725,21345700,5781975,BUY
2020-12-24 13:08:00,13:08,15506925,21213675,5706750,BUY
2020-12-24 13:09:00,13:09,15243300,21323025,6079725,BUY
2020-12-24 13:10:00,13:10,15665475,21372025,5706550,BUY
2020-12-24 13:11:00,13:11,15453750,21155225,5701475,BUY
2020-12-24 13:12:00,13:12,15133750,20316700,5182950,BUY
2020-12-24 13:13:00,13:13,15451975,20851675,5399700,BUY
2020-12-24 13:14:00,13:14,15361925,21314400,5952475,BUY
2020-12-24 13:15:00,13:15,15808550,21410225,5601675,BUY
2020-12-24 13:16:00,13:16,15727825,21442225,5714400,BUY
2020-12-24 13:17:00,13:17,15697275,21354750,5657475,BUY
2020-12-24 13:18:00,13:18,15697050,21147500,5450450,BUY
2020-12-24 13:19:00,13:19,15486600,21071575,5584975,BUY
2020-12-24 13:20:00,13:20,15663575,21147500,5483925,BUY
2020-12-24 13:21:00,13:21,15819675,21366925,5547250,BUY
2020-12-24 13:22:00,13:22,15841775,21305725,5463950,BUY
2020-12-24 13:23:00,13:23,15809025,21297925,5488900,BUY
2020-12-24 13:24:00,13:24,15434175,20406800,4972625,BUY
2020-12-24 13:25:00,13:25,15370775,20399950,5029175,BUY
2020-12-24 13:26:00,13:26,15376875,20400175,5023300,BUY
2020-12-24 13:27:00,13:27,14949225,20443850,5494625,BUY
2020-12-24 13:28:00,13:28,14941575,20343725,5402150,BUY
2020-12-24 13:29:00,13:29,15086075,20495800,5409725,BUY
2020-12-24 13:30:00,13:30,15064825,20521775,5456950,BUY
2020-12-24 13:31:00,13:31,14943675,20536700,5593025,BUY
2020-12-24 13:32:00,13:32,14943675,20530175,5586500,BUY
2020-12-24 13:33:00,13:33,14862525,20452925,5590400,BUY
2020-12-24 13:34:00,13:34,14885700,20376225,5490525,BUY
2020-12-24 13:35:00,13:35,14864425,20447700,5583275,BUY
2020-12-24 13:36:00,13:36,14823850,20311275,5487425,BUY
2020-12-24 13:37:00,13:37,14856950,20362725,5505775,BUY
2020-12-24 13:38:00,13:38,14918700,20369475,5450775,BUY
2020-12-24 13:39:00,13:39,14796225,20425450,5629225,BUY
2020-12-24 13:40:00,13:40,14879925,20412300,5532375,BUY
2020-12-24 13:41:00,13:41,14849350,20420575,5571225,BUY
2020-12-24 13:42:00,13:42,15011850,20152725,5140875,BUY
2020-12-24 13:43:00,13:43,14833000,20233950,5400950,BUY
2020-12-24 13:44:00,13:44,14842825,20209350,5366525,BUY
2020-12-24 13:45:00,13:45,14823600,20260975,5437375,BUY
2020-12-24 13:46:00,13:46,14846250,20151700,5305450,BUY
2020-12-24 13:47:00,13:47,14799150,20253050,5453900,BUY
2020-12-24 13:48:00,13:48,15010450,20278600,5268150,BUY
2020-12-24 13:49:00,13:49,14880700,20122150,5241450,BUY
2020-12-24 13:50:00,13:50,14543850,19711050,5167200,BUY
2020-12-24 13:51:00,13:51,3643125,6574725,2931600,BUY
2020-12-24 13:52:00,13:52,14660875,19955375,5294500,BUY
2020-12-24 13:53:00,13:53,14951225,20200200,5248975,BUY
2020-12-24 13:54:00,13:54,14874050,19757100,4883050,BUY
2020-12-24 13:55:00,13:55,14737600,20064350,5326750,BUY
2020-12-24 13:56:00,13:56,14776925,19222350,4445425,BUY
2020-12-24 13:57:00,13:57,15272275,20230775,4958500,BUY
2020-12-24 13:58:00,13:58,13369225,18135100,4765875,BUY
2020-12-24 13:59:00,13:59,3604150,6656625,3052475,BUY
2020-12-24 14:00:00,14:00,3580825,6852625,3271800,BUY
2020-12-24 14:01:00,14:01,3580825,6852625,3271800,BUY
2020-12-24 14:02:00,14:02,15215300,20747000,5531700,BUY
2020-12-24 14:03:00,14:03,15145275,20563075,5417800,BUY
2020-12-24 14:04:00,14:04,15227125,20700875,5473750,BUY
2020-12-24 14:05:00,14:05,15166250,20718000,5551750,BUY
2020-12-24 14:06:00,14:06,15329575,20625450,5295875,BUY
2020-12-24 14:07:00,14:07,15179375,20594525,5415150,BUY
2020-12-24 14:08:00,14:08,15267825,20614075,5346250,BUY
2020-12-24 14:09:00,14:09,15335850,20599650,5263800,BUY
2020-12-24 14:10:00,14:10,15304950,20687900,5382950,BUY
2020-12-24 14:11:00,14:11,15344000,20689450,5345450,BUY
2020-12-24 14:12:00,14:12,15503400,20501525,4998125,BUY
2020-12-24 14:13:00,14:13,15482650,20553375,5070725,BUY
2020-12-24 14:14:00,14:14,15390750,20480100,5089350,BUY
2020-12-24 14:15:00,14:15,15297100,20341000,5043900,BUY
2020-12-24 14:16:00,14:16,15321850,20330675,5008825,BUY
2020-12-24 14:17:00,14:17,15275100,20330675,5055575,BUY
2020-12-24 14:18:00,14:18,15277550,20069000,4791450,BUY
2020-12-24 14:19:00,14:19,15332575,20141775,4809200,BUY
2020-12-24 14:20:00,14:20,15224575,20089875,4865300,BUY
2020-12-24 14:21:00,14:21,15525175,20014725,4489550,BUY
2020-12-24 14:22:00,14:22,15492450,19935300,4442850,BUY
2020-12-24 14:23:00,14:23,15431650,20035000,4603350,BUY
2020-12-24 14:24:00,14:24,15639100,19832900,4193800,BUY
2020-12-24 14:25:00,14:25,15702625,19912475,4209850,BUY
2020-12-24 14:26:00,14:26,15687175,19906150,4218975,BUY
2020-12-24 14:27:00,14:27,15676825,19653025,3976200,BUY
2020-12-24 14:28:00,14:28,15654425,19645425,3991000,BUY
2020-12-24 14:29:00,14:29,15578650,19606525,4027875,BUY
2020-12-24 14:30:00,14:30,15601825,19597275,3995450,BUY
2020-12-24 14:31:00,14:31,15510975,19089125,3578150,BUY
2020-12-24 14:32:00,14:32,13847200,18146275,4299075,BUY
2020-12-24 14:33:00,14:33,15551375,19314275,3762900,BUY
2020-12-24 14:34:00,14:34,15599825,19354925,3755100,BUY
2020-12-24 14:35:00,14:35,15693325,19445675,3752350,BUY
2020-12-24 14:36:00,14:36,15278075,19406575,4128500,BUY
2020-12-24 14:37:00,14:37,15400150,19413900,4013750,BUY
2020-12-24 14:38:00,14:38,15378675,19413900,4035225,BUY
2020-12-24 14:39:00,14:39,15010825,19258525,4247700,BUY
2020-12-24 14:40:00,14:40,14982175,19237950,4255775,BUY
2020-12-24 14:41:00,14:41,15064500,19250875,4186375,BUY
2020-12-24 14:42:00,14:42,15089450,18960075,3870625,BUY
2020-12-24 14:43:00,14:43,15131150,19067950,3936800,BUY
2020-12-24 14:44:00,14:44,15050250,19074425,4024175,BUY
2020-12-24 14:45:00,14:45,14870775,18466325,3595550,BUY
2020-12-24 14:46:00,14:46,15023225,18614475,3591250,BUY
2020-12-24 14:47:00,14:47,14895500,18620600,3725100,BUY
2020-12-24 14:48:00,14:48,14973025,18387250,3414225,BUY
2020-12-24 14:49:00,14:49,15019925,18366275,3346350,BUY
2020-12-24 14:50:00,14:50,15010800,18348525,3337725,BUY
2020-12-24 14:51:00,14:51,14945500,18133675,3188175,BUY
2020-12-24 14:52:00,14:52,15229750,18072625,2842875,BUY
2020-12-24 14:53:00,14:53,15099400,18166975,3067575,BUY
2020-12-24 14:54:00,14:54,14579550,17373400,2793850,BUY
2020-12-24 14:55:00,14:55,14711825,17514825,2803000,BUY
2020-12-24 14:56:00,14:56,14652475,17413875,2761400,BUY
2020-12-24 14:57:00,14:57,14378825,16925350,2546525,BUY
2020-12-24 14:58:00,14:58,14428450,17041250,2612800,BUY
2020-12-24 14:59:00,14:59,14421025,16917725,2496700,BUY
2020-12-24 15:00:00,15:00,14104800,16698875,2594075,BUY
2020-12-24 15:01:00,15:01,14068900,16364750,2295850,BUY
2020-12-24 15:02:00,15:02,14115775,16343275,2227500,BUY
2020-12-24 15:03:00,15:03,13932075,16236725,2304650,BUY
2020-12-24 15:04:00,15:04,13766775,16232050,2465275,BUY
2020-12-24 15:05:00,15:05,13866525,16261275,2394750,BUY
2020-12-24 15:06:00,15:06,13543075,15823475,2280400,BUY
2020-12-24 15:07:00,15:07,13573100,15781575,2208475,BUY
2020-12-24 15:08:00,15:08,13555600,15785000,2229400,BUY
2020-12-24 15:09:00,15:09,12985075,15258650,2273575,BUY
2020-12-24 15:10:00,15:10,13036325,15263475,2227150,BUY
2020-12-24 15:11:00,15:11,12993475,15194200,2200725,BUY
2020-12-24 15:12:00,15:12,12335775,14872500,2536725,BUY
2020-12-24 15:13:00,15:13,12478225,14760425,2282200,BUY
2020-12-24 15:14:00,15:14,12466950,14939425,2472475,BUY
2020-12-24 15:15:00,15:15,11666225,14089175,2422950,BUY
2020-12-24 15:16:00,15:16,11525625,13996800,2471175,BUY
2020-12-24 15:17:00,15:17,11596650,14079525,2482875,BUY
2020-12-24 15:18:00,15:18,11190850,13627550,2436700,BUY
2020-12-24 15:19:00,15:19,10875475,13623550,2748075,BUY
2020-12-24 15:20:00,15:20,10738600,13579525,2840925,BUY
2020-12-24 15:21:00,15:21,10108650,12885975,2777325,BUY
2020-12-24 15:22:00,15:22,9892300,12837525,2945225,BUY
2020-12-24 15:23:00,15:23,9863425,13047500,3184075,BUY
2020-12-24 15:24:00,15:24,9731825,12390275,2658450,BUY
2020-12-24 15:25:00,15:25,9597550,12411675,2814125,BUY
2020-12-24 15:26:00,15:26,9618000,12447975,2829975,BUY
2020-12-24 15:27:00,15:27,9020900,11362800,2341900,BUY
2020-12-24 15:28:00,15:28,9064075,11793475,2729400,BUY
2020-12-24 15:29:00,15:29,8891725,11840775,2949050,BUY
