,timestamp,call,put,diff,sellOrBuy
2020-12-28 09:15:00,09:15,5154900,5178200,23300,BUY
2020-12-28 09:16:00,09:16,5154350,5167875,13525,BUY
2020-12-28 09:17:00,09:17,5419775,5404250,-15525,SELL
2020-12-28 09:18:00,09:18,5397975,5404200,6225,BUY
2020-12-28 09:19:00,09:19,5449475,5305500,-143975,SELL
2020-12-28 09:20:00,09:20,5980075,6175250,195175,BUY
2020-12-28 09:21:00,09:21,5932475,6114225,181750,BUY
2020-12-28 09:22:00,09:22,5958550,6221275,262725,BUY
2020-12-28 09:23:00,09:23,6419650,6743075,323425,BUY
2020-12-28 09:24:00,09:24,6419750,6827650,407900,BUY
2020-12-28 09:25:00,09:25,6425200,6851350,426150,BUY
2020-12-28 09:26:00,09:26,6692000,6921550,229550,BUY
2020-12-28 09:27:00,09:27,6713900,7104975,391075,BUY
2020-12-28 09:28:00,09:28,6605475,7065600,460125,BUY
2020-12-28 09:29:00,09:29,6718000,7796350,1078350,BUY
2020-12-28 09:30:00,09:30,6746850,7906100,1159250,BUY
2020-12-28 09:31:00,09:31,6721300,7783125,1061825,BUY
2020-12-28 09:32:00,09:32,6893800,8192950,1299150,BUY
2020-12-28 09:33:00,09:33,6911925,8241950,1330025,BUY
2020-12-28 09:34:00,09:34,6909725,8299650,1389925,BUY
2020-12-28 09:35:00,09:35,6987400,8496575,1509175,BUY
2020-12-28 09:36:00,09:36,7050225,8468375,1418150,BUY
2020-12-28 09:37:00,09:37,6875350,8497200,1621850,BUY
2020-12-28 09:38:00,09:38,7114375,8930850,1816475,BUY
2020-12-28 09:39:00,09:39,7136550,8931025,1794475,BUY
2020-12-28 09:40:00,09:40,7127200,8966100,1838900,BUY
2020-12-28 09:41:00,09:41,7160900,9272650,2111750,BUY
2020-12-28 09:42:00,09:42,7170100,9134150,1964050,BUY
2020-12-28 09:43:00,09:43,7237925,9317025,2079100,BUY
2020-12-28 09:44:00,09:44,7390150,9507200,2117050,BUY
2020-12-28 09:45:00,09:45,7394325,9545700,2151375,BUY
2020-12-28 09:46:00,09:46,7260850,9555425,2294575,BUY
2020-12-28 09:47:00,09:47,7359075,9541075,2182000,BUY
2020-12-28 09:48:00,09:48,7437150,9685425,2248275,BUY
2020-12-28 09:49:00,09:49,7512825,9573675,2060850,BUY
2020-12-28 09:50:00,09:50,7476225,9784850,2308625,BUY
2020-12-28 09:51:00,09:51,7435150,9856350,2421200,BUY
2020-12-28 09:52:00,09:52,7357650,9615075,2257425,BUY
2020-12-28 09:53:00,09:53,7652100,9585575,1933475,BUY
2020-12-28 09:54:00,09:54,7649275,9676250,2026975,BUY
2020-12-28 09:55:00,09:55,7534150,9891275,2357125,BUY
2020-12-28 09:56:00,09:56,7638700,9876225,2237525,BUY
2020-12-28 09:57:00,09:57,7755925,9967225,2211300,BUY
2020-12-28 09:58:00,09:58,7669925,9962550,2292625,BUY
2020-12-28 09:59:00,09:59,7811875,9775850,1963975,BUY
2020-12-28 10:00:00,10:00,7742575,10188150,2445575,BUY
2020-12-28 10:01:00,10:01,7685250,10211650,2526400,BUY
2020-12-28 10:02:00,10:02,7829225,10297275,2468050,BUY
2020-12-28 10:03:00,10:03,7826175,10257275,2431100,BUY
2020-12-28 10:04:00,10:04,7957575,10344225,2386650,BUY
2020-12-28 10:05:00,10:05,7910575,10172575,2262000,BUY
2020-12-28 10:06:00,10:06,7800875,10207575,2406700,BUY
2020-12-28 10:07:00,10:07,7927150,10273250,2346100,BUY
2020-12-28 10:08:00,10:08,7839725,10291700,2451975,BUY
2020-12-28 10:09:00,10:09,7998525,10138200,2139675,BUY
2020-12-28 10:10:00,10:10,8018050,10172350,2154300,BUY
2020-12-28 10:11:00,10:11,8167500,10415900,2248400,BUY
2020-12-28 10:12:00,10:12,7990600,10371150,2380550,BUY
2020-12-28 10:13:00,10:13,7948875,10322325,2373450,BUY
2020-12-28 10:14:00,10:14,7991050,10193450,2202400,BUY
2020-12-28 10:15:00,10:15,8022525,10371775,2349250,BUY
2020-12-28 10:16:00,10:16,8227650,10384750,2157100,BUY
2020-12-28 10:17:00,10:17,8176150,10383000,2206850,BUY
2020-12-28 10:18:00,10:18,8069525,10503550,2434025,BUY
2020-12-28 10:19:00,10:19,8178150,10377125,2198975,BUY
2020-12-28 10:20:00,10:20,8124875,10542450,2417575,BUY
2020-12-28 10:21:00,10:21,8069825,10499375,2429550,BUY
2020-12-28 10:22:00,10:22,8177600,10460675,2283075,BUY
2020-12-28 10:23:00,10:23,8232975,10434725,2201750,BUY
2020-12-28 10:24:00,10:24,7995825,10344675,2348850,BUY
2020-12-28 10:25:00,10:25,8128975,10100775,1971800,BUY
2020-12-28 10:26:00,10:26,8077775,10395925,2318150,BUY
2020-12-28 10:27:00,10:27,8244425,10393375,2148950,BUY
2020-12-28 10:28:00,10:28,8097525,10402825,2305300,BUY
2020-12-28 10:29:00,10:29,8032725,10006950,1974225,BUY
2020-12-28 10:30:00,10:30,8063225,10303550,2240325,BUY
2020-12-28 10:31:00,10:31,8053825,10352925,2299100,BUY
2020-12-28 10:32:00,10:32,8401325,10513825,2112500,BUY
2020-12-28 10:33:00,10:33,8206650,10327775,2121125,BUY
2020-12-28 10:34:00,10:34,8352375,10327250,1974875,BUY
2020-12-28 10:35:00,10:35,8421300,9471550,1050250,BUY
2020-12-28 10:36:00,10:36,8712975,10525400,1812425,BUY
2020-12-28 10:37:00,10:37,8485550,10450825,1965275,BUY
2020-12-28 10:38:00,10:38,8623725,10433300,1809575,BUY
2020-12-28 10:39:00,10:39,8531000,10346400,1815400,BUY
2020-12-28 10:40:00,10:40,8782950,10275300,1492350,BUY
2020-12-28 10:41:00,10:41,8660175,10313800,1653625,BUY
2020-12-28 10:42:00,10:42,8752050,9946775,1194725,BUY
2020-12-28 10:43:00,10:43,8726125,10290325,1564200,BUY
2020-12-28 10:44:00,10:44,8825475,10430125,1604650,BUY
2020-12-28 10:45:00,10:45,8883900,10478225,1594325,BUY
2020-12-28 10:46:00,10:46,8791025,9992800,1201775,BUY
2020-12-28 10:47:00,10:47,8729750,10406800,1677050,BUY
2020-12-28 10:48:00,10:48,8876650,10596900,1720250,BUY
2020-12-28 10:49:00,10:49,8933000,10470775,1537775,BUY
2020-12-28 10:50:00,10:50,8955850,10659575,1703725,BUY
2020-12-28 10:51:00,10:51,8911900,10299975,1388075,BUY
2020-12-28 10:52:00,10:52,8795225,10372125,1576900,BUY
2020-12-28 10:53:00,10:53,8760050,10506875,1746825,BUY
2020-12-28 10:54:00,10:54,8836175,10631325,1795150,BUY
2020-12-28 10:55:00,10:55,8778925,10375525,1596600,BUY
2020-12-28 10:56:00,10:56,9009725,10534425,1524700,BUY
2020-12-28 10:57:00,10:57,8764775,10119450,1354675,BUY
2020-12-28 10:58:00,10:58,8904675,10111275,1206600,BUY
2020-12-28 10:59:00,10:59,8960875,10243800,1282925,BUY
2020-12-28 11:00:00,11:00,9086275,10526400,1440125,BUY
2020-12-28 11:01:00,11:01,8953875,10516650,1562775,BUY
2020-12-28 11:02:00,11:02,9221600,10553250,1331650,BUY
2020-12-28 11:03:00,11:03,9133675,10604675,1471000,BUY
2020-12-28 11:04:00,11:04,9103775,10473175,1369400,BUY
2020-12-28 11:05:00,11:05,9230275,10543050,1312775,BUY
2020-12-28 11:06:00,11:06,9092950,10599875,1506925,BUY
2020-12-28 11:07:00,11:07,9252075,10580975,1328900,BUY
2020-12-28 11:08:00,11:08,9340775,10783850,1443075,BUY
2020-12-28 11:09:00,11:09,9214925,10303925,1089000,BUY
2020-12-28 11:10:00,11:10,9303725,10589075,1285350,BUY
2020-12-28 11:11:00,11:11,9436325,10665300,1228975,BUY
2020-12-28 11:12:00,11:12,9441925,10572050,1130125,BUY
2020-12-28 11:13:00,11:13,9434025,10633875,1199850,BUY
2020-12-28 11:14:00,11:14,9459775,10633625,1173850,BUY
2020-12-28 11:15:00,11:15,9336725,10589100,1252375,BUY
2020-12-28 11:16:00,11:16,9631375,10698025,1066650,BUY
2020-12-28 11:17:00,11:17,9577650,10618275,1040625,BUY
2020-12-28 11:18:00,11:18,9559825,10569100,1009275,BUY
2020-12-28 11:19:00,11:19,9458925,10213125,754200,BUY
2020-12-28 11:20:00,11:20,9581525,10258650,677125,BUY
2020-12-28 11:21:00,11:21,9558500,10328325,769825,BUY
2020-12-28 11:22:00,11:22,9619625,10231125,611500,BUY
2020-12-28 11:23:00,11:23,9585500,10300975,715475,BUY
2020-12-28 11:24:00,11:24,9520225,9823100,302875,BUY
2020-12-28 11:25:00,11:25,9492700,9811550,318850,BUY
2020-12-28 11:26:00,11:26,9590025,10244400,654375,BUY
2020-12-28 11:27:00,11:27,9370375,10214575,844200,BUY
2020-12-28 11:28:00,11:28,9653450,10579350,925900,BUY
2020-12-28 11:29:00,11:29,9692600,10709025,1016425,BUY
2020-12-28 11:30:00,11:30,9645350,10611650,966300,BUY
2020-12-28 11:31:00,11:31,9567300,10879150,1311850,BUY
2020-12-28 11:32:00,11:32,9540625,10710125,1169500,BUY
2020-12-28 11:33:00,11:33,9487225,10687025,1199800,BUY
2020-12-28 11:34:00,11:34,9592925,10651250,1058325,BUY
2020-12-28 11:35:00,11:35,9451475,10652225,1200750,BUY
2020-12-28 11:36:00,11:36,9452300,10748175,1295875,BUY
2020-12-28 11:37:00,11:37,9698175,10938100,1239925,BUY
2020-12-28 11:38:00,11:38,9650525,10407075,756550,BUY
2020-12-28 11:39:00,11:39,9507650,10700225,1192575,BUY
2020-12-28 11:40:00,11:40,9654600,10447925,793325,BUY
2020-12-28 11:41:00,11:41,9678725,10503675,824950,BUY
2020-12-28 11:42:00,11:42,9673400,10948375,1274975,BUY
2020-12-28 11:43:00,11:43,9443450,10603025,1159575,BUY
2020-12-28 11:44:00,11:44,9705525,10808250,1102725,BUY
2020-12-28 11:45:00,11:45,9847425,10892600,1045175,BUY
2020-12-28 11:46:00,11:46,9546300,10928850,1382550,BUY
2020-12-28 11:47:00,11:47,9465050,10660325,1195275,BUY
2020-12-28 11:48:00,11:48,9687750,10488400,800650,BUY
2020-12-28 11:49:00,11:49,9716650,10850500,1133850,BUY
2020-12-28 11:50:00,11:50,9749425,10757325,1007900,BUY
2020-12-28 11:51:00,11:51,9496250,10704700,1208450,BUY
2020-12-28 11:52:00,11:52,9770225,10685500,915275,BUY
2020-12-28 11:53:00,11:53,9589900,10630325,1040425,BUY
2020-12-28 11:54:00,11:54,9620075,10815975,1195900,BUY
2020-12-28 11:55:00,11:55,9707025,10882125,1175100,BUY
2020-12-28 11:56:00,11:56,9577575,10960775,1383200,BUY
2020-12-28 11:57:00,11:57,9612950,10409500,796550,BUY
2020-12-28 11:58:00,11:58,9612950,10409125,796175,BUY
2020-12-28 11:59:00,11:59,9652850,10985150,1332300,BUY
2020-12-28 12:00:00,12:00,9703075,10508450,805375,BUY
2020-12-28 12:01:00,12:01,9709200,10825250,1116050,BUY
2020-12-28 12:02:00,12:02,9608925,10711825,1102900,BUY
2020-12-28 12:03:00,12:03,9669150,10877150,1208000,BUY
2020-12-28 12:04:00,12:04,9618675,10371700,753025,BUY
2020-12-28 12:05:00,12:05,9602500,10805725,1203225,BUY
2020-12-28 12:06:00,12:06,9604300,10578925,974625,BUY
2020-12-28 12:07:00,12:07,9674550,10880600,1206050,BUY
2020-12-28 12:08:00,12:08,9555875,10401300,845425,BUY
2020-12-28 12:09:00,12:09,9699875,10336625,636750,BUY
2020-12-28 12:10:00,12:10,9701825,10783625,1081800,BUY
2020-12-28 12:11:00,12:11,9713775,10852750,1138975,BUY
2020-12-28 12:12:00,12:12,9566050,10054400,488350,BUY
2020-12-28 12:13:00,12:13,9776400,11075225,1298825,BUY
2020-12-28 12:14:00,12:14,10108925,11238150,1129225,BUY
2020-12-28 12:15:00,12:15,9918725,11141575,1222850,BUY
2020-12-28 12:16:00,12:16,9829400,10940575,1111175,BUY
2020-12-28 12:17:00,12:17,9774700,10665475,890775,BUY
2020-12-28 12:18:00,12:18,9647650,10637600,989950,BUY
2020-12-28 12:19:00,12:19,9554500,10708300,1153800,BUY
2020-12-28 12:20:00,12:20,9688950,10933075,1244125,BUY
2020-12-28 12:21:00,12:21,9705500,10623650,918150,BUY
2020-12-28 12:22:00,12:22,9672100,10494350,822250,BUY
2020-12-28 12:23:00,12:23,9649100,10315600,666500,BUY
2020-12-28 12:24:00,12:24,9669575,10735675,1066100,BUY
2020-12-28 12:25:00,12:25,9713900,10628600,914700,BUY
2020-12-28 12:26:00,12:26,9629875,10788875,1159000,BUY
2020-12-28 12:27:00,12:27,9645425,10908250,1262825,BUY
2020-12-28 12:28:00,12:28,9507350,10849500,1342150,BUY
2020-12-28 12:29:00,12:29,9654950,10870175,1215225,BUY
2020-12-28 12:30:00,12:30,9846200,11064025,1217825,BUY
2020-12-28 12:31:00,12:31,9651975,11099500,1447525,BUY
2020-12-28 12:32:00,12:32,9666775,10840050,1173275,BUY
2020-12-28 12:33:00,12:33,9649100,10486825,837725,BUY
2020-12-28 12:34:00,12:34,9749775,10566825,817050,BUY
2020-12-28 12:35:00,12:35,9422975,10972250,1549275,BUY
2020-12-28 12:36:00,12:36,9605150,10577000,971850,BUY
2020-12-28 12:37:00,12:37,9726950,10475125,748175,BUY
2020-12-28 12:38:00,12:38,9681650,10514875,833225,BUY
2020-12-28 12:39:00,12:39,9751525,10986950,1235425,BUY
2020-12-28 12:40:00,12:40,9796300,11078425,1282125,BUY
2020-12-28 12:41:00,12:41,9575325,10538400,963075,BUY
2020-12-28 12:42:00,12:42,9727225,11021925,1294700,BUY
2020-12-28 12:43:00,12:43,9477125,10565350,1088225,BUY
2020-12-28 12:44:00,12:44,9662125,11012450,1350325,BUY
2020-12-28 12:45:00,12:45,9681125,10655525,974400,BUY
2020-12-28 12:46:00,12:46,9839275,10693250,853975,BUY
2020-12-28 12:47:00,12:47,9769575,10904075,1134500,BUY
2020-12-28 12:48:00,12:48,9756350,10600075,843725,BUY
2020-12-28 12:49:00,12:49,9785625,11192200,1406575,BUY
2020-12-28 12:50:00,12:50,9719050,11257375,1538325,BUY
2020-12-28 12:51:00,12:51,9720700,10735525,1014825,BUY
2020-12-28 12:52:00,12:52,9591100,10148675,557575,BUY
2020-12-28 12:53:00,12:53,9760425,11062125,1301700,BUY
2020-12-28 12:54:00,12:54,9448275,11128675,1680400,BUY
2020-12-28 12:55:00,12:55,9648675,11058575,1409900,BUY
2020-12-28 12:56:00,12:56,9478500,10337425,858925,BUY
2020-12-28 12:57:00,12:57,9610675,10718450,1107775,BUY
2020-12-28 12:58:00,12:58,9621775,10876225,1254450,BUY
2020-12-28 12:59:00,12:59,9625700,11006625,1380925,BUY
2020-12-28 13:00:00,13:00,9685650,10329600,643950,BUY
2020-12-28 13:01:00,13:01,9681575,10941025,1259450,BUY
2020-12-28 13:02:00,13:02,9576675,10648075,1071400,BUY
2020-12-28 13:03:00,13:03,9559825,10370775,810950,BUY
2020-12-28 13:04:00,13:04,9427275,10704275,1277000,BUY
2020-12-28 13:05:00,13:05,9637975,10669400,1031425,BUY
2020-12-28 13:06:00,13:06,9559075,9695350,136275,BUY
2020-12-28 13:07:00,13:07,9553450,9803450,250000,BUY
2020-12-28 13:08:00,13:08,9528500,10860175,1331675,BUY
2020-12-28 13:09:00,13:09,9578750,10662925,1084175,BUY
2020-12-28 13:10:00,13:10,9471350,10774600,1303250,BUY
2020-12-28 13:11:00,13:11,9565875,10690800,1124925,BUY
2020-12-28 13:12:00,13:12,9581900,10798500,1216600,BUY
2020-12-28 13:13:00,13:13,9690300,10702400,1012100,BUY
2020-12-28 13:14:00,13:14,9679300,10861925,1182625,BUY
2020-12-28 13:15:00,13:15,9651175,10739025,1087850,BUY
2020-12-28 13:16:00,13:16,9693125,10900325,1207200,BUY
2020-12-28 13:17:00,13:17,9695125,10668025,972900,BUY
2020-12-28 13:18:00,13:18,9821000,10926800,1105800,BUY
2020-12-28 13:19:00,13:19,9774100,10567375,793275,BUY
2020-12-28 13:20:00,13:20,9852550,10707400,854850,BUY
2020-12-28 13:21:00,13:21,9734075,10612425,878350,BUY
2020-12-28 13:22:00,13:22,9776950,11058825,1281875,BUY
2020-12-28 13:23:00,13:23,9908725,10887475,978750,BUY
2020-12-28 13:24:00,13:24,9683425,10708700,1025275,BUY
2020-12-28 13:25:00,13:25,9808700,11152875,1344175,BUY
2020-12-28 13:26:00,13:26,9862025,10823850,961825,BUY
2020-12-28 13:27:00,13:27,9821350,11129125,1307775,BUY
2020-12-28 13:28:00,13:28,9817150,10846950,1029800,BUY
2020-12-28 13:29:00,13:29,9801900,11045650,1243750,BUY
2020-12-28 13:30:00,13:30,9990000,10905350,915350,BUY
2020-12-28 13:31:00,13:31,9860700,10930675,1069975,BUY
2020-12-28 13:32:00,13:32,9956925,11169700,1212775,BUY
2020-12-28 13:33:00,13:33,9817475,11247575,1430100,BUY
2020-12-28 13:34:00,13:34,9031800,10870775,1838975,BUY
2020-12-28 13:35:00,13:35,9870175,10635250,765075,BUY
2020-12-28 13:36:00,13:36,9879425,11138775,1259350,BUY
2020-12-28 13:37:00,13:37,9625875,10270700,644825,BUY
2020-12-28 13:38:00,13:38,9661300,10497850,836550,BUY
2020-12-28 13:39:00,13:39,9825000,11156500,1331500,BUY
2020-12-28 13:40:00,13:40,9871575,10731925,860350,BUY
2020-12-28 13:41:00,13:41,9616500,11035675,1419175,BUY
2020-12-28 13:42:00,13:42,9925100,11199250,1274150,BUY
2020-12-28 13:43:00,13:43,9880150,10839050,958900,BUY
2020-12-28 13:44:00,13:44,9796750,10867600,1070850,BUY
2020-12-28 13:45:00,13:45,9987675,10908225,920550,BUY
2020-12-28 13:46:00,13:46,9850000,10857225,1007225,BUY
2020-12-28 13:47:00,13:47,9774875,11228675,1453800,BUY
2020-12-28 13:48:00,13:48,9864475,10962600,1098125,BUY
2020-12-28 13:49:00,13:49,9842850,10594050,751200,BUY
2020-12-28 13:50:00,13:50,9965700,11158450,1192750,BUY
2020-12-28 13:51:00,13:51,10032675,11214525,1181850,BUY
2020-12-28 13:52:00,13:52,10071700,11429525,1357825,BUY
2020-12-28 13:53:00,13:53,9920500,11148900,1228400,BUY
2020-12-28 13:54:00,13:54,9677800,10813750,1135950,BUY
2020-12-28 13:55:00,13:55,9708275,10934075,1225800,BUY
2020-12-28 13:56:00,13:56,9852275,11021475,1169200,BUY
2020-12-28 13:57:00,13:57,9937050,11250425,1313375,BUY
2020-12-28 13:58:00,13:58,9954900,10875025,920125,BUY
2020-12-28 13:59:00,13:59,10073075,11299425,1226350,BUY
2020-12-28 14:00:00,14:00,9908750,11145825,1237075,BUY
2020-12-28 14:01:00,14:01,9765525,11134575,1369050,BUY
2020-12-28 14:02:00,14:02,9803950,11206775,1402825,BUY
2020-12-28 14:03:00,14:03,9764050,11277950,1513900,BUY
2020-12-28 14:04:00,14:04,9791950,11109325,1317375,BUY
2020-12-28 14:05:00,14:05,9962800,11186500,1223700,BUY
2020-12-28 14:06:00,14:06,9894950,11208375,1313425,BUY
2020-12-28 14:07:00,14:07,9848450,11041025,1192575,BUY
2020-12-28 14:08:00,14:08,9798300,11061200,1262900,BUY
2020-12-28 14:09:00,14:09,9875300,11287275,1411975,BUY
2020-12-28 14:10:00,14:10,9806450,11282875,1476425,BUY
2020-12-28 14:11:00,14:11,9757275,10804825,1047550,BUY
2020-12-28 14:12:00,14:12,9855300,10776825,921525,BUY
2020-12-28 14:13:00,14:13,9732650,10702100,969450,BUY
2020-12-28 14:14:00,14:14,9743275,10690375,947100,BUY
2020-12-28 14:15:00,14:15,9881100,10789375,908275,BUY
2020-12-28 14:16:00,14:16,10071325,11337500,1266175,BUY
2020-12-28 14:17:00,14:17,9973450,10993350,1019900,BUY
2020-12-28 14:18:00,14:18,9684300,10698000,1013700,BUY
2020-12-28 14:19:00,14:19,9771050,10982400,1211350,BUY
2020-12-28 14:20:00,14:20,9705275,10990800,1285525,BUY
2020-12-28 14:21:00,14:21,9880600,11176800,1296200,BUY
2020-12-28 14:22:00,14:22,9811225,10529250,718025,BUY
2020-12-28 14:23:00,14:23,9855600,11050850,1195250,BUY
2020-12-28 14:24:00,14:24,9609125,11063375,1454250,BUY
2020-12-28 14:25:00,14:25,9652300,10979500,1327200,BUY
2020-12-28 14:26:00,14:26,9879050,11099200,1220150,BUY
2020-12-28 14:27:00,14:27,9791725,11140250,1348525,BUY
2020-12-28 14:28:00,14:28,9577650,11219600,1641950,BUY
2020-12-28 14:29:00,14:29,9803225,10841175,1037950,BUY
2020-12-28 14:30:00,14:30,9715275,10816975,1101700,BUY
2020-12-28 14:31:00,14:31,9677800,10921375,1243575,BUY
2020-12-28 14:32:00,14:32,9726775,10981875,1255100,BUY
2020-12-28 14:33:00,14:33,9610125,11067000,1456875,BUY
2020-12-28 14:34:00,14:34,9707425,11054750,1347325,BUY
2020-12-28 14:35:00,14:35,9670925,11094025,1423100,BUY
2020-12-28 14:36:00,14:36,9547050,11085375,1538325,BUY
2020-12-28 14:37:00,14:37,9558275,11110975,1552700,BUY
2020-12-28 14:38:00,14:38,9548900,11111675,1562775,BUY
2020-12-28 14:39:00,14:39,9573025,11125100,1552075,BUY
2020-12-28 14:40:00,14:40,9503425,11096075,1592650,BUY
2020-12-28 14:41:00,14:41,9567625,11162175,1594550,BUY
2020-12-28 14:42:00,14:42,9714850,11123000,1408150,BUY
2020-12-28 14:43:00,14:43,9547775,11204225,1656450,BUY
2020-12-28 14:44:00,14:44,9570950,10997325,1426375,BUY
2020-12-28 14:45:00,14:45,9540750,11039700,1498950,BUY
2020-12-28 14:46:00,14:46,9451750,10979475,1527725,BUY
2020-12-28 14:47:00,14:47,9311125,10997850,1686725,BUY
2020-12-28 14:48:00,14:48,9418750,11103925,1685175,BUY
2020-12-28 14:49:00,14:49,9457600,11051700,1594100,BUY
2020-12-28 14:50:00,14:50,9457550,10938000,1480450,BUY
2020-12-28 14:51:00,14:51,9363875,10824325,1460450,BUY
2020-12-28 14:52:00,14:52,9392100,10859400,1467300,BUY
2020-12-28 14:53:00,14:53,9494650,10910800,1416150,BUY
2020-12-28 14:54:00,14:54,9404300,10891775,1487475,BUY
2020-12-28 14:55:00,14:55,9276900,10813625,1536725,BUY
2020-12-28 14:56:00,14:56,9306800,10791925,1485125,BUY
2020-12-28 14:57:00,14:57,9239725,10852175,1612450,BUY
2020-12-28 14:58:00,14:58,9285300,10752800,1467500,BUY
2020-12-28 14:59:00,14:59,9165350,10766975,1601625,BUY
2020-12-28 15:00:00,15:00,9294250,10861875,1567625,BUY
2020-12-28 15:01:00,15:01,9252050,10768250,1516200,BUY
2020-12-28 15:02:00,15:02,9220875,10884450,1663575,BUY
2020-12-28 15:03:00,15:03,9065650,10688925,1623275,BUY
2020-12-28 15:04:00,15:04,9123825,10629050,1505225,BUY
2020-12-28 15:05:00,15:05,9045250,10638200,1592950,BUY
2020-12-28 15:06:00,15:06,8944800,10509950,1565150,BUY
2020-12-28 15:07:00,15:07,9167575,10508900,1341325,BUY
2020-12-28 15:08:00,15:08,8861425,10581900,1720475,BUY
2020-12-28 15:09:00,15:09,8976050,10521475,1545425,BUY
2020-12-28 15:10:00,15:10,9120900,10582100,1461200,BUY
2020-12-28 15:11:00,15:11,9053525,10434225,1380700,BUY
2020-12-28 15:12:00,15:12,8788575,10311050,1522475,BUY
2020-12-28 15:13:00,15:13,9028100,10481525,1453425,BUY
2020-12-28 15:14:00,15:14,8824150,10443800,1619650,BUY
2020-12-28 15:15:00,15:15,8715675,10091725,1376050,BUY
2020-12-28 15:16:00,15:16,8765350,10217500,1452150,BUY
2020-12-28 15:17:00,15:17,8610850,10180200,1569350,BUY
2020-12-28 15:18:00,15:18,8616125,10123400,1507275,BUY
2020-12-28 15:19:00,15:19,8481725,10122950,1641225,BUY
2020-12-28 15:20:00,15:20,8776525,10101975,1325450,BUY
2020-12-28 15:21:00,15:21,8198550,9999825,1801275,BUY
2020-12-28 15:22:00,15:22,8407600,10091025,1683425,BUY
2020-12-28 15:23:00,15:23,8439100,9688075,1248975,BUY
2020-12-28 15:24:00,15:24,8060850,9938275,1877425,BUY
2020-12-28 15:25:00,15:25,8344100,9793625,1449525,BUY
2020-12-28 15:26:00,15:26,8232850,9940350,1707500,BUY
2020-12-28 15:27:00,15:27,8094875,9648450,1553575,BUY
2020-12-28 15:28:00,15:28,8184125,9707150,1523025,BUY
2020-12-28 15:29:00,15:29,8243700,9802575,1558875,BUY
2020-12-29 09:15:00,09:15,7991100,9613150,1622050,BUY
2020-12-29 09:16:00,09:16,7983200,9298575,1315375,BUY
2020-12-29 09:17:00,09:17,8419150,10000800,1581650,BUY
2020-12-29 09:18:00,09:18,8437475,9977800,1540325,BUY
2020-12-29 09:19:00,09:19,8394150,10101725,1707575,BUY
2020-12-29 09:20:00,09:20,8706650,10587550,1880900,BUY
2020-12-29 09:21:00,09:21,8757675,10642850,1885175,BUY
2020-12-29 09:22:00,09:22,8678650,10434725,1756075,BUY
2020-12-29 09:23:00,09:23,9351125,11136900,1785775,BUY
2020-12-29 09:24:00,09:24,9316575,11013325,1696750,BUY
2020-12-29 09:25:00,09:25,9355350,11065825,1710475,BUY
2020-12-29 09:26:00,09:26,9476500,11389525,1913025,BUY
2020-12-29 09:27:00,09:27,9662625,11382975,1720350,BUY
2020-12-29 09:28:00,09:28,9613200,11373050,1759850,BUY
2020-12-29 09:29:00,09:29,9827050,11540200,1713150,BUY
2020-12-29 09:30:00,09:30,9867475,11206650,1339175,BUY
2020-12-29 09:31:00,09:31,9763375,11467500,1704125,BUY
2020-12-29 09:32:00,09:32,10129875,11753475,1623600,BUY
2020-12-29 09:33:00,09:33,10176725,11788975,1612250,BUY
2020-12-29 09:34:00,09:34,10196350,11189875,993525,BUY
2020-12-29 09:35:00,09:35,9925700,11400550,1474850,BUY
2020-12-29 09:36:00,09:36,10144350,11892850,1748500,BUY
2020-12-29 09:37:00,09:37,10006050,11960825,1954775,BUY
2020-12-29 09:38:00,09:38,10171100,12007875,1836775,BUY
2020-12-29 09:39:00,09:39,10241525,11781800,1540275,BUY
2020-12-29 09:40:00,09:40,10251300,11944975,1693675,BUY
2020-12-29 09:41:00,09:41,10451625,12059175,1607550,BUY
2020-12-29 09:42:00,09:42,10239975,11959175,1719200,BUY
2020-12-29 09:43:00,09:43,10334325,11852925,1518600,BUY
2020-12-29 09:44:00,09:44,10110825,11707575,1596750,BUY
2020-12-29 09:45:00,09:45,10278975,12068575,1789600,BUY
2020-12-29 09:46:00,09:46,10402850,11727500,1324650,BUY
2020-12-29 09:47:00,09:47,10315450,12047100,1731650,BUY
2020-12-29 09:48:00,09:48,10223200,12131850,1908650,BUY
2020-12-29 09:49:00,09:49,10423100,12045925,1622825,BUY
2020-12-29 09:50:00,09:50,10579775,12170575,1590800,BUY
2020-12-29 09:51:00,09:51,10512900,12163200,1650300,BUY
2020-12-29 09:52:00,09:52,10288175,12246100,1957925,BUY
2020-12-29 09:53:00,09:53,10402375,12291825,1889450,BUY
2020-12-29 09:54:00,09:54,10540525,12268825,1728300,BUY
2020-12-29 09:55:00,09:55,10517425,12343400,1825975,BUY
2020-12-29 09:56:00,09:56,10666575,12435875,1769300,BUY
2020-12-29 09:57:00,09:57,10645400,12412600,1767200,BUY
2020-12-29 09:58:00,09:58,10584150,12189825,1605675,BUY
2020-12-29 09:59:00,09:59,10647225,12483850,1836625,BUY
2020-12-29 10:00:00,10:00,10606975,12126950,1519975,BUY
2020-12-29 10:01:00,10:01,10721450,12394025,1672575,BUY
2020-12-29 10:02:00,10:02,10532500,12218575,1686075,BUY
2020-12-29 10:03:00,10:03,10510100,12270475,1760375,BUY
2020-12-29 10:04:00,10:04,10229775,12517200,2287425,BUY
2020-12-29 10:05:00,10:05,10522250,12878375,2356125,BUY
2020-12-29 10:06:00,10:06,10708275,12641600,1933325,BUY
2020-12-29 10:07:00,10:07,10793925,12603175,1809250,BUY
2020-12-29 10:08:00,10:08,10626450,12650400,2023950,BUY
2020-12-29 10:09:00,10:09,10855775,12695525,1839750,BUY
2020-12-29 10:10:00,10:10,10807200,12592400,1785200,BUY
2020-12-29 10:11:00,10:11,10759000,12843450,2084450,BUY
2020-12-29 10:12:00,10:12,10965350,12778525,1813175,BUY
2020-12-29 10:13:00,10:13,10726050,12770600,2044550,BUY
2020-12-29 10:14:00,10:14,10370100,12839675,2469575,BUY
2020-12-29 10:15:00,10:15,10759350,12907775,2148425,BUY
2020-12-29 10:16:00,10:16,10720625,12996750,2276125,BUY
2020-12-29 10:17:00,10:17,10840950,12625375,1784425,BUY
2020-12-29 10:18:00,10:18,10848200,12546275,1698075,BUY
2020-12-29 10:19:00,10:19,10939725,12235775,1296050,BUY
2020-12-29 10:20:00,10:20,10993000,12677775,1684775,BUY
2020-12-29 10:21:00,10:21,10935825,12998700,2062875,BUY
2020-12-29 10:22:00,10:22,11020975,12970200,1949225,BUY
2020-12-29 10:23:00,10:23,11023725,12919325,1895600,BUY
2020-12-29 10:24:00,10:24,10905475,12624800,1719325,BUY
2020-12-29 10:25:00,10:25,10867450,12971625,2104175,BUY
2020-12-29 10:26:00,10:26,11025900,12319050,1293150,BUY
2020-12-29 10:27:00,10:27,11069000,13132675,2063675,BUY
2020-12-29 10:28:00,10:28,11132100,13278075,2145975,BUY
2020-12-29 10:29:00,10:29,11209275,12965300,1756025,BUY
2020-12-29 10:30:00,10:30,11168400,12891825,1723425,BUY
2020-12-29 10:31:00,10:31,11209575,13029000,1819425,BUY
2020-12-29 10:32:00,10:32,11279650,12730750,1451100,BUY
2020-12-29 10:33:00,10:33,11100850,12778800,1677950,BUY
2020-12-29 10:34:00,10:34,11217725,12943375,1725650,BUY
2020-12-29 10:35:00,10:35,11612600,13297275,1684675,BUY
2020-12-29 10:36:00,10:36,11390550,12747450,1356900,BUY
2020-12-29 10:37:00,10:37,11357750,12617125,1259375,BUY
2020-12-29 10:38:00,10:38,11317400,13172200,1854800,BUY
2020-12-29 10:39:00,10:39,11209650,12443225,1233575,BUY
2020-12-29 10:40:00,10:40,11271600,12500825,1229225,BUY
2020-12-29 10:41:00,10:41,11474825,12783700,1308875,BUY
2020-12-29 10:42:00,10:42,11606825,12956100,1349275,BUY
2020-12-29 10:43:00,10:43,11324300,12620600,1296300,BUY
2020-12-29 10:44:00,10:44,11606675,12965050,1358375,BUY
2020-12-29 10:45:00,10:45,11515050,13191400,1676350,BUY
2020-12-29 10:46:00,10:46,11842375,13510425,1668050,BUY
2020-12-29 10:47:00,10:47,11538275,12769525,1231250,BUY
2020-12-29 10:48:00,10:48,11382900,12494075,1111175,BUY
2020-12-29 10:49:00,10:49,11304850,12331300,1026450,BUY
2020-12-29 10:50:00,10:50,11363925,12088225,724300,BUY
2020-12-29 10:51:00,10:51,11354950,12300725,945775,BUY
2020-12-29 10:52:00,10:52,11337075,12390175,1053100,BUY
2020-12-29 10:53:00,10:53,11258150,12173650,915500,BUY
2020-12-29 10:54:00,10:54,11280875,12085850,804975,BUY
2020-12-29 10:55:00,10:55,11292750,12163800,871050,BUY
2020-12-29 10:56:00,10:56,11199025,12098700,899675,BUY
2020-12-29 10:57:00,10:57,11028125,12082300,1054175,BUY
2020-12-29 10:58:00,10:58,10991425,11919225,927800,BUY
2020-12-29 10:59:00,10:59,11181075,12026675,845600,BUY
2020-12-29 11:00:00,11:00,11058300,12004125,945825,BUY
2020-12-29 11:01:00,11:01,11045225,11706200,660975,BUY
2020-12-29 11:02:00,11:02,11161925,11789700,627775,BUY
2020-12-29 11:03:00,11:03,11157400,12146850,989450,BUY
2020-12-29 11:04:00,11:04,11042000,12208750,1166750,BUY
2020-12-29 11:05:00,11:05,10996650,12032550,1035900,BUY
2020-12-29 11:06:00,11:06,11133150,11875800,742650,BUY
2020-12-29 11:07:00,11:07,10900175,11953375,1053200,BUY
2020-12-29 11:08:00,11:08,10870250,11983675,1113425,BUY
2020-12-29 11:09:00,11:09,11071350,11966275,894925,BUY
2020-12-29 11:10:00,11:10,11075450,12015900,940450,BUY
2020-12-29 11:11:00,11:11,10907425,11984750,1077325,BUY
2020-12-29 11:12:00,11:12,11026600,11966475,939875,BUY
2020-12-29 11:13:00,11:13,11173525,12094500,920975,BUY
2020-12-29 11:14:00,11:14,11162225,12186375,1024150,BUY
2020-12-29 11:15:00,11:15,10953250,12190625,1237375,BUY
2020-12-29 11:16:00,11:16,11142425,12186125,1043700,BUY
2020-12-29 11:17:00,11:17,11185625,12203625,1018000,BUY
2020-12-29 11:18:00,11:18,10902600,11926425,1023825,BUY
2020-12-29 11:19:00,11:19,10973050,12276250,1303200,BUY
2020-12-29 11:20:00,11:20,11151350,12152500,1001150,BUY
2020-12-29 11:21:00,11:21,11103775,11804400,700625,BUY
2020-12-29 11:22:00,11:22,11100525,11974225,873700,BUY
2020-12-29 11:23:00,11:23,11165650,12401450,1235800,BUY
2020-12-29 11:24:00,11:24,11275950,12149900,873950,BUY
2020-12-29 11:25:00,11:25,11145100,12446800,1301700,BUY
2020-12-29 11:26:00,11:26,11241225,12343050,1101825,BUY
2020-12-29 11:27:00,11:27,11041325,12396250,1354925,BUY
2020-12-29 11:28:00,11:28,11123500,12189675,1066175,BUY
2020-12-29 11:29:00,11:29,11351825,12325950,974125,BUY
2020-12-29 11:30:00,11:30,11124250,12297425,1173175,BUY
2020-12-29 11:31:00,11:31,11158500,12065550,907050,BUY
2020-12-29 11:32:00,11:32,11249100,12276525,1027425,BUY
2020-12-29 11:33:00,11:33,11477450,12260700,783250,BUY
2020-12-29 11:34:00,11:34,11228625,12375725,1147100,BUY
2020-12-29 11:35:00,11:35,11227850,12089900,862050,BUY
2020-12-29 11:36:00,11:36,11270125,12028450,758325,BUY
2020-12-29 11:37:00,11:37,11413500,11601950,188450,BUY
2020-12-29 11:38:00,11:38,11475300,11882925,407625,BUY
2020-12-29 11:39:00,11:39,11426175,11996750,570575,BUY
2020-12-29 11:40:00,11:40,11365800,11900425,534625,BUY
2020-12-29 11:41:00,11:41,11243475,11997300,753825,BUY
2020-12-29 11:42:00,11:42,11259275,12042850,783575,BUY
2020-12-29 11:43:00,11:43,11206350,11843425,637075,BUY
2020-12-29 11:44:00,11:44,11300100,12138500,838400,BUY
2020-12-29 11:45:00,11:45,11468125,11980100,511975,BUY
2020-12-29 11:46:00,11:46,11425625,11829325,403700,BUY
2020-12-29 11:47:00,11:47,11565450,11933950,368500,BUY
2020-12-29 11:48:00,11:48,11440575,11973100,532525,BUY
2020-12-29 11:49:00,11:49,11206875,12108425,901550,BUY
2020-12-29 11:50:00,11:50,11601625,12462400,860775,BUY
2020-12-29 11:51:00,11:51,11711000,12648700,937700,BUY
2020-12-29 11:52:00,11:52,11479850,12214425,734575,BUY
2020-12-29 11:53:00,11:53,11494800,11700875,206075,BUY
2020-12-29 11:54:00,11:54,11426525,12060300,633775,BUY
2020-12-29 11:55:00,11:55,11538275,12148950,610675,BUY
2020-12-29 11:56:00,11:56,11610825,12216075,605250,BUY
2020-12-29 11:57:00,11:57,11114450,12534775,1420325,BUY
2020-12-29 11:58:00,11:58,11336775,12102750,765975,BUY
2020-12-29 11:59:00,11:59,11141275,12438025,1296750,BUY
2020-12-29 12:00:00,12:00,11317350,11320000,2650,BUY
2020-12-29 12:01:00,12:01,11611700,12213575,601875,BUY
2020-12-29 12:02:00,12:02,11617750,12407575,789825,BUY
2020-12-29 12:03:00,12:03,10976425,12454175,1477750,BUY
2020-12-29 12:04:00,12:04,11406625,12306650,900025,BUY
2020-12-29 12:05:00,12:05,11536800,12327200,790400,BUY
2020-12-29 12:06:00,12:06,11204100,12319125,1115025,BUY
2020-12-29 12:07:00,12:07,11577300,12403225,825925,BUY
2020-12-29 12:08:00,12:08,11464375,12571525,1107150,BUY
2020-12-29 12:09:00,12:09,11557875,12512800,954925,BUY
2020-12-29 12:10:00,12:10,11286600,12458725,1172125,BUY
2020-12-29 12:11:00,12:11,11805800,12756225,950425,BUY
2020-12-29 12:12:00,12:12,11579300,12553675,974375,BUY
2020-12-29 12:13:00,12:13,11736425,12621075,884650,BUY
2020-12-29 12:14:00,12:14,11506525,11488250,-18275,SELL
2020-12-29 12:15:00,12:15,11492525,12447725,955200,BUY
2020-12-29 12:16:00,12:16,11558800,12576425,1017625,BUY
2020-12-29 12:17:00,12:17,11647475,11824850,177375,BUY
2020-12-29 12:18:00,12:18,11662600,12244275,581675,BUY
2020-12-29 12:19:00,12:19,11698375,12198925,500550,BUY
2020-12-29 12:20:00,12:20,11750550,12604075,853525,BUY
2020-12-29 12:21:00,12:21,11664250,12280550,616300,BUY
2020-12-29 12:22:00,12:22,11772025,12545500,773475,BUY
2020-12-29 12:23:00,12:23,11768175,12455800,687625,BUY
2020-12-29 12:24:00,12:24,11741750,12726375,984625,BUY
2020-12-29 12:25:00,12:25,11782250,12725800,943550,BUY
2020-12-29 12:26:00,12:26,11656300,12588750,932450,BUY
2020-12-29 12:27:00,12:27,11671275,12007175,335900,BUY
2020-12-29 12:28:00,12:28,11599150,12629450,1030300,BUY
2020-12-29 12:29:00,12:29,11840400,12587325,746925,BUY
2020-12-29 12:30:00,12:30,11725950,12617075,891125,BUY
2020-12-29 12:31:00,12:31,11294425,12262825,968400,BUY
2020-12-29 12:32:00,12:32,11876275,12600675,724400,BUY
2020-12-29 12:33:00,12:33,11774725,12736150,961425,BUY
2020-12-29 12:34:00,12:34,11966150,12788300,822150,BUY
2020-12-29 12:35:00,12:35,11920450,12502400,581950,BUY
2020-12-29 12:36:00,12:36,11875200,12646225,771025,BUY
2020-12-29 12:37:00,12:37,11682200,11467175,-215025,SELL
2020-12-29 12:38:00,12:38,11771275,12688275,917000,BUY
2020-12-29 12:39:00,12:39,11474425,12811400,1336975,BUY
2020-12-29 12:40:00,12:40,11670525,12881450,1210925,BUY
2020-12-29 12:41:00,12:41,11678550,12773400,1094850,BUY
2020-12-29 12:42:00,12:42,11595000,12300575,705575,BUY
2020-12-29 12:43:00,12:43,11501125,12309125,808000,BUY
2020-12-29 12:44:00,12:44,11556150,12205675,649525,BUY
2020-12-29 12:45:00,12:45,11634750,12348175,713425,BUY
2020-12-29 12:46:00,12:46,11628700,12258300,629600,BUY
2020-12-29 12:47:00,12:47,11619550,12747750,1128200,BUY
2020-12-29 12:48:00,12:48,11588050,12519575,931525,BUY
2020-12-29 12:49:00,12:49,11921625,12113875,192250,BUY
2020-12-29 12:50:00,12:50,11383825,11871875,488050,BUY
2020-12-29 12:51:00,12:51,11467650,11671750,204100,BUY
2020-12-29 12:52:00,12:52,11756175,12468800,712625,BUY
2020-12-29 12:53:00,12:53,11640925,11448375,-192550,SELL
2020-12-29 12:54:00,12:54,11675225,12244950,569725,BUY
2020-12-29 12:55:00,12:55,11423625,12491700,1068075,BUY
2020-12-29 12:56:00,12:56,11636850,12885300,1248450,BUY
2020-12-29 12:57:00,12:57,11583375,12343450,760075,BUY
2020-12-29 12:58:00,12:58,11762750,12507875,745125,BUY
2020-12-29 12:59:00,12:59,11285500,12698700,1413200,BUY
2020-12-29 13:00:00,13:00,11886500,12824200,937700,BUY
2020-12-29 13:01:00,13:01,11601425,12556875,955450,BUY
2020-12-29 13:02:00,13:02,11920725,12900225,979500,BUY
2020-12-29 13:03:00,13:03,11740625,12417275,676650,BUY
2020-12-29 13:04:00,13:04,12300550,13068375,767825,BUY
2020-12-29 13:05:00,13:05,12215975,12652100,436125,BUY
2020-12-29 13:06:00,13:06,11721325,12901425,1180100,BUY
2020-12-29 13:07:00,13:07,11658525,12827875,1169350,BUY
2020-12-29 13:08:00,13:08,11644725,12790700,1145975,BUY
2020-12-29 13:09:00,13:09,11775350,12919850,1144500,BUY
2020-12-29 13:10:00,13:10,11427750,12828200,1400450,BUY
2020-12-29 13:11:00,13:11,11427000,12463475,1036475,BUY
2020-12-29 13:12:00,13:12,10948600,12277225,1328625,BUY
2020-12-29 13:13:00,13:13,11081025,12405350,1324325,BUY
2020-12-29 13:14:00,13:14,11174200,11644500,470300,BUY
2020-12-29 13:15:00,13:15,11054400,12365900,1311500,BUY
2020-12-29 13:16:00,13:16,10928100,12505650,1577550,BUY
2020-12-29 13:17:00,13:17,10905025,12535925,1630900,BUY
2020-12-29 13:18:00,13:18,10683925,12261800,1577875,BUY
2020-12-29 13:19:00,13:19,10944100,12509725,1565625,BUY
2020-12-29 13:20:00,13:20,10924625,12522175,1597550,BUY
2020-12-29 13:21:00,13:21,10919775,12644100,1724325,BUY
2020-12-29 13:22:00,13:22,10869625,12314200,1444575,BUY
2020-12-29 13:23:00,13:23,10868300,12564025,1695725,BUY
2020-12-29 13:24:00,13:24,10687850,11825450,1137600,BUY
2020-12-29 13:25:00,13:25,10744850,12348800,1603950,BUY
2020-12-29 13:26:00,13:26,10443175,12547750,2104575,BUY
2020-12-29 13:27:00,13:27,10754925,12667600,1912675,BUY
2020-12-29 13:28:00,13:28,10569650,12349250,1779600,BUY
2020-12-29 13:29:00,13:29,10892700,12360575,1467875,BUY
2020-12-29 13:30:00,13:30,10823825,12299500,1475675,BUY
2020-12-29 13:31:00,13:31,10823100,12276000,1452900,BUY
2020-12-29 13:32:00,13:32,10864450,12090700,1226250,BUY
2020-12-29 13:33:00,13:33,10574825,12180125,1605300,BUY
2020-12-29 13:34:00,13:34,10265525,12461250,2195725,BUY
2020-12-29 13:35:00,13:35,10556000,12674775,2118775,BUY
2020-12-29 13:36:00,13:36,10664950,12505400,1840450,BUY
2020-12-29 13:37:00,13:37,10727100,12541975,1814875,BUY
2020-12-29 13:38:00,13:38,10905475,12821575,1916100,BUY
2020-12-29 13:39:00,13:39,10673425,12832275,2158850,BUY
2020-12-29 13:40:00,13:40,11147200,13006325,1859125,BUY
2020-12-29 13:41:00,13:41,10879050,12888100,2009050,BUY
2020-12-29 13:42:00,13:42,10833700,12717100,1883400,BUY
2020-12-29 13:43:00,13:43,10923125,12732625,1809500,BUY
2020-12-29 13:44:00,13:44,10635100,12741725,2106625,BUY
2020-12-29 13:45:00,13:45,10971525,12511600,1540075,BUY
2020-12-29 13:46:00,13:46,10853325,12291875,1438550,BUY
2020-12-29 13:47:00,13:47,10592375,12274725,1682350,BUY
2020-12-29 13:48:00,13:48,10945575,11798700,853125,BUY
2020-12-29 13:49:00,13:49,10978950,12836625,1857675,BUY
2020-12-29 13:50:00,13:50,10920200,12857250,1937050,BUY
2020-12-29 13:51:00,13:51,11390050,12478150,1088100,BUY
2020-12-29 13:52:00,13:52,11219375,12087400,868025,BUY
2020-12-29 13:53:00,13:53,10759025,12897975,2138950,BUY
2020-12-29 13:54:00,13:54,11311025,11763925,452900,BUY
2020-12-29 13:55:00,13:55,11249075,12795725,1546650,BUY
2020-12-29 13:56:00,13:56,11317200,12902350,1585150,BUY
2020-12-29 13:57:00,13:57,11245450,12799925,1554475,BUY
2020-12-29 13:58:00,13:58,10780275,12535625,1755350,BUY
2020-12-29 13:59:00,13:59,10794450,12903375,2108925,BUY
2020-12-29 14:00:00,14:00,11279600,13009800,1730200,BUY
2020-12-29 14:01:00,14:01,11223675,12624275,1400600,BUY
2020-12-29 14:02:00,14:02,11252950,12595850,1342900,BUY
2020-12-29 14:03:00,14:03,11359050,12186575,827525,BUY
2020-12-29 14:04:00,14:04,11262975,12625650,1362675,BUY
2020-12-29 14:05:00,14:05,10936900,12166525,1229625,BUY
2020-12-29 14:06:00,14:06,10875675,13078150,2202475,BUY
2020-12-29 14:07:00,14:07,11183750,12915775,1732025,BUY
2020-12-29 14:08:00,14:08,10828525,12568475,1739950,BUY
2020-12-29 14:09:00,14:09,11400125,12774400,1374275,BUY
2020-12-29 14:10:00,14:10,11232700,13061975,1829275,BUY
2020-12-29 14:11:00,14:11,11195475,12516950,1321475,BUY
2020-12-29 14:12:00,14:12,11308550,12518500,1209950,BUY
2020-12-29 14:13:00,14:13,10781450,12829475,2048025,BUY
2020-12-29 14:14:00,14:14,11121825,12622725,1500900,BUY
2020-12-29 14:15:00,14:15,11238825,12682350,1443525,BUY
2020-12-29 14:16:00,14:16,11071325,12658325,1587000,BUY
2020-12-29 14:17:00,14:17,10955550,13140950,2185400,BUY
2020-12-29 14:18:00,14:18,10735100,13233875,2498775,BUY
2020-12-29 14:19:00,14:19,11088325,12703675,1615350,BUY
2020-12-29 14:20:00,14:20,11082900,12597725,1514825,BUY
2020-12-29 14:21:00,14:21,11128275,12978650,1850375,BUY
2020-12-29 14:22:00,14:22,11142950,12687150,1544200,BUY
2020-12-29 14:23:00,14:23,11314775,13109400,1794625,BUY
2020-12-29 14:24:00,14:24,11090125,12960200,1870075,BUY
2020-12-29 14:25:00,14:25,11154100,13149775,1995675,BUY
2020-12-29 14:26:00,14:26,11111150,13200325,2089175,BUY
2020-12-29 14:27:00,14:27,11084825,13030200,1945375,BUY
2020-12-29 14:28:00,14:28,11019150,13197800,2178650,BUY
2020-12-29 14:29:00,14:29,10999900,12984625,1984725,BUY
2020-12-29 14:30:00,14:30,11078450,13188175,2109725,BUY
2020-12-29 14:31:00,14:31,11012275,13115275,2103000,BUY
2020-12-29 14:32:00,14:32,10911525,12816350,1904825,BUY
2020-12-29 14:33:00,14:33,10911600,12980000,2068400,BUY
2020-12-29 14:34:00,14:34,10867375,12685575,1818200,BUY
2020-12-29 14:35:00,14:35,11083350,12793625,1710275,BUY
2020-12-29 14:36:00,14:36,11115425,13058925,1943500,BUY
2020-12-29 14:37:00,14:37,10924975,12698500,1773525,BUY
2020-12-29 14:38:00,14:38,10996175,12814825,1818650,BUY
2020-12-29 14:39:00,14:39,11216350,12706975,1490625,BUY
2020-12-29 14:40:00,14:40,11223225,12812775,1589550,BUY
2020-12-29 14:41:00,14:41,10851150,12699275,1848125,BUY
2020-12-29 14:42:00,14:42,11178050,13180650,2002600,BUY
2020-12-29 14:43:00,14:43,11131900,13259250,2127350,BUY
2020-12-29 14:44:00,14:44,11098725,12731675,1632950,BUY
2020-12-29 14:45:00,14:45,10899175,12995850,2096675,BUY
2020-12-29 14:46:00,14:46,10874625,12596450,1721825,BUY
2020-12-29 14:47:00,14:47,10874900,12958475,2083575,BUY
2020-12-29 14:48:00,14:48,10651175,12570650,1919475,BUY
2020-12-29 14:49:00,14:49,10672225,12266125,1593900,BUY
2020-12-29 14:50:00,14:50,10481700,13069525,2587825,BUY
2020-12-29 14:51:00,14:51,10666450,12968175,2301725,BUY
2020-12-29 14:52:00,14:52,10712850,12884400,2171550,BUY
2020-12-29 14:53:00,14:53,10533725,12139650,1605925,BUY
2020-12-29 14:54:00,14:54,10527575,12972525,2444950,BUY
2020-12-29 14:55:00,14:55,10831950,13007800,2175850,BUY
2020-12-29 14:56:00,14:56,10735750,12785025,2049275,BUY
2020-12-29 14:57:00,14:57,10649525,12555850,1906325,BUY
2020-12-29 14:58:00,14:58,10340500,12970625,2630125,BUY
2020-12-29 14:59:00,14:59,10524625,12853325,2328700,BUY
2020-12-29 15:00:00,15:00,10148525,12928525,2780000,BUY
2020-12-29 15:01:00,15:01,10561750,12935800,2374050,BUY
2020-12-29 15:02:00,15:02,10436300,12934325,2498025,BUY
2020-12-29 15:03:00,15:03,10219750,12311425,2091675,BUY
2020-12-29 15:04:00,15:04,10448275,12779600,2331325,BUY
2020-12-29 15:05:00,15:05,10319825,12640000,2320175,BUY
2020-12-29 15:06:00,15:06,10320375,12580625,2260250,BUY
2020-12-29 15:07:00,15:07,10161825,12689575,2527750,BUY
2020-12-29 15:08:00,15:08,10383300,12555025,2171725,BUY
2020-12-29 15:09:00,15:09,10372500,12622500,2250000,BUY
2020-12-29 15:10:00,15:10,10295050,12555575,2260525,BUY
2020-12-29 15:11:00,15:11,10232775,12545100,2312325,BUY
2020-12-29 15:12:00,15:12,10267800,12404250,2136450,BUY
2020-12-29 15:13:00,15:13,10132000,12535600,2403600,BUY
2020-12-29 15:14:00,15:14,10301425,12367675,2066250,BUY
2020-12-29 15:15:00,15:15,9985250,12337175,2351925,BUY
2020-12-29 15:16:00,15:16,9994250,12356550,2362300,BUY
2020-12-29 15:17:00,15:17,9989400,12398575,2409175,BUY
2020-12-29 15:18:00,15:18,9868300,12180650,2312350,BUY
2020-12-29 15:19:00,15:19,9904650,12207650,2303000,BUY
2020-12-29 15:20:00,15:20,10028950,12247675,2218725,BUY
2020-12-29 15:21:00,15:21,9536000,11878050,2342050,BUY
2020-12-29 15:22:00,15:22,9414600,11903300,2488700,BUY
2020-12-29 15:23:00,15:23,9276525,11859600,2583075,BUY
2020-12-29 15:24:00,15:24,9223775,11441925,2218150,BUY
2020-12-29 15:25:00,15:25,9244800,11733125,2488325,BUY
2020-12-29 15:26:00,15:26,9229550,11748775,2519225,BUY
2020-12-29 15:27:00,15:27,9034550,11590700,2556150,BUY
2020-12-29 15:28:00,15:28,8980325,11545525,2565200,BUY
2020-12-29 15:29:00,15:29,9182525,11582750,2400225,BUY
2020-12-30 09:15:00,09:15,8795850,11229275,2433425,BUY
2020-12-30 09:16:00,09:16,8656025,11250000,2593975,BUY
2020-12-30 09:17:00,09:17,9398375,11526600,2128225,BUY
2020-12-30 09:18:00,09:18,9367050,11735225,2368175,BUY
2020-12-30 09:19:00,09:19,9382350,11789650,2407300,BUY
2020-12-30 09:20:00,09:20,9864900,12351800,2486900,BUY
2020-12-30 09:21:00,09:21,9950750,12421350,2470600,BUY
2020-12-30 09:22:00,09:22,9958700,12391875,2433175,BUY
2020-12-30 09:23:00,09:23,10427175,12631175,2204000,BUY
2020-12-30 09:24:00,09:24,10277125,12617225,2340100,BUY
2020-12-30 09:25:00,09:25,10420625,12516675,2096050,BUY
2020-12-30 09:26:00,09:26,10468350,12677225,2208875,BUY
2020-12-30 09:27:00,09:27,10431775,12392875,1961100,BUY
2020-12-30 09:28:00,09:28,10384375,12752900,2368525,BUY
2020-12-30 09:29:00,09:29,10801125,13038075,2236950,BUY
2020-12-30 09:30:00,09:30,10852600,13078750,2226150,BUY
2020-12-30 09:31:00,09:31,10852600,13093125,2240525,BUY
2020-12-30 09:32:00,09:32,11232500,13380050,2147550,BUY
2020-12-30 09:33:00,09:33,11092275,13271700,2179425,BUY
2020-12-30 09:34:00,09:34,11258425,13359775,2101350,BUY
2020-12-30 09:35:00,09:35,11398750,13134050,1735300,BUY
2020-12-30 09:36:00,09:36,11373825,13550950,2177125,BUY
2020-12-30 09:37:00,09:37,11257825,13416075,2158250,BUY
2020-12-30 09:38:00,09:38,11634575,13333500,1698925,BUY
2020-12-30 09:39:00,09:39,11493375,13524650,2031275,BUY
2020-12-30 09:40:00,09:40,11813200,13767675,1954475,BUY
2020-12-30 09:41:00,09:41,11864075,13730875,1866800,BUY
2020-12-30 09:42:00,09:42,11455850,13405375,1949525,BUY
2020-12-30 09:43:00,09:43,11835025,13742750,1907725,BUY
2020-12-30 09:44:00,09:44,11864700,13797850,1933150,BUY
2020-12-30 09:45:00,09:45,12001900,13286300,1284400,BUY
2020-12-30 09:46:00,09:46,12105150,13575400,1470250,BUY
2020-12-30 09:47:00,09:47,12167900,13980275,1812375,BUY
2020-12-30 09:48:00,09:48,12063200,13871850,1808650,BUY
2020-12-30 09:49:00,09:49,12020525,13582525,1562000,BUY
2020-12-30 09:50:00,09:50,12506075,14242250,1736175,BUY
2020-12-30 09:51:00,09:51,12150225,13733525,1583300,BUY
2020-12-30 09:52:00,09:52,12451875,14227525,1775650,BUY
2020-12-30 09:53:00,09:53,12580600,13788650,1208050,BUY
2020-12-30 09:54:00,09:54,12352075,13856025,1503950,BUY
2020-12-30 09:55:00,09:55,12497775,13923950,1426175,BUY
2020-12-30 09:56:00,09:56,12421000,14033225,1612225,BUY
2020-12-30 09:57:00,09:57,12600750,14387150,1786400,BUY
2020-12-30 09:58:00,09:58,12438450,14052675,1614225,BUY
2020-12-30 09:59:00,09:59,12401425,14086225,1684800,BUY
2020-12-30 10:00:00,10:00,12469000,14188650,1719650,BUY
2020-12-30 10:01:00,10:01,12566500,14467375,1900875,BUY
2020-12-30 10:02:00,10:02,12453425,14365425,1912000,BUY
2020-12-30 10:03:00,10:03,12801950,14359225,1557275,BUY
2020-12-30 10:04:00,10:04,12579700,14417775,1838075,BUY
2020-12-30 10:05:00,10:05,12457375,14598875,2141500,BUY
2020-12-30 10:06:00,10:06,12778275,14241225,1462950,BUY
2020-12-30 10:07:00,10:07,12931675,14486050,1554375,BUY
2020-12-30 10:08:00,10:08,12790575,14378875,1588300,BUY
2020-12-30 10:09:00,10:09,12472675,14347425,1874750,BUY
2020-12-30 10:10:00,10:10,12650075,14777825,2127750,BUY
2020-12-30 10:11:00,10:11,12652275,14787150,2134875,BUY
2020-12-30 10:12:00,10:12,12609500,14703700,2094200,BUY
2020-12-30 10:13:00,10:13,12606675,14711900,2105225,BUY
2020-12-30 10:14:00,10:14,12734300,14303775,1569475,BUY
2020-12-30 10:15:00,10:15,12671475,14404450,1732975,BUY
2020-12-30 10:16:00,10:16,12867125,14597125,1730000,BUY
2020-12-30 10:17:00,10:17,12517550,13555525,1037975,BUY
2020-12-30 10:18:00,10:18,12961825,14806800,1844975,BUY
2020-12-30 10:19:00,10:19,12926675,14192575,1265900,BUY
2020-12-30 10:20:00,10:20,13147125,14618225,1471100,BUY
2020-12-30 10:21:00,10:21,13161675,14460525,1298850,BUY
2020-12-30 10:22:00,10:22,13118725,14863625,1744900,BUY
2020-12-30 10:23:00,10:23,12809350,14194450,1385100,BUY
2020-12-30 10:24:00,10:24,13003125,14204075,1200950,BUY
2020-12-30 10:25:00,10:25,12858225,14612050,1753825,BUY
2020-12-30 10:26:00,10:26,13151950,14606275,1454325,BUY
2020-12-30 10:27:00,10:27,13073775,14808875,1735100,BUY
2020-12-30 10:28:00,10:28,13102000,14675325,1573325,BUY
2020-12-30 10:29:00,10:29,13237800,14664450,1426650,BUY
2020-12-30 10:30:00,10:30,13052325,14626775,1574450,BUY
2020-12-30 10:31:00,10:31,13046150,14512700,1466550,BUY
2020-12-30 10:32:00,10:32,12774250,14281750,1507500,BUY
2020-12-30 10:33:00,10:33,12980325,14213250,1232925,BUY
2020-12-30 10:34:00,10:34,12611375,14421225,1809850,BUY
2020-12-30 10:35:00,10:35,12791925,14273875,1481950,BUY
2020-12-30 10:36:00,10:36,13075200,14532825,1457625,BUY
2020-12-30 10:37:00,10:37,13060525,14440175,1379650,BUY
2020-12-30 10:38:00,10:38,13079100,14521825,1442725,BUY
2020-12-30 10:39:00,10:39,13301400,14386275,1084875,BUY
2020-12-30 10:40:00,10:40,13178575,14618100,1439525,BUY
2020-12-30 10:41:00,10:41,13028950,14269475,1240525,BUY
2020-12-30 10:42:00,10:42,13038250,13911200,872950,BUY
2020-12-30 10:43:00,10:43,13071500,14777675,1706175,BUY
2020-12-30 10:44:00,10:44,13189750,14591375,1401625,BUY
2020-12-30 10:45:00,10:45,13284825,14709025,1424200,BUY
2020-12-30 10:46:00,10:46,13091750,14797700,1705950,BUY
2020-12-30 10:47:00,10:47,12841425,14414050,1572625,BUY
2020-12-30 10:48:00,10:48,13221800,14377275,1155475,BUY
2020-12-30 10:49:00,10:49,13049650,14179925,1130275,BUY
2020-12-30 10:50:00,10:50,13394100,14456975,1062875,BUY
2020-12-30 10:51:00,10:51,13256125,14928625,1672500,BUY
2020-12-30 10:52:00,10:52,13200225,14335875,1135650,BUY
2020-12-30 10:53:00,10:53,13210200,14714550,1504350,BUY
2020-12-30 10:54:00,10:54,12882750,14285750,1403000,BUY
2020-12-30 10:55:00,10:55,13081900,14380300,1298400,BUY
2020-12-30 10:56:00,10:56,13426400,14793600,1367200,BUY
2020-12-30 10:57:00,10:57,13395875,14960075,1564200,BUY
2020-12-30 10:58:00,10:58,13456625,14554500,1097875,BUY
2020-12-30 10:59:00,10:59,13270900,14819625,1548725,BUY
2020-12-30 11:00:00,11:00,13273525,14522600,1249075,BUY
2020-12-30 11:01:00,11:01,13315300,14453600,1138300,BUY
2020-12-30 11:02:00,11:02,13438050,14468125,1030075,BUY
2020-12-30 11:03:00,11:03,13322900,14874300,1551400,BUY
2020-12-30 11:04:00,11:04,13208725,14771025,1562300,BUY
2020-12-30 11:05:00,11:05,13347575,14627175,1279600,BUY
2020-12-30 11:06:00,11:06,13367650,14858050,1490400,BUY
2020-12-30 11:07:00,11:07,13158625,14456275,1297650,BUY
2020-12-30 11:08:00,11:08,13127125,14010100,882975,BUY
2020-12-30 11:09:00,11:09,13334425,13497250,162825,BUY
2020-12-30 11:10:00,11:10,13274700,13804125,529425,BUY
2020-12-30 11:11:00,11:11,13320925,14769775,1448850,BUY
2020-12-30 11:12:00,11:12,12999650,14500025,1500375,BUY
2020-12-30 11:13:00,11:13,13235775,14547675,1311900,BUY
2020-12-30 11:14:00,11:14,13346350,14837500,1491150,BUY
2020-12-30 11:15:00,11:15,13458250,14637525,1179275,BUY
2020-12-30 11:16:00,11:16,13336225,14328575,992350,BUY
2020-12-30 11:17:00,11:17,13373350,13994375,621025,BUY
2020-12-30 11:18:00,11:18,13394600,14388600,994000,BUY
2020-12-30 11:19:00,11:19,13493525,14833900,1340375,BUY
2020-12-30 11:20:00,11:20,13558200,14896475,1338275,BUY
2020-12-30 11:21:00,11:21,13574375,14538600,964225,BUY
2020-12-30 11:22:00,11:22,13689525,14437175,747650,BUY
2020-12-30 11:23:00,11:23,13726025,14936575,1210550,BUY
2020-12-30 11:24:00,11:24,13637625,14598325,960700,BUY
2020-12-30 11:25:00,11:25,13871700,14992900,1121200,BUY
2020-12-30 11:26:00,11:26,13269625,14507025,1237400,BUY
2020-12-30 11:27:00,11:27,13680750,14653275,972525,BUY
2020-12-30 11:28:00,11:28,13609375,14501650,892275,BUY
2020-12-30 11:29:00,11:29,13855025,15163075,1308050,BUY
2020-12-30 11:30:00,11:30,13517775,15089050,1571275,BUY
2020-12-30 11:31:00,11:31,13786300,14190975,404675,BUY
2020-12-30 11:32:00,11:32,13552300,14798775,1246475,BUY
2020-12-30 11:33:00,11:33,13807700,14436550,628850,BUY
2020-12-30 11:34:00,11:34,13553950,14919750,1365800,BUY
2020-12-30 11:35:00,11:35,13615900,14815100,1199200,BUY
2020-12-30 11:36:00,11:36,14039050,15173800,1134750,BUY
2020-12-30 11:37:00,11:37,13902425,14861975,959550,BUY
2020-12-30 11:38:00,11:38,13857625,14697800,840175,BUY
2020-12-30 11:39:00,11:39,13718775,14985275,1266500,BUY
2020-12-30 11:40:00,11:40,13807525,14139225,331700,BUY
2020-12-30 11:41:00,11:41,13889675,14879325,989650,BUY
2020-12-30 11:42:00,11:42,13941625,14872775,931150,BUY
2020-12-30 11:43:00,11:43,14046700,15026375,979675,BUY
2020-12-30 11:44:00,11:44,13928300,15107500,1179200,BUY
2020-12-30 11:45:00,11:45,13894475,14783125,888650,BUY
2020-12-30 11:46:00,11:46,13519725,14576250,1056525,BUY
2020-12-30 11:47:00,11:47,13971150,15034275,1063125,BUY
2020-12-30 11:48:00,11:48,13772200,14745375,973175,BUY
2020-12-30 11:49:00,11:49,13830500,15050475,1219975,BUY
2020-12-30 11:50:00,11:50,13809400,14632650,823250,BUY
2020-12-30 11:51:00,11:51,13875575,14332125,456550,BUY
2020-12-30 11:52:00,11:52,13846250,14858275,1012025,BUY
2020-12-30 11:53:00,11:53,13867700,13823275,-44425,SELL
2020-12-30 11:54:00,11:54,13884525,14150050,265525,BUY
2020-12-30 11:55:00,11:55,13787600,14901750,1114150,BUY
2020-12-30 11:56:00,11:56,13924600,14555450,630850,BUY
2020-12-30 11:57:00,11:57,13812650,13941200,128550,BUY
2020-12-30 11:58:00,11:58,14204825,14962225,757400,BUY
2020-12-30 11:59:00,11:59,13981750,14776375,794625,BUY
2020-12-30 12:00:00,12:00,14017300,14558550,541250,BUY
2020-12-30 12:01:00,12:01,13728175,14836225,1108050,BUY
2020-12-30 12:02:00,12:02,14146650,14716975,570325,BUY
2020-12-30 12:03:00,12:03,13591000,14756925,1165925,BUY
2020-12-30 12:04:00,12:04,13942525,14592475,649950,BUY
2020-12-30 12:05:00,12:05,14065150,15050475,985325,BUY
2020-12-30 12:06:00,12:06,13991450,14552575,561125,BUY
2020-12-30 12:07:00,12:07,13827325,14627100,799775,BUY
2020-12-30 12:08:00,12:08,14070475,15079725,1009250,BUY
2020-12-30 12:09:00,12:09,13901625,14969700,1068075,BUY
2020-12-30 12:10:00,12:10,13694200,14997575,1303375,BUY
2020-12-30 12:11:00,12:11,13865225,14742750,877525,BUY
2020-12-30 12:12:00,12:12,13637375,14980975,1343600,BUY
2020-12-30 12:13:00,12:13,13730550,14986000,1255450,BUY
2020-12-30 12:14:00,12:14,14056225,15122225,1066000,BUY
2020-12-30 12:15:00,12:15,14030525,14781225,750700,BUY
2020-12-30 12:16:00,12:16,13782175,14619425,837250,BUY
2020-12-30 12:17:00,12:17,13646375,14899375,1253000,BUY
2020-12-30 12:18:00,12:18,13946850,14885250,938400,BUY
2020-12-30 12:19:00,12:19,13716125,14409325,693200,BUY
2020-12-30 12:20:00,12:20,14175825,14893725,717900,BUY
2020-12-30 12:21:00,12:21,14039975,14926350,886375,BUY
2020-12-30 12:22:00,12:22,14204600,14616400,411800,BUY
2020-12-30 12:23:00,12:23,13765525,14269350,503825,BUY
2020-12-30 12:24:00,12:24,13917100,13960100,43000,BUY
2020-12-30 12:25:00,12:25,13942625,14597000,654375,BUY
2020-12-30 12:26:00,12:26,14056425,14735375,678950,BUY
2020-12-30 12:27:00,12:27,13796900,14735325,938425,BUY
2020-12-30 12:28:00,12:28,12842150,14812950,1970800,BUY
2020-12-30 12:29:00,12:29,13753175,14565425,812250,BUY
2020-12-30 12:30:00,12:30,14234050,14464725,230675,BUY
2020-12-30 12:31:00,12:31,13951275,14363275,412000,BUY
2020-12-30 12:32:00,12:32,13814300,14642775,828475,BUY
2020-12-30 12:33:00,12:33,13910100,14307400,397300,BUY
2020-12-30 12:34:00,12:34,13792750,14848050,1055300,BUY
2020-12-30 12:35:00,12:35,14073350,14855575,782225,BUY
2020-12-30 12:36:00,12:36,14057725,14424950,367225,BUY
2020-12-30 12:37:00,12:37,14471000,14907425,436425,BUY
2020-12-30 12:38:00,12:38,14241075,15129825,888750,BUY
2020-12-30 12:39:00,12:39,14225600,14709550,483950,BUY
2020-12-30 12:40:00,12:40,14145450,14575625,430175,BUY
2020-12-30 12:41:00,12:41,14002200,14574075,571875,BUY
2020-12-30 12:42:00,12:42,13978700,13801300,-177400,SELL
2020-12-30 12:43:00,12:43,13987025,13717250,-269775,SELL
2020-12-30 12:44:00,12:44,13999300,13922225,-77075,SELL
2020-12-30 12:45:00,12:45,13917175,13669900,-247275,SELL
2020-12-30 12:46:00,12:46,13879850,13791875,-87975,SELL
2020-12-30 12:47:00,12:47,13900700,13838175,-62525,SELL
2020-12-30 12:48:00,12:48,13988250,13980000,-8250,SELL
2020-12-30 12:49:00,12:49,13849975,13924525,74550,BUY
2020-12-30 12:50:00,12:50,13871950,14056575,184625,BUY
2020-12-30 12:51:00,12:51,13712700,13270625,-442075,SELL
2020-12-30 12:52:00,12:52,13982675,13982525,-150,SELL
2020-12-30 12:53:00,12:53,14014200,13915350,-98850,SELL
2020-12-30 12:54:00,12:54,13759925,14004775,244850,BUY
2020-12-30 12:55:00,12:55,13999875,13144550,-855325,SELL
2020-12-30 12:56:00,12:56,13908275,13772400,-135875,SELL
2020-12-30 12:57:00,12:57,13766850,14058925,292075,BUY
2020-12-30 12:58:00,12:58,13593050,13892775,299725,BUY
2020-12-30 12:59:00,12:59,13855400,14060050,204650,BUY
2020-12-30 13:00:00,13:00,14048575,14257925,209350,BUY
2020-12-30 13:01:00,13:01,14086375,14307550,221175,BUY
2020-12-30 13:02:00,13:02,13979675,14033650,53975,BUY
2020-12-30 13:03:00,13:03,13724125,13976550,252425,BUY
2020-12-30 13:04:00,13:04,13901700,14280775,379075,BUY
2020-12-30 13:05:00,13:05,13963075,14204575,241500,BUY
2020-12-30 13:06:00,13:06,14088725,14200150,111425,BUY
2020-12-30 13:07:00,13:07,14075175,13103250,-971925,SELL
2020-12-30 13:08:00,13:08,14090000,14175150,85150,BUY
2020-12-30 13:09:00,13:09,14121650,14050650,-71000,SELL
2020-12-30 13:10:00,13:10,14096425,13989375,-107050,SELL
2020-12-30 13:11:00,13:11,13955225,13556975,-398250,SELL
2020-12-30 13:12:00,13:12,13881075,13955925,74850,BUY
2020-12-30 13:13:00,13:13,13732175,14295325,563150,BUY
2020-12-30 13:14:00,13:14,13971900,13890750,-81150,SELL
2020-12-30 13:15:00,13:15,13894400,14094900,200500,BUY
2020-12-30 13:16:00,13:16,13891800,13660175,-231625,SELL
2020-12-30 13:17:00,13:17,13877175,14367800,490625,BUY
2020-12-30 13:18:00,13:18,14058325,14352325,294000,BUY
2020-12-30 13:19:00,13:19,13935025,14399475,464450,BUY
2020-12-30 13:20:00,13:20,13689500,13829900,140400,BUY
2020-12-30 13:21:00,13:21,13997750,14239650,241900,BUY
2020-12-30 13:22:00,13:22,13700800,14205250,504450,BUY
2020-12-30 13:23:00,13:23,13884525,13858925,-25600,SELL
2020-12-30 13:24:00,13:24,13766575,13726475,-40100,SELL
2020-12-30 13:25:00,13:25,13843050,13923775,80725,BUY
2020-12-30 13:26:00,13:26,13844725,13622800,-221925,SELL
2020-12-30 13:27:00,13:27,13759250,14045325,286075,BUY
2020-12-30 13:28:00,13:28,13863500,13764025,-99475,SELL
2020-12-30 13:29:00,13:29,13944250,14041475,97225,BUY
2020-12-30 13:30:00,13:30,14066600,13925625,-140975,SELL
2020-12-30 13:31:00,13:31,14121150,13936275,-184875,SELL
2020-12-30 13:32:00,13:32,14162975,13951350,-211625,SELL
2020-12-30 13:33:00,13:33,14073225,14004100,-69125,SELL
2020-12-30 13:34:00,13:34,13862250,14023600,161350,BUY
2020-12-30 13:35:00,13:35,14070625,13906975,-163650,SELL
2020-12-30 13:36:00,13:36,13980650,13950525,-30125,SELL
2020-12-30 13:37:00,13:37,14039675,14046450,6775,BUY
2020-12-30 13:38:00,13:38,14051500,13871275,-180225,SELL
2020-12-30 13:39:00,13:39,14211575,14473925,262350,BUY
2020-12-30 13:40:00,13:40,14278775,14194550,-84225,SELL
2020-12-30 13:41:00,13:41,14339100,14429900,90800,BUY
2020-12-30 13:42:00,13:42,13913075,13888325,-24750,SELL
2020-12-30 13:43:00,13:43,13895575,13942675,47100,BUY
2020-12-30 13:44:00,13:44,13808325,14264050,455725,BUY
2020-12-30 13:45:00,13:45,13513475,14283200,769725,BUY
2020-12-30 13:46:00,13:46,13499400,13870375,370975,BUY
2020-12-30 13:47:00,13:47,13519275,13697075,177800,BUY
2020-12-30 13:48:00,13:48,13491050,14266375,775325,BUY
2020-12-30 13:49:00,13:49,13560675,14174050,613375,BUY
2020-12-30 13:50:00,13:50,13761675,14139025,377350,BUY
2020-12-30 13:51:00,13:51,13448825,14258725,809900,BUY
2020-12-30 13:52:00,13:52,13550275,14151475,601200,BUY
2020-12-30 13:53:00,13:53,13583250,14271675,688425,BUY
2020-12-30 13:54:00,13:54,13601125,14124575,523450,BUY
2020-12-30 13:55:00,13:55,13553775,14176000,622225,BUY
2020-12-30 13:56:00,13:56,13257225,14234675,977450,BUY
2020-12-30 13:57:00,13:57,13647525,14009225,361700,BUY
2020-12-30 13:58:00,13:58,13574600,14242450,667850,BUY
2020-12-30 13:59:00,13:59,13630950,13927025,296075,BUY
2020-12-30 14:00:00,14:00,13750025,14248075,498050,BUY
2020-12-30 14:01:00,14:01,13643725,13952800,309075,BUY
2020-12-30 14:02:00,14:02,13722200,14108800,386600,BUY
2020-12-30 14:03:00,14:03,13353575,14400700,1047125,BUY
2020-12-30 14:04:00,14:04,13266275,14413725,1147450,BUY
2020-12-30 14:05:00,14:05,13510700,14422675,911975,BUY
2020-12-30 14:06:00,14:06,13368125,14486475,1118350,BUY
2020-12-30 14:07:00,14:07,13160700,14528325,1367625,BUY
2020-12-30 14:08:00,14:08,13249850,14365100,1115250,BUY
2020-12-30 14:09:00,14:09,13216500,14439825,1223325,BUY
2020-12-30 14:10:00,14:10,13356725,14337725,981000,BUY
2020-12-30 14:11:00,14:11,13232775,14306800,1074025,BUY
2020-12-30 14:12:00,14:12,13189025,14339550,1150525,BUY
2020-12-30 14:13:00,14:13,13230775,14438350,1207575,BUY
2020-12-30 14:14:00,14:14,13261750,14444375,1182625,BUY
2020-12-30 14:15:00,14:15,13157025,14362950,1205925,BUY
2020-12-30 14:16:00,14:16,12865350,14333800,1468450,BUY
2020-12-30 14:17:00,14:17,13224200,14414825,1190625,BUY
2020-12-30 14:18:00,14:18,13121025,13853975,732950,BUY
2020-12-30 14:19:00,14:19,13065650,14397125,1331475,BUY
2020-12-30 14:20:00,14:20,13041675,14321200,1279525,BUY
2020-12-30 14:21:00,14:21,13268375,14391425,1123050,BUY
2020-12-30 14:22:00,14:22,13186100,14391350,1205250,BUY
2020-12-30 14:23:00,14:23,13192075,14423925,1231850,BUY
2020-12-30 14:24:00,14:24,13265300,14152775,887475,BUY
2020-12-30 14:25:00,14:25,13264150,14190475,926325,BUY
2020-12-30 14:26:00,14:26,13306700,14276050,969350,BUY
2020-12-30 14:27:00,14:27,13151725,14474425,1322700,BUY
2020-12-30 14:28:00,14:28,13101250,14222075,1120825,BUY
2020-12-30 14:29:00,14:29,12890050,14425400,1535350,BUY
2020-12-30 14:30:00,14:30,13275675,14461975,1186300,BUY
2020-12-30 14:31:00,14:31,13210650,13802750,592100,BUY
2020-12-30 14:32:00,14:32,13202750,14217300,1014550,BUY
2020-12-30 14:33:00,14:33,13111175,14565825,1454650,BUY
2020-12-30 14:34:00,14:34,13042900,14415275,1372375,BUY
2020-12-30 14:35:00,14:35,13090725,14122550,1031825,BUY
2020-12-30 14:36:00,14:36,13190875,14198075,1007200,BUY
2020-12-30 14:37:00,14:37,13127700,13825325,697625,BUY
2020-12-30 14:38:00,14:38,13003425,14152975,1149550,BUY
2020-12-30 14:39:00,14:39,13037950,14082350,1044400,BUY
2020-12-30 14:40:00,14:40,12954850,14091850,1137000,BUY
2020-12-30 14:41:00,14:41,13022600,14166250,1143650,BUY
2020-12-30 14:42:00,14:42,12806700,13638200,831500,BUY
2020-12-30 14:43:00,14:43,12937600,13965200,1027600,BUY
2020-12-30 14:44:00,14:44,13144000,14085450,941450,BUY
2020-12-30 14:45:00,14:45,13150950,14096025,945075,BUY
2020-12-30 14:46:00,14:46,12813425,13905900,1092475,BUY
2020-12-30 14:47:00,14:47,13109075,14325775,1216700,BUY
2020-12-30 14:48:00,14:48,13048200,14318850,1270650,BUY
2020-12-30 14:49:00,14:49,13101475,13894025,792550,BUY
2020-12-30 14:50:00,14:50,12840450,14138575,1298125,BUY
2020-12-30 14:51:00,14:51,13037525,14040700,1003175,BUY
2020-12-30 14:52:00,14:52,12890325,14304925,1414600,BUY
2020-12-30 14:53:00,14:53,12945075,14330100,1385025,BUY
2020-12-30 14:54:00,14:54,12676875,14060800,1383925,BUY
2020-12-30 14:55:00,14:55,12825700,14169125,1343425,BUY
2020-12-30 14:56:00,14:56,12800350,14215600,1415250,BUY
2020-12-30 14:57:00,14:57,12965100,14063125,1098025,BUY
2020-12-30 14:58:00,14:58,12865950,13950750,1084800,BUY
2020-12-30 14:59:00,14:59,12385575,14026000,1640425,BUY
2020-12-30 15:00:00,15:00,12745375,14009125,1263750,BUY
2020-12-30 15:01:00,15:01,12638825,13993800,1354975,BUY
2020-12-30 15:02:00,15:02,12755200,13883075,1127875,BUY
2020-12-30 15:03:00,15:03,12223275,13768000,1544725,BUY
2020-12-30 15:04:00,15:04,12525150,13835100,1309950,BUY
2020-12-30 15:05:00,15:05,12467525,13800875,1333350,BUY
2020-12-30 15:06:00,15:06,12272125,13695250,1423125,BUY
2020-12-30 15:07:00,15:07,12197300,13695900,1498600,BUY
2020-12-30 15:08:00,15:08,12398500,13672725,1274225,BUY
2020-12-30 15:09:00,15:09,12284625,13565425,1280800,BUY
2020-12-30 15:10:00,15:10,12065700,13557500,1491800,BUY
2020-12-30 15:11:00,15:11,12380725,13413975,1033250,BUY
2020-12-30 15:12:00,15:12,12076425,13533100,1456675,BUY
2020-12-30 15:13:00,15:13,12117025,13547675,1430650,BUY
2020-12-30 15:14:00,15:14,12085250,13510150,1424900,BUY
2020-12-30 15:15:00,15:15,12010400,13232850,1222450,BUY
2020-12-30 15:16:00,15:16,11932600,13314200,1381600,BUY
2020-12-30 15:17:00,15:17,11979375,13252675,1273300,BUY
2020-12-30 15:18:00,15:18,11829700,12999075,1169375,BUY
2020-12-30 15:19:00,15:19,11591500,12983425,1391925,BUY
2020-12-30 15:20:00,15:20,11677925,12916850,1238925,BUY
2020-12-30 15:21:00,15:21,11341075,12656425,1315350,BUY
2020-12-30 15:22:00,15:22,11373625,12626750,1253125,BUY
2020-12-30 15:23:00,15:23,11287025,12638200,1351175,BUY
2020-12-30 15:24:00,15:24,10965375,12291100,1325725,BUY
2020-12-30 15:25:00,15:25,11122625,12353075,1230450,BUY
2020-12-30 15:26:00,15:26,10872250,12111925,1239675,BUY
2020-12-30 15:27:00,15:27,10950675,12091150,1140475,BUY
2020-12-30 15:28:00,15:28,11004075,12117050,1112975,BUY
2020-12-30 15:29:00,15:29,11052875,12171350,1118475,BUY
2020-12-31 09:15:00,09:15,10866350,11874975,1008625,BUY
2020-12-31 09:16:00,09:16,10914300,11829325,915025,BUY
2020-12-31 09:17:00,09:17,11558725,12717575,1158850,BUY
2020-12-31 09:18:00,09:18,11596075,12773600,1177525,BUY
2020-12-31 09:19:00,09:19,11628125,12820875,1192750,BUY
2020-12-31 09:20:00,09:20,12510650,13549950,1039300,BUY
2020-12-31 09:21:00,09:21,12441525,13449825,1008300,BUY
2020-12-31 09:22:00,09:22,12320250,13519725,1199475,BUY
2020-12-31 09:23:00,09:23,12723450,13875700,1152250,BUY
2020-12-31 09:24:00,09:24,12812625,14024775,1212150,BUY
2020-12-31 09:25:00,09:25,12753250,14023500,1270250,BUY
2020-12-31 09:26:00,09:26,13563350,14601800,1038450,BUY
2020-12-31 09:27:00,09:27,13592775,14661025,1068250,BUY
2020-12-31 09:28:00,09:28,13608625,14745675,1137050,BUY
2020-12-31 09:29:00,09:29,14001625,15039925,1038300,BUY
2020-12-31 09:30:00,09:30,13950375,15412250,1461875,BUY
2020-12-31 09:31:00,09:31,13965750,15431675,1465925,BUY
2020-12-31 09:32:00,09:32,14305575,15897350,1591775,BUY
2020-12-31 09:33:00,09:33,14414775,15912600,1497825,BUY
2020-12-31 09:34:00,09:34,14328525,15887900,1559375,BUY
2020-12-31 09:35:00,09:35,14659400,16254350,1594950,BUY
2020-12-31 09:36:00,09:36,14691600,16255700,1564100,BUY
2020-12-31 09:37:00,09:37,14548825,16264500,1715675,BUY
2020-12-31 09:38:00,09:38,15112375,16446550,1334175,BUY
2020-12-31 09:39:00,09:39,14869925,16322625,1452700,BUY
2020-12-31 09:40:00,09:40,14957275,16462100,1504825,BUY
2020-12-31 09:41:00,09:41,15383950,16540550,1156600,BUY
2020-12-31 09:42:00,09:42,15114525,16216250,1101725,BUY
2020-12-31 09:43:00,09:43,15309250,16458875,1149625,BUY
2020-12-31 09:44:00,09:44,15291800,16653300,1361500,BUY
2020-12-31 09:45:00,09:45,15447475,16645950,1198475,BUY
2020-12-31 09:46:00,09:46,15170725,16756150,1585425,BUY
2020-12-31 09:47:00,09:47,15589875,16866350,1276475,BUY
2020-12-31 09:48:00,09:48,15455325,16607925,1152600,BUY
2020-12-31 09:49:00,09:49,15591650,16718725,1127075,BUY
2020-12-31 09:50:00,09:50,15569050,17131175,1562125,BUY
2020-12-31 09:51:00,09:51,15583700,16993700,1410000,BUY
2020-12-31 09:52:00,09:52,15452225,16890525,1438300,BUY
2020-12-31 09:53:00,09:53,15715250,16843850,1128600,BUY
2020-12-31 09:54:00,09:54,15315850,17272325,1956475,BUY
2020-12-31 09:55:00,09:55,15682425,17420475,1738050,BUY
2020-12-31 09:56:00,09:56,15957775,17696625,1738850,BUY
2020-12-31 09:57:00,09:57,15680425,17590800,1910375,BUY
2020-12-31 09:58:00,09:58,15691150,17556475,1865325,BUY
2020-12-31 09:59:00,09:59,15847350,17762375,1915025,BUY
2020-12-31 10:00:00,10:00,15660175,17673075,2012900,BUY
2020-12-31 10:01:00,10:01,15659975,17760450,2100475,BUY
2020-12-31 10:02:00,10:02,15900700,17826375,1925675,BUY
2020-12-31 10:03:00,10:03,15765250,17853725,2088475,BUY
2020-12-31 10:04:00,10:04,15715325,17707050,1991725,BUY
2020-12-31 10:05:00,10:05,15739550,17816675,2077125,BUY
2020-12-31 10:06:00,10:06,15669875,18007325,2337450,BUY
2020-12-31 10:07:00,10:07,16178300,18006500,1828200,BUY
2020-12-31 10:08:00,10:08,15969475,17560000,1590525,BUY
2020-12-31 10:09:00,10:09,16056225,18161750,2105525,BUY
2020-12-31 10:10:00,10:10,15829725,18116400,2286675,BUY
2020-12-31 10:11:00,10:11,15822150,18108475,2286325,BUY
2020-12-31 10:12:00,10:12,16048750,17842750,1794000,BUY
2020-12-31 10:13:00,10:13,16007625,18027475,2019850,BUY
2020-12-31 10:14:00,10:14,15937775,18381950,2444175,BUY
2020-12-31 10:15:00,10:15,15938900,18390725,2451825,BUY
2020-12-31 10:16:00,10:16,15541250,18203550,2662300,BUY
2020-12-31 10:17:00,10:17,15840400,17633950,1793550,BUY
2020-12-31 10:18:00,10:18,16217600,18386250,2168650,BUY
2020-12-31 10:19:00,10:19,15487300,18421475,2934175,BUY
2020-12-31 10:20:00,10:20,16006800,18185550,2178750,BUY
2020-12-31 10:21:00,10:21,16066100,17951975,1885875,BUY
2020-12-31 10:22:00,10:22,15742850,18369350,2626500,BUY
2020-12-31 10:23:00,10:23,16108175,18503275,2395100,BUY
2020-12-31 10:24:00,10:24,15917100,18113775,2196675,BUY
2020-12-31 10:25:00,10:25,16222225,18530775,2308550,BUY
2020-12-31 10:26:00,10:26,16209425,17682775,1473350,BUY
2020-12-31 10:27:00,10:27,15637200,18559400,2922200,BUY
2020-12-31 10:28:00,10:28,15928675,18616525,2687850,BUY
2020-12-31 10:29:00,10:29,16194925,18362575,2167650,BUY
2020-12-31 10:30:00,10:30,16089475,18163250,2073775,BUY
2020-12-31 10:31:00,10:31,16320325,18461150,2140825,BUY
2020-12-31 10:32:00,10:32,16281925,17965800,1683875,BUY
2020-12-31 10:33:00,10:33,16351725,18061475,1709750,BUY
2020-12-31 10:34:00,10:34,16154600,18758625,2604025,BUY
2020-12-31 10:35:00,10:35,16170900,18218100,2047200,BUY
2020-12-31 10:36:00,10:36,16178025,18013675,1835650,BUY
2020-12-31 10:37:00,10:37,16243675,18435625,2191950,BUY
2020-12-31 10:38:00,10:38,16482925,18962500,2479575,BUY
2020-12-31 10:39:00,10:39,16196850,18779275,2582425,BUY
2020-12-31 10:40:00,10:40,16283250,18407725,2124475,BUY
2020-12-31 10:41:00,10:41,16426250,18837625,2411375,BUY
2020-12-31 10:42:00,10:42,16363200,18491225,2128025,BUY
2020-12-31 10:43:00,10:43,16371150,18732825,2361675,BUY
2020-12-31 10:44:00,10:44,16367875,18747275,2379400,BUY
2020-12-31 10:45:00,10:45,16615925,19164100,2548175,BUY
2020-12-31 10:46:00,10:46,16072625,18511575,2438950,BUY
2020-12-31 10:47:00,10:47,16255775,18569350,2313575,BUY
2020-12-31 10:48:00,10:48,16043600,19015350,2971750,BUY
2020-12-31 10:49:00,10:49,16142075,18256400,2114325,BUY
2020-12-31 10:50:00,10:50,16002025,19249750,3247725,BUY
2020-12-31 10:51:00,10:51,16331800,18834125,2502325,BUY
2020-12-31 10:52:00,10:52,16191200,18932125,2740925,BUY
2020-12-31 10:53:00,10:53,16511375,18869725,2358350,BUY
2020-12-31 10:54:00,10:54,16862125,19582225,2720100,BUY
2020-12-31 10:55:00,10:55,16899775,19597350,2697575,BUY
2020-12-31 10:56:00,10:56,16430825,18557525,2126700,BUY
2020-12-31 10:57:00,10:57,16467575,18712200,2244625,BUY
2020-12-31 10:58:00,10:58,16473125,18520450,2047325,BUY
2020-12-31 10:59:00,10:59,16932375,18603625,1671250,BUY
2020-12-31 11:00:00,11:00,16763400,18489875,1726475,BUY
2020-12-31 11:01:00,11:01,16706500,18744825,2038325,BUY
2020-12-31 11:02:00,11:02,16950275,18711975,1761700,BUY
2020-12-31 11:03:00,11:03,16967825,18996475,2028650,BUY
2020-12-31 11:04:00,11:04,16851025,18878850,2027825,BUY
2020-12-31 11:05:00,11:05,16996750,18792050,1795300,BUY
2020-12-31 11:06:00,11:06,16719525,18361775,1642250,BUY
2020-12-31 11:07:00,11:07,16872300,18619050,1746750,BUY
2020-12-31 11:08:00,11:08,16847425,18537525,1690100,BUY
2020-12-31 11:09:00,11:09,16778675,18694575,1915900,BUY
2020-12-31 11:10:00,11:10,16607075,18249950,1642875,BUY
2020-12-31 11:11:00,11:11,16609150,18924150,2315000,BUY
2020-12-31 11:12:00,11:12,16862600,18917450,2054850,BUY
2020-12-31 11:13:00,11:13,16695200,18080675,1385475,BUY
2020-12-31 11:14:00,11:14,16531400,18793375,2261975,BUY
2020-12-31 11:15:00,11:15,16921775,18682900,1761125,BUY
2020-12-31 11:16:00,11:16,17066925,19247500,2180575,BUY
2020-12-31 11:17:00,11:17,17035525,19212025,2176500,BUY
2020-12-31 11:18:00,11:18,16455200,19007650,2552450,BUY
2020-12-31 11:19:00,11:19,17018450,18731800,1713350,BUY
2020-12-31 11:20:00,11:20,17164550,19015350,1850800,BUY
2020-12-31 11:21:00,11:21,17004700,18393250,1388550,BUY
2020-12-31 11:22:00,11:22,16971275,18793175,1821900,BUY
2020-12-31 11:23:00,11:23,17001775,19090875,2089100,BUY
2020-12-31 11:24:00,11:24,17175625,19119250,1943625,BUY
2020-12-31 11:25:00,11:25,17021350,18914775,1893425,BUY
2020-12-31 11:26:00,11:26,17454375,19699625,2245250,BUY
2020-12-31 11:27:00,11:27,17196700,19617500,2420800,BUY
2020-12-31 11:28:00,11:28,17357450,19236300,1878850,BUY
2020-12-31 11:29:00,11:29,17294975,19592550,2297575,BUY
2020-12-31 11:30:00,11:30,17252000,19638000,2386000,BUY
2020-12-31 11:31:00,11:31,17256325,19489400,2233075,BUY
2020-12-31 11:32:00,11:32,17405450,19169475,1764025,BUY
2020-12-31 11:33:00,11:33,17451900,19030100,1578200,BUY
2020-12-31 11:34:00,11:34,17444825,18995275,1550450,BUY
2020-12-31 11:35:00,11:35,17647475,19688225,2040750,BUY
2020-12-31 11:36:00,11:36,17117775,19603375,2485600,BUY
2020-12-31 11:37:00,11:37,17536575,18408450,871875,BUY
2020-12-31 11:38:00,11:38,17000350,19244450,2244100,BUY
2020-12-31 11:39:00,11:39,17282650,19509375,2226725,BUY
2020-12-31 11:40:00,11:40,17396400,19312025,1915625,BUY
2020-12-31 11:41:00,11:41,17680600,19391225,1710625,BUY
2020-12-31 11:42:00,11:42,17414775,19167075,1752300,BUY
2020-12-31 11:43:00,11:43,17848225,19917850,2069625,BUY
2020-12-31 11:44:00,11:44,17629625,19884775,2255150,BUY
2020-12-31 11:45:00,11:45,17867650,19951200,2083550,BUY
2020-12-31 11:46:00,11:46,17812425,19869625,2057200,BUY
2020-12-31 11:47:00,11:47,17236100,19973875,2737775,BUY
2020-12-31 11:48:00,11:48,17657150,20225625,2568475,BUY
2020-12-31 11:49:00,11:49,17391375,20244500,2853125,BUY
2020-12-31 11:50:00,11:50,17411100,19993900,2582800,BUY
2020-12-31 11:51:00,11:51,17358050,20501125,3143075,BUY
2020-12-31 11:52:00,11:52,17683675,20280225,2596550,BUY
2020-12-31 11:53:00,11:53,17940075,20715150,2775075,BUY
2020-12-31 11:54:00,11:54,17771950,20394550,2622600,BUY
2020-12-31 11:55:00,11:55,17784500,20057150,2272650,BUY
2020-12-31 11:56:00,11:56,17861175,20374800,2513625,BUY
2020-12-31 11:57:00,11:57,17465175,19561975,2096800,BUY
2020-12-31 11:58:00,11:58,17702050,20032675,2330625,BUY
2020-12-31 11:59:00,11:59,17666625,19834150,2167525,BUY
2020-12-31 12:00:00,12:00,17682125,19368750,1686625,BUY
2020-12-31 12:01:00,12:01,17462100,19546200,2084100,BUY
2020-12-31 12:02:00,12:02,17609600,19686175,2076575,BUY
2020-12-31 12:03:00,12:03,17711825,20215350,2503525,BUY
2020-12-31 12:04:00,12:04,17554550,20054175,2499625,BUY
2020-12-31 12:05:00,12:05,17665275,20366725,2701450,BUY
2020-12-31 12:06:00,12:06,17480775,20116175,2635400,BUY
2020-12-31 12:07:00,12:07,17756725,19742000,1985275,BUY
2020-12-31 12:08:00,12:08,17868775,20152475,2283700,BUY
2020-12-31 12:09:00,12:09,17575900,19744800,2168900,BUY
2020-12-31 12:10:00,12:10,17486750,19403500,1916750,BUY
2020-12-31 12:11:00,12:11,17532975,19856525,2323550,BUY
2020-12-31 12:12:00,12:12,17501350,19882750,2381400,BUY
2020-12-31 12:13:00,12:13,17611650,19884925,2273275,BUY
2020-12-31 12:14:00,12:14,17816825,20145500,2328675,BUY
2020-12-31 12:15:00,12:15,17645700,19812075,2166375,BUY
2020-12-31 12:16:00,12:16,17576600,19867925,2291325,BUY
2020-12-31 12:17:00,12:17,17359025,19725650,2366625,BUY
2020-12-31 12:18:00,12:18,17397725,18783275,1385550,BUY
2020-12-31 12:19:00,12:19,17715600,18888375,1172775,BUY
2020-12-31 12:20:00,12:20,17244325,19252025,2007700,BUY
2020-12-31 12:21:00,12:21,17791350,19498050,1706700,BUY
2020-12-31 12:22:00,12:22,17655725,19519225,1863500,BUY
2020-12-31 12:23:00,12:23,17787000,19647000,1860000,BUY
2020-12-31 12:24:00,12:24,17821425,19294350,1472925,BUY
2020-12-31 12:25:00,12:25,17834125,18861675,1027550,BUY
2020-12-31 12:26:00,12:26,17908475,19278150,1369675,BUY
2020-12-31 12:27:00,12:27,17780400,19159975,1379575,BUY
2020-12-31 12:28:00,12:28,17869550,18933375,1063825,BUY
2020-12-31 12:29:00,12:29,17957600,19327225,1369625,BUY
2020-12-31 12:30:00,12:30,18119900,19777700,1657800,BUY
2020-12-31 12:31:00,12:31,18210350,19834700,1624350,BUY
2020-12-31 12:32:00,12:32,18202700,19677750,1475050,BUY
2020-12-31 12:33:00,12:33,17873050,19435500,1562450,BUY
2020-12-31 12:34:00,12:34,17787800,19460400,1672600,BUY
2020-12-31 12:35:00,12:35,17662075,19371325,1709250,BUY
2020-12-31 12:36:00,12:36,17343075,19107975,1764900,BUY
2020-12-31 12:37:00,12:37,17559825,19019675,1459850,BUY
2020-12-31 12:38:00,12:38,17555975,18947875,1391900,BUY
2020-12-31 12:39:00,12:39,17467125,18980475,1513350,BUY
2020-12-31 12:40:00,12:40,17459400,19090700,1631300,BUY
2020-12-31 12:41:00,12:41,17301125,19079425,1778300,BUY
2020-12-31 12:42:00,12:42,17340250,18638500,1298250,BUY
2020-12-31 12:43:00,12:43,17621825,19138750,1516925,BUY
2020-12-31 12:44:00,12:44,17572350,19237675,1665325,BUY
2020-12-31 12:45:00,12:45,17619675,19253450,1633775,BUY
2020-12-31 12:46:00,12:46,17714875,19178350,1463475,BUY
2020-12-31 12:47:00,12:47,17393375,19020475,1627100,BUY
2020-12-31 12:48:00,12:48,17596275,19126700,1530425,BUY
2020-12-31 12:49:00,12:49,17489500,18952600,1463100,BUY
2020-12-31 12:50:00,12:50,17405800,19180875,1775075,BUY
2020-12-31 12:51:00,12:51,17816200,19688800,1872600,BUY
2020-12-31 12:52:00,12:52,17905250,19740700,1835450,BUY
2020-12-31 12:53:00,12:53,17819475,19353350,1533875,BUY
2020-12-31 12:54:00,12:54,17337650,18959050,1621400,BUY
2020-12-31 12:55:00,12:55,17879975,19658425,1778450,BUY
2020-12-31 12:56:00,12:56,17594850,19774700,2179850,BUY
2020-12-31 12:57:00,12:57,17784175,19519450,1735275,BUY
2020-12-31 12:58:00,12:58,17901025,19420650,1519625,BUY
2020-12-31 12:59:00,12:59,17974100,19614225,1640125,BUY
2020-12-31 13:00:00,13:00,17798525,19674750,1876225,BUY
2020-12-31 13:01:00,13:01,17820450,19624050,1803600,BUY
2020-12-31 13:02:00,13:02,17909975,19326850,1416875,BUY
2020-12-31 13:03:00,13:03,17791350,19835825,2044475,BUY
2020-12-31 13:04:00,13:04,17599450,19657000,2057550,BUY
2020-12-31 13:05:00,13:05,17899625,19841850,1942225,BUY
2020-12-31 13:06:00,13:06,17854400,19722850,1868450,BUY
2020-12-31 13:07:00,13:07,17836025,19843400,2007375,BUY
2020-12-31 13:08:00,13:08,17788525,19997450,2208925,BUY
2020-12-31 13:09:00,13:09,17974675,19157450,1182775,BUY
2020-12-31 13:10:00,13:10,17737500,19222300,1484800,BUY
2020-12-31 13:11:00,13:11,17740500,18706900,966400,BUY
2020-12-31 13:12:00,13:12,17710550,19857625,2147075,BUY
2020-12-31 13:13:00,13:13,17603100,20011175,2408075,BUY
2020-12-31 13:14:00,13:14,17700925,19934575,2233650,BUY
2020-12-31 13:15:00,13:15,17750125,20030050,2279925,BUY
2020-12-31 13:16:00,13:16,17708625,20109525,2400900,BUY
2020-12-31 13:17:00,13:17,17802050,19474800,1672750,BUY
2020-12-31 13:18:00,13:18,18303850,20253400,1949550,BUY
2020-12-31 13:19:00,13:19,18120600,19688275,1567675,BUY
2020-12-31 13:20:00,13:20,18076925,20138375,2061450,BUY
2020-12-31 13:21:00,13:21,17913525,19786125,1872600,BUY
2020-12-31 13:22:00,13:22,17680850,19794700,2113850,BUY
2020-12-31 13:23:00,13:23,17763050,20102875,2339825,BUY
2020-12-31 13:24:00,13:24,17625475,19802075,2176600,BUY
2020-12-31 13:25:00,13:25,17722025,20063400,2341375,BUY
2020-12-31 13:26:00,13:26,18033750,20234375,2200625,BUY
2020-12-31 13:27:00,13:27,17566050,20334975,2768925,BUY
2020-12-31 13:28:00,13:28,18223075,20369150,2146075,BUY
2020-12-31 13:29:00,13:29,18238425,20423250,2184825,BUY
2020-12-31 13:30:00,13:30,17946025,20247050,2301025,BUY
2020-12-31 13:31:00,13:31,17935575,20271850,2336275,BUY
2020-12-31 13:32:00,13:32,17875075,20091900,2216825,BUY
2020-12-31 13:33:00,13:33,17735175,20152175,2417000,BUY
2020-12-31 13:34:00,13:34,17428500,19608150,2179650,BUY
2020-12-31 13:35:00,13:35,17642875,20162750,2519875,BUY
2020-12-31 13:36:00,13:36,17928025,20317100,2389075,BUY
2020-12-31 13:37:00,13:37,17835350,20287550,2452200,BUY
2020-12-31 13:38:00,13:38,17890575,20290625,2400050,BUY
2020-12-31 13:39:00,13:39,17629150,20312225,2683075,BUY
2020-12-31 13:40:00,13:40,17581900,20394150,2812250,BUY
2020-12-31 13:41:00,13:41,17784025,20100325,2316300,BUY
2020-12-31 13:42:00,13:42,17843525,20295350,2451825,BUY
2020-12-31 13:43:00,13:43,17832675,19861600,2028925,BUY
2020-12-31 13:44:00,13:44,17810750,19877000,2066250,BUY
2020-12-31 13:45:00,13:45,17822125,20188825,2366700,BUY
2020-12-31 13:46:00,13:46,17649325,20479500,2830175,BUY
2020-12-31 13:47:00,13:47,17716750,20367825,2651075,BUY
2020-12-31 13:48:00,13:48,17591650,20425225,2833575,BUY
2020-12-31 13:49:00,13:49,17459925,20259575,2799650,BUY
2020-12-31 13:50:00,13:50,17860050,20280975,2420925,BUY
2020-12-31 13:51:00,13:51,17894875,20092750,2197875,BUY
2020-12-31 13:52:00,13:52,17628350,20058775,2430425,BUY
2020-12-31 13:53:00,13:53,17680075,20229700,2549625,BUY
2020-12-31 13:54:00,13:54,17819200,20039600,2220400,BUY
2020-12-31 13:55:00,13:55,17879875,20245350,2365475,BUY
2020-12-31 13:56:00,13:56,17757175,19824250,2067075,BUY
2020-12-31 13:57:00,13:57,17426325,20150500,2724175,BUY
2020-12-31 13:58:00,13:58,17552150,20035500,2483350,BUY
2020-12-31 13:59:00,13:59,17440925,19786175,2345250,BUY
2020-12-31 14:00:00,14:00,17426025,20059450,2633425,BUY
2020-12-31 14:01:00,14:01,17547600,19961775,2414175,BUY
2020-12-31 14:02:00,14:02,17491500,20112100,2620600,BUY
2020-12-31 14:03:00,14:03,17426025,20382700,2956675,BUY
2020-12-31 14:04:00,14:04,17397700,19936175,2538475,BUY
2020-12-31 14:05:00,14:05,17247125,20332250,3085125,BUY
2020-12-31 14:06:00,14:06,17103650,20185575,3081925,BUY
2020-12-31 14:07:00,14:07,16941400,19899500,2958100,BUY
2020-12-31 14:08:00,14:08,16941575,19963550,3021975,BUY
2020-12-31 14:09:00,14:09,17231925,20074500,2842575,BUY
2020-12-31 14:10:00,14:10,17427275,20306575,2879300,BUY
2020-12-31 14:11:00,14:11,17414050,20145100,2731050,BUY
2020-12-31 14:12:00,14:12,17188100,19697025,2508925,BUY
2020-12-31 14:13:00,14:13,17119725,19875825,2756100,BUY
2020-12-31 14:14:00,14:14,17388650,20018500,2629850,BUY
2020-12-31 14:15:00,14:15,17427375,20127300,2699925,BUY
2020-12-31 14:16:00,14:16,17271250,20083350,2812100,BUY
2020-12-31 14:17:00,14:17,17257350,19869025,2611675,BUY
2020-12-31 14:18:00,14:18,17208400,19380750,2172350,BUY
2020-12-31 14:19:00,14:19,17235625,19315050,2079425,BUY
2020-12-31 14:20:00,14:20,17067450,18674300,1606850,BUY
2020-12-31 14:21:00,14:21,16913750,19087675,2173925,BUY
2020-12-31 14:22:00,14:22,16846275,19456700,2610425,BUY
2020-12-31 14:23:00,14:23,16766275,18846925,2080650,BUY
2020-12-31 14:24:00,14:24,16934200,19195350,2261150,BUY
2020-12-31 14:25:00,14:25,16996750,18407725,1410975,BUY
2020-12-31 14:26:00,14:26,17032225,18502950,1470725,BUY
2020-12-31 14:27:00,14:27,17032325,19611800,2579475,BUY
2020-12-31 14:28:00,14:28,17049825,19606925,2557100,BUY
2020-12-31 14:29:00,14:29,17024250,19478775,2454525,BUY
2020-12-31 14:30:00,14:30,17068050,19183100,2115050,BUY
2020-12-31 14:31:00,14:31,16805175,19418075,2612900,BUY
2020-12-31 14:32:00,14:32,17055300,19534500,2479200,BUY
2020-12-31 14:33:00,14:33,16970250,19810425,2840175,BUY
2020-12-31 14:34:00,14:34,16871950,19805050,2933100,BUY
2020-12-31 14:35:00,14:35,16845275,19455200,2609925,BUY
2020-12-31 14:36:00,14:36,16622300,19364075,2741775,BUY
2020-12-31 14:37:00,14:37,16784250,19120575,2336325,BUY
2020-12-31 14:38:00,14:38,16773900,18888325,2114425,BUY
2020-12-31 14:39:00,14:39,16650850,19223750,2572900,BUY
2020-12-31 14:40:00,14:40,16695850,19115225,2419375,BUY
2020-12-31 14:41:00,14:41,16849975,18546925,1696950,BUY
2020-12-31 14:42:00,14:42,16865775,19021725,2155950,BUY
2020-12-31 14:43:00,14:43,16769300,18209025,1439725,BUY
2020-12-31 14:44:00,14:44,16600925,18961000,2360075,BUY
2020-12-31 14:45:00,14:45,16904775,18785600,1880825,BUY
2020-12-31 14:46:00,14:46,16649850,18932875,2283025,BUY
2020-12-31 14:47:00,14:47,16884500,18705600,1821100,BUY
2020-12-31 14:48:00,14:48,16893725,19000975,2107250,BUY
2020-12-31 14:49:00,14:49,16749600,18694425,1944825,BUY
2020-12-31 14:50:00,14:50,16723250,18874500,2151250,BUY
2020-12-31 14:51:00,14:51,16901750,19079950,2178200,BUY
2020-12-31 14:52:00,14:52,16739350,18929650,2190300,BUY
2020-12-31 14:53:00,14:53,16812125,18796100,1983975,BUY
2020-12-31 14:54:00,14:54,16805525,18905375,2099850,BUY
2020-12-31 14:55:00,14:55,16617475,18949125,2331650,BUY
2020-12-31 14:56:00,14:56,16741150,18895050,2153900,BUY
2020-12-31 14:57:00,14:57,16945775,19053975,2108200,BUY
2020-12-31 14:58:00,14:58,16851325,18981125,2129800,BUY
2020-12-31 14:59:00,14:59,16685375,18998350,2312975,BUY
2020-12-31 15:00:00,15:00,16692300,19171100,2478800,BUY
2020-12-31 15:01:00,15:01,16588850,19063825,2474975,BUY
2020-12-31 15:02:00,15:02,16542400,18980875,2438475,BUY
2020-12-31 15:03:00,15:03,16283125,18323650,2040525,BUY
2020-12-31 15:04:00,15:04,16176600,18521275,2344675,BUY
2020-12-31 15:05:00,15:05,16437450,17492375,1054925,BUY
2020-12-31 15:06:00,15:06,16506175,17520350,1014175,BUY
2020-12-31 15:07:00,15:07,16484025,17679875,1195850,BUY
2020-12-31 15:08:00,15:08,16426025,17995775,1569750,BUY
2020-12-31 15:09:00,15:09,16170550,18011425,1840875,BUY
2020-12-31 15:10:00,15:10,16246275,17792350,1546075,BUY
2020-12-31 15:11:00,15:11,16203800,17636125,1432325,BUY
2020-12-31 15:12:00,15:12,15809725,17239975,1430250,BUY
2020-12-31 15:13:00,15:13,15748000,17278625,1530625,BUY
2020-12-31 15:14:00,15:14,15926775,17510375,1583600,BUY
2020-12-31 15:15:00,15:15,15725250,16950600,1225350,BUY
2020-12-31 15:16:00,15:16,15653050,17013150,1360100,BUY
2020-12-31 15:17:00,15:17,15731725,17246850,1515125,BUY
2020-12-31 15:18:00,15:18,15436450,16255975,819525,BUY
2020-12-31 15:19:00,15:19,15333750,16068925,735175,BUY
2020-12-31 15:20:00,15:20,15321125,16446450,1125325,BUY
2020-12-31 15:21:00,15:21,14700500,15439225,738725,BUY
2020-12-31 15:22:00,15:22,14679950,15427925,747975,BUY
2020-12-31 15:23:00,15:23,14722725,15804725,1082000,BUY
2020-12-31 15:24:00,15:24,14322475,14333450,10975,BUY
2020-12-31 15:25:00,15:25,14386100,14564300,178200,BUY
2020-12-31 15:26:00,15:26,14099600,14206825,107225,BUY
2020-12-31 15:27:00,15:27,13714100,13307625,-406475,SELL
2020-12-31 15:28:00,15:28,13666975,13633325,-33650,SELL
2020-12-31 15:29:00,15:29,13582425,14256200,673775,BUY
