,timestamp,call,put,diff,sellOrBuy
2020-10-30 09:15:00,09:15,2904850,1520350,-1384500,SELL
2020-10-30 09:16:00,09:16,2905425,1520875,-1384550,SELL
2020-10-30 09:17:00,09:17,3164700,1720175,-1444525,SELL
2020-10-30 09:18:00,09:18,3174225,1719700,-1454525,SELL
2020-10-30 09:19:00,09:19,3170125,1713725,-1456400,SELL
2020-10-30 09:20:00,09:20,3477225,1974875,-1502350,SELL
2020-10-30 09:21:00,09:21,3477675,1975825,-1501850,SELL
2020-10-30 09:22:00,09:22,3477975,1972750,-1505225,SELL
2020-10-30 09:23:00,09:23,3690300,2112875,-1577425,SELL
2020-10-30 09:24:00,09:24,3670600,2122175,-1548425,SELL
2020-10-30 09:25:00,09:25,3689150,2126850,-1562300,SELL
2020-10-30 09:26:00,09:26,3831675,2242825,-1588850,SELL
2020-10-30 09:27:00,09:27,3830500,2242000,-1588500,SELL
2020-10-30 09:28:00,09:28,3831425,2239250,-1592175,SELL
2020-10-30 09:29:00,09:29,3935650,2377950,-1557700,SELL
2020-10-30 09:30:00,09:30,3932150,2368400,-1563750,SELL
2020-10-30 09:31:00,09:31,3912625,2381275,-1531350,SELL
2020-10-30 09:32:00,09:32,4085200,2477375,-1607825,SELL
2020-10-30 09:33:00,09:33,4084425,2488275,-1596150,SELL
2020-10-30 09:34:00,09:34,4084050,2491650,-1592400,SELL
2020-10-30 09:35:00,09:35,4164525,2514600,-1649925,SELL
2020-10-30 09:36:00,09:36,4164525,2511850,-1652675,SELL
2020-10-30 09:37:00,09:37,4159600,2510075,-1649525,SELL
2020-10-30 09:38:00,09:38,4265050,2565850,-1699200,SELL
2020-10-30 09:39:00,09:39,4263175,2579650,-1683525,SELL
2020-10-30 09:40:00,09:40,4264025,2571475,-1692550,SELL
2020-10-30 09:41:00,09:41,4409900,2617400,-1792500,SELL
2020-10-30 09:42:00,09:42,4407275,2620875,-1786400,SELL
2020-10-30 09:43:00,09:43,4371225,2623300,-1747925,SELL
2020-10-30 09:44:00,09:44,4490375,2693875,-1796500,SELL
2020-10-30 09:45:00,09:45,4463850,2692150,-1771700,SELL
2020-10-30 09:46:00,09:46,4494125,2698175,-1795950,SELL
2020-10-30 09:47:00,09:47,4521775,2725675,-1796100,SELL
2020-10-30 09:48:00,09:48,4507725,2718825,-1788900,SELL
2020-10-30 09:49:00,09:49,4519650,2714275,-1805375,SELL
2020-10-30 09:50:00,09:50,4570400,2767550,-1802850,SELL
2020-10-30 09:51:00,09:51,4544875,2775225,-1769650,SELL
2020-10-30 09:52:00,09:52,4543000,2777500,-1765500,SELL
2020-10-30 09:53:00,09:53,4651000,2842525,-1808475,SELL
2020-10-30 09:54:00,09:54,4637825,2848225,-1789600,SELL
2020-10-30 09:55:00,09:55,4607350,2837575,-1769775,SELL
2020-10-30 09:56:00,09:56,4755700,2914450,-1841250,SELL
2020-10-30 09:57:00,09:57,4726550,2924100,-1802450,SELL
2020-10-30 09:58:00,09:58,4731575,2924100,-1807475,SELL
2020-10-30 09:59:00,09:59,4793400,2958975,-1834425,SELL
2020-10-30 10:00:00,10:00,4797475,2971700,-1825775,SELL
2020-10-30 10:01:00,10:01,4777900,2965950,-1811950,SELL
2020-10-30 10:02:00,10:02,4832850,2998300,-1834550,SELL
2020-10-30 10:03:00,10:03,4834300,2995850,-1838450,SELL
2020-10-30 10:04:00,10:04,4831825,2995850,-1835975,SELL
2020-10-30 10:05:00,10:05,4911950,3006950,-1905000,SELL
2020-10-30 10:06:00,10:06,4922300,2990150,-1932150,SELL
2020-10-30 10:07:00,10:07,4938250,3007600,-1930650,SELL
2020-10-30 10:08:00,10:08,4966125,3026325,-1939800,SELL
2020-10-30 10:09:00,10:09,4951875,3033475,-1918400,SELL
2020-10-30 10:10:00,10:10,5004100,3034625,-1969475,SELL
2020-10-30 10:11:00,10:11,5047225,3058325,-1988900,SELL
2020-10-30 10:12:00,10:12,5060300,3053725,-2006575,SELL
2020-10-30 10:13:00,10:13,5010650,3053725,-1956925,SELL
2020-10-30 10:14:00,10:14,5120100,3072675,-2047425,SELL
2020-10-30 10:15:00,10:15,5092500,3079775,-2012725,SELL
2020-10-30 10:16:00,10:16,5093875,3075325,-2018550,SELL
2020-10-30 10:17:00,10:17,5173250,3106950,-2066300,SELL
2020-10-30 10:18:00,10:18,5175900,3103925,-2071975,SELL
2020-10-30 10:19:00,10:19,5134000,3099825,-2034175,SELL
2020-10-30 10:20:00,10:20,5217075,3153775,-2063300,SELL
2020-10-30 10:21:00,10:21,5233675,3145625,-2088050,SELL
2020-10-30 10:22:00,10:22,5201950,3138175,-2063775,SELL
2020-10-30 10:23:00,10:23,5256025,3236775,-2019250,SELL
2020-10-30 10:24:00,10:24,5268650,3238675,-2029975,SELL
2020-10-30 10:25:00,10:25,5248450,3235700,-2012750,SELL
2020-10-30 10:26:00,10:26,5340200,3296075,-2044125,SELL
2020-10-30 10:27:00,10:27,5338100,3286500,-2051600,SELL
2020-10-30 10:28:00,10:28,5336000,3279250,-2056750,SELL
2020-10-30 10:29:00,10:29,5349025,3296450,-2052575,SELL
2020-10-30 10:30:00,10:30,5381525,3305925,-2075600,SELL
2020-10-30 10:31:00,10:31,5376675,3295000,-2081675,SELL
2020-10-30 10:32:00,10:32,5352575,3281175,-2071400,SELL
2020-10-30 10:33:00,10:33,5340625,3315025,-2025600,SELL
2020-10-30 10:34:00,10:34,5357675,3305375,-2052300,SELL
2020-10-30 10:35:00,10:35,5386150,3358000,-2028150,SELL
2020-10-30 10:36:00,10:36,5373400,3339025,-2034375,SELL
2020-10-30 10:37:00,10:37,5339125,3351250,-1987875,SELL
2020-10-30 10:38:00,10:38,5363775,3372375,-1991400,SELL
2020-10-30 10:39:00,10:39,5352075,3372450,-1979625,SELL
2020-10-30 10:40:00,10:40,5392200,3384600,-2007600,SELL
2020-10-30 10:41:00,10:41,5440825,3422625,-2018200,SELL
2020-10-30 10:42:00,10:42,5442150,3424550,-2017600,SELL
2020-10-30 10:43:00,10:43,5443600,3421150,-2022450,SELL
2020-10-30 10:44:00,10:44,5469150,3461450,-2007700,SELL
2020-10-30 10:45:00,10:45,5456200,3463675,-1992525,SELL
2020-10-30 10:46:00,10:46,5480675,3464275,-2016400,SELL
2020-10-30 10:47:00,10:47,5424300,3480850,-1943450,SELL
2020-10-30 10:48:00,10:48,5394175,3459600,-1934575,SELL
2020-10-30 10:49:00,10:49,5412150,3474875,-1937275,SELL
2020-10-30 10:50:00,10:50,5488075,3497875,-1990200,SELL
2020-10-30 10:51:00,10:51,5484650,3490275,-1994375,SELL
2020-10-30 10:52:00,10:52,5449125,3472075,-1977050,SELL
2020-10-30 10:53:00,10:53,5478050,3501250,-1976800,SELL
2020-10-30 10:54:00,10:54,5482325,3500975,-1981350,SELL
2020-10-30 10:55:00,10:55,5448125,3512350,-1935775,SELL
2020-10-30 10:56:00,10:56,5491450,3483125,-2008325,SELL
2020-10-30 10:57:00,10:57,5474900,3479450,-1995450,SELL
2020-10-30 10:58:00,10:58,5491450,3475200,-2016250,SELL
2020-10-30 10:59:00,10:59,5426050,3491900,-1934150,SELL
2020-10-30 11:00:00,11:00,5478800,3505250,-1973550,SELL
2020-10-30 11:01:00,11:01,5480625,3501300,-1979325,SELL
2020-10-30 11:02:00,11:02,5478775,3407700,-2071075,SELL
2020-10-30 11:03:00,11:03,5487850,3417350,-2070500,SELL
2020-10-30 11:04:00,11:04,5487850,3400500,-2087350,SELL
2020-10-30 11:05:00,11:05,5514175,3423750,-2090425,SELL
2020-10-30 11:06:00,11:06,5508025,3426850,-2081175,SELL
2020-10-30 11:07:00,11:07,5483625,3434575,-2049050,SELL
2020-10-30 11:08:00,11:08,5525350,3415675,-2109675,SELL
2020-10-30 11:09:00,11:09,5550225,3420400,-2129825,SELL
2020-10-30 11:10:00,11:10,5562275,3419950,-2142325,SELL
2020-10-30 11:11:00,11:11,5612425,3372250,-2240175,SELL
2020-10-30 11:12:00,11:12,5611200,3367875,-2243325,SELL
2020-10-30 11:13:00,11:13,5600500,3367875,-2232625,SELL
2020-10-30 11:14:00,11:14,5653650,3404500,-2249150,SELL
2020-10-30 11:15:00,11:15,5637050,3400700,-2236350,SELL
2020-10-30 11:16:00,11:16,5639700,3406450,-2233250,SELL
2020-10-30 11:17:00,11:17,5737875,3361325,-2376550,SELL
2020-10-30 11:18:00,11:18,5720875,3361300,-2359575,SELL
2020-10-30 11:19:00,11:19,5739375,3353750,-2385625,SELL
2020-10-30 11:20:00,11:20,5833375,3369175,-2464200,SELL
2020-10-30 11:21:00,11:21,5830900,3362850,-2468050,SELL
2020-10-30 11:22:00,11:22,5831650,3366650,-2465000,SELL
2020-10-30 11:23:00,11:23,5822300,3363550,-2458750,SELL
2020-10-30 11:24:00,11:24,5757625,3357375,-2400250,SELL
2020-10-30 11:25:00,11:25,5796675,3351650,-2445025,SELL
2020-10-30 11:26:00,11:26,5869300,3361725,-2507575,SELL
2020-10-30 11:27:00,11:27,5870050,3373000,-2497050,SELL
2020-10-30 11:28:00,11:28,5850550,3367150,-2483400,SELL
2020-10-30 11:29:00,11:29,5897175,3256575,-2640600,SELL
2020-10-30 11:30:00,11:30,5916200,3254025,-2662175,SELL
2020-10-30 11:31:00,11:31,5917775,3253850,-2663925,SELL
2020-10-30 11:32:00,11:32,5975550,3235050,-2740500,SELL
2020-10-30 11:33:00,11:33,5971600,3216925,-2754675,SELL
2020-10-30 11:34:00,11:34,5973850,3227925,-2745925,SELL
2020-10-30 11:35:00,11:35,5991850,3220625,-2771225,SELL
2020-10-30 11:36:00,11:36,5997950,3232625,-2765325,SELL
2020-10-30 11:37:00,11:37,5946425,3223075,-2723350,SELL
2020-10-30 11:38:00,11:38,6033700,3145900,-2887800,SELL
2020-10-30 11:39:00,11:39,6040050,3156850,-2883200,SELL
2020-10-30 11:40:00,11:40,6051700,3155650,-2896050,SELL
2020-10-30 11:41:00,11:41,6065625,3031725,-3033900,SELL
2020-10-30 11:42:00,11:42,6029575,3018675,-3010900,SELL
2020-10-30 11:43:00,11:43,6061800,3022500,-3039300,SELL
2020-10-30 11:44:00,11:44,6023025,3043400,-2979625,SELL
2020-10-30 11:45:00,11:45,6092350,3043300,-3049050,SELL
2020-10-30 11:46:00,11:46,6076000,3039500,-3036500,SELL
2020-10-30 11:47:00,11:47,6250975,2967925,-3283050,SELL
2020-10-30 11:48:00,11:48,6248250,2967475,-3280775,SELL
2020-10-30 11:49:00,11:49,6247450,2968425,-3279025,SELL
2020-10-30 11:50:00,11:50,6297475,3012125,-3285350,SELL
2020-10-30 11:51:00,11:51,6296300,3015800,-3280500,SELL
2020-10-30 11:52:00,11:52,6292525,3011450,-3281075,SELL
2020-10-30 11:53:00,11:53,6363675,3047250,-3316425,SELL
2020-10-30 11:54:00,11:54,6308800,3047500,-3261300,SELL
2020-10-30 11:55:00,11:55,6373725,3052700,-3321025,SELL
2020-10-30 11:56:00,11:56,6412375,3041500,-3370875,SELL
2020-10-30 11:57:00,11:57,6415625,3046700,-3368925,SELL
2020-10-30 11:58:00,11:58,6415325,3042100,-3373225,SELL
2020-10-30 11:59:00,11:59,6402275,3015325,-3386950,SELL
2020-10-30 12:00:00,12:00,6401800,3017650,-3384150,SELL
2020-10-30 12:01:00,12:01,6401625,2973900,-3427725,SELL
2020-10-30 12:02:00,12:02,6364975,3028850,-3336125,SELL
2020-10-30 12:03:00,12:03,6418450,3022550,-3395900,SELL
2020-10-30 12:04:00,12:04,6437725,3024450,-3413275,SELL
2020-10-30 12:05:00,12:05,6463550,3081650,-3381900,SELL
2020-10-30 12:06:00,12:06,6459750,3092950,-3366800,SELL
2020-10-30 12:07:00,12:07,6459750,3040300,-3419450,SELL
2020-10-30 12:08:00,12:08,6474175,3076125,-3398050,SELL
2020-10-30 12:09:00,12:09,6456050,3101400,-3354650,SELL
2020-10-30 12:10:00,12:10,6473275,3092450,-3380825,SELL
2020-10-30 12:11:00,12:11,6455625,3084400,-3371225,SELL
2020-10-30 12:12:00,12:12,6506300,3116000,-3390300,SELL
2020-10-30 12:13:00,12:13,6509075,3097950,-3411125,SELL
2020-10-30 12:14:00,12:14,6517775,3134450,-3383325,SELL
2020-10-30 12:15:00,12:15,6540750,3131900,-3408850,SELL
2020-10-30 12:16:00,12:16,6502725,3090825,-3411900,SELL
2020-10-30 12:17:00,12:17,6517525,3130800,-3386725,SELL
2020-10-30 12:18:00,12:18,6586250,3147000,-3439250,SELL
2020-10-30 12:19:00,12:19,6540275,3148375,-3391900,SELL
2020-10-30 12:20:00,12:20,6556300,3140125,-3416175,SELL
2020-10-30 12:21:00,12:21,6598675,3182525,-3416150,SELL
2020-10-30 12:22:00,12:22,6600775,3145825,-3454950,SELL
2020-10-30 12:23:00,12:23,6601075,3158275,-3442800,SELL
2020-10-30 12:24:00,12:24,6606025,3188725,-3417300,SELL
2020-10-30 12:25:00,12:25,6609250,3156425,-3452825,SELL
2020-10-30 12:26:00,12:26,6657550,3162725,-3494825,SELL
2020-10-30 12:27:00,12:27,6635575,3193175,-3442400,SELL
2020-10-30 12:28:00,12:28,6661300,3169975,-3491325,SELL
2020-10-30 12:29:00,12:29,6612075,3195500,-3416575,SELL
2020-10-30 12:30:00,12:30,6612650,3193175,-3419475,SELL
2020-10-30 12:31:00,12:31,6561875,3186575,-3375300,SELL
2020-10-30 12:32:00,12:32,6584400,3199350,-3385050,SELL
2020-10-30 12:33:00,12:33,6596050,3150000,-3446050,SELL
2020-10-30 12:34:00,12:34,6598125,3202050,-3396075,SELL
2020-10-30 12:35:00,12:35,6574075,3220275,-3353800,SELL
2020-10-30 12:36:00,12:36,6589150,3208625,-3380525,SELL
2020-10-30 12:37:00,12:37,6519575,3214000,-3305575,SELL
2020-10-30 12:38:00,12:38,6575325,3189925,-3385400,SELL
2020-10-30 12:39:00,12:39,6600500,3192825,-3407675,SELL
2020-10-30 12:40:00,12:40,6591600,3188550,-3403050,SELL
2020-10-30 12:41:00,12:41,6477325,3218075,-3259250,SELL
2020-10-30 12:42:00,12:42,6540600,3179450,-3361150,SELL
2020-10-30 12:43:00,12:43,6579350,3171800,-3407550,SELL
2020-10-30 12:44:00,12:44,6538750,3212250,-3326500,SELL
2020-10-30 12:45:00,12:45,6608600,3212050,-3396550,SELL
2020-10-30 12:46:00,12:46,6610175,3187925,-3422250,SELL
2020-10-30 12:47:00,12:47,6551975,3204625,-3347350,SELL
2020-10-30 12:48:00,12:48,6600650,3197375,-3403275,SELL
2020-10-30 12:49:00,12:49,6553750,3178675,-3375075,SELL
2020-10-30 12:50:00,12:50,6623225,3213300,-3409925,SELL
2020-10-30 12:51:00,12:51,6589800,3180725,-3409075,SELL
2020-10-30 12:52:00,12:52,6622425,3188300,-3434125,SELL
2020-10-30 12:53:00,12:53,6636100,3174800,-3461300,SELL
2020-10-30 12:54:00,12:54,6683075,3224900,-3458175,SELL
2020-10-30 12:55:00,12:55,6678300,3216425,-3461875,SELL
2020-10-30 12:56:00,12:56,6649575,3149875,-3499700,SELL
2020-10-30 12:57:00,12:57,6630625,3151700,-3478925,SELL
2020-10-30 12:58:00,12:58,6676000,3142500,-3533500,SELL
2020-10-30 12:59:00,12:59,6709075,3157725,-3551350,SELL
2020-10-30 13:00:00,13:00,6686200,3162225,-3523975,SELL
2020-10-30 13:01:00,13:01,6707775,3151850,-3555925,SELL
2020-10-30 13:02:00,13:02,6715350,3165000,-3550350,SELL
2020-10-30 13:03:00,13:03,6665700,3166650,-3499050,SELL
2020-10-30 13:04:00,13:04,6710600,3143925,-3566675,SELL
2020-10-30 13:05:00,13:05,6688650,3138200,-3550450,SELL
2020-10-30 13:06:00,13:06,6677825,3175000,-3502825,SELL
2020-10-30 13:07:00,13:07,6711750,3170400,-3541350,SELL
2020-10-30 13:08:00,13:08,6693900,3174675,-3519225,SELL
2020-10-30 13:09:00,13:09,6721400,3184075,-3537325,SELL
2020-10-30 13:10:00,13:10,6721400,3177950,-3543450,SELL
2020-10-30 13:11:00,13:11,6667925,3181500,-3486425,SELL
2020-10-30 13:12:00,13:12,6730950,3139500,-3591450,SELL
2020-10-30 13:13:00,13:13,6693350,3156625,-3536725,SELL
2020-10-30 13:14:00,13:14,6642075,3120475,-3521600,SELL
2020-10-30 13:15:00,13:15,6735925,3215525,-3520400,SELL
2020-10-30 13:16:00,13:16,6700600,3207400,-3493200,SELL
2020-10-30 13:17:00,13:17,6667800,3174475,-3493325,SELL
2020-10-30 13:18:00,13:18,6748925,3194925,-3554000,SELL
2020-10-30 13:19:00,13:19,6765100,3214950,-3550150,SELL
2020-10-30 13:20:00,13:20,6681900,3225725,-3456175,SELL
2020-10-30 13:21:00,13:21,6761050,3219625,-3541425,SELL
2020-10-30 13:22:00,13:22,6736700,3194025,-3542675,SELL
2020-10-30 13:23:00,13:23,6647575,3185125,-3462450,SELL
2020-10-30 13:24:00,13:24,6672875,3156475,-3516400,SELL
2020-10-30 13:25:00,13:25,6707950,3068250,-3639700,SELL
2020-10-30 13:26:00,13:26,6664050,3184100,-3479950,SELL
2020-10-30 13:27:00,13:27,6787025,3180450,-3606575,SELL
2020-10-30 13:28:00,13:28,6781325,3194475,-3586850,SELL
2020-10-30 13:29:00,13:29,6775275,3215600,-3559675,SELL
2020-10-30 13:30:00,13:30,6746175,3180550,-3565625,SELL
2020-10-30 13:31:00,13:31,6746200,3226050,-3520150,SELL
2020-10-30 13:32:00,13:32,6732475,3221525,-3510950,SELL
2020-10-30 13:33:00,13:33,6740750,3158300,-3582450,SELL
2020-10-30 13:34:00,13:34,6703575,3151875,-3551700,SELL
2020-10-30 13:35:00,13:35,6742600,3157725,-3584875,SELL
2020-10-30 13:36:00,13:36,6827775,3122950,-3704825,SELL
2020-10-30 13:37:00,13:37,6835050,3128800,-3706250,SELL
2020-10-30 13:38:00,13:38,6794575,3084600,-3709975,SELL
2020-10-30 13:39:00,13:39,6785275,3090925,-3694350,SELL
2020-10-30 13:40:00,13:40,6837175,3134700,-3702475,SELL
2020-10-30 13:41:00,13:41,6813700,3115125,-3698575,SELL
2020-10-30 13:42:00,13:42,6817275,3092000,-3725275,SELL
2020-10-30 13:43:00,13:43,6849025,3092925,-3756100,SELL
2020-10-30 13:44:00,13:44,6823600,3087725,-3735875,SELL
2020-10-30 13:45:00,13:45,6783100,3156550,-3626550,SELL
2020-10-30 13:46:00,13:46,6841950,3153450,-3688500,SELL
2020-10-30 13:47:00,13:47,6787250,3150775,-3636475,SELL
2020-10-30 13:48:00,13:48,6785450,3108575,-3676875,SELL
2020-10-30 13:49:00,13:49,6776050,3072925,-3703125,SELL
2020-10-30 13:50:00,13:50,6806350,3082500,-3723850,SELL
2020-10-30 13:51:00,13:51,6803175,3060100,-3743075,SELL
2020-10-30 13:52:00,13:52,6802500,3112550,-3689950,SELL
2020-10-30 13:53:00,13:53,6804900,3109875,-3695025,SELL
2020-10-30 13:54:00,13:54,6776200,3096600,-3679600,SELL
2020-10-30 13:55:00,13:55,6729250,3066875,-3662375,SELL
2020-10-30 13:56:00,13:56,6776200,3102125,-3674075,SELL
2020-10-30 13:57:00,13:57,6730250,3109800,-3620450,SELL
2020-10-30 13:58:00,13:58,6782300,3116450,-3665850,SELL
2020-10-30 13:59:00,13:59,6769450,3089825,-3679625,SELL
2020-10-30 14:00:00,14:00,6769350,3147650,-3621700,SELL
2020-10-30 14:01:00,14:01,6767600,3138725,-3628875,SELL
2020-10-30 14:02:00,14:02,6792925,3148350,-3644575,SELL
2020-10-30 14:03:00,14:03,6776175,3152200,-3623975,SELL
2020-10-30 14:04:00,14:04,6807225,3153175,-3654050,SELL
2020-10-30 14:05:00,14:05,6755700,3138750,-3616950,SELL
2020-10-30 14:06:00,14:06,6757375,3130875,-3626500,SELL
2020-10-30 14:07:00,14:07,6780475,3136950,-3643525,SELL
2020-10-30 14:08:00,14:08,6762450,3118450,-3644000,SELL
2020-10-30 14:09:00,14:09,6711475,3137900,-3573575,SELL
2020-10-30 14:10:00,14:10,6741625,3135250,-3606375,SELL
2020-10-30 14:11:00,14:11,6726175,3130375,-3595800,SELL
2020-10-30 14:12:00,14:12,6678575,3146100,-3532475,SELL
2020-10-30 14:13:00,14:13,6658300,3141250,-3517050,SELL
2020-10-30 14:14:00,14:14,6706450,3142700,-3563750,SELL
2020-10-30 14:15:00,14:15,6718100,3170200,-3547900,SELL
2020-10-30 14:16:00,14:16,6720375,3169400,-3550975,SELL
2020-10-30 14:17:00,14:17,6720025,3175975,-3544050,SELL
2020-10-30 14:18:00,14:18,6678575,3187025,-3491550,SELL
2020-10-30 14:19:00,14:19,6636225,3186875,-3449350,SELL
2020-10-30 14:20:00,14:20,6617275,3175725,-3441550,SELL
2020-10-30 14:21:00,14:21,6655525,3174450,-3481075,SELL
2020-10-30 14:22:00,14:22,6658125,3207875,-3450250,SELL
2020-10-30 14:23:00,14:23,6644650,3172750,-3471900,SELL
2020-10-30 14:24:00,14:24,6717700,3220600,-3497100,SELL
2020-10-30 14:25:00,14:25,6694125,3211150,-3482975,SELL
2020-10-30 14:26:00,14:26,6672050,3206025,-3466025,SELL
2020-10-30 14:27:00,14:27,6621600,3215800,-3405800,SELL
2020-10-30 14:28:00,14:28,6638725,3223175,-3415550,SELL
2020-10-30 14:29:00,14:29,6605350,3215800,-3389550,SELL
2020-10-30 14:30:00,14:30,6664100,3238800,-3425300,SELL
2020-10-30 14:31:00,14:31,6573400,3202775,-3370625,SELL
2020-10-30 14:32:00,14:32,6621575,3220950,-3400625,SELL
2020-10-30 14:33:00,14:33,6682350,3230575,-3451775,SELL
2020-10-30 14:34:00,14:34,6660850,3204800,-3456050,SELL
2020-10-30 14:35:00,14:35,6661800,3231025,-3430775,SELL
2020-10-30 14:36:00,14:36,6669175,3217350,-3451825,SELL
2020-10-30 14:37:00,14:37,6692375,3206650,-3485725,SELL
2020-10-30 14:38:00,14:38,6689575,3206650,-3482925,SELL
2020-10-30 14:39:00,14:39,6677000,3235475,-3441525,SELL
2020-10-30 14:40:00,14:40,6692125,3227475,-3464650,SELL
2020-10-30 14:41:00,14:41,6692325,3235550,-3456775,SELL
2020-10-30 14:42:00,14:42,6697100,3238700,-3458400,SELL
2020-10-30 14:43:00,14:43,6695050,3205875,-3489175,SELL
2020-10-30 14:44:00,14:44,6690325,3223725,-3466600,SELL
2020-10-30 14:45:00,14:45,6708525,3185950,-3522575,SELL
2020-10-30 14:46:00,14:46,6708525,3186800,-3521725,SELL
2020-10-30 14:47:00,14:47,6684425,3182500,-3501925,SELL
2020-10-30 14:48:00,14:48,6705225,3211400,-3493825,SELL
2020-10-30 14:49:00,14:49,6733250,3215825,-3517425,SELL
2020-10-30 14:50:00,14:50,6728900,3202875,-3526025,SELL
2020-10-30 14:51:00,14:51,6690200,3245150,-3445050,SELL
2020-10-30 14:52:00,14:52,6717275,3229375,-3487900,SELL
2020-10-30 14:53:00,14:53,6720175,3236700,-3483475,SELL
2020-10-30 14:54:00,14:54,6708325,3223525,-3484800,SELL
2020-10-30 14:55:00,14:55,6710825,3225300,-3485525,SELL
2020-10-30 14:56:00,14:56,6706050,3217625,-3488425,SELL
2020-10-30 14:57:00,14:57,6727175,3200800,-3526375,SELL
2020-10-30 14:58:00,14:58,6746125,3187125,-3559000,SELL
2020-10-30 14:59:00,14:59,6727750,3200150,-3527600,SELL
2020-10-30 15:00:00,15:00,6689275,3193150,-3496125,SELL
2020-10-30 15:01:00,15:01,6679925,3186625,-3493300,SELL
2020-10-30 15:02:00,15:02,6674800,3178450,-3496350,SELL
2020-10-30 15:03:00,15:03,6608625,3148200,-3460425,SELL
2020-10-30 15:04:00,15:04,6617075,3149850,-3467225,SELL
2020-10-30 15:05:00,15:05,6551650,3148075,-3403575,SELL
2020-10-30 15:06:00,15:06,6554525,3096425,-3458100,SELL
2020-10-30 15:07:00,15:07,6578050,3130100,-3447950,SELL
2020-10-30 15:08:00,15:08,6583250,3122025,-3461225,SELL
2020-10-30 15:09:00,15:09,6538525,3086225,-3452300,SELL
2020-10-30 15:10:00,15:10,6548600,3092375,-3456225,SELL
2020-10-30 15:11:00,15:11,6533525,3080625,-3452900,SELL
2020-10-30 15:12:00,15:12,6494825,3045100,-3449725,SELL
2020-10-30 15:13:00,15:13,6493250,3045100,-3448150,SELL
2020-10-30 15:14:00,15:14,6479575,3049350,-3430225,SELL
2020-10-30 15:15:00,15:15,6426350,3010800,-3415550,SELL
2020-10-30 15:16:00,15:16,6418275,3011575,-3406700,SELL
2020-10-30 15:17:00,15:17,6367500,3007775,-3359725,SELL
2020-10-30 15:18:00,15:18,6340375,2945175,-3395200,SELL
2020-10-30 15:19:00,15:19,6360600,2957025,-3403575,SELL
2020-10-30 15:20:00,15:20,6352425,2961750,-3390675,SELL
2020-10-30 15:21:00,15:21,6176675,2870300,-3306375,SELL
2020-10-30 15:22:00,15:22,6160625,2858550,-3302075,SELL
2020-10-30 15:23:00,15:23,6164675,2820675,-3344000,SELL
2020-10-30 15:24:00,15:24,6075000,2822900,-3252100,SELL
2020-10-30 15:25:00,15:25,6092950,2843650,-3249300,SELL
2020-10-30 15:26:00,15:26,6080450,2837250,-3243200,SELL
2020-10-30 15:27:00,15:27,5912525,2811125,-3101400,SELL
2020-10-30 15:28:00,15:28,5902800,2793675,-3109125,SELL
2020-10-30 15:29:00,15:29,5912500,2803225,-3109275,SELL
2020-11-02 09:15:00,09:15,5789475,2741675,-3047800,SELL
2020-11-02 09:16:00,09:16,5783725,2738300,-3045425,SELL
2020-11-02 09:17:00,09:17,5977150,3084600,-2892550,SELL
2020-11-02 09:18:00,09:18,5973925,3080950,-2892975,SELL
2020-11-02 09:19:00,09:19,5973925,3082750,-2891175,SELL
2020-11-02 09:20:00,09:20,6245975,3506050,-2739925,SELL
2020-11-02 09:21:00,09:21,6246525,3509200,-2737325,SELL
2020-11-02 09:22:00,09:22,6249700,3505000,-2744700,SELL
2020-11-02 09:23:00,09:23,6334000,3905650,-2428350,SELL
2020-11-02 09:24:00,09:24,6337425,3902400,-2435025,SELL
2020-11-02 09:25:00,09:25,6330300,3899550,-2430750,SELL
2020-11-02 09:26:00,09:26,6407100,3989275,-2417825,SELL
2020-11-02 09:27:00,09:27,6421625,3982225,-2439400,SELL
2020-11-02 09:28:00,09:28,6402700,3983700,-2419000,SELL
2020-11-02 09:29:00,09:29,6444725,4052725,-2392000,SELL
2020-11-02 09:30:00,09:30,6442150,4052725,-2389425,SELL
2020-11-02 09:31:00,09:31,6444725,4049900,-2394825,SELL
2020-11-02 09:32:00,09:32,6538550,4223425,-2315125,SELL
2020-11-02 09:33:00,09:33,6529025,4223425,-2305600,SELL
2020-11-02 09:34:00,09:34,6505625,4220525,-2285100,SELL
2020-11-02 09:35:00,09:35,6605175,4384425,-2220750,SELL
2020-11-02 09:36:00,09:36,6613825,4384425,-2229400,SELL
2020-11-02 09:37:00,09:37,6597750,4386525,-2211225,SELL
2020-11-02 09:38:00,09:38,6660700,4564475,-2096225,SELL
2020-11-02 09:39:00,09:39,6684700,4564475,-2120225,SELL
2020-11-02 09:40:00,09:40,6679400,4564475,-2114925,SELL
2020-11-02 09:41:00,09:41,6678600,4658100,-2020500,SELL
2020-11-02 09:42:00,09:42,6729125,4666075,-2063050,SELL
2020-11-02 09:43:00,09:43,6729550,4659125,-2070425,SELL
2020-11-02 09:44:00,09:44,6751875,4740200,-2011675,SELL
2020-11-02 09:45:00,09:45,6739825,4710400,-2029425,SELL
2020-11-02 09:46:00,09:46,6707725,4730525,-1977200,SELL
2020-11-02 09:47:00,09:47,6784250,4804650,-1979600,SELL
2020-11-02 09:48:00,09:48,6725600,4803575,-1922025,SELL
2020-11-02 09:49:00,09:49,6793100,4798775,-1994325,SELL
2020-11-02 09:50:00,09:50,6805025,4834725,-1970300,SELL
2020-11-02 09:51:00,09:51,6776575,4847450,-1929125,SELL
2020-11-02 09:52:00,09:52,6761075,4826700,-1934375,SELL
2020-11-02 09:53:00,09:53,6860350,4928675,-1931675,SELL
2020-11-02 09:54:00,09:54,6816800,4926150,-1890650,SELL
2020-11-02 09:55:00,09:55,6798725,4923125,-1875600,SELL
2020-11-02 09:56:00,09:56,6931150,4976275,-1954875,SELL
2020-11-02 09:57:00,09:57,6914275,4978875,-1935400,SELL
2020-11-02 09:58:00,09:58,6475700,4976950,-1498750,SELL
2020-11-02 09:59:00,09:59,6943200,4993600,-1949600,SELL
2020-11-02 10:00:00,10:00,6945350,4997525,-1947825,SELL
2020-11-02 10:01:00,10:01,6935175,4997950,-1937225,SELL
2020-11-02 10:02:00,10:02,6972600,5062875,-1909725,SELL
2020-11-02 10:03:00,10:03,6988825,5056475,-1932350,SELL
2020-11-02 10:04:00,10:04,6990000,5066925,-1923075,SELL
2020-11-02 10:05:00,10:05,6959500,5094700,-1864800,SELL
2020-11-02 10:06:00,10:06,6955850,5094200,-1861650,SELL
2020-11-02 10:07:00,10:07,6957375,5090800,-1866575,SELL
2020-11-02 10:08:00,10:08,6937925,5188350,-1749575,SELL
2020-11-02 10:09:00,10:09,6967350,5181825,-1785525,SELL
2020-11-02 10:10:00,10:10,6944125,5182300,-1761825,SELL
2020-11-02 10:11:00,10:11,6990175,5264550,-1725625,SELL
2020-11-02 10:12:00,10:12,6940000,5264800,-1675200,SELL
2020-11-02 10:13:00,10:13,6950000,5272850,-1677150,SELL
2020-11-02 10:14:00,10:14,6885150,5249950,-1635200,SELL
2020-11-02 10:15:00,10:15,6977950,5266775,-1711175,SELL
2020-11-02 10:16:00,10:16,6998900,5266200,-1732700,SELL
2020-11-02 10:17:00,10:17,6765375,5387225,-1378150,SELL
2020-11-02 10:18:00,10:18,6817100,5388525,-1428575,SELL
2020-11-02 10:19:00,10:19,6812025,5388350,-1423675,SELL
2020-11-02 10:20:00,10:20,6906875,5472725,-1434150,SELL
2020-11-02 10:21:00,10:21,6854875,5454725,-1400150,SELL
2020-11-02 10:22:00,10:22,6878150,5455800,-1422350,SELL
2020-11-02 10:23:00,10:23,6953700,5537375,-1416325,SELL
2020-11-02 10:24:00,10:24,6947700,5534400,-1413300,SELL
2020-11-02 10:25:00,10:25,6947700,5536250,-1411450,SELL
2020-11-02 10:26:00,10:26,6920875,5524950,-1395925,SELL
2020-11-02 10:27:00,10:27,6873350,5538800,-1334550,SELL
2020-11-02 10:28:00,10:28,6911725,5519375,-1392350,SELL
2020-11-02 10:29:00,10:29,6958550,5582950,-1375600,SELL
2020-11-02 10:30:00,10:30,6987575,5585925,-1401650,SELL
2020-11-02 10:31:00,10:31,6981150,5582950,-1398200,SELL
2020-11-02 10:32:00,10:32,6974250,5659625,-1314625,SELL
2020-11-02 10:33:00,10:33,6906725,5609125,-1297600,SELL
2020-11-02 10:34:00,10:34,7013100,5659750,-1353350,SELL
2020-11-02 10:35:00,10:35,6951950,5718925,-1233025,SELL
2020-11-02 10:36:00,10:36,6891500,5720750,-1170750,SELL
2020-11-02 10:37:00,10:37,6956050,5725225,-1230825,SELL
2020-11-02 10:38:00,10:38,6984375,5826375,-1158000,SELL
2020-11-02 10:39:00,10:39,6987675,5834625,-1153050,SELL
2020-11-02 10:40:00,10:40,6986675,5836800,-1149875,SELL
2020-11-02 10:41:00,10:41,7011425,5898175,-1113250,SELL
2020-11-02 10:42:00,10:42,6970025,5909050,-1060975,SELL
2020-11-02 10:43:00,10:43,7026825,5909050,-1117775,SELL
2020-11-02 10:44:00,10:44,7002300,5977175,-1025125,SELL
2020-11-02 10:45:00,10:45,7041475,5973700,-1067775,SELL
2020-11-02 10:46:00,10:46,7064200,5981475,-1082725,SELL
2020-11-02 10:47:00,10:47,7037975,6010375,-1027600,SELL
2020-11-02 10:48:00,10:48,7019550,5997450,-1022100,SELL
2020-11-02 10:49:00,10:49,7024775,6006250,-1018525,SELL
2020-11-02 10:50:00,10:50,6962475,6011275,-951200,SELL
2020-11-02 10:51:00,10:51,6968400,5996100,-972300,SELL
2020-11-02 10:52:00,10:52,6916975,5990825,-926150,SELL
2020-11-02 10:53:00,10:53,6839025,6086550,-752475,SELL
2020-11-02 10:54:00,10:54,7000600,6090725,-909875,SELL
2020-11-02 10:55:00,10:55,7013300,6087525,-925775,SELL
2020-11-02 10:56:00,10:56,6963950,6124575,-839375,SELL
2020-11-02 10:57:00,10:57,6901050,6128400,-772650,SELL
2020-11-02 10:58:00,10:58,7010475,6097750,-912725,SELL
2020-11-02 10:59:00,10:59,7008775,6147500,-861275,SELL
2020-11-02 11:00:00,11:00,7056975,6143775,-913200,SELL
2020-11-02 11:01:00,11:01,7050200,6163400,-886800,SELL
2020-11-02 11:02:00,11:02,7035675,6148975,-886700,SELL
2020-11-02 11:03:00,11:03,7056625,6161175,-895450,SELL
2020-11-02 11:04:00,11:04,6919075,6157150,-761925,SELL
2020-11-02 11:05:00,11:05,7105075,6199050,-906025,SELL
2020-11-02 11:06:00,11:06,7014200,6211250,-802950,SELL
2020-11-02 11:07:00,11:07,7003675,6202050,-801625,SELL
2020-11-02 11:08:00,11:08,7111350,6248400,-862950,SELL
2020-11-02 11:09:00,11:09,7065425,6243875,-821550,SELL
2020-11-02 11:10:00,11:10,7081875,6255825,-826050,SELL
2020-11-02 11:11:00,11:11,7102550,6289475,-813075,SELL
2020-11-02 11:12:00,11:12,7071300,6290725,-780575,SELL
2020-11-02 11:13:00,11:13,7098175,6284525,-813650,SELL
2020-11-02 11:14:00,11:14,7157525,6346950,-810575,SELL
2020-11-02 11:15:00,11:15,7155050,6351175,-803875,SELL
2020-11-02 11:16:00,11:16,7158425,6351825,-806600,SELL
2020-11-02 11:17:00,11:17,6997650,6448700,-548950,SELL
2020-11-02 11:18:00,11:18,6981900,6442900,-539000,SELL
2020-11-02 11:19:00,11:19,6967275,6439775,-527500,SELL
2020-11-02 11:20:00,11:20,6936875,6506375,-430500,SELL
2020-11-02 11:21:00,11:21,6903375,6489450,-413925,SELL
2020-11-02 11:22:00,11:22,6932750,6501250,-431500,SELL
2020-11-02 11:23:00,11:23,6910200,6569800,-340400,SELL
2020-11-02 11:24:00,11:24,6945350,6566925,-378425,SELL
2020-11-02 11:25:00,11:25,6889075,6573400,-315675,SELL
2020-11-02 11:26:00,11:26,6861550,6671650,-189900,SELL
2020-11-02 11:27:00,11:27,7021425,6660350,-361075,SELL
2020-11-02 11:28:00,11:28,6831525,6660175,-171350,SELL
2020-11-02 11:29:00,11:29,6963675,6658575,-305100,SELL
2020-11-02 11:30:00,11:30,6962775,6662375,-300400,SELL
2020-11-02 11:31:00,11:31,7058600,6659250,-399350,SELL
2020-11-02 11:32:00,11:32,7008450,6701350,-307100,SELL
2020-11-02 11:33:00,11:33,7032675,6701150,-331525,SELL
2020-11-02 11:34:00,11:34,6990800,6702900,-287900,SELL
2020-11-02 11:35:00,11:35,6984050,6718500,-265550,SELL
2020-11-02 11:36:00,11:36,7039200,6730775,-308425,SELL
2020-11-02 11:37:00,11:37,7054750,6728300,-326450,SELL
2020-11-02 11:38:00,11:38,7031125,6739475,-291650,SELL
2020-11-02 11:39:00,11:39,6877800,6761550,-116250,SELL
2020-11-02 11:40:00,11:40,7001025,6750275,-250750,SELL
2020-11-02 11:41:00,11:41,6957325,6740825,-216500,SELL
2020-11-02 11:42:00,11:42,7000700,6745500,-255200,SELL
2020-11-02 11:43:00,11:43,7022450,6730200,-292250,SELL
2020-11-02 11:44:00,11:44,7026700,6756075,-270625,SELL
2020-11-02 11:45:00,11:45,7113450,6762500,-350950,SELL
2020-11-02 11:46:00,11:46,7069000,6747300,-321700,SELL
2020-11-02 11:47:00,11:47,7094275,6790275,-304000,SELL
2020-11-02 11:48:00,11:48,6989150,6772850,-216300,SELL
2020-11-02 11:49:00,11:49,7029525,6780225,-249300,SELL
2020-11-02 11:50:00,11:50,7090750,6851575,-239175,SELL
2020-11-02 11:51:00,11:51,7045500,6842325,-203175,SELL
2020-11-02 11:52:00,11:52,7094675,6857300,-237375,SELL
2020-11-02 11:53:00,11:53,7127675,6874625,-253050,SELL
2020-11-02 11:54:00,11:54,7036975,6881375,-155600,SELL
2020-11-02 11:55:00,11:55,7163125,6872175,-290950,SELL
2020-11-02 11:56:00,11:56,7063875,6879375,-184500,SELL
2020-11-02 11:57:00,11:57,6970225,6891600,-78625,SELL
2020-11-02 11:58:00,11:58,7138175,6891800,-246375,SELL
2020-11-02 11:59:00,11:59,7128300,6889350,-238950,SELL
2020-11-02 12:00:00,12:00,7223150,6908075,-315075,SELL
2020-11-02 12:01:00,12:01,7176825,6887075,-289750,SELL
2020-11-02 12:02:00,12:02,7107050,6899150,-207900,SELL
2020-11-02 12:03:00,12:03,7098600,6917450,-181150,SELL
2020-11-02 12:04:00,12:04,7105575,6902900,-202675,SELL
2020-11-02 12:05:00,12:05,7138900,6902200,-236700,SELL
2020-11-02 12:06:00,12:06,7193150,6904750,-288400,SELL
2020-11-02 12:07:00,12:07,7012925,6904100,-108825,SELL
2020-11-02 12:08:00,12:08,7141000,6919525,-221475,SELL
2020-11-02 12:09:00,12:09,7170525,6920225,-250300,SELL
2020-11-02 12:10:00,12:10,7144650,6923025,-221625,SELL
2020-11-02 12:11:00,12:11,7053175,6953400,-99775,SELL
2020-11-02 12:12:00,12:12,7154275,6953500,-200775,SELL
2020-11-02 12:13:00,12:13,7189625,6931975,-257650,SELL
2020-11-02 12:14:00,12:14,7134200,6940725,-193475,SELL
2020-11-02 12:15:00,12:15,7138825,6965475,-173350,SELL
2020-11-02 12:16:00,12:16,7035400,6950475,-84925,SELL
2020-11-02 12:17:00,12:17,7158025,6987300,-170725,SELL
2020-11-02 12:18:00,12:18,7099400,6994500,-104900,SELL
2020-11-02 12:19:00,12:19,6995225,6991850,-3375,SELL
2020-11-02 12:20:00,12:20,7200325,7022625,-177700,SELL
2020-11-02 12:21:00,12:21,7204150,7017525,-186625,SELL
2020-11-02 12:22:00,12:22,7113100,7007700,-105400,SELL
2020-11-02 12:23:00,12:23,7207550,7050850,-156700,SELL
2020-11-02 12:24:00,12:24,7140325,7045150,-95175,SELL
2020-11-02 12:25:00,12:25,7088275,7055250,-33025,SELL
2020-11-02 12:26:00,12:26,7212125,7075400,-136725,SELL
2020-11-02 12:27:00,12:27,7276725,7076725,-200000,SELL
2020-11-02 12:28:00,12:28,7182400,7052075,-130325,SELL
2020-11-02 12:29:00,12:29,7105525,7068525,-37000,SELL
2020-11-02 12:30:00,12:30,7162175,7060000,-102175,SELL
2020-11-02 12:31:00,12:31,7041000,7054500,13500,BUY
2020-11-02 12:32:00,12:32,7102975,7093425,-9550,SELL
2020-11-02 12:33:00,12:33,7065025,7121450,56425,BUY
2020-11-02 12:34:00,12:34,7156800,7116375,-40425,SELL
2020-11-02 12:35:00,12:35,7178850,7174975,-3875,SELL
2020-11-02 12:36:00,12:36,7235375,7158875,-76500,SELL
2020-11-02 12:37:00,12:37,7183250,7150375,-32875,SELL
2020-11-02 12:38:00,12:38,7238600,7183975,-54625,SELL
2020-11-02 12:39:00,12:39,7262950,7190850,-72100,SELL
2020-11-02 12:40:00,12:40,7172675,7201000,28325,BUY
2020-11-02 12:41:00,12:41,7217950,7196225,-21725,SELL
2020-11-02 12:42:00,12:42,7170850,7186075,15225,BUY
2020-11-02 12:43:00,12:43,7210250,7181475,-28775,SELL
2020-11-02 12:44:00,12:44,7199875,7191100,-8775,SELL
2020-11-02 12:45:00,12:45,7214175,7212050,-2125,SELL
2020-11-02 12:46:00,12:46,7282750,7198525,-84225,SELL
2020-11-02 12:47:00,12:47,7119425,7237325,117900,BUY
2020-11-02 12:48:00,12:48,7066600,7236575,169975,BUY
2020-11-02 12:49:00,12:49,7069925,7236575,166650,BUY
2020-11-02 12:50:00,12:50,7056300,7280250,223950,BUY
2020-11-02 12:51:00,12:51,7098475,7274825,176350,BUY
2020-11-02 12:52:00,12:52,7055875,7270750,214875,BUY
2020-11-02 12:53:00,12:53,7139075,7300575,161500,BUY
2020-11-02 12:54:00,12:54,7051450,7302550,251100,BUY
2020-11-02 12:55:00,12:55,7110575,7302500,191925,BUY
2020-11-02 12:56:00,12:56,7080100,7308550,228450,BUY
2020-11-02 12:57:00,12:57,7035450,7304575,269125,BUY
2020-11-02 12:58:00,12:58,7044125,7310150,266025,BUY
2020-11-02 12:59:00,12:59,7100150,7306975,206825,BUY
2020-11-02 13:00:00,13:00,7114725,7299825,185100,BUY
2020-11-02 13:01:00,13:01,7088750,7303075,214325,BUY
2020-11-02 13:02:00,13:02,7124225,7349100,224875,BUY
2020-11-02 13:03:00,13:03,7142925,7332475,189550,BUY
2020-11-02 13:04:00,13:04,7122425,7357875,235450,BUY
2020-11-02 13:05:00,13:05,7099275,7317050,217775,BUY
2020-11-02 13:06:00,13:06,7114675,7291900,177225,BUY
2020-11-02 13:07:00,13:07,7039125,7303850,264725,BUY
2020-11-02 13:08:00,13:08,7113250,7301775,188525,BUY
2020-11-02 13:09:00,13:09,7098975,7334800,235825,BUY
2020-11-02 13:10:00,13:10,7042325,7316375,274050,BUY
2020-11-02 13:11:00,13:11,7169300,7369675,200375,BUY
2020-11-02 13:12:00,13:12,7181200,7362025,180825,BUY
2020-11-02 13:13:00,13:13,7176700,7350100,173400,BUY
2020-11-02 13:14:00,13:14,7209100,7384875,175775,BUY
2020-11-02 13:15:00,13:15,7233000,7399350,166350,BUY
2020-11-02 13:16:00,13:16,7174775,7387425,212650,BUY
2020-11-02 13:17:00,13:17,7205775,7452500,246725,BUY
2020-11-02 13:18:00,13:18,7191800,7487325,295525,BUY
2020-11-02 13:19:00,13:19,7272350,7492525,220175,BUY
2020-11-02 13:20:00,13:20,7249875,7504425,254550,BUY
2020-11-02 13:21:00,13:21,7136425,7513850,377425,BUY
2020-11-02 13:22:00,13:22,7209225,7501075,291850,BUY
2020-11-02 13:23:00,13:23,7178450,7511900,333450,BUY
2020-11-02 13:24:00,13:24,7263300,7596650,333350,BUY
2020-11-02 13:25:00,13:25,7289200,7573500,284300,BUY
2020-11-02 13:26:00,13:26,7137750,7594475,456725,BUY
2020-11-02 13:27:00,13:27,7263275,7633725,370450,BUY
2020-11-02 13:28:00,13:28,7162000,7627400,465400,BUY
2020-11-02 13:29:00,13:29,7273025,7632900,359875,BUY
2020-11-02 13:30:00,13:30,7274400,7648050,373650,BUY
2020-11-02 13:31:00,13:31,7312875,7661450,348575,BUY
2020-11-02 13:32:00,13:32,7279875,7660650,380775,BUY
2020-11-02 13:33:00,13:33,7314925,7635375,320450,BUY
2020-11-02 13:34:00,13:34,7318000,7625275,307275,BUY
2020-11-02 13:35:00,13:35,7358750,7636525,277775,BUY
2020-11-02 13:36:00,13:36,7384225,7622350,238125,BUY
2020-11-02 13:37:00,13:37,7343075,7612325,269250,BUY
2020-11-02 13:38:00,13:38,7348550,7623625,275075,BUY
2020-11-02 13:39:00,13:39,7371450,7699350,327900,BUY
2020-11-02 13:40:00,13:40,7365475,7700500,335025,BUY
2020-11-02 13:41:00,13:41,7364325,7710525,346200,BUY
2020-11-02 13:42:00,13:42,7406100,7751925,345825,BUY
2020-11-02 13:43:00,13:43,7328075,7754500,426425,BUY
2020-11-02 13:44:00,13:44,7331350,7768225,436875,BUY
2020-11-02 13:45:00,13:45,7421025,7769325,348300,BUY
2020-11-02 13:46:00,13:46,7395225,7773200,377975,BUY
2020-11-02 13:47:00,13:47,7405500,7755300,349800,BUY
2020-11-02 13:48:00,13:48,7512350,7833725,321375,BUY
2020-11-02 13:49:00,13:49,7469175,7813550,344375,BUY
2020-11-02 13:50:00,13:50,7574550,7834875,260325,BUY
2020-11-02 13:51:00,13:51,7512400,7818625,306225,BUY
2020-11-02 13:52:00,13:52,7574900,7826450,251550,BUY
2020-11-02 13:53:00,13:53,7529775,7819525,289750,BUY
2020-11-02 13:54:00,13:54,7403175,7763825,360650,BUY
2020-11-02 13:55:00,13:55,7285175,7774350,489175,BUY
2020-11-02 13:56:00,13:56,7403175,7755600,352425,BUY
2020-11-02 13:57:00,13:57,7466925,7762475,295550,BUY
2020-11-02 13:58:00,13:58,7388600,7766400,377800,BUY
2020-11-02 13:59:00,13:59,7471325,7756375,285050,BUY
2020-11-02 14:00:00,14:00,7478700,7782275,303575,BUY
2020-11-02 14:01:00,14:01,7481875,7771500,289625,BUY
2020-11-02 14:02:00,14:02,7397800,7772900,375100,BUY
2020-11-02 14:03:00,14:03,7424725,7766925,342200,BUY
2020-11-02 14:04:00,14:04,7455525,7751900,296375,BUY
2020-11-02 14:05:00,14:05,7466800,7772975,306175,BUY
2020-11-02 14:06:00,14:06,7512175,7739325,227150,BUY
2020-11-02 14:07:00,14:07,7437800,7748725,310925,BUY
2020-11-02 14:08:00,14:08,7450800,7735175,284375,BUY
2020-11-02 14:09:00,14:09,7439725,7768250,328525,BUY
2020-11-02 14:10:00,14:10,7616025,7784900,168875,BUY
2020-11-02 14:11:00,14:11,7609575,7771400,161825,BUY
2020-11-02 14:12:00,14:12,7402450,7818900,416450,BUY
2020-11-02 14:13:00,14:13,7463925,7805325,341400,BUY
2020-11-02 14:14:00,14:14,7439675,7818750,379075,BUY
2020-11-02 14:15:00,14:15,7566275,7829950,263675,BUY
2020-11-02 14:16:00,14:16,7578800,7830000,251200,BUY
2020-11-02 14:17:00,14:17,7534600,7831950,297350,BUY
2020-11-02 14:18:00,14:18,7251700,7663725,412025,BUY
2020-11-02 14:19:00,14:19,7232275,7660025,427750,BUY
2020-11-02 14:20:00,14:20,7247600,7661700,414100,BUY
2020-11-02 14:21:00,14:21,7206700,7595325,388625,BUY
2020-11-02 14:22:00,14:22,7170750,7594600,423850,BUY
2020-11-02 14:23:00,14:23,7176725,7601225,424500,BUY
2020-11-02 14:24:00,14:24,7155750,7598250,442500,BUY
2020-11-02 14:25:00,14:25,7124900,7595700,470800,BUY
2020-11-02 14:26:00,14:26,7159500,7598350,438850,BUY
2020-11-02 14:27:00,14:27,7100500,7625550,525050,BUY
2020-11-02 14:28:00,14:28,7115550,7634475,518925,BUY
2020-11-02 14:29:00,14:29,7078350,7632175,553825,BUY
2020-11-02 14:30:00,14:30,6996900,7669050,672150,BUY
2020-11-02 14:31:00,14:31,6969375,7669050,699675,BUY
2020-11-02 14:32:00,14:32,7073325,7665925,592600,BUY
2020-11-02 14:33:00,14:33,7026200,7742600,716400,BUY
2020-11-02 14:34:00,14:34,6975125,7746075,770950,BUY
2020-11-02 14:35:00,14:35,6988650,7742675,754025,BUY
2020-11-02 14:36:00,14:36,6967925,7725600,757675,BUY
2020-11-02 14:37:00,14:37,6984950,7720500,735550,BUY
2020-11-02 14:38:00,14:38,6974000,7719700,745700,BUY
2020-11-02 14:39:00,14:39,6964000,7718525,754525,BUY
2020-11-02 14:40:00,14:40,7006750,7726900,720150,BUY
2020-11-02 14:41:00,14:41,7044325,7726900,682575,BUY
2020-11-02 14:42:00,14:42,7018600,7755725,737125,BUY
2020-11-02 14:43:00,14:43,7104325,7762675,658350,BUY
2020-11-02 14:44:00,14:44,7072850,7758025,685175,BUY
2020-11-02 14:45:00,14:45,7099575,7762525,662950,BUY
2020-11-02 14:46:00,14:46,7110500,7769125,658625,BUY
2020-11-02 14:47:00,14:47,7103675,7752000,648325,BUY
2020-11-02 14:48:00,14:48,7067875,7767375,699500,BUY
2020-11-02 14:49:00,14:49,7069400,7763525,694125,BUY
2020-11-02 14:50:00,14:50,7056125,7763525,707400,BUY
2020-11-02 14:51:00,14:51,7059700,7769175,709475,BUY
2020-11-02 14:52:00,14:52,7051000,7772875,721875,BUY
2020-11-02 14:53:00,14:53,6980275,7757950,777675,BUY
2020-11-02 14:54:00,14:54,7038375,7747650,709275,BUY
2020-11-02 14:55:00,14:55,7001275,7749350,748075,BUY
2020-11-02 14:56:00,14:56,6944925,7748175,803250,BUY
2020-11-02 14:57:00,14:57,6943900,7673150,729250,BUY
2020-11-02 14:58:00,14:58,6888300,7676100,787800,BUY
2020-11-02 14:59:00,14:59,6971875,7671550,699675,BUY
2020-11-02 15:00:00,15:00,6919025,7659150,740125,BUY
2020-11-02 15:01:00,15:01,6845575,7654575,809000,BUY
2020-11-02 15:02:00,15:02,6835425,7658225,822800,BUY
2020-11-02 15:03:00,15:03,6852225,7523700,671475,BUY
2020-11-02 15:04:00,15:04,6683750,7523800,840050,BUY
2020-11-02 15:05:00,15:05,6849875,7530275,680400,BUY
2020-11-02 15:06:00,15:06,6809800,7435375,625575,BUY
2020-11-02 15:07:00,15:07,6674975,7428075,753100,BUY
2020-11-02 15:08:00,15:08,6708500,7436650,728150,BUY
2020-11-02 15:09:00,15:09,6641125,7243800,602675,BUY
2020-11-02 15:10:00,15:10,6653175,7244000,590825,BUY
2020-11-02 15:11:00,15:11,6565650,7228000,662350,BUY
2020-11-02 15:13:00,15:13,6661750,7171725,509975,BUY
2020-11-02 15:14:00,15:14,6625700,7171350,545650,BUY
2020-11-02 15:15:00,15:15,6688675,7069125,380450,BUY
2020-11-02 15:16:00,15:16,6671100,7071100,400000,BUY
2020-11-02 15:17:00,15:17,6712575,7065050,352475,BUY
2020-11-02 15:18:00,15:18,6639475,6853225,213750,BUY
2020-11-02 15:19:00,15:19,6566725,6857975,291250,BUY
2020-11-02 15:20:00,15:20,6643150,6858975,215825,BUY
2020-11-02 15:21:00,15:21,6531675,6758450,226775,BUY
2020-11-02 15:22:00,15:22,6477100,6750775,273675,BUY
2020-11-02 15:23:00,15:23,6492175,6749450,257275,BUY
2020-11-02 15:24:00,15:24,6460925,6697100,236175,BUY
2020-11-02 15:25:00,15:25,6499475,6700575,201100,BUY
2020-11-02 15:26:00,15:26,6391475,6691925,300450,BUY
2020-11-02 15:27:00,15:27,6346875,6493325,146450,BUY
2020-11-02 15:28:00,15:28,6342050,6479275,137225,BUY
2020-11-02 15:29:00,15:29,6366200,6493825,127625,BUY
2020-11-03 09:15:00,09:15,6175500,6280725,105225,BUY
2020-11-03 09:16:00,09:16,6165275,6273050,107775,BUY
2020-11-03 09:17:00,09:17,6158550,6354625,196075,BUY
2020-11-03 09:18:00,09:18,6221225,6362975,141750,BUY
2020-11-03 09:19:00,09:19,6157000,6364350,207350,BUY
2020-11-03 09:20:00,09:20,6364900,6682450,317550,BUY
2020-11-03 09:21:00,09:21,6338425,6680975,342550,BUY
2020-11-03 09:22:00,09:22,6309450,6679250,369800,BUY
2020-11-03 09:23:00,09:23,6666225,7104100,437875,BUY
2020-11-03 09:24:00,09:24,6633550,7091825,458275,BUY
2020-11-03 09:25:00,09:25,6610900,7103150,492250,BUY
2020-11-03 09:26:00,09:26,6542725,7166900,624175,BUY
2020-11-03 09:27:00,09:27,6591450,7168450,577000,BUY
2020-11-03 09:28:00,09:28,6665975,7165775,499800,BUY
2020-11-03 09:29:00,09:29,6837275,7226650,389375,BUY
2020-11-03 09:30:00,09:30,6805150,7238725,433575,BUY
2020-11-03 09:31:00,09:31,6821575,7238850,417275,BUY
2020-11-03 09:32:00,09:32,6871950,7413225,541275,BUY
2020-11-03 09:33:00,09:33,6871850,7411400,539550,BUY
2020-11-03 09:34:00,09:34,6902650,7411400,508750,BUY
2020-11-03 09:35:00,09:35,6898775,7483525,584750,BUY
2020-11-03 09:36:00,09:36,6956925,7484650,527725,BUY
2020-11-03 09:37:00,09:37,6973375,7475675,502300,BUY
2020-11-03 09:38:00,09:38,7163875,7585025,421150,BUY
2020-11-03 09:39:00,09:39,7084200,7583675,499475,BUY
2020-11-03 09:40:00,09:40,7142300,7582275,439975,BUY
2020-11-03 09:41:00,09:41,7066775,7632325,565550,BUY
2020-11-03 09:42:00,09:42,7203325,7635300,431975,BUY
2020-11-03 09:43:00,09:43,7078825,7623775,544950,BUY
2020-11-03 09:44:00,09:44,7150575,7673725,523150,BUY
2020-11-03 09:45:00,09:45,7062425,7685200,622775,BUY
2020-11-03 09:46:00,09:46,7227275,7685200,457925,BUY
2020-11-03 09:47:00,09:47,7163450,7697625,534175,BUY
2020-11-03 09:48:00,09:48,7084250,7710625,626375,BUY
2020-11-03 09:49:00,09:49,7096050,7709075,613025,BUY
2020-11-03 09:50:00,09:50,6999550,7635700,636150,BUY
2020-11-03 09:51:00,09:51,6947775,7634175,686400,BUY
2020-11-03 09:52:00,09:52,6954525,7634175,679650,BUY
2020-11-03 09:53:00,09:53,7028450,7681200,652750,BUY
2020-11-03 09:54:00,09:54,7004150,7680900,676750,BUY
2020-11-03 09:55:00,09:55,7066075,7682450,616375,BUY
2020-11-03 09:56:00,09:56,6953400,7711325,757925,BUY
2020-11-03 09:57:00,09:57,6856050,7713600,857550,BUY
2020-11-03 09:58:00,09:58,6974550,7713275,738725,BUY
2020-11-03 09:59:00,09:59,6962425,7776950,814525,BUY
2020-11-03 10:00:00,10:00,6993025,7771550,778525,BUY
2020-11-03 10:01:00,10:01,6994275,7769250,774975,BUY
2020-11-03 10:02:00,10:02,7130475,7754525,624050,BUY
2020-11-03 10:03:00,10:03,7130500,7756775,626275,BUY
2020-11-03 10:04:00,10:04,7090625,7754525,663900,BUY
2020-11-03 10:05:00,10:05,7113225,7691650,578425,BUY
2020-11-03 10:06:00,10:06,7025475,7691650,666175,BUY
2020-11-03 10:07:00,10:07,7123000,7677150,554150,BUY
2020-11-03 10:08:00,10:08,7108375,7745300,636925,BUY
2020-11-03 10:09:00,10:09,7042175,7746850,704675,BUY
2020-11-03 10:10:00,10:10,7230400,7746850,516450,BUY
2020-11-03 10:11:00,10:11,7301800,7751625,449825,BUY
2020-11-03 10:12:00,10:12,7282600,7765150,482550,BUY
2020-11-03 10:13:00,10:13,7148375,7752525,604150,BUY
2020-11-03 10:14:00,10:14,7109225,7801850,692625,BUY
2020-11-03 10:15:00,10:15,7070325,7802875,732550,BUY
2020-11-03 10:16:00,10:16,7246500,7811600,565100,BUY
2020-11-03 10:17:00,10:17,7209800,7875600,665800,BUY
2020-11-03 10:18:00,10:18,7099775,7875300,775525,BUY
2020-11-03 10:19:00,10:19,7290675,7873100,582425,BUY
2020-11-03 10:20:00,10:20,7275975,7905950,629975,BUY
2020-11-03 10:21:00,10:21,7343350,7909700,566350,BUY
2020-11-03 10:22:00,10:22,7341175,7903700,562525,BUY
2020-11-03 10:23:00,10:23,7243125,7937075,693950,BUY
2020-11-03 10:24:00,10:24,7188000,7937075,749075,BUY
2020-11-03 10:25:00,10:25,7242600,7937075,694475,BUY
2020-11-03 10:26:00,10:26,7263475,7925400,661925,BUY
2020-11-03 10:27:00,10:27,7157800,7926500,768700,BUY
2020-11-03 10:28:00,10:28,7250525,7923850,673325,BUY
2020-11-03 10:29:00,10:29,7287800,7968250,680450,BUY
2020-11-03 10:30:00,10:30,7183375,7968250,784875,BUY
2020-11-03 10:31:00,10:31,7157825,7956575,798750,BUY
2020-11-03 10:32:00,10:32,7133725,8013000,879275,BUY
2020-11-03 10:33:00,10:33,7223650,8013175,789525,BUY
2020-11-03 10:34:00,10:34,7291325,8005825,714500,BUY
2020-11-03 10:35:00,10:35,7318125,8039400,721275,BUY
2020-11-03 10:36:00,10:36,7232050,8033400,801350,BUY
2020-11-03 10:37:00,10:37,7204325,8022725,818400,BUY
2020-11-03 10:38:00,10:38,7250625,8050975,800350,BUY
2020-11-03 10:39:00,10:39,7244625,8059000,814375,BUY
2020-11-03 10:40:00,10:40,7188075,8056850,868775,BUY
2020-11-03 10:41:00,10:41,7297725,8110850,813125,BUY
2020-11-03 10:42:00,10:42,7263450,8108200,844750,BUY
2020-11-03 10:43:00,10:43,7059925,8110550,1050625,BUY
2020-11-03 10:44:00,10:44,7422900,8137100,714200,BUY
2020-11-03 10:45:00,10:45,7233300,8133350,900050,BUY
2020-11-03 10:46:00,10:46,7294100,8133300,839200,BUY
2020-11-03 10:47:00,10:47,7086050,8149850,1063800,BUY
2020-11-03 10:48:00,10:48,7387900,8151775,763875,BUY
2020-11-03 10:49:00,10:49,7274200,8151775,877575,BUY
2020-11-03 10:50:00,10:50,7410125,8181175,771050,BUY
2020-11-03 10:51:00,10:51,7304875,8181550,876675,BUY
2020-11-03 10:52:00,10:52,7135375,8190475,1055100,BUY
2020-11-03 10:53:00,10:53,6961975,8201500,1239525,BUY
2020-11-03 10:54:00,10:54,7253450,8143850,890400,BUY
2020-11-03 10:55:00,10:55,7079675,8186575,1106900,BUY
2020-11-03 10:56:00,10:56,7221625,8214125,992500,BUY
2020-11-03 10:57:00,10:57,7266225,8216425,950200,BUY
2020-11-03 10:58:00,10:58,7408075,8216600,808525,BUY
2020-11-03 10:59:00,10:59,7288200,8248175,959975,BUY
2020-11-03 11:00:00,11:00,7290375,8242975,952600,BUY
2020-11-03 11:01:00,11:01,7357200,8243500,886300,BUY
2020-11-03 11:02:00,11:02,7538050,8270425,732375,BUY
2020-11-03 11:03:00,11:03,7306000,8265100,959100,BUY
2020-11-03 11:04:00,11:04,7360350,8267725,907375,BUY
2020-11-03 11:05:00,11:05,7296975,8278450,981475,BUY
2020-11-03 11:06:00,11:06,7316800,8270525,953725,BUY
2020-11-03 11:07:00,11:07,7294150,8272975,978825,BUY
2020-11-03 11:08:00,11:08,7448000,8316050,868050,BUY
2020-11-03 11:09:00,11:09,7349900,8310475,960575,BUY
2020-11-03 11:10:00,11:10,7181700,8307875,1126175,BUY
2020-11-03 11:11:00,11:11,7192025,8341575,1149550,BUY
2020-11-03 11:12:00,11:12,6956875,8331575,1374700,BUY
2020-11-03 11:13:00,11:13,7390225,8331575,941350,BUY
2020-11-03 11:14:00,11:14,7318975,8325075,1006100,BUY
2020-11-03 11:15:00,11:15,7323150,8387625,1064475,BUY
2020-11-03 11:16:00,11:16,7325950,8372375,1046425,BUY
2020-11-03 11:17:00,11:17,7362700,8406800,1044100,BUY
2020-11-03 11:18:00,11:18,7231675,8421550,1189875,BUY
2020-11-03 11:19:00,11:19,7084075,8406825,1322750,BUY
2020-11-03 11:20:00,11:20,7636375,8446650,810275,BUY
2020-11-03 11:21:00,11:21,7374850,8444175,1069325,BUY
2020-11-03 11:22:00,11:22,7551900,8401975,850075,BUY
2020-11-03 11:23:00,11:23,6991225,8467575,1476350,BUY
2020-11-03 11:24:00,11:24,7186675,8469450,1282775,BUY
2020-11-03 11:25:00,11:25,7460300,8484100,1023800,BUY
2020-11-03 11:26:00,11:26,7424400,8502025,1077625,BUY
2020-11-03 11:27:00,11:27,7323125,8506675,1183550,BUY
2020-11-03 11:28:00,11:28,7381625,8510475,1128850,BUY
2020-11-03 11:29:00,11:29,7077675,8381775,1304100,BUY
2020-11-03 11:30:00,11:30,7198725,8491900,1293175,BUY
2020-11-03 11:31:00,11:31,7407425,8502425,1095000,BUY
2020-11-03 11:32:00,11:32,7375225,8536300,1161075,BUY
2020-11-03 11:33:00,11:33,7274675,8543350,1268675,BUY
2020-11-03 11:34:00,11:34,7281100,8555125,1274025,BUY
2020-11-03 11:35:00,11:35,7378625,8559925,1181300,BUY
2020-11-03 11:36:00,11:36,7358600,8557750,1199150,BUY
2020-11-03 11:37:00,11:37,7250575,8557225,1306650,BUY
2020-11-03 11:38:00,11:38,7317775,8586600,1268825,BUY
2020-11-03 11:39:00,11:39,7198300,8588575,1390275,BUY
2020-11-03 11:40:00,11:40,7463750,8584425,1120675,BUY
2020-11-03 11:41:00,11:41,7365000,8609875,1244875,BUY
2020-11-03 11:42:00,11:42,7333275,8612000,1278725,BUY
2020-11-03 11:43:00,11:43,7615350,8615025,999675,BUY
2020-11-03 11:44:00,11:44,7392300,8668300,1276000,BUY
2020-11-03 11:45:00,11:45,7325925,8668100,1342175,BUY
2020-11-03 11:46:00,11:46,7250550,8668200,1417650,BUY
2020-11-03 11:47:00,11:47,7412275,8733625,1321350,BUY
2020-11-03 11:48:00,11:48,7338150,8743525,1405375,BUY
2020-11-03 11:49:00,11:49,7427775,8743575,1315800,BUY
2020-11-03 11:50:00,11:50,7208050,8785950,1577900,BUY
2020-11-03 11:51:00,11:51,7153125,8781000,1627875,BUY
2020-11-03 11:52:00,11:52,7070100,8784100,1714000,BUY
2020-11-03 11:53:00,11:53,7175625,8775850,1600225,BUY
2020-11-03 11:54:00,11:54,7357700,8786125,1428425,BUY
2020-11-03 11:55:00,11:55,7243525,8784700,1541175,BUY
2020-11-03 11:56:00,11:56,7186600,8791000,1604400,BUY
2020-11-03 11:57:00,11:57,7139450,8777850,1638400,BUY
2020-11-03 11:58:00,11:58,7000800,8779250,1778450,BUY
2020-11-03 11:59:00,11:59,7271250,8753550,1482300,BUY
2020-11-03 12:00:00,12:00,7251475,8742650,1491175,BUY
2020-11-03 12:01:00,12:01,7219625,8747875,1528250,BUY
2020-11-03 12:02:00,12:02,7293750,8766800,1473050,BUY
2020-11-03 12:03:00,12:03,7270575,8611650,1341075,BUY
2020-11-03 12:04:00,12:04,7213700,8614875,1401175,BUY
2020-11-03 12:05:00,12:05,7300450,8752325,1451875,BUY
2020-11-03 12:06:00,12:06,7146400,8788750,1642350,BUY
2020-11-03 12:07:00,12:07,7323650,8784500,1460850,BUY
2020-11-03 12:08:00,12:08,7124050,8808900,1684850,BUY
2020-11-03 12:09:00,12:09,7426975,8811100,1384125,BUY
2020-11-03 12:10:00,12:10,7281275,8816300,1535025,BUY
2020-11-03 12:11:00,12:11,7204550,8813525,1608975,BUY
2020-11-03 12:12:00,12:12,7202000,8826175,1624175,BUY
2020-11-03 12:13:00,12:13,7484475,8823975,1339500,BUY
2020-11-03 12:14:00,12:14,7236375,8837750,1601375,BUY
2020-11-03 12:15:00,12:15,7296925,8828900,1531975,BUY
2020-11-03 12:16:00,12:16,7434675,8838325,1403650,BUY
2020-11-03 12:17:00,12:17,7130675,8828725,1698050,BUY
2020-11-03 12:18:00,12:18,7335075,8837925,1502850,BUY
2020-11-03 12:19:00,12:19,7273725,8837925,1564200,BUY
2020-11-03 12:20:00,12:20,7386700,8857450,1470750,BUY
2020-11-03 12:21:00,12:21,7378425,8860750,1482325,BUY
2020-11-03 12:22:00,12:22,7201675,8800125,1598450,BUY
2020-11-03 12:23:00,12:23,6970100,8892375,1922275,BUY
2020-11-03 12:24:00,12:24,7326075,8893100,1567025,BUY
2020-11-03 12:25:00,12:25,7348125,8893100,1544975,BUY
2020-11-03 12:26:00,12:26,7329550,8952100,1622550,BUY
2020-11-03 12:27:00,12:27,7633600,8962250,1328650,BUY
2020-11-03 12:28:00,12:28,7461925,8962250,1500325,BUY
2020-11-03 12:29:00,12:29,7270225,8976650,1706425,BUY
2020-11-03 12:30:00,12:30,7352900,8974350,1621450,BUY
2020-11-03 12:31:00,12:31,7412300,8976625,1564325,BUY
2020-11-03 12:32:00,12:32,7332750,9024025,1691275,BUY
2020-11-03 12:33:00,12:33,7115625,9017675,1902050,BUY
2020-11-03 12:34:00,12:34,7219200,9028350,1809150,BUY
2020-11-03 12:35:00,12:35,7124525,9070800,1946275,BUY
2020-11-03 12:36:00,12:36,7216375,9071275,1854900,BUY
2020-11-03 12:37:00,12:37,7281800,9063925,1782125,BUY
2020-11-03 12:38:00,12:38,7288775,9101900,1813125,BUY
2020-11-03 12:39:00,12:39,7375900,9100925,1725025,BUY
2020-11-03 12:40:00,12:40,7555575,9101425,1545850,BUY
2020-11-03 12:41:00,12:41,7622450,9147575,1525125,BUY
2020-11-03 12:42:00,12:42,7511650,9155975,1644325,BUY
2020-11-03 12:43:00,12:43,7208225,9146675,1938450,BUY
2020-11-03 12:44:00,12:44,7321350,9108300,1786950,BUY
2020-11-03 12:45:00,12:45,7480800,9111650,1630850,BUY
2020-11-03 12:46:00,12:46,7429200,9104400,1675200,BUY
2020-11-03 12:47:00,12:47,7290500,9142400,1851900,BUY
2020-11-03 12:48:00,12:48,7287800,9149925,1862125,BUY
2020-11-03 12:49:00,12:49,7514550,9158850,1644300,BUY
2020-11-03 12:50:00,12:50,7309450,9177625,1868175,BUY
2020-11-03 12:51:00,12:51,7261275,9174350,1913075,BUY
2020-11-03 12:52:00,12:52,7237450,9175150,1937700,BUY
2020-11-03 12:53:00,12:53,7323600,9198875,1875275,BUY
2020-11-03 12:54:00,12:54,7276400,9215625,1939225,BUY
2020-11-03 12:55:00,12:55,7475475,9216175,1740700,BUY
2020-11-03 12:56:00,12:56,7331500,9204925,1873425,BUY
2020-11-03 12:57:00,12:57,7313400,9204775,1891375,BUY
2020-11-03 12:58:00,12:58,7062550,9206100,2143550,BUY
2020-11-03 12:59:00,12:59,7312725,9212850,1900125,BUY
2020-11-03 13:00:00,13:00,6879700,9222300,2342600,BUY
2020-11-03 13:01:00,13:01,7241450,9219725,1978275,BUY
2020-11-03 13:02:00,13:02,7015450,9239650,2224200,BUY
2020-11-03 13:03:00,13:03,7103650,9244850,2141200,BUY
2020-11-03 13:04:00,13:04,7286650,9250675,1964025,BUY
2020-11-03 13:05:00,13:05,7214825,9250975,2036150,BUY
2020-11-03 13:06:00,13:06,7219125,9252525,2033400,BUY
2020-11-03 13:07:00,13:07,7138775,9261500,2122725,BUY
2020-11-03 13:08:00,13:08,7275875,9274450,1998575,BUY
2020-11-03 13:09:00,13:09,7205500,9280850,2075350,BUY
2020-11-03 13:10:00,13:10,7305125,9275550,1970425,BUY
2020-11-03 13:11:00,13:11,7266100,9276125,2010025,BUY
2020-11-03 13:12:00,13:12,7150025,9283800,2133775,BUY
2020-11-03 13:13:00,13:13,7174575,9279375,2104800,BUY
2020-11-03 13:14:00,13:14,6834025,9295825,2461800,BUY
2020-11-03 13:15:00,13:15,7143100,9309675,2166575,BUY
2020-11-03 13:16:00,13:16,7166200,9300150,2133950,BUY
2020-11-03 13:17:00,13:17,7520675,9304050,1783375,BUY
2020-11-03 13:18:00,13:18,7513675,9282550,1768875,BUY
2020-11-03 13:19:00,13:19,7185625,9279175,2093550,BUY
2020-11-03 13:20:00,13:20,7383500,9290850,1907350,BUY
2020-11-03 13:21:00,13:21,7136875,9303775,2166900,BUY
2020-11-03 13:22:00,13:22,7200975,9313850,2112875,BUY
2020-11-03 13:23:00,13:23,7266250,9294675,2028425,BUY
2020-11-03 13:24:00,13:24,7101275,9307725,2206450,BUY
2020-11-03 13:25:00,13:25,7406175,9307750,1901575,BUY
2020-11-03 13:26:00,13:26,7281900,9319250,2037350,BUY
2020-11-03 13:27:00,13:27,6721125,9340775,2619650,BUY
2020-11-03 13:28:00,13:28,7161775,9330650,2168875,BUY
2020-11-03 13:29:00,13:29,7160800,9330975,2170175,BUY
2020-11-03 13:30:00,13:30,7286925,9355800,2068875,BUY
2020-11-03 13:31:00,13:31,7203525,9340025,2136500,BUY
2020-11-03 13:32:00,13:32,7332575,9346450,2013875,BUY
2020-11-03 13:33:00,13:33,6966675,9366325,2399650,BUY
2020-11-03 13:34:00,13:34,7180325,9369325,2189000,BUY
2020-11-03 13:35:00,13:35,7389500,9375675,1986175,BUY
2020-11-03 13:36:00,13:36,7397525,9409000,2011475,BUY
2020-11-03 13:37:00,13:37,7303200,9397675,2094475,BUY
2020-11-03 13:38:00,13:38,7220475,9400175,2179700,BUY
2020-11-03 13:39:00,13:39,7335250,9400125,2064875,BUY
2020-11-03 13:40:00,13:40,7422025,9402875,1980850,BUY
2020-11-03 13:41:00,13:41,7604700,9425825,1821125,BUY
2020-11-03 13:42:00,13:42,7254450,9386200,2131750,BUY
2020-11-03 13:43:00,13:43,7177400,9385800,2208400,BUY
2020-11-03 13:44:00,13:44,7275625,9390250,2114625,BUY
2020-11-03 13:45:00,13:45,7006725,9394825,2388100,BUY
2020-11-03 13:46:00,13:46,7029100,9404025,2374925,BUY
2020-11-03 13:47:00,13:47,7210275,9406975,2196700,BUY
2020-11-03 13:48:00,13:48,7222575,9457450,2234875,BUY
2020-11-03 13:49:00,13:49,7318400,9449925,2131525,BUY
2020-11-03 13:50:00,13:50,7254725,9456000,2201275,BUY
2020-11-03 13:51:00,13:51,7322625,9505725,2183100,BUY
2020-11-03 13:52:00,13:52,6974150,9506175,2532025,BUY
2020-11-03 13:53:00,13:53,7142000,9509725,2367725,BUY
2020-11-03 13:54:00,13:54,6931900,9515550,2583650,BUY
2020-11-03 13:55:00,13:55,6896675,9511875,2615200,BUY
2020-11-03 13:56:00,13:56,7062725,9505625,2442900,BUY
2020-11-03 13:57:00,13:57,7306850,9515175,2208325,BUY
2020-11-03 13:58:00,13:58,7145450,9514225,2368775,BUY
2020-11-03 13:59:00,13:59,7239025,9516350,2277325,BUY
2020-11-03 14:00:00,14:00,7225575,9556775,2331200,BUY
2020-11-03 14:01:00,14:01,6860375,9546650,2686275,BUY
2020-11-03 14:02:00,14:02,6814350,9539900,2725550,BUY
2020-11-03 14:03:00,14:03,6865700,9619900,2754200,BUY
2020-11-03 14:04:00,14:04,6894725,9613450,2718725,BUY
2020-11-03 14:05:00,14:05,7124750,9611900,2487150,BUY
2020-11-03 14:06:00,14:06,7073425,9611775,2538350,BUY
2020-11-03 14:07:00,14:07,6798025,9617725,2819700,BUY
2020-11-03 14:08:00,14:08,6985425,9607675,2622250,BUY
2020-11-03 14:09:00,14:09,7222900,9658900,2436000,BUY
2020-11-03 14:10:00,14:10,7198500,9655075,2456575,BUY
2020-11-03 14:11:00,14:11,7026575,9662350,2635775,BUY
2020-11-03 14:12:00,14:12,7130700,9655675,2524975,BUY
2020-11-03 14:13:00,14:13,7126900,9647400,2520500,BUY
2020-11-03 14:14:00,14:14,7161100,9647725,2486625,BUY
2020-11-03 14:15:00,14:15,7264575,9605450,2340875,BUY
2020-11-03 14:16:00,14:16,6796925,9602425,2805500,BUY
2020-11-03 14:17:00,14:17,7003075,9602650,2599575,BUY
2020-11-03 14:18:00,14:18,6748425,9650450,2902025,BUY
2020-11-03 14:19:00,14:19,7214600,9658450,2443850,BUY
2020-11-03 14:20:00,14:20,7215000,9648550,2433550,BUY
2020-11-03 14:21:00,14:21,7057875,9657675,2599800,BUY
2020-11-03 14:22:00,14:22,7078000,9667625,2589625,BUY
2020-11-03 14:23:00,14:23,7038925,9668625,2629700,BUY
2020-11-03 14:24:00,14:24,7083350,9679375,2596025,BUY
2020-11-03 14:25:00,14:25,7292775,9694525,2401750,BUY
2020-11-03 14:26:00,14:26,7264800,9679375,2414575,BUY
2020-11-03 14:27:00,14:27,7209750,9648950,2439200,BUY
2020-11-03 14:28:00,14:28,7388200,9646075,2257875,BUY
2020-11-03 14:29:00,14:29,7296125,9646125,2350000,BUY
2020-11-03 14:30:00,14:30,7218375,9543875,2325500,BUY
2020-11-03 14:31:00,14:31,7129750,9552300,2422550,BUY
2020-11-03 14:32:00,14:32,6941825,9539875,2598050,BUY
2020-11-03 14:33:00,14:33,7138775,9498175,2359400,BUY
2020-11-03 14:34:00,14:34,6963200,9502675,2539475,BUY
2020-11-03 14:35:00,14:35,6996125,9499475,2503350,BUY
2020-11-03 14:36:00,14:36,7170675,9534700,2364025,BUY
2020-11-03 14:37:00,14:37,6994950,9540625,2545675,BUY
2020-11-03 14:38:00,14:38,7144600,9540625,2396025,BUY
2020-11-03 14:39:00,14:39,7137825,9554600,2416775,BUY
2020-11-03 14:40:00,14:40,6969600,9554575,2584975,BUY
2020-11-03 14:41:00,14:41,7189025,9554575,2365550,BUY
2020-11-03 14:42:00,14:42,7052425,9604175,2551750,BUY
2020-11-03 14:43:00,14:43,6886750,9586225,2699475,BUY
2020-11-03 14:44:00,14:44,7042525,9581400,2538875,BUY
2020-11-03 14:45:00,14:45,7342125,9625600,2283475,BUY
2020-11-03 14:46:00,14:46,7357875,9632700,2274825,BUY
2020-11-03 14:47:00,14:47,7213075,9620650,2407575,BUY
2020-11-03 14:48:00,14:48,7127400,9598975,2471575,BUY
2020-11-03 14:49:00,14:49,6926950,9614850,2687900,BUY
2020-11-03 14:50:00,14:50,7068825,9602275,2533450,BUY
2020-11-03 14:51:00,14:51,6896000,9521675,2625675,BUY
2020-11-03 14:52:00,14:52,6879175,9502625,2623450,BUY
2020-11-03 14:53:00,14:53,6899750,9506450,2606700,BUY
2020-11-03 14:54:00,14:54,6948125,9519700,2571575,BUY
2020-11-03 14:55:00,14:55,7100450,9532450,2432000,BUY
2020-11-03 14:56:00,14:56,7123150,9531000,2407850,BUY
2020-11-03 14:57:00,14:57,7039675,9581875,2542200,BUY
2020-11-03 14:58:00,14:58,7072125,9587150,2515025,BUY
2020-11-03 14:59:00,14:59,7024050,9581875,2557825,BUY
2020-11-03 15:00:00,15:00,7089700,9451250,2361550,BUY
2020-11-03 15:01:00,15:01,7088675,9461525,2372850,BUY
2020-11-03 15:02:00,15:02,6761900,9465675,2703775,BUY
2020-11-03 15:03:00,15:03,6922625,9372200,2449575,BUY
2020-11-03 15:04:00,15:04,6884000,9391500,2507500,BUY
2020-11-03 15:05:00,15:05,6907800,9383075,2475275,BUY
2020-11-03 15:06:00,15:06,6656200,9267525,2611325,BUY
2020-11-03 15:07:00,15:07,6780500,9263425,2482925,BUY
2020-11-03 15:08:00,15:08,6879925,9263800,2383875,BUY
2020-11-03 15:09:00,15:09,6622375,9254075,2631700,BUY
2020-11-03 15:10:00,15:10,6977775,9264475,2286700,BUY
2020-11-03 15:11:00,15:11,6665300,9258625,2593325,BUY
2020-11-03 15:12:00,15:12,6678175,9176675,2498500,BUY
2020-11-03 15:13:00,15:13,6649750,9178475,2528725,BUY
2020-11-03 15:14:00,15:14,6639825,9168725,2528900,BUY
2020-11-03 15:15:00,15:15,6657250,9052850,2395600,BUY
2020-11-03 15:16:00,15:16,6599400,9052850,2453450,BUY
2020-11-03 15:17:00,15:17,6635950,9052850,2416900,BUY
2020-11-03 15:18:00,15:18,6426775,8926950,2500175,BUY
2020-11-03 15:19:00,15:19,6463875,8923275,2459400,BUY
2020-11-03 15:20:00,15:20,6522700,8923325,2400625,BUY
2020-11-03 15:21:00,15:21,6219800,8785175,2565375,BUY
2020-11-03 15:22:00,15:22,6257650,8784675,2527025,BUY
2020-11-03 15:23:00,15:23,6119050,8780000,2660950,BUY
2020-11-03 15:24:00,15:24,6112900,8674050,2561150,BUY
2020-11-03 15:25:00,15:25,6190250,8683775,2493525,BUY
2020-11-03 15:26:00,15:26,5996900,8692175,2695275,BUY
2020-11-03 15:27:00,15:27,5839625,8529700,2690075,BUY
2020-11-03 15:28:00,15:28,5972025,8542400,2570375,BUY
2020-11-03 15:29:00,15:29,5976675,8546325,2569650,BUY
2020-11-04 09:15:00,09:15,5759625,8321250,2561625,BUY
2020-11-04 09:16:00,09:16,5753375,8316450,2563075,BUY
2020-11-04 09:17:00,09:17,5795450,8455675,2660225,BUY
2020-11-04 09:18:00,09:18,5787450,8450875,2663425,BUY
2020-11-04 09:19:00,09:19,5707725,8443475,2735750,BUY
2020-11-04 09:20:00,09:20,6100425,8705725,2605300,BUY
2020-11-04 09:21:00,09:21,5987600,8703075,2715475,BUY
2020-11-04 09:22:00,09:22,5926800,8706275,2779475,BUY
2020-11-04 09:23:00,09:23,6412700,9032525,2619825,BUY
2020-11-04 09:24:00,09:24,6311175,9028775,2717600,BUY
2020-11-04 09:25:00,09:25,6324675,9024000,2699325,BUY
2020-11-04 09:26:00,09:26,6651100,9372475,2721375,BUY
2020-11-04 09:27:00,09:27,6581175,9372475,2791300,BUY
2020-11-04 09:28:00,09:28,6648625,9370100,2721475,BUY
2020-11-04 09:29:00,09:29,6720825,9562500,2841675,BUY
2020-11-04 09:30:00,09:30,6779150,9563125,2783975,BUY
2020-11-04 09:31:00,09:31,6763675,9569425,2805750,BUY
2020-11-04 09:32:00,09:32,6963975,9715550,2751575,BUY
2020-11-04 09:33:00,09:33,7012750,9701475,2688725,BUY
2020-11-04 09:34:00,09:34,6949325,9709975,2760650,BUY
2020-11-04 09:35:00,09:35,6868725,9494000,2625275,BUY
2020-11-04 09:36:00,09:36,6886750,9490600,2603850,BUY
2020-11-04 09:37:00,09:37,6741925,9476550,2734625,BUY
2020-11-04 09:38:00,09:38,6946550,9561675,2615125,BUY
2020-11-04 09:39:00,09:39,7022725,9567900,2545175,BUY
2020-11-04 09:40:00,09:40,6871125,9565100,2693975,BUY
2020-11-04 09:41:00,09:41,7158475,9673700,2515225,BUY
2020-11-04 09:42:00,09:42,7058025,9673700,2615675,BUY
2020-11-04 09:43:00,09:43,7118800,9674775,2555975,BUY
2020-11-04 09:44:00,09:44,6968525,9659775,2691250,BUY
2020-11-04 09:45:00,09:45,6947000,9672675,2725675,BUY
2020-11-04 09:46:00,09:46,7104275,9666175,2561900,BUY
2020-11-04 09:47:00,09:47,7102725,9762225,2659500,BUY
2020-11-04 09:48:00,09:48,6958100,9745825,2787725,BUY
2020-11-04 09:49:00,09:49,7005325,9740150,2734825,BUY
2020-11-04 09:50:00,09:50,7259225,9795075,2535850,BUY
2020-11-04 09:51:00,09:51,7127900,9815400,2687500,BUY
2020-11-04 09:52:00,09:52,7191425,9786725,2595300,BUY
2020-11-04 09:53:00,09:53,7118175,9891825,2773650,BUY
2020-11-04 09:54:00,09:54,7048775,9869525,2820750,BUY
2020-11-04 09:55:00,09:55,7114075,9872025,2757950,BUY
2020-11-04 09:56:00,09:56,7100225,9936925,2836700,BUY
2020-11-04 09:57:00,09:57,7103800,9935675,2831875,BUY
2020-11-04 09:58:00,09:58,7247300,9939500,2692200,BUY
2020-11-04 09:59:00,09:59,7278600,9928825,2650225,BUY
2020-11-04 10:00:00,10:00,7218500,9948675,2730175,BUY
2020-11-04 10:01:00,10:01,7016725,9936150,2919425,BUY
2020-11-04 10:02:00,10:02,7313500,10041675,2728175,BUY
2020-11-04 10:03:00,10:03,7256775,10049475,2792700,BUY
2020-11-04 10:04:00,10:04,7206675,10052025,2845350,BUY
2020-11-04 10:05:00,10:05,7500775,10147500,2646725,BUY
2020-11-04 10:06:00,10:06,7425675,10147500,2721825,BUY
2020-11-04 10:07:00,10:07,7449500,10143125,2693625,BUY
2020-11-04 10:08:00,10:08,7109425,10152525,3043100,BUY
2020-11-04 10:09:00,10:09,7367850,10136900,2769050,BUY
2020-11-04 10:10:00,10:10,7351200,10142500,2791300,BUY
2020-11-04 10:11:00,10:11,7403575,10206275,2802700,BUY
2020-11-04 10:12:00,10:12,7431800,10210450,2778650,BUY
2020-11-04 10:13:00,10:13,7449350,10222200,2772850,BUY
2020-11-04 10:14:00,10:14,7691625,10231525,2539900,BUY
2020-11-04 10:15:00,10:15,7641725,10231100,2589375,BUY
2020-11-04 10:16:00,10:16,7691600,10231100,2539500,BUY
2020-11-04 10:17:00,10:17,7504425,10052375,2547950,BUY
2020-11-04 10:18:00,10:18,7404850,10050600,2645750,BUY
2020-11-04 10:19:00,10:19,7520225,10031725,2511500,BUY
2020-11-04 10:20:00,10:20,7412725,9885200,2472475,BUY
2020-11-04 10:21:00,10:21,7457250,9881575,2424325,BUY
2020-11-04 10:22:00,10:22,7331500,9859550,2528050,BUY
2020-11-04 10:23:00,10:23,7578925,9903525,2324600,BUY
2020-11-04 10:24:00,10:24,7478675,9916350,2437675,BUY
2020-11-04 10:25:00,10:25,7380400,9912325,2531925,BUY
2020-11-04 10:26:00,10:26,7452850,10020450,2567600,BUY
2020-11-04 10:27:00,10:27,7331950,10020450,2688500,BUY
2020-11-04 10:28:00,10:28,7274225,10022725,2748500,BUY
2020-11-04 10:29:00,10:29,7489250,10051325,2562075,BUY
2020-11-04 10:30:00,10:30,7631150,10046600,2415450,BUY
2020-11-04 10:31:00,10:31,7363800,10049150,2685350,BUY
2020-11-04 10:32:00,10:32,7711275,10084925,2373650,BUY
2020-11-04 10:33:00,10:33,7471300,10092275,2620975,BUY
2020-11-04 10:34:00,10:34,7637475,10085850,2448375,BUY
2020-11-04 10:35:00,10:35,7713625,10162450,2448825,BUY
2020-11-04 10:36:00,10:36,7557900,10146600,2588700,BUY
2020-11-04 10:37:00,10:37,7311025,10133250,2822225,BUY
2020-11-04 10:38:00,10:38,7540475,10265475,2725000,BUY
2020-11-04 10:39:00,10:39,7581125,10249550,2668425,BUY
2020-11-04 10:40:00,10:40,7556650,10260600,2703950,BUY
2020-11-04 10:41:00,10:41,7533525,10250900,2717375,BUY
2020-11-04 10:42:00,10:42,7315325,10238225,2922900,BUY
2020-11-04 10:43:00,10:43,7508775,10231525,2722750,BUY
2020-11-04 10:44:00,10:44,7601200,10239025,2637825,BUY
2020-11-04 10:45:00,10:45,7603950,10262875,2658925,BUY
2020-11-04 10:46:00,10:46,7734400,10279375,2544975,BUY
2020-11-04 10:47:00,10:47,7630500,10282050,2651550,BUY
2020-11-04 10:48:00,10:48,7395950,10290425,2894475,BUY
2020-11-04 10:49:00,10:49,7738325,10258100,2519775,BUY
2020-11-04 10:50:00,10:50,7861250,10313200,2451950,BUY
2020-11-04 10:51:00,10:51,7748200,10317725,2569525,BUY
2020-11-04 10:52:00,10:52,7736125,10326125,2590000,BUY
2020-11-04 10:53:00,10:53,7613400,10348100,2734700,BUY
2020-11-04 10:54:00,10:54,7910800,10351525,2440725,BUY
2020-11-04 10:55:00,10:55,7932475,10330675,2398200,BUY
2020-11-04 10:56:00,10:56,7801925,10384700,2582775,BUY
2020-11-04 10:57:00,10:57,7733000,10372150,2639150,BUY
2020-11-04 10:58:00,10:58,7641450,10391500,2750050,BUY
2020-11-04 10:59:00,10:59,7799275,10431075,2631800,BUY
2020-11-04 11:00:00,11:00,7840425,10432600,2592175,BUY
2020-11-04 11:01:00,11:01,7867800,10383000,2515200,BUY
2020-11-04 11:02:00,11:02,7886675,10581600,2694925,BUY
2020-11-04 11:03:00,11:03,7886350,10477675,2591325,BUY
2020-11-04 11:04:00,11:04,7579325,10474625,2895300,BUY
2020-11-04 11:05:00,11:05,8125700,10585450,2459750,BUY
2020-11-04 11:06:00,11:06,7960275,10564925,2604650,BUY
2020-11-04 11:07:00,11:07,8006050,10563875,2557825,BUY
2020-11-04 11:08:00,11:08,7805700,10489950,2684250,BUY
2020-11-04 11:09:00,11:09,7912025,10483900,2571875,BUY
2020-11-04 11:10:00,11:10,7893975,10467050,2573075,BUY
2020-11-04 11:11:00,11:11,7873600,10533725,2660125,BUY
2020-11-04 11:12:00,11:12,7797700,10540250,2742550,BUY
2020-11-04 11:13:00,11:13,7803725,10538725,2735000,BUY
2020-11-04 11:14:00,11:14,7801950,10557050,2755100,BUY
2020-11-04 11:15:00,11:15,7898200,10564050,2665850,BUY
2020-11-04 11:16:00,11:16,7663275,10573625,2910350,BUY
2020-11-04 11:17:00,11:17,7839100,10600350,2761250,BUY
2020-11-04 11:18:00,11:18,7691500,10593425,2901925,BUY
2020-11-04 11:19:00,11:19,7809475,10605850,2796375,BUY
2020-11-04 11:20:00,11:20,7538275,10619875,3081600,BUY
2020-11-04 11:21:00,11:21,7509800,10615300,3105500,BUY
2020-11-04 11:22:00,11:22,7686850,10611025,2924175,BUY
2020-11-04 11:23:00,11:23,7643775,10657075,3013300,BUY
2020-11-04 11:24:00,11:24,7835250,10682300,2847050,BUY
2020-11-04 11:25:00,11:25,7605250,10679150,3073900,BUY
2020-11-04 11:26:00,11:26,7857825,10662600,2804775,BUY
2020-11-04 11:27:00,11:27,7720975,10682975,2962000,BUY
2020-11-04 11:28:00,11:28,7712300,10692700,2980400,BUY
2020-11-04 11:29:00,11:29,7686925,10688075,3001150,BUY
2020-11-04 11:30:00,11:30,7610600,10698125,3087525,BUY
2020-11-04 11:31:00,11:31,7753525,10703875,2950350,BUY
2020-11-04 11:32:00,11:32,7681050,10645900,2964850,BUY
2020-11-04 11:33:00,11:33,7412200,10708175,3295975,BUY
2020-11-04 11:34:00,11:34,7456050,10715300,3259250,BUY
2020-11-04 11:35:00,11:35,7502000,10717900,3215900,BUY
2020-11-04 11:36:00,11:36,7550650,10663000,3112350,BUY
2020-11-04 11:37:00,11:37,7649500,10714150,3064650,BUY
2020-11-04 11:38:00,11:38,7689425,10754350,3064925,BUY
2020-11-04 11:39:00,11:39,7460375,10732025,3271650,BUY
2020-11-04 11:40:00,11:40,7853450,10737325,2883875,BUY
2020-11-04 11:41:00,11:41,7850800,10741700,2890900,BUY
2020-11-04 11:42:00,11:42,7776750,10745700,2968950,BUY
2020-11-04 11:43:00,11:43,7819825,10708650,2888825,BUY
2020-11-04 11:44:00,11:44,7969000,10801900,2832900,BUY
2020-11-04 11:45:00,11:45,7972375,10799950,2827575,BUY
2020-11-04 11:46:00,11:46,7513025,10732025,3219000,BUY
2020-11-04 11:47:00,11:47,7626000,10796100,3170100,BUY
2020-11-04 11:48:00,11:48,7562550,10723900,3161350,BUY
2020-11-04 11:49:00,11:49,7798125,10794050,2995925,BUY
2020-11-04 11:50:00,11:50,7700925,10740375,3039450,BUY
2020-11-04 11:51:00,11:51,8007100,10797925,2790825,BUY
2020-11-04 11:52:00,11:52,7827425,10802375,2974950,BUY
2020-11-04 11:53:00,11:53,7878100,10741975,2863875,BUY
2020-11-04 11:54:00,11:54,7792275,10713200,2920925,BUY
2020-11-04 11:55:00,11:55,7965475,10781550,2816075,BUY
2020-11-04 11:56:00,11:56,8046525,10747000,2700475,BUY
2020-11-04 11:57:00,11:57,7897275,10740450,2843175,BUY
2020-11-04 11:58:00,11:58,8135425,10798825,2663400,BUY
2020-11-04 11:59:00,11:59,8311225,10770425,2459200,BUY
2020-11-04 12:00:00,12:00,8177550,10830900,2653350,BUY
2020-11-04 12:01:00,12:01,8327850,10856975,2529125,BUY
2020-11-04 12:02:00,12:02,8259400,10834450,2575050,BUY
2020-11-04 12:03:00,12:03,8140750,10828975,2688225,BUY
2020-11-04 12:04:00,12:04,8249150,10831050,2581900,BUY
2020-11-04 12:05:00,12:05,8280975,10756625,2475650,BUY
2020-11-04 12:06:00,12:06,8176600,10745800,2569200,BUY
2020-11-04 12:07:00,12:07,8072000,10753300,2681300,BUY
2020-11-04 12:08:00,12:08,8218025,10715725,2497700,BUY
2020-11-04 12:09:00,12:09,8166225,10666150,2499925,BUY
2020-11-04 12:10:00,12:10,8185625,10752200,2566575,BUY
2020-11-04 12:11:00,12:11,8230875,10703800,2472925,BUY
2020-11-04 12:12:00,12:12,8141375,10767075,2625700,BUY
2020-11-04 12:13:00,12:13,8099975,10704175,2604200,BUY
2020-11-04 12:14:00,12:14,8357975,10740675,2382700,BUY
2020-11-04 12:15:00,12:15,8413325,10752200,2338875,BUY
2020-11-04 12:16:00,12:16,8481650,10757425,2275775,BUY
2020-11-04 12:17:00,12:17,8317775,10691400,2373625,BUY
2020-11-04 12:18:00,12:18,8268825,10683775,2414950,BUY
2020-11-04 12:19:00,12:19,8392525,10691425,2298900,BUY
2020-11-04 12:20:00,12:20,8496800,10706125,2209325,BUY
2020-11-04 12:21:00,12:21,8447000,10733950,2286950,BUY
2020-11-04 12:22:00,12:22,8418275,10722875,2304600,BUY
2020-11-04 12:23:00,12:23,8536675,10726625,2189950,BUY
2020-11-04 12:24:00,12:24,8562925,10745400,2182475,BUY
2020-11-04 12:25:00,12:25,8563600,10746275,2182675,BUY
2020-11-04 12:26:00,12:26,8471625,10795025,2323400,BUY
2020-11-04 12:27:00,12:27,8297475,10780650,2483175,BUY
2020-11-04 12:28:00,12:28,8456800,10768875,2312075,BUY
2020-11-04 12:29:00,12:29,8354950,10829325,2474375,BUY
2020-11-04 12:30:00,12:30,8463125,10770125,2307000,BUY
2020-11-04 12:31:00,12:31,8454925,10835525,2380600,BUY
2020-11-04 12:32:00,12:32,8156625,10873900,2717275,BUY
2020-11-04 12:33:00,12:33,8102000,10872775,2770775,BUY
2020-11-04 12:34:00,12:34,8304725,10876875,2572150,BUY
2020-11-04 12:35:00,12:35,8575950,10872950,2297000,BUY
2020-11-04 12:36:00,12:36,8349550,10887100,2537550,BUY
2020-11-04 12:37:00,12:37,8011650,10768475,2756825,BUY
2020-11-04 12:38:00,12:38,8429050,10973200,2544150,BUY
2020-11-04 12:39:00,12:39,8434925,10952225,2517300,BUY
2020-11-04 12:40:00,12:40,8317950,10952225,2634275,BUY
2020-11-04 12:41:00,12:41,8521375,10973550,2452175,BUY
2020-11-04 12:42:00,12:42,8386925,10974175,2587250,BUY
2020-11-04 12:43:00,12:43,8331075,10990475,2659400,BUY
2020-11-04 12:44:00,12:44,8250350,10973825,2723475,BUY
2020-11-04 12:45:00,12:45,8537025,10994425,2457400,BUY
2020-11-04 12:46:00,12:46,8291825,10986375,2694550,BUY
2020-11-04 12:47:00,12:47,8418850,10947225,2528375,BUY
2020-11-04 12:48:00,12:48,8552400,10926625,2374225,BUY
2020-11-04 12:49:00,12:49,8262425,10925750,2663325,BUY
2020-11-04 12:50:00,12:50,8489850,10925125,2435275,BUY
2020-11-04 12:51:00,12:51,8068125,10766700,2698575,BUY
2020-11-04 12:52:00,12:52,8537500,10869625,2332125,BUY
2020-11-04 12:53:00,12:53,8465350,10854975,2389625,BUY
2020-11-04 12:54:00,12:54,8447825,10914825,2467000,BUY
2020-11-04 12:55:00,12:55,8398375,10861800,2463425,BUY
2020-11-04 12:56:00,12:56,8477350,10968400,2491050,BUY
2020-11-04 12:57:00,12:57,8180800,10972375,2791575,BUY
2020-11-04 12:58:00,12:58,8451275,10977400,2526125,BUY
2020-11-04 12:59:00,12:59,8338000,10962000,2624000,BUY
2020-11-04 13:00:00,13:00,8370825,10987675,2616850,BUY
2020-11-04 13:01:00,13:01,8458600,10860425,2401825,BUY
2020-11-04 13:02:00,13:02,8673125,10904575,2231450,BUY
2020-11-04 13:03:00,13:03,8530725,10906525,2375800,BUY
2020-11-04 13:04:00,13:04,8792525,10931125,2138600,BUY
2020-11-04 13:05:00,13:05,8839275,10790900,1951625,BUY
2020-11-04 13:06:00,13:06,8562350,10779225,2216875,BUY
2020-11-04 13:07:00,13:07,8575800,10769000,2193200,BUY
2020-11-04 13:08:00,13:08,8481400,10851275,2369875,BUY
2020-11-04 13:09:00,13:09,8754825,10867475,2112650,BUY
2020-11-04 13:10:00,13:10,8714400,10882925,2168525,BUY
2020-11-04 13:11:00,13:11,8734325,10837375,2103050,BUY
2020-11-04 13:12:00,13:12,8611450,10845150,2233700,BUY
2020-11-04 13:13:00,13:13,8690450,10847125,2156675,BUY
2020-11-04 13:14:00,13:14,8620050,10607625,1987575,BUY
2020-11-04 13:15:00,13:15,8712775,10613650,1900875,BUY
2020-11-04 13:16:00,13:16,8565675,10611700,2046025,BUY
2020-11-04 13:17:00,13:17,8589825,10513525,1923700,BUY
2020-11-04 13:18:00,13:18,8698375,10528300,1829925,BUY
2020-11-04 13:19:00,13:19,8639700,10510250,1870550,BUY
2020-11-04 13:20:00,13:20,8632750,10478050,1845300,BUY
2020-11-04 13:21:00,13:21,8507450,10433050,1925600,BUY
2020-11-04 13:22:00,13:22,8389025,10429825,2040800,BUY
2020-11-04 13:23:00,13:23,8480000,10321050,1841050,BUY
2020-11-04 13:24:00,13:24,8431500,10178975,1747475,BUY
2020-11-04 13:25:00,13:25,8262350,10183600,1921250,BUY
2020-11-04 13:26:00,13:26,8569900,10192750,1622850,BUY
2020-11-04 13:27:00,13:27,8674025,10189850,1515825,BUY
2020-11-04 13:28:00,13:28,8575450,10175700,1600250,BUY
2020-11-04 13:29:00,13:29,8612025,10139325,1527300,BUY
2020-11-04 13:30:00,13:30,8653825,10197050,1543225,BUY
2020-11-04 13:31:00,13:31,8456175,10191975,1735800,BUY
2020-11-04 13:32:00,13:32,8601750,10205375,1603625,BUY
2020-11-04 13:33:00,13:33,8668850,10249450,1580600,BUY
2020-11-04 13:34:00,13:34,8485025,10229300,1744275,BUY
2020-11-04 13:35:00,13:35,8484625,10240750,1756125,BUY
2020-11-04 13:36:00,13:36,8637225,10173300,1536075,BUY
2020-11-04 13:37:00,13:37,8673225,10157575,1484350,BUY
2020-11-04 13:38:00,13:38,8614000,10149250,1535250,BUY
2020-11-04 13:39:00,13:39,8659025,10203600,1544575,BUY
2020-11-04 13:40:00,13:40,8552150,10200825,1648675,BUY
2020-11-04 13:41:00,13:41,8660775,10209675,1548900,BUY
2020-11-04 13:42:00,13:42,8546375,10249675,1703300,BUY
2020-11-04 13:43:00,13:43,8681475,10249675,1568200,BUY
2020-11-04 13:44:00,13:44,8614375,10256825,1642450,BUY
2020-11-04 13:45:00,13:45,8636125,10190550,1554425,BUY
2020-11-04 13:46:00,13:46,8594825,10174875,1580050,BUY
2020-11-04 13:47:00,13:47,8475400,10173675,1698275,BUY
2020-11-04 13:48:00,13:48,8627250,10268150,1640900,BUY
2020-11-04 13:49:00,13:49,8577900,10261475,1683575,BUY
2020-11-04 13:50:00,13:50,8545000,10259975,1714975,BUY
2020-11-04 13:51:00,13:51,8344725,10251325,1906600,BUY
2020-11-04 13:52:00,13:52,8344775,10271950,1927175,BUY
2020-11-04 13:53:00,13:53,8676400,10273150,1596750,BUY
2020-11-04 13:54:00,13:54,8653375,10334325,1680950,BUY
2020-11-04 13:55:00,13:55,8598875,10333475,1734600,BUY
2020-11-04 13:56:00,13:56,8500475,10316000,1815525,BUY
2020-11-04 13:57:00,13:57,8586800,10385525,1798725,BUY
2020-11-04 13:58:00,13:58,8722075,10399275,1677200,BUY
2020-11-04 13:59:00,13:59,8692825,10389100,1696275,BUY
2020-11-04 14:00:00,14:00,8688575,10319350,1630775,BUY
2020-11-04 14:01:00,14:01,8528150,10314850,1786700,BUY
2020-11-04 14:02:00,14:02,8649375,10316050,1666675,BUY
2020-11-04 14:03:00,14:03,8489250,10392850,1903600,BUY
2020-11-04 14:04:00,14:04,8427175,10388550,1961375,BUY
2020-11-04 14:05:00,14:05,8681525,10351200,1669675,BUY
2020-11-04 14:06:00,14:06,8626400,10258650,1632250,BUY
2020-11-04 14:07:00,14:07,8645125,10258750,1613625,BUY
2020-11-04 14:08:00,14:08,8548600,10254650,1706050,BUY
2020-11-04 14:09:00,14:09,8445675,10334775,1889100,BUY
2020-11-04 14:10:00,14:10,8301525,10357200,2055675,BUY
2020-11-04 14:11:00,14:11,8347250,10336400,1989150,BUY
2020-11-04 14:12:00,14:12,8079800,10360875,2281075,BUY
2020-11-04 14:13:00,14:13,8219375,10362200,2142825,BUY
2020-11-04 14:14:00,14:14,8225900,10361350,2135450,BUY
2020-11-04 14:15:00,14:15,8424075,10438600,2014525,BUY
2020-11-04 14:16:00,14:16,8447400,10425375,1977975,BUY
2020-11-04 14:17:00,14:17,8279475,10421200,2141725,BUY
2020-11-04 14:18:00,14:18,8466550,10475675,2009125,BUY
2020-11-04 14:19:00,14:19,8496275,10490800,1994525,BUY
2020-11-04 14:20:00,14:20,8378550,10488025,2109475,BUY
2020-11-04 14:21:00,14:21,8349900,10568725,2218825,BUY
2020-11-04 14:22:00,14:22,8444125,10568725,2124600,BUY
2020-11-04 14:23:00,14:23,8449125,10569900,2120775,BUY
2020-11-04 14:24:00,14:24,8427200,10533825,2106625,BUY
2020-11-04 14:25:00,14:25,8421775,10487500,2065725,BUY
2020-11-04 14:26:00,14:26,8459025,10547800,2088775,BUY
2020-11-04 14:27:00,14:27,8387750,10571475,2183725,BUY
2020-11-04 14:28:00,14:28,8427425,10571775,2144350,BUY
2020-11-04 14:29:00,14:29,8376450,10573400,2196950,BUY
2020-11-04 14:30:00,14:30,8264250,10653675,2389425,BUY
2020-11-04 14:31:00,14:31,8297550,10593450,2295900,BUY
2020-11-04 14:32:00,14:32,8377225,10650375,2273150,BUY
2020-11-04 14:33:00,14:33,8435425,10691150,2255725,BUY
2020-11-04 14:34:00,14:34,8311925,10692975,2381050,BUY
2020-11-04 14:35:00,14:35,8246675,10694650,2447975,BUY
2020-11-04 14:36:00,14:36,8101400,10713625,2612225,BUY
2020-11-04 14:37:00,14:37,8211525,10777300,2565775,BUY
2020-11-04 14:38:00,14:38,8193250,10777025,2583775,BUY
2020-11-04 14:39:00,14:39,7859600,10636300,2776700,BUY
2020-11-04 14:40:00,14:40,7602875,10648925,3046050,BUY
2020-11-04 14:41:00,14:41,7762525,10637475,2874950,BUY
2020-11-04 14:42:00,14:42,7650100,10673275,3023175,BUY
2020-11-04 14:43:00,14:43,7782700,10668450,2885750,BUY
2020-11-04 14:44:00,14:44,7732025,10687425,2955400,BUY
2020-11-04 14:45:00,14:45,7496225,10746950,3250725,BUY
2020-11-04 14:46:00,14:46,7422175,10618150,3195975,BUY
2020-11-04 14:47:00,14:47,7680650,10762900,3082250,BUY
2020-11-04 14:48:00,14:48,7607575,10894950,3287375,BUY
2020-11-04 14:49:00,14:49,7512825,10893225,3380400,BUY
2020-11-04 14:50:00,14:50,7649975,10894200,3244225,BUY
2020-11-04 14:51:00,14:51,7594700,11005400,3410700,BUY
2020-11-04 14:52:00,14:52,7636675,11017725,3381050,BUY
2020-11-04 14:53:00,14:53,7667775,11017725,3349950,BUY
2020-11-04 14:54:00,14:54,7642500,10998100,3355600,BUY
2020-11-04 14:55:00,14:55,7606875,10998125,3391250,BUY
2020-11-04 14:56:00,14:56,7626800,10998125,3371325,BUY
2020-11-04 14:57:00,14:57,7338900,11018100,3679200,BUY
2020-11-04 14:58:00,14:58,7585125,11033400,3448275,BUY
2020-11-04 14:59:00,14:59,7634200,11034950,3400750,BUY
2020-11-04 15:00:00,15:00,7636600,10962025,3325425,BUY
2020-11-04 15:01:00,15:01,7399500,10961550,3562050,BUY
2020-11-04 15:02:00,15:02,7525125,10965600,3440475,BUY
2020-11-04 15:03:00,15:03,7428200,10948175,3519975,BUY
2020-11-04 15:04:00,15:04,7471750,10946300,3474550,BUY
2020-11-04 15:05:00,15:05,7512675,10948150,3435475,BUY
2020-11-04 15:06:00,15:06,7084525,10879825,3795300,BUY
2020-11-04 15:07:00,15:07,7156650,10870475,3713825,BUY
2020-11-04 15:08:00,15:08,7373125,10870475,3497350,BUY
2020-11-04 15:09:00,15:09,7366900,10832825,3465925,BUY
2020-11-04 15:10:00,15:10,7260825,10832825,3572000,BUY
2020-11-04 15:11:00,15:11,7139625,10830925,3691300,BUY
2020-11-04 15:12:00,15:12,7178550,10753575,3575025,BUY
2020-11-04 15:13:00,15:13,7146625,10755250,3608625,BUY
2020-11-04 15:14:00,15:14,7035575,10749350,3713775,BUY
2020-11-04 15:15:00,15:15,6880700,10663050,3782350,BUY
2020-11-04 15:16:00,15:16,6930925,10691725,3760800,BUY
2020-11-04 15:17:00,15:17,6907600,10683700,3776100,BUY
2020-11-04 15:18:00,15:18,6730475,10542350,3811875,BUY
2020-11-04 15:19:00,15:19,6728950,10548450,3819500,BUY
2020-11-04 15:20:00,15:20,6802900,10566075,3763175,BUY
2020-11-04 15:21:00,15:21,6596600,10465425,3868825,BUY
2020-11-04 15:22:00,15:22,6740850,10469050,3728200,BUY
2020-11-04 15:23:00,15:23,6821975,10452975,3631000,BUY
2020-11-04 15:24:00,15:24,6481825,10154100,3672275,BUY
2020-11-04 15:25:00,15:25,6376250,10147025,3770775,BUY
2020-11-04 15:26:00,15:26,6500575,10155750,3655175,BUY
2020-11-04 15:27:00,15:27,6213950,9927650,3713700,BUY
2020-11-04 15:28:00,15:28,6413950,9915750,3501800,BUY
2020-11-04 15:29:00,15:29,6483525,9912425,3428900,BUY
2020-11-05 09:15:00,09:15,4310675,9671075,5360400,BUY
2020-11-05 09:16:00,09:16,5001625,9671075,4669450,BUY
2020-11-05 09:17:00,09:17,6210700,9880100,3669400,BUY
2020-11-05 09:18:00,09:18,6103400,9883075,3779675,BUY
2020-11-05 09:19:00,09:19,6104625,9843400,3738775,BUY
2020-11-05 09:20:00,09:20,6204025,10284150,4080125,BUY
2020-11-05 09:21:00,09:21,6174875,10284150,4109275,BUY
2020-11-05 09:22:00,09:22,6206725,10281175,4074450,BUY
2020-11-05 09:23:00,09:23,6599275,11242550,4643275,BUY
2020-11-05 09:24:00,09:24,6515400,11241650,4726250,BUY
2020-11-05 09:25:00,09:25,6445950,11241650,4795700,BUY
2020-11-05 09:26:00,09:26,7475850,13194600,5718750,BUY
2020-11-05 09:27:00,09:27,7285700,13192425,5906725,BUY
2020-11-05 09:28:00,09:28,7069700,13147925,6078225,BUY
2020-11-05 09:29:00,09:29,8016625,13981775,5965150,BUY
2020-11-05 09:30:00,09:30,7823950,13981775,6157825,BUY
2020-11-05 09:31:00,09:31,7810125,13968000,6157875,BUY
2020-11-05 09:32:00,09:32,8294825,14410375,6115550,BUY
2020-11-05 09:33:00,09:33,8385100,14413725,6028625,BUY
2020-11-05 09:34:00,09:34,8341400,14376100,6034700,BUY
2020-11-05 09:35:00,09:35,9051000,15069875,6018875,BUY
2020-11-05 09:36:00,09:36,8957500,15026925,6069425,BUY
2020-11-05 09:37:00,09:37,8925100,15069875,6144775,BUY
2020-11-05 09:38:00,09:38,9203950,15678925,6474975,BUY
2020-11-05 09:39:00,09:39,9172825,15723425,6550600,BUY
2020-11-05 09:40:00,09:40,9085350,15721025,6635675,BUY
2020-11-05 09:41:00,09:41,9757275,16108825,6351550,BUY
2020-11-05 09:42:00,09:42,9750800,16072600,6321800,BUY
2020-11-05 09:43:00,09:43,9443250,16070775,6627525,BUY
2020-11-05 09:44:00,09:44,9725275,16454875,6729600,BUY
2020-11-05 09:45:00,09:45,10062100,16451850,6389750,BUY
2020-11-05 09:46:00,09:46,9858425,16368650,6510225,BUY
2020-11-05 09:47:00,09:47,10146400,16677300,6530900,BUY
2020-11-05 09:48:00,09:48,9879650,16771300,6891650,BUY
2020-11-05 09:49:00,09:49,10172725,16730400,6557675,BUY
2020-11-05 09:50:00,09:50,10239450,16741200,6501750,BUY
2020-11-05 09:51:00,09:51,10393300,16781075,6387775,BUY
2020-11-05 09:52:00,09:52,10349525,16767225,6417700,BUY
2020-11-05 09:53:00,09:53,10272925,17109750,6836825,BUY
2020-11-05 09:54:00,09:54,10657775,17159200,6501425,BUY
2020-11-05 09:55:00,09:55,10613250,17156200,6542950,BUY
2020-11-05 09:56:00,09:56,10765250,17368525,6603275,BUY
2020-11-05 09:57:00,09:57,10798325,17403175,6604850,BUY
2020-11-05 09:58:00,09:58,10646175,17412325,6766150,BUY
2020-11-05 09:59:00,09:59,10963400,17649375,6685975,BUY
2020-11-05 10:00:00,10:00,10913275,17530800,6617525,BUY
2020-11-05 10:01:00,10:01,11044325,17446275,6401950,BUY
2020-11-05 10:02:00,10:02,11149125,17970875,6821750,BUY
2020-11-05 10:03:00,10:03,11175500,17951175,6775675,BUY
2020-11-05 10:04:00,10:04,11041525,18034075,6992550,BUY
2020-11-05 10:05:00,10:05,11098400,18247150,7148750,BUY
2020-11-05 10:06:00,10:06,10865725,18334325,7468600,BUY
2020-11-05 10:07:00,10:07,10808650,18334325,7525675,BUY
2020-11-05 10:08:00,10:08,11279100,18358900,7079800,BUY
2020-11-05 10:09:00,10:09,11402425,18557825,7155400,BUY
2020-11-05 10:10:00,10:10,11336275,18602800,7266525,BUY
2020-11-05 10:11:00,10:11,11404050,18774800,7370750,BUY
2020-11-05 10:12:00,10:12,11389550,18835275,7445725,BUY
2020-11-05 10:13:00,10:13,11333650,18835450,7501800,BUY
2020-11-05 10:14:00,10:14,11504250,18980375,7476125,BUY
2020-11-05 10:15:00,10:15,11528300,18913950,7385650,BUY
2020-11-05 10:16:00,10:16,11578550,18886300,7307750,BUY
2020-11-05 10:17:00,10:17,11534400,19122800,7588400,BUY
2020-11-05 10:18:00,10:18,11747675,19155625,7407950,BUY
2020-11-05 10:19:00,10:19,11446925,19213375,7766450,BUY
2020-11-05 10:20:00,10:20,11714025,19048175,7334150,BUY
2020-11-05 10:21:00,10:21,11689375,19203000,7513625,BUY
2020-11-05 10:22:00,10:22,11602525,18758525,7156000,BUY
2020-11-05 10:23:00,10:23,11569775,19162775,7593000,BUY
2020-11-05 10:24:00,10:24,11760450,19199900,7439450,BUY
2020-11-05 10:25:00,10:25,11603350,19341275,7737925,BUY
2020-11-05 10:26:00,10:26,11704975,19440950,7735975,BUY
2020-11-05 10:27:00,10:27,11767075,19202800,7435725,BUY
2020-11-05 10:28:00,10:28,11500100,19436375,7936275,BUY
2020-11-05 10:29:00,10:29,11688500,19367700,7679200,BUY
2020-11-05 10:30:00,10:30,11845275,19471975,7626700,BUY
2020-11-05 10:31:00,10:31,11903450,19309400,7405950,BUY
2020-11-05 10:32:00,10:32,12286700,19369025,7082325,BUY
2020-11-05 10:33:00,10:33,12316650,19469200,7152550,BUY
2020-11-05 10:34:00,10:34,12196250,19372325,7176075,BUY
2020-11-05 10:35:00,10:35,12084375,18916250,6831875,BUY
2020-11-05 10:36:00,10:36,12282375,18933575,6651200,BUY
2020-11-05 10:37:00,10:37,12147700,18830325,6682625,BUY
2020-11-05 10:38:00,10:38,12094225,18786025,6691800,BUY
2020-11-05 10:39:00,10:39,12143275,18861500,6718225,BUY
2020-11-05 10:40:00,10:40,12088175,18819300,6731125,BUY
2020-11-05 10:41:00,10:41,12235850,19009550,6773700,BUY
2020-11-05 10:42:00,10:42,12534825,18750800,6215975,BUY
2020-11-05 10:43:00,10:43,12404400,19115400,6711000,BUY
2020-11-05 10:44:00,10:44,12304775,18697000,6392225,BUY
2020-11-05 10:45:00,10:45,12396300,19008875,6612575,BUY
2020-11-05 10:46:00,10:46,12550050,18944275,6394225,BUY
2020-11-05 10:47:00,10:47,12626400,18956525,6330125,BUY
2020-11-05 10:48:00,10:48,12180650,19011350,6830700,BUY
2020-11-05 10:49:00,10:49,12852500,18875750,6023250,BUY
2020-11-05 10:50:00,10:50,12642400,19024325,6381925,BUY
2020-11-05 10:51:00,10:51,12656700,18839325,6182625,BUY
2020-11-05 10:52:00,10:52,12665125,18801975,6136850,BUY
2020-11-05 10:53:00,10:53,12513150,18958125,6444975,BUY
2020-11-05 10:54:00,10:54,12531350,18988125,6456775,BUY
2020-11-05 10:55:00,10:55,12584475,18748750,6164275,BUY
2020-11-05 10:56:00,10:56,12919500,19274825,6355325,BUY
2020-11-05 10:57:00,10:57,12799000,19274550,6475550,BUY
2020-11-05 10:58:00,10:58,13094975,19077550,5982575,BUY
2020-11-05 10:59:00,10:59,13317200,19072625,5755425,BUY
2020-11-05 11:00:00,11:00,13325175,19124600,5799425,BUY
2020-11-05 11:01:00,11:01,13160400,19122600,5962200,BUY
2020-11-05 11:02:00,11:02,13050575,19066625,6016050,BUY
2020-11-05 11:03:00,11:03,12936600,18887350,5950750,BUY
2020-11-05 11:04:00,11:04,12764100,18914825,6150725,BUY
2020-11-05 11:05:00,11:05,12636400,19039500,6403100,BUY
2020-11-05 11:06:00,11:06,12690200,18614500,5924300,BUY
2020-11-05 11:07:00,11:07,12695175,18822900,6127725,BUY
2020-11-05 11:08:00,11:08,12542725,18662175,6119450,BUY
2020-11-05 11:09:00,11:09,12994300,18907600,5913300,BUY
2020-11-05 11:10:00,11:10,12767925,19109200,6341275,BUY
2020-11-05 11:11:00,11:11,13040875,18949425,5908550,BUY
2020-11-05 11:12:00,11:12,12636025,19093275,6457250,BUY
2020-11-05 11:13:00,11:13,13129725,19384325,6254600,BUY
2020-11-05 11:14:00,11:14,13373725,19467400,6093675,BUY
2020-11-05 11:15:00,11:15,12602750,19567100,6964350,BUY
2020-11-05 11:16:00,11:16,12934075,19385450,6451375,BUY
2020-11-05 11:17:00,11:17,12891275,19432775,6541500,BUY
2020-11-05 11:18:00,11:18,13556100,19658225,6102125,BUY
2020-11-05 11:19:00,11:19,13404375,19700325,6295950,BUY
2020-11-05 11:20:00,11:20,12541600,19668150,7126550,BUY
2020-11-05 11:21:00,11:21,12705100,19712825,7007725,BUY
2020-11-05 11:22:00,11:22,12426350,19681300,7254950,BUY
2020-11-05 11:23:00,11:23,12631250,19862150,7230900,BUY
2020-11-05 11:24:00,11:24,12133475,19734325,7600850,BUY
2020-11-05 11:25:00,11:25,12207775,19533075,7325300,BUY
2020-11-05 11:26:00,11:26,12850125,19945650,7095525,BUY
2020-11-05 11:27:00,11:27,12669675,19964725,7295050,BUY
2020-11-05 11:28:00,11:28,12685100,19738300,7053200,BUY
2020-11-05 11:29:00,11:29,12410400,19960925,7550525,BUY
2020-11-05 11:30:00,11:30,12827075,19905100,7078025,BUY
2020-11-05 11:31:00,11:31,12502975,19382425,6879450,BUY
2020-11-05 11:32:00,11:32,12664175,19847900,7183725,BUY
2020-11-05 11:33:00,11:33,12606900,19785525,7178625,BUY
2020-11-05 11:34:00,11:34,12804575,19686675,6882100,BUY
2020-11-05 11:35:00,11:35,12841350,19550800,6709450,BUY
2020-11-05 11:36:00,11:36,12993025,19837350,6844325,BUY
2020-11-05 11:37:00,11:37,12977175,19912325,6935150,BUY
2020-11-05 11:38:00,11:38,12937775,20056775,7119000,BUY
2020-11-05 11:39:00,11:39,13184275,20102775,6918500,BUY
2020-11-05 11:40:00,11:40,13168725,19973400,6804675,BUY
2020-11-05 11:41:00,11:41,13121800,20056850,6935050,BUY
2020-11-05 11:42:00,11:42,13013475,19943925,6930450,BUY
2020-11-05 11:43:00,11:43,12826250,20030225,7203975,BUY
2020-11-05 11:44:00,11:44,13083000,20180675,7097675,BUY
2020-11-05 11:45:00,11:45,12932625,20067200,7134575,BUY
2020-11-05 11:46:00,11:46,13044175,19144725,6100550,BUY
2020-11-05 11:47:00,11:47,13214300,19865100,6650800,BUY
2020-11-05 11:48:00,11:48,12964550,19946225,6981675,BUY
2020-11-05 11:49:00,11:49,13086600,19735375,6648775,BUY
2020-11-05 11:50:00,11:50,13411875,19947100,6535225,BUY
2020-11-05 11:51:00,11:51,13354725,19858300,6503575,BUY
2020-11-05 11:52:00,11:52,13121925,20067350,6945425,BUY
2020-11-05 11:53:00,11:53,13211850,20370475,7158625,BUY
2020-11-05 11:54:00,11:54,13264625,20383750,7119125,BUY
2020-11-05 11:55:00,11:55,12906775,19889500,6982725,BUY
2020-11-05 11:56:00,11:56,13135550,19972600,6837050,BUY
2020-11-05 11:57:00,11:57,13430975,20390850,6959875,BUY
2020-11-05 11:58:00,11:58,13298075,20151275,6853200,BUY
2020-11-05 11:59:00,11:59,13523775,20512300,6988525,BUY
2020-11-05 12:00:00,12:00,13839500,20163300,6323800,BUY
2020-11-05 12:01:00,12:01,13607450,20394600,6787150,BUY
2020-11-05 12:02:00,12:02,13594400,20344600,6750200,BUY
2020-11-05 12:03:00,12:03,13931950,20564425,6632475,BUY
2020-11-05 12:04:00,12:04,13545900,20278600,6732700,BUY
2020-11-05 12:05:00,12:05,14076950,20422200,6345250,BUY
2020-11-05 12:06:00,12:06,13680700,20290725,6610025,BUY
2020-11-05 12:07:00,12:07,13572575,19923300,6350725,BUY
2020-11-05 12:08:00,12:08,13477000,20101300,6624300,BUY
2020-11-05 12:09:00,12:09,13377900,20580650,7202750,BUY
2020-11-05 12:10:00,12:10,13929525,20366725,6437200,BUY
2020-11-05 12:11:00,12:11,13610000,20004700,6394700,BUY
2020-11-05 12:12:00,12:12,13931100,19909425,5978325,BUY
2020-11-05 12:13:00,12:13,13867250,20690700,6823450,BUY
2020-11-05 12:14:00,12:14,13642600,20140200,6497600,BUY
2020-11-05 12:15:00,12:15,13662050,20802775,7140725,BUY
2020-11-05 12:16:00,12:16,13598475,20739800,7141325,BUY
2020-11-05 12:17:00,12:17,13654225,20706525,7052300,BUY
2020-11-05 12:18:00,12:18,13521425,20912300,7390875,BUY
2020-11-05 12:19:00,12:19,13513900,19800050,6286150,BUY
2020-11-05 12:20:00,12:20,13356600,21056350,7699750,BUY
2020-11-05 12:21:00,12:21,13780350,21116350,7336000,BUY
2020-11-05 12:22:00,12:22,13645825,20972500,7326675,BUY
2020-11-05 12:23:00,12:23,13431550,20507400,7075850,BUY
2020-11-05 12:24:00,12:24,13778975,20726975,6948000,BUY
2020-11-05 12:25:00,12:25,13690750,20520250,6829500,BUY
2020-11-05 12:26:00,12:26,13528400,21321500,7793100,BUY
2020-11-05 12:27:00,12:27,13785175,21138825,7353650,BUY
2020-11-05 12:28:00,12:28,13627350,20368725,6741375,BUY
2020-11-05 12:29:00,12:29,13638800,20702650,7063850,BUY
2020-11-05 12:30:00,12:30,13901475,20921125,7019650,BUY
2020-11-05 12:31:00,12:31,13516600,21301800,7785200,BUY
2020-11-05 12:32:00,12:32,13727425,21384525,7657100,BUY
2020-11-05 12:33:00,12:33,14061375,21420450,7359075,BUY
2020-11-05 12:34:00,12:34,13780900,21427025,7646125,BUY
2020-11-05 12:35:00,12:35,13037325,21162325,8125000,BUY
2020-11-05 12:36:00,12:36,13271725,21378025,8106300,BUY
2020-11-05 12:37:00,12:37,12913550,21298525,8384975,BUY
2020-11-05 12:38:00,12:38,13255000,21435475,8180475,BUY
2020-11-05 12:39:00,12:39,12836400,20989875,8153475,BUY
2020-11-05 12:40:00,12:40,13045675,21297400,8251725,BUY
2020-11-05 12:41:00,12:41,13144000,21530475,8386475,BUY
2020-11-05 12:42:00,12:42,13448350,21350600,7902250,BUY
2020-11-05 12:43:00,12:43,13024550,21546350,8521800,BUY
2020-11-05 12:44:00,12:44,13102025,21102275,8000250,BUY
2020-11-05 12:45:00,12:45,13397625,21495775,8098150,BUY
2020-11-05 12:46:00,12:46,13058600,21736525,8677925,BUY
2020-11-05 12:47:00,12:47,13400375,21741700,8341325,BUY
2020-11-05 12:48:00,12:48,13286550,21491425,8204875,BUY
2020-11-05 12:49:00,12:49,13261850,21807200,8545350,BUY
2020-11-05 12:50:00,12:50,13021350,21315150,8293800,BUY
2020-11-05 12:51:00,12:51,13206550,21988375,8781825,BUY
2020-11-05 12:52:00,12:52,13173175,21351800,8178625,BUY
2020-11-05 12:53:00,12:53,13456975,21569475,8112500,BUY
2020-11-05 12:54:00,12:54,13380425,21871800,8491375,BUY
2020-11-05 12:55:00,12:55,13417700,21606900,8189200,BUY
2020-11-05 12:56:00,12:56,13019900,21328250,8308350,BUY
2020-11-05 12:57:00,12:57,13009050,21689025,8679975,BUY
2020-11-05 12:58:00,12:58,13329700,21710225,8380525,BUY
2020-11-05 12:59:00,12:59,13400200,21836900,8436700,BUY
2020-11-05 13:00:00,13:00,13031975,22028825,8996850,BUY
2020-11-05 13:01:00,13:01,13022025,21866000,8843975,BUY
2020-11-05 13:02:00,13:02,12804975,21882850,9077875,BUY
2020-11-05 13:03:00,13:03,13014525,22090500,9075975,BUY
2020-11-05 13:04:00,13:04,13093725,21704800,8611075,BUY
2020-11-05 13:05:00,13:05,13128450,22058950,8930500,BUY
2020-11-05 13:06:00,13:06,12973350,21917875,8944525,BUY
2020-11-05 13:07:00,13:07,13045625,21763400,8717775,BUY
2020-11-05 13:08:00,13:08,12837375,22026250,9188875,BUY
2020-11-05 13:09:00,13:09,12858900,22149600,9290700,BUY
2020-11-05 13:10:00,13:10,12894675,22038500,9143825,BUY
2020-11-05 13:11:00,13:11,13156775,22354225,9197450,BUY
2020-11-05 13:12:00,13:12,12957800,22200675,9242875,BUY
2020-11-05 13:13:00,13:13,13029450,22020775,8991325,BUY
2020-11-05 13:14:00,13:14,12542675,22099750,9557075,BUY
2020-11-05 13:15:00,13:15,12827600,22351825,9524225,BUY
2020-11-05 13:16:00,13:16,13008775,22075150,9066375,BUY
2020-11-05 13:17:00,13:17,13183800,22320575,9136775,BUY
2020-11-05 13:18:00,13:18,13046025,22077525,9031500,BUY
2020-11-05 13:19:00,13:19,12904525,22057075,9152550,BUY
2020-11-05 13:20:00,13:20,13159625,22255925,9096300,BUY
2020-11-05 13:21:00,13:21,13275950,22423150,9147200,BUY
2020-11-05 13:22:00,13:22,13395050,22351350,8956300,BUY
2020-11-05 13:23:00,13:23,13086350,22572625,9486275,BUY
2020-11-05 13:24:00,13:24,12863625,21694050,8830425,BUY
2020-11-05 13:25:00,13:25,12800025,21965525,9165500,BUY
2020-11-05 13:26:00,13:26,12759575,21814175,9054600,BUY
2020-11-05 13:27:00,13:27,12973950,22044500,9070550,BUY
2020-11-05 13:28:00,13:28,12508725,20818900,8310175,BUY
2020-11-05 13:29:00,13:29,13057100,21662325,8605225,BUY
2020-11-05 13:30:00,13:30,13190075,21991575,8801500,BUY
2020-11-05 13:31:00,13:31,13150200,22121175,8970975,BUY
2020-11-05 13:32:00,13:32,13035350,21801600,8766250,BUY
2020-11-05 13:33:00,13:33,13132625,22183175,9050550,BUY
2020-11-05 13:34:00,13:34,13221975,22137725,8915750,BUY
2020-11-05 13:35:00,13:35,13331125,22139500,8808375,BUY
2020-11-05 13:36:00,13:36,13297500,22077075,8779575,BUY
2020-11-05 13:37:00,13:37,13040600,21434175,8393575,BUY
2020-11-05 13:38:00,13:38,13203525,22318900,9115375,BUY
2020-11-05 13:39:00,13:39,12890250,22455850,9565600,BUY
2020-11-05 13:40:00,13:40,13278975,22061600,8782625,BUY
2020-11-05 13:41:00,13:41,12785000,22405675,9620675,BUY
2020-11-05 13:42:00,13:42,13010375,22595875,9585500,BUY
2020-11-05 13:43:00,13:43,13142575,22504450,9361875,BUY
2020-11-05 13:44:00,13:44,12631300,22570075,9938775,BUY
2020-11-05 13:45:00,13:45,12951725,22443575,9491850,BUY
2020-11-05 13:46:00,13:46,12866425,22518600,9652175,BUY
2020-11-05 13:47:00,13:47,12699225,22169475,9470250,BUY
2020-11-05 13:48:00,13:48,12674125,22339650,9665525,BUY
2020-11-05 13:49:00,13:49,13009300,22278900,9269600,BUY
2020-11-05 13:50:00,13:50,12884875,22294775,9409900,BUY
2020-11-05 13:51:00,13:51,12962000,22378900,9416900,BUY
2020-11-05 13:52:00,13:52,12932500,22633450,9700950,BUY
2020-11-05 13:53:00,13:53,12830750,22751025,9920275,BUY
2020-11-05 13:54:00,13:54,12677850,22637300,9959450,BUY
2020-11-05 13:55:00,13:55,12975100,22677600,9702500,BUY
2020-11-05 13:56:00,13:56,13343675,22611850,9268175,BUY
2020-11-05 13:57:00,13:57,12869900,22573950,9704050,BUY
2020-11-05 13:58:00,13:58,12765775,22325200,9559425,BUY
2020-11-05 13:59:00,13:59,12499625,22615475,10115850,BUY
2020-11-05 14:00:00,14:00,13184575,22329575,9145000,BUY
2020-11-05 14:01:00,14:01,13111250,22661675,9550425,BUY
2020-11-05 14:02:00,14:02,12912225,22700100,9787875,BUY
2020-11-05 14:03:00,14:03,13319575,22656825,9337250,BUY
2020-11-05 14:04:00,14:04,13092825,22728600,9635775,BUY
2020-11-05 14:05:00,14:05,13083075,22455575,9372500,BUY
2020-11-05 14:06:00,14:06,13534850,22763525,9228675,BUY
2020-11-05 14:07:00,14:07,13204650,22731475,9526825,BUY
2020-11-05 14:08:00,14:08,13126450,22537975,9411525,BUY
2020-11-05 14:09:00,14:09,12975725,22593300,9617575,BUY
2020-11-05 14:10:00,14:10,13186075,22686725,9500650,BUY
2020-11-05 14:11:00,14:11,13089325,22150125,9060800,BUY
2020-11-05 14:12:00,14:12,13295525,22550225,9254700,BUY
2020-11-05 14:13:00,14:13,12879300,22552325,9673025,BUY
2020-11-05 14:14:00,14:14,13106475,22555250,9448775,BUY
2020-11-05 14:15:00,14:15,13417525,22453650,9036125,BUY
2020-11-05 14:16:00,14:16,13378775,22581600,9202825,BUY
2020-11-05 14:17:00,14:17,13123050,22635900,9512850,BUY
2020-11-05 14:18:00,14:18,13394700,22223300,8828600,BUY
2020-11-05 14:19:00,14:19,13217050,22371700,9154650,BUY
2020-11-05 14:20:00,14:20,13246650,22275250,9028600,BUY
2020-11-05 14:21:00,14:21,12814875,22316400,9501525,BUY
2020-11-05 14:22:00,14:22,12849525,22191025,9341500,BUY
2020-11-05 14:23:00,14:23,13168200,22316100,9147900,BUY
2020-11-05 14:24:00,14:24,12607225,21960975,9353750,BUY
2020-11-05 14:25:00,14:25,12668800,21949825,9281025,BUY
2020-11-05 14:26:00,14:26,12448900,21969675,9520775,BUY
2020-11-05 14:27:00,14:27,13046025,21989825,8943800,BUY
2020-11-05 14:28:00,14:28,12780800,22041975,9261175,BUY
2020-11-05 14:29:00,14:29,12819325,22044600,9225275,BUY
2020-11-05 14:30:00,14:30,12763050,22001300,9238250,BUY
2020-11-05 14:31:00,14:31,12609850,21866675,9256825,BUY
2020-11-05 14:32:00,14:32,12758675,21910525,9151850,BUY
2020-11-05 14:33:00,14:33,12912125,21663500,8751375,BUY
2020-11-05 14:34:00,14:34,12862325,21600200,8737875,BUY
2020-11-05 14:35:00,14:35,13112950,21864625,8751675,BUY
2020-11-05 14:36:00,14:36,12944775,21596025,8651250,BUY
2020-11-05 14:37:00,14:37,12957400,21676725,8719325,BUY
2020-11-05 14:38:00,14:38,12985200,21575700,8590500,BUY
2020-11-05 14:39:00,14:39,13179400,21736500,8557100,BUY
2020-11-05 14:40:00,14:40,12930500,21874525,8944025,BUY
2020-11-05 14:41:00,14:41,12821900,21735325,8913425,BUY
2020-11-05 14:42:00,14:42,12896225,21633000,8736775,BUY
2020-11-05 14:43:00,14:43,12916825,21610575,8693750,BUY
2020-11-05 14:44:00,14:44,12916800,21755825,8839025,BUY
2020-11-05 14:45:00,14:45,13004500,21518075,8513575,BUY
2020-11-05 14:46:00,14:46,12904625,21453025,8548400,BUY
2020-11-05 14:47:00,14:47,12788900,21479750,8690850,BUY
2020-11-05 14:48:00,14:48,12881800,21119100,8237300,BUY
2020-11-05 14:49:00,14:49,13288725,21199125,7910400,BUY
2020-11-05 14:50:00,14:50,13214425,21162475,7948050,BUY
2020-11-05 14:51:00,14:51,12721950,20528975,7807025,BUY
2020-11-05 14:52:00,14:52,12619350,20357800,7738450,BUY
2020-11-05 14:53:00,14:53,12671075,20429225,7758150,BUY
2020-11-05 14:54:00,14:54,12631650,20419700,7788050,BUY
2020-11-05 14:55:00,14:55,12565150,20201275,7636125,BUY
2020-11-05 14:56:00,14:56,12462475,20150875,7688400,BUY
2020-11-05 14:57:00,14:57,12629750,20565800,7936050,BUY
2020-11-05 14:58:00,14:58,12561650,20586850,8025200,BUY
2020-11-05 14:59:00,14:59,12536975,20622125,8085150,BUY
2020-11-05 15:00:00,15:00,12932450,20510050,7577600,BUY
2020-11-05 15:01:00,15:01,12856750,20465900,7609150,BUY
2020-11-05 15:02:00,15:02,12772525,20452500,7679975,BUY
2020-11-05 15:03:00,15:03,12784775,20204500,7419725,BUY
2020-11-05 15:04:00,15:04,12967075,20197375,7230300,BUY
2020-11-05 15:05:00,15:05,12978750,20191050,7212300,BUY
2020-11-05 15:06:00,15:06,12438950,19610375,7171425,BUY
2020-11-05 15:07:00,15:07,12571075,19547825,6976750,BUY
2020-11-05 15:08:00,15:08,12599875,19542300,6942425,BUY
2020-11-05 15:09:00,15:09,12473450,18909375,6435925,BUY
2020-11-05 15:10:00,15:10,12530975,19181425,6650450,BUY
2020-11-05 15:11:00,15:11,12331150,19202925,6871775,BUY
2020-11-05 15:12:00,15:12,11897550,18750925,6853375,BUY
2020-11-05 15:13:00,15:13,11725800,18440550,6714750,BUY
2020-11-05 15:14:00,15:14,11818100,18523400,6705300,BUY
2020-11-05 15:15:00,15:15,11486300,17820800,6334500,BUY
2020-11-05 15:16:00,15:16,11503125,18072125,6569000,BUY
2020-11-05 15:17:00,15:17,11599100,18133850,6534750,BUY
2020-11-05 15:18:00,15:18,10762700,17725700,6963000,BUY
2020-11-05 15:19:00,15:19,10821250,17735425,6914175,BUY
2020-11-05 15:20:00,15:20,10677325,17801925,7124600,BUY
2020-11-05 15:21:00,15:21,10009725,17086150,7076425,BUY
2020-11-05 15:22:00,15:22,9985850,17271100,7285250,BUY
2020-11-05 15:23:00,15:23,9816925,16969525,7152600,BUY
2020-11-05 15:24:00,15:24,9387625,16124050,6736425,BUY
2020-11-05 15:25:00,15:25,9431325,16216375,6785050,BUY
2020-11-05 15:26:00,15:26,9448675,16209100,6760425,BUY
2020-11-05 15:27:00,15:27,8374500,14796925,6422425,BUY
2020-11-05 15:28:00,15:28,8381725,14910550,6528825,BUY
2020-11-05 15:29:00,15:29,8361175,13891000,5529825,BUY
